,001,01,05,10,10 healthy,100,11,12,12 healthy,13,14,14 healthy,15,15 healthy,16,16 healthy,17,18,18 healthy,19,20,20 healthy,200,2007,2014,2014 2014,2014 wiley,21,22,23,24,25,26,27,28,29,30,31,32,33,34,35,36,37,38,39,3d,3t,40,41,42,44,45,46,47,48,50,60,70,75,80,90,aberrant,abilities,ability,able,abnormal,abnormalities,abnormality,absence,absent,absolute,abstract,abuse,acc,access,accompanied,accordance,according,accordingly,account,accounted,accounts,accumbens,accuracy,accurate,accurately,achieve,achieved,acoustic,acquired,acquisition,act,action,action observation,actions,activate,activates,activations,active,actively,activities,acts,actual,actually,acute,ad,adaptation,adapted,adaptive,add,addiction,addition,additional,additionally,addressed,adhd,adjacent,administered,administration,adolescence,adolescent,adolescents,adopted,adult,adulthood,adults,advance,advanced,advantage,affect,affected,affecting,affective,affects,age,age controls,age gender,age groups,age healthy,age sex,aged,agent,ages,aging,agreement,aim,aimed,aims,al,alcohol,alff,algorithm,allele,allocation,allow,allowed,allowing,allows,alpha,alter,alteration,alterations,altered,alternating,alternative,alters,alzheimer,alzheimer disease,ambiguous,amplitude,amplitude low,amplitudes,amygdala,amygdala anterior,amygdala hippocampus,amygdala insula,amygdala response,amygdala responses,analysed,analyses,analyze,analyzed,analyzed using,anatomical,anatomically,anatomy,anger,angry,angular,angular gyrus,animal,animals,anisotropy,anisotropy fa,anterior,anterior cingulate,anterior hippocampus,anterior inferior,anterior insula,anterior insular,anterior intraparietal,anterior medial,anterior posterior,anterior prefrontal,anterior superior,anterior temporal,anticipated,anticipation,anticipatory,anxiety,anxiety disorders,aphasia,apparent,appear,appeared,appears,application,applied,apply,applying,appraisal,approach,approaches,appropriate,approximately,architecture,argue,arise,arithmetic,arm,arousal,array,arterial,arterial spin,articulatory,asd,asked,aspect,aspects,assess,assessed,assessed using,assessing,assessment,assessments,assigned,association,association cortex,associations,associative,assume,assumed,assumption,asymmetry,atrophy,attempt,attempted,attend,attended,attending,attention,attention deficit,attention network,attention task,attentional,attentional control,attenuated,attenuation,attribute,attributed,attributes,attribution,atypical,audio,audiovisual,auditory,auditory cortex,auditory cortices,auditory stimuli,auditory visual,autism,autism spectrum,autobiographical,autobiographical memory,automated,automatic,automatically,autonomic,available,average,aversive,avoid,avoidance,awareness,away,axis,ba,ba 10,ba 40,ba 44,background,balance,band,basal,basal ganglia,baseline,bases,basic,basis,bayesian,beginning,behavior,behavioral,behavioral level,behavioral measures,behavioral performance,behavioral responses,behaviorally,behaviors,behaviour,behavioural,belief,beliefs,believed,beneficial,benefit,benefits,best,beta,better,better understanding,bias,biased,biases,bilaterally,bilinguals,binding,biological,bipolar,bipolar disorder,blind,block,block design,blocked,blocks,blood,blood flow,blood oxygen,blood oxygenation,bodily,body,bold,bold response,bold responses,bold signal,bold signals,brains,brainstem,brief,broad,broader,broca,brodmann,brodmann ba,button,calculated,calculation,called,callosum,canonical,capacity,capture,carried,carriers,case,cases,categorical,categories,categorization,category,caudal,caudate,caudate nucleus,causal,causal modeling,causality,cause,caused,causes,center,centered,central,central role,cerebellar,cerebellum,cerebral,cerebral blood,cerebral cortex,certain,challenge,challenges,challenging,change,changed,changing,character,characteristic,characteristics,characterization,characterize,characterized,characterizing,characters,childhood,children,chinese,choice,choices,choose,chosen,chronic,chronic pain,cingulate,cingulate cortex,cingulate cortices,cingulate gyrus,circuit,circuitry,circuits,clarify,class,classic,classical,classification,classified,clear,clearly,clinical,clinically,clips,close,closed,closely,cluster,clusters,code,coding,cognition,cognitive,cognitive control,cognitive deficits,cognitive emotional,cognitive function,cognitive functions,cognitive impairment,cognitive neuroscience,cognitive performance,cognitive processes,cognitive task,cognitive tasks,cognitively,coherence,coherent,cohort,collected,collectively,color,combination,combinations,combined,combining,common,commonly,communication,community,comparable,compare,comparing,comparisons,compatible,compensate,compensation,compensatory,competing,competition,complementary,complete,completed,completely,complex,complexity,component,component ica,components,composed,comprehension,comprehensive,comprised,compulsive,compulsive disorder,computation,computational,computed,concentration,concept,concepts,conceptual,concerning,conclude,conclusion,concomitant,concrete,concurrent,concurrently,condition,conditioned,conditioning,conditions,conductance,conducted,confirm,confirmed,conflict,conflicting,confounding,congruency,congruent,congruent incongruent,conjunction,connected,connection,connections,connectivity,connectivity amygdala,connectivity analyses,connectivity fc,connectivity networks,connectivity patterns,connectivity posterior,conscious,consciousness,consecutive,consequence,consequences,consequently,consider,considerable,considered,considering,consisted,consistency,consistently,consisting,consists,consolidation,constant,constitute,constrained,constraints,construct,constructed,construction,contain,contained,containing,contains,content,contents,context,contexts,contextual,continuous,continuously,contralateral,contralateral primary,contrary,contrast,contrasted,contrasting,contrasts,contribute,contributes,contributing,contribution,contributions,control,control condition,control conditions,control group,control groups,control network,control processes,control task,controlled,controlling,controls,controls hc,controversial,conventional,convergence,converging,conversely,conveyed,coordinates,coordination,core,corpus,corpus callosum,correct,corrected,correction,correctly,correlate,correlated,correlated negatively,correlated positively,correlates,correlating,correlation,correlation analyses,correlations,correspond,corresponded,correspondence,corresponding,cortex acc,cortex amygdala,cortex anterior,cortex ba,cortex bilaterally,cortex cerebellum,cortex contrast,cortex dacc,cortex dlpfc,cortex dorsal,cortex dorsolateral,cortex frontal,cortex hippocampus,cortex inferior,cortex insula,cortex involved,cortex lateral,cortex m1,cortex medial,cortex middle,cortex mpfc,cortex ofc,cortex parietal,cortex pcc,cortex pfc,cortex posterior,cortex ppc,cortex precuneus,cortex suggest,cortex superior,cortex supplementary,cortex thalamus,cortex ventral,cortex vlpfc,cortex vmpfc,cortical,cortical involved,cortical motor,cortical network,cortical networks,cortical subcortical,cortical thickness,cortices,cortico,coupled,coupling,course,courses,covariance,covaried,covert,craving,created,criteria,critical,critical role,critically,cross,cross modal,cross sectional,crossover,crucial,crucial role,crucially,crus,cue,cued,cues,cuneus,current,current functional,currently,cycle,dacc,daily,daily life,damage,date,day,days,deactivated,deactivation,deactivations,debate,debated,decision,decision making,decision task,decisions,declarative,decline,decoding,decreases,decreasing,dedicated,deep,default,default mode,default network,deficient,deficit,deficit hyperactivity,deficits,define,defined,degree,degrees,delay,delayed,delineate,delivered,demand,demanding,demands,dementia,demonstrate,demonstrated,demonstrates,demonstrating,density,depend,depended,dependence,depending,depends,depicting,depressed,depression,depressive,depressive disorder,deprivation,depth,derived,described,describing,design,designed,designs,despite,detailed,details,detect,detected,detecting,detection,detection task,determine,determined,determining,develop,developed,developing,development,developmental,diagnosed,diagnosis,diagnostic,did,did differ,differ,differed,difference,differential,differentially,differentiate,differentiated,differentiation,differently,differing,differs,difficult,difficulties,difficulty,diffusion,diffusion tensor,digit,dimension,dimensional,dimensions,diminished,direct,direct evidence,directed,direction,directions,directly,discrete,discriminate,discriminated,discriminating,discrimination,discrimination task,discriminative,discuss,discussed,disease,disease ad,disease pd,diseases,disgust,disorder,disorder adhd,disorder mdd,disorder ptsd,disorders,display,displayed,displays,disrupted,disruption,dissociable,dissociate,dissociated,dissociation,dissociations,distance,distinction,distinguish,distinguished,distraction,distractor,distractors,distress,distributed,distributed network,distribution,disturbances,divergent,diverse,divided,dlpfc,dmn,dmpfc,documented,does,domain,domain general,domains,dominance,dominant,dopamine,dopaminergic,dorsal,dorsal anterior,dorsal attention,dorsal medial,dorsal premotor,dorsal striatum,dorsal ventral,dorsolateral,dorsolateral pfc,dorsolateral prefrontal,dorsomedial,dorsomedial prefrontal,dose,dot,double,double blind,drive,driven,driving,drug,drugs,dti,dual,duration,dynamic,dynamic causal,dynamically,dynamics,dysfunction,dysfunctional,dysfunctions,dyslexia,dysregulation,earlier,early,early stage,early stages,early visual,easy,eating,echo,economic,education,eeg,effect,effective,effective connectivity,effectively,effects,efficacy,efficiency,efficient,effort,effortful,eighteen,elderly,electrical,electroencephalography,electroencephalography eeg,electrophysiological,elements,elevated,elicit,elicited,elicits,elucidate,elucidated,embedded,emerge,emerged,emerging,emission,emission tomography,emotion,emotion regulation,emotional,emotional faces,emotional information,emotional neutral,emotional responses,emotional stimuli,emotional valence,emotionally,emotions,empathic,empathy,emphasize,empirical,employed,employing,enable,enabled,enables,encode,encoded,encoding,encoding retrieval,encompassing,end,endogenous,engage,engaged,engagement,engages,engaging,english,enhance,enhancement,enhances,enhancing,entire,environment,environmental,environments,epilepsy,episode,episodes,episodic,episodic memory,equal,equally,equation,equivalent,erp,erps,error,errors,especially,essential,establish,established,estimate,estimated,estimates,estimation,et,et al,evaluate,evaluated,evaluating,evaluation,evaluations,event,event design,event functional,event potential,event potentials,events,everyday,everyday life,evidence,evidence suggests,evidenced,evident,evoke,evoked,evolution,exact,examination,examines,examining,example,excessive,exclusively,executed,execution,executive,executive control,executive function,executive functions,exert,exhibit,exhibited,exhibited greater,exhibiting,exist,existence,existing,exists,expectancy,expectation,expectations,expected,experience,experienced,experiences,experiencing,experiment,experimental,experimental conditions,experimentally,experiments,expertise,explain,explained,explanation,explicit,explicitly,exploration,exploratory,explore,explored,exploring,exposed,exposure,expressed,expression,expressions,extend,extended,extending,extends,extension,extensive,extensively,extent,external,externally,extinction,extra,extract,extracted,extrastriate,extrastriate visual,eye,eye field,eye fields,eye movement,eye movements,eyes,fa,face,face ffa,face recognition,face stimuli,faces,facial,facial expression,facial expressions,facilitate,facilitated,facilitates,facilitation,fact,factor,factorial,factorial design,factors,failed,failure,false,familiar,familiarity,family,far,fasciculus,fashion,fast,faster,favor,fc,fear,fearful,fearful faces,feature,features,feedback,feeling,feelings,female,females,ffa,fiber,field,fields,final,finally,fine,finger,finger movements,finger tapping,fixation,fixed,flexibility,flexible,flexibly,flow,fluctuations,fluency,focal,foci,focus,focused,focusing,follow,followed,following,food,foot,force,form,formation,formed,forming,forms,forward,fourteen,fractional,fractional anisotropy,framework,free,frequencies,frequency,frequency fluctuations,frequent,frequently,frontal,frontal cortex,frontal cortices,frontal eye,frontal gyri,frontal gyrus,frontal lobe,frontal lobes,frontal operculum,frontal parietal,frontal temporal,fronto,fronto parietal,fronto striatal,fronto temporal,frontoparietal,frontoparietal network,frontopolar,frontotemporal,fully,function,functional abnormalities,functional connectivity,functional coupling,functional magnetic,functional network,functional networks,functional neuroanatomy,functional organization,functional role,functional structural,functionally,functionally connected,functioning,functions,fundamental,furthermore,fusiform,fusiform face,fusiform gyri,fusiform gyrus,future,gain,gains,gambling,game,gamma,ganglia,gaze,gender,gene,general,general linear,generalized,generally,generate,generated,generating,generation,genetic,genotype,german,gestures,given,global,globus,globus pallidus,gm,goal,goal directed,goals,good,gradient,graph,grasping,gray,gray matter,greater,greatest,grey,grey matter,group,group healthy,group level,groups,growing,guide,guided,gyri,gyrus,gyrus anterior,gyrus ba,gyrus cerebellum,gyrus ifg,gyrus inferior,gyrus insula,gyrus medial,gyrus mfg,gyrus middle,gyrus posterior,gyrus precuneus,gyrus stg,gyrus superior,half,hand,hand movements,handed,handedness,hands,happy,happy faces,having,hc,head,health,healthy,healthy adults,healthy control,healthy controls,healthy handed,healthy human,healthy individuals,healthy male,healthy volunteers,healthy young,heard,hearing,heart,heat,heightened,held,help,hemifield,hemisphere,hemispheres,hemispheric,hemodynamic,hemodynamic response,hemodynamic responses,heschl,heschl gyrus,heterogeneity,heterogeneous,hierarchical,high,high frequency,high functioning,high level,high low,high resolution,high risk,higher,higher level,higher order,highest,highlight,highlighted,highlights,highly,hippocampal,hippocampus,history,hoc,homogeneity,homogeneity reho,hum,hum mapp,human,humans,hyperactivation,hyperactivity,hyperactivity disorder,hypoactivation,hypothalamus,hypotheses,hypothesize,hypothesized,hz,ica,idea,identical,identification,identified,identify,identifying,identity,ifg,ii,iii,illness,illusion,illustrate,image,imagery,images,images acquired,imagine,imagined,imitation,immediate,immediately,impact,impaired,impairment,impairment mci,impairments,implementation,implemented,implicate,implicated,implications,implicit,imply,importance,important,important role,importantly,improve,improved,improvement,improvements,improves,impulsivity,incentive,incentive delay,incidental,include,included,includes,incongruent,inconsistent,incorrect,increases,increasing,increasingly,independent,independent component,independently,index,index finger,indexed,indicate,indicated,indicates,indicating,indices,indirect,individual,individually,individuals,induce,induced,induces,inducing,induction,infer,inference,inferences,inferior,inferior frontal,inferior middle,inferior occipital,inferior parietal,inferior prefrontal,inferior superior,inferior temporal,influence,influenced,influences,information,inhibit,inhibiting,inhibition,inhibitory,inhibitory control,initial,initially,initiation,injury,input,inputs,insight,insights,instead,instructed,instruction,instructions,insula,insula anterior,insula inferior,insular,insular cortex,intact,integrate,integrated,integrating,integration,integrative,integrity,intelligence,intended,intense,intensity,intention,intentional,intentions,inter,interact,interacting,interaction,interactions,interactive,interestingly,interference,interhemispheric,intermediate,internal,internally,interoceptive,interpersonal,interplay,interpret,interpretation,interpreted,interval,intervals,intervention,interventions,intra,intraparietal,intraparietal sulcus,intrinsic,intrinsic functional,introduced,introduction,invasive,inverse,inversely,investigates,investigating,investigation,investigations,involve,involved,involved cognitive,involvement,involves,involving,ipl,ips,ipsilateral,iq,irrelevant,irrespective,isolate,isolated,issue,issues,item,items,iv,joint,judge,judged,judgment,judgment task,judgments,junction,junction tpj,just,key,key role,kinds,know,knowledge,known,known involved,labeling,laboratory,lack,lacking,language,language comprehension,language network,languages,large,large scale,largely,largely unknown,larger,late,latencies,latency,later,lateral,lateral frontal,lateral medial,lateral occipital,lateral orbitofrontal,lateral parietal,lateral prefrontal,lateral temporal,laterality,lateralization,lateralized,lead,leading,leads,learn,learned,learning,learning task,led,length,lesion,lesions,lesser,letter,letters,level,level bold,level signal,levels,lexical,lexical decision,life,light,like,likelihood,likely,limb,limbic,limitations,limited,line,linear,linear model,linearly,lingual,lingual gyrus,linguistic,link,linked,linking,links,list,listened,listeners,listening,literature,little,little known,load,lobe,lobe mtl,lobes,lobule,lobule ipl,lobules,local,localization,localize,localized,located,location,locations,locus,long,long term,longer,longitudinal,loop,loss,losses,low,low frequency,low high,low level,lower,m1,machine,magnetic,magnetic resonance,magnetic stimulation,magnetoencephalography,magnitude,main,main effect,mainly,maintain,maintained,maintaining,maintenance,major,major depression,major depressive,majority,make,making,male,male female,males,manifest,manipulated,manipulating,manipulation,manipulations,manner,manual,map,mapp,mapped,mapping,maps,marked,marker,markers,masked,mass,match,matching,matching task,material,materials,matrix,matter,matter gm,matter volume,matter volumes,maturation,maximal,maximum,mci,mdd,mean,mean age,meaning,meaningful,means,measure,measurement,measurements,measures,measuring,mechanism,mechanisms,mechanisms involved,mechanisms underlying,medial,medial frontal,medial lateral,medial orbitofrontal,medial prefrontal,medial superior,medial temporal,median,mediate,mediated,mediates,mediating,medication,meg,memories,memory,memory encoding,memory load,memory performance,memory processes,memory retrieval,memory task,memory tasks,memory wm,men,men women,mental,mental imagery,mental state,mental states,mentalizing,mesial,mesolimbic,met,metabolic,metabolism,method,methodological,methodology,methodology principal,methods,methods functional,mfg,mg,mid,midbrain,middle,middle cingulate,middle frontal,middle inferior,middle occipital,middle superior,middle temporal,midline,mild,mild cognitive,min,mind,mind tom,minimal,mirror,mirror neuron,mixed,mm,mnemonic,modal,modalities,modality,mode,mode network,model,modeling,models,moderate,modified,modulate,modulated,modulates,modulating,modulation,modulations,modulatory,monetary,monetary reward,money,monitor,monitored,monitoring,monkey,monkeys,months,mood,moral,morphological,morphology,morphometry,morphometry vbm,motion,motivation,motivational,motor,motor control,motor cortex,motor imagery,motor network,motor performance,motor pre,motor premotor,motor response,motor responses,motor sma,motor task,movement,movements,moving,mpfc,mr,ms,mt,mtg,mtl,multi,multimodal,multiple,multiple sclerosis,multisensory,multivariate,multivariate pattern,muscle,music,musical,musicians,naive,names,naming,native,natural,naturalistic,nature,navigation,near,necessary,need,needed,needs,negative,negative affect,negative correlation,negative emotional,negative neutral,negative positive,negatively,negatively correlated,negativity,neocortical,nerve,nervous,network,network connectivity,network dmn,network involved,networks,networks involved,neuro,neuroanatomical,neuroanatomy,neurobiological,neurobiology,neurocognitive,neurodegenerative,neurodevelopmental,neurofunctional,neurological,neuron,neuronal,neurons,neurophysiological,neuropsychiatric,neuropsychological,neuroscience,neutral,neutral faces,neutral pictures,neutral stimuli,new,newly,nineteen,nociceptive,node,nodes,nogo,noise,non,normal,normal controls,normalization,normalized,normally,notably,noted,notion,noun,nouns,novel,novelty,noxious,nuclei,nucleus,nucleus accumbens,number,numbers,numerical,numerous,object,object recognition,objective,objectives,objects,observation,observations,observer,observers,observing,obsessive,obsessive compulsive,obtain,obtained,occipital,occipital cortex,occipital gyrus,occipital lobe,occipital parietal,occipital temporal,occipito,occipito temporal,occipitotemporal,occur,occurred,occurrence,occurring,occurs,oddball,ofc,offer,offers,old,older,older adults,ones,ongoing,online,onset,open,operation,operations,opercular,opercularis,operculum,opportunity,opposed,opposite,optimal,optimized,options,oral,orbital,orbitofrontal,orbitofrontal cortex,order,organization,organized,orientation,oriented,orienting,origin,original,orthographic,oscillations,outcome,outcomes,output,outside,overall,overlap,overlapped,overlapping,overt,oxygen,oxygen level,oxygenation,oxygenation level,paced,pain,painful,pair,paired,pairs,pallidus,paper,paradigm,paradigms,parahippocampal,parahippocampal cortex,parahippocampal gyrus,parahippocampus,paralimbic,parallel,parameter,parameters,parametric,parametric mapping,parametrically,parietal,parietal cortex,parietal cortices,parietal frontal,parietal junction,parietal lobe,parietal lobes,parietal lobule,parietal lobules,parietal network,parietal occipital,parietal prefrontal,parietal temporal,parieto,parieto occipital,parkinson,parkinson disease,pars,pars opercularis,partial,partially,participant,participate,participated,particular,particularly,partly,parts,passive,passive viewing,passively,past,pathological,pathology,pathophysiological,pathophysiology,pathway,pathways,patient,patient group,pattern,patterns,pcc,pd,peak,people,perceive,perceived,perceiving,percept,perception,perceptual,perform,performance,performance task,performances,performing,perfusion,periaqueductal,period,periodicals,periods,peripheral,perisylvian,persistent,person,personal,personality,personality traits,persons,perspective,pet,pfc,pharmacological,phase,phases,phenomena,phenomenon,phonetic,phonological,photographs,physical,physiological,picture,pictures,pitch,place,placebo,placebo controlled,planning,planum,planum temporale,plasticity,play,play important,play role,played,playing,plays,plays important,plays role,pleasant,plus,point,pointing,points,pole,polymorphism,poor,poorer,poorly,poorly understood,population,populations,portion,portions,position,positive,positive correlation,positive correlations,positive negative,positively,positively correlated,positron,positron emission,possibility,possible,possibly,post,post hoc,postcentral,postcentral gyrus,posterior,posterior anterior,posterior cingulate,posterior inferior,posterior insula,posterior medial,posterior middle,posterior parietal,posterior superior,posterior temporal,potential,potentially,potentials,power,powerful,ppc,practice,pre,pre sma,pre supplementary,preceded,preceding,precentral,precentral gyrus,precise,precuneus,precuneus posterior,predict,predicted,predicting,prediction,prediction error,predictions,predictive,predicts,predominantly,preference,preferences,preferential,preferentially,prefrontal,prefrontal anterior,prefrontal cortex,prefrontal cortical,prefrontal cortices,prefrontal parietal,preliminary,premotor,premotor cortex,premotor cortices,preparation,preparatory,presence,presentation,presentations,presented,presenting,preserved,press,pressure,presumably,previous,previous functional,previous reports,previous research,previous shown,previous work,primarily,primary,primary auditory,primary motor,primary secondary,primary sensorimotor,primary sensory,primary somatosensory,primary visual,primates,prime,priming,principal,principle,prior,priori,probabilistic,probability,probably,probe,problem,problems,procedure,procedures,process,processed,processes,processes involved,processes underlying,produce,produced,produces,producing,production,profile,profiles,progression,progressive,projections,prolonged,prominent,promising,pronounced,proper,properties,proportion,proposal,propose,proposed,prospective,protocol,provide,provide evidence,provide new,provided,provides,provides evidence,providing,pseudowords,psts,psychiatric,psychiatric disorders,psychological,psychopathology,psychophysical,psychophysiological,psychophysiological interaction,psychosis,psychotic,ptsd,published,punishment,pure,purpose,putamen,putative,quality,quantify,quantitative,question,questionnaire,questions,random,random effects,randomized,randomly,range,ranging,rapid,rapidly,rare,rarely,rate,rated,rates,rating,ratings,ratio,rationale,reach,reaching,reaction,reaction time,reaction times,reactions,reactivity,read,readers,reading,real,real time,real world,reality,reappraisal,reasoning,recall,receive,received,receiving,recently,receptor,recognition,recognition memory,recognition task,recognize,recognized,recognizing,recollection,recorded,recording,recordings,recovery,recruit,recruited,recruitment,recruits,reduce,reducing,reduction,reductions,reference,referential,referred,refers,reflect,reflected,reflecting,reflects,regard,regarding,regardless,regional,regional cerebral,regional gray,regional homogeneity,regular,regulate,regulating,regulation,regulatory,rehabilitation,rehearsal,reho,reinforcement,relate,relation,relational,relations,relationship,relationships,relatively,relevance,relevant,relevant information,reliability,reliable,reliably,reliance,relied,relies,rely,remain,remain unclear,remained,remaining,remember,remembered,remembering,remote,reorganization,repeat,repeated,repeatedly,repetition,repetition suppression,repetitive,replicated,report,reported,reports,represent,representation,representations,represented,representing,represents,require,required,requirements,requires,requiring,research,research suggests,researchers,residual,resolution,resolve,resonance,resonance compare,resonance experiment,resonance healthy,resonance identify,resonance images,resonance measure,resonance performing,resonance scans,resources,respect,respective,respectively,respond,responded,responding,responds,response,response inhibition,response selection,response time,response times,responses,responsible,responsive,responsiveness,rest,resting,resting state,restricted,result,resulted,resulting,retention,retrieval,retrieved,retrosplenial,retrosplenial cortex,reveal,revealing,reveals,reversal,reverse,reversed,reward,reward anticipation,rewarding,rewards,rhythm,rich,rise,risk,risky,robust,roi,rois,role,roles,rostral,rostral anterior,rotation,rs,rt,rule,rules,run,runs,s1,saccade,saccades,sad,salience,salience network,salient,sample,samples,sampling,scale,scales,scalp,scan,scanned,scanned using,scanner,scanning,scans,scene,scenes,schizophrenia,schizophrenic,sclerosis,score,scores,scrambled,screen,sd,se,search,second,secondary,secondary somatosensory,sectional,seed,seeds,seeking,seen,segregated,segregation,select,selected,selection,selective,selective attention,selectively,selectivity,self,self referential,self reported,semantic,semantic information,semantic knowledge,semantic memory,semantically,semantics,sensation,sensations,sense,sensitive,sensitivity,sensorimotor,sensorimotor cortex,sensory,sensory information,sensory modalities,sensory motor,sentence,sentence comprehension,sentences,separable,separate,separated,separately,separation,sequence,sequences,sequential,serial,series,serotonin,serve,served,serves,session,sessions,set,sets,setting,seven,seventeen,severe,severity,sex,sexual,sham,shape,shaped,shapes,share,shared,shed,shed light,shift,shifted,shifting,shifts,short,short term,shorter,showing,shown,shows,si,sided,sighted,sign,signal,signal change,signal intensity,signal task,signaling,signals,signature,significance,signs,sii,silent,similarities,similarity,similarly,simple,simply,simulated,simulation,simultaneous,simultaneous eeg,simultaneously,single,single subject,single trial,site,sites,situation,situations,sixteen,size,skill,skills,skin,skin conductance,sleep,slow,slower,sma,small,smaller,smokers,smoking,social,social cognition,social cognitive,social interaction,social interactions,socially,software,solving,somatosensory,somatosensory cortex,somatosensory cortices,sought,sound,sounds,source,sources,space,span,sparse,spatial,spatial attention,spatial information,spatial temporal,spatially,spatiotemporal,speaker,speakers,speaking,special,specialization,specialized,species,specifically,specificity,specified,spectral,spectrum,spectrum disorder,spectrum disorders,speech,speech perception,speech production,speech sounds,speed,spin,spinal,spl,spoken,spontaneous,stable,stage,stages,standard,standardized,state,state functional,state networks,states,static,statistics,status,step,stg,stimulated,stimulation,stimulation tms,stimuli,stimuli presented,stimulus,stimulus driven,stimulus response,stop,stop signal,storage,stored,strategic,strategies,strategy,stream,streams,strength,stress,stress disorder,striatal,striatum,striking,stroke,strong,strongest,strongly,stroop,stroop task,structural,structural functional,structural magnetic,structure,structure function,structures,structures involved,sts,studied,studying,sub,subcortical,subcortical structures,subgenual,subject,subjective,subregions,subsequent,subsequent memory,subsequently,subserve,subserved,subserving,subset,substance,substantia,substantial,substantially,substrate,substrates,subtle,subtraction,success,successful,successfully,successive,suffering,sufficient,suggest,suggested,suggesting,suggests,sulci,sulcus,sulcus ips,sulcus psts,sulcus sts,summary,superior,superior frontal,superior inferior,superior middle,superior parietal,superior temporal,supplementary,supplementary motor,supported,supporting,supports,suppressed,suppression,supramarginal,supramarginal gyrus,surface,surprisingly,surrounding,susceptibility,sustained,switch,switching,symptom,symptom severity,symptoms,synchronization,syndrome,syntactic,systematic,systematically,systems,systems involved,t1,t1 weighted,tactile,taken,taking,tapping,target,target detection,targeted,targets,task,task conditions,task demands,task difficulty,task functional,task involving,task irrelevant,task performance,task positive,task relevant,task required,task task,task using,tasks,tasks requiring,taste,technique,techniques,temporal,temporal cortex,temporal cortices,temporal frontal,temporal gyri,temporal gyrus,temporal inferior,temporal lobe,temporal lobes,temporal occipital,temporal parietal,temporal pole,temporal sulcus,temporale,temporally,temporo,temporo parietal,temporoparietal,temporoparietal junction,tend,tendency,tensor,tensor dti,term,term memory,terms,tesla,test,tested,testing,tests,thalamic,thalamus,theoretical,theories,theory,theory mind,therapeutic,therapy,thickness,thinking,thirteen,thirty,thought,thoughts,threat,threatening,threshold,time,time course,time courses,time rt,time series,time task,times,timing,tissue,tms,tom,tomography,tomography pet,tone,tones,took,tool,tools,topography,total,touch,tpj,track,tracking,tract,tractography,tracts,traditional,traditionally,trained,training,trait,traits,transcranial,transcranial magnetic,transfer,transformation,transient,transition,transporter,trauma,traumatic,treated,treatment,treatments,trend,trial,trial trial,trials,trigger,triggered,true,turn,twice,type,types,typical,typically,typically developing,unaffected,uncertain,uncertainty,unclear,undergoing,undergoing functional,underlie,underlies,underlying,underlying mechanisms,underpinnings,understand,understanding,understood,unexpected,unfamiliar,unilateral,unimodal,unique,uniquely,univariate,unknown,unlike,unmedicated,unpleasant,unrelated,upcoming,updating,upper,use,use functional,useful,users,uses,using,using event,using functional,using resting,using voxel,usually,utility,utilized,utilizing,v1,v5,valence,valid,validated,validity,valuable,value,values,variability,variable,variables,variance,variant,variation,variations,varied,varies,variety,various,vary,varying,vbm,vector,ventral,ventral anterior,ventral dorsal,ventral medial,ventral premotor,ventral striatum,ventral visual,ventrolateral,ventrolateral prefrontal,ventromedial,ventromedial prefrontal,verb,verbal,verbal fluency,verbal working,verbs,vermis,version,versus,vi,video,video clips,videos,view,viewed,viewing,violations,virtual,vision,visual,visual attention,visual auditory,visual cortex,visual cortical,visual cortices,visual field,visual information,visual motion,visual perception,visual spatial,visual stimuli,visual stimulus,visual stream,visual word,visually,visually presented,visuo,visuomotor,visuospatial,vivo,vlpfc,vmpfc,vocal,voice,volume,volumes,volumetric,voluntary,volunteers,voxel,voxel morphometry,voxel wise,voxels,vs,vulnerability,watched,way,ways,weak,weaker,week,weeks,weight,weighted,whilst,white,white matter,wide,widely,widespread,wiley,wiley periodicals,wise,wm,wm task,women,word,word form,word pairs,word recognition,words,work,working,working memory,world,worse,written,year,year old,years,yield,yielded,young,young adults,young healthy,younger,younger adults,zone,0.concept_name
trm_4a3fd79d09af8,-0.0006,-0.0358,0.0208,0.1047,0.0348,-0.0041,0.0004,0.0262,-0.0038,0.0399,-0.0039,-0.0048,-0.0003,0.0259,0.0591,-0.0115,0.0369,0.165,0.0466,0.0741,0.0529,0.0072,-0.0083,0.0098,-0.0356,-0.032,-0.0321,0.078,0.0343,-0.0075,0.0429,0.08,0.0246,0.0322,0.0552,0.0691,-0.0363,0.0192,0.0518,0.0592,0.0278,-0.0045,-0.0303,0.0181,0.0599,0.0718,-0.0583,0.0029,-0.0185,0.0504,0.0183,0.0073,0.036,0.0927,0.1231,0.0167,-0.002,0.0105,-0.0068,-0.0028,0.0009,0.0001,0.0725,0.0548,0.08,-0.1185,0.122,0.1772,0.1185,-0.0409,0.018,-0.023,0.032,0.0156,0.0714,0.0158,-0.017,0.0091,0.038,-0.1079,-0.0182,0.0512,0.0514,0.0501,0.054,-0.0533,-0.0045,-0.0664,-0.0169,-0.1428,-0.015,-0.0948,-0.0191,-0.2201,-0.2233,-0.2269,-0.1016,-0.0399,-0.1115,-0.1432,-0.0353,0.0396,-0.0332,-0.1376,-0.0637,0.0545,0.0837,-0.0994,0.0035,0.0152,0.0367,0.0738,0.0027,-0.0833,0.0089,0.0118,0.1054,-0.1841,0.0816,0.023,0.094,0.0561,0.1084,0.0136,0.1087,0.0805,0.1335,-0.017,-0.0294,-0.0752,0.0372,0.0679,-0.0389,0.0466,0.0437,0.1374,-0.0129,0.0656,0.0205,-0.0165,0.036,0.0657,-0.0243,0.0659,0.0874,-0.0267,-0.0094,0.0695,0.0155,0.0393,0.0542,0.0742,0.0129,0.084,-0.0061,-0.0705,-0.0197,-0.0183,0.0009,0.009,0.0274,0.0509,0.1315,0.048,-0.0033,-0.0381,0.0099,0.0901,0.0915,0.0634,-0.0815,0.0946,-0.0908,0.0741,0.0511,0.0373,0.0379,0.0934,0.0404,-0.0297,-0.0051,-0.0624,0.0001,0.0197,-0.0225,0.0244,-0.0766,0.0342,0.0464,0.1228,0.1208,-0.0042,-0.0259,0.111,0.1095,0.0847,0.1326,0.0299,0.0609,-0.0452,-0.0384,-0.1723,0.0679,0.0327,0.1626,-0.0725,0.0572,0.0459,0.0136,0.0315,0.126,0.0396,-0.0482,0.0318,0.008,0.0116,-0.0273,-0.0202,-0.1407,0.0019,-0.0921,0.07,0.0107,0.0043,-0.0405,-0.0528,0.0416,-0.0879,0.0011,0.1322,-0.1992,0.0174,-0.0483,-0.0147,-0.021,-0.0999,0.0322,0.092,0.0008,-0.0002,-0.0442,0.0426,0.0042,-0.0241,0.0888,0.0688,0.0561,0.052,-0.0249,0.1445,-0.0009,-0.0321,0.0133,0.016,-0.0307,0.0697,-0.0349,0.0125,-0.0659,-0.0289,-0.0121,-0.0373,0.093,0.0359,-0.0368,-0.0204,0.0471,0.0576,-0.032,-0.0054,-0.0002,-0.0494,0.0525,0.0408,-0.144,-0.1614,-0.1788,-0.1444,-0.1592,-0.0831,-0.1077,0.0224,0.0418,0.1289,0.1122,-0.0177,-0.0349,-0.0553,-0.0209,0.0213,0.0142,0.0307,-0.0058,0.0357,-0.0292,0.0022,0.0327,0.0455,0.0543,0.021,0.0115,0.1756,-0.0042,0.0041,-0.0907,-0.0976,-0.014,0.0191,-0.1186,0.0535,0.0007,-0.0053,0.0855,0.1019,0.0295,-0.0141,0.0162,-0.0136,0.0544,0.0903,0.0512,0.0532,0.0453,0.0991,-0.0239,0.0365,0.0239,-0.0219,0.0119,-0.0597,0.0193,0.0518,0.0568,0.0342,0.0849,-0.0927,0.0335,0.1027,-0.035,0.1449,0.1293,-0.0037,-0.1226,-0.0601,-0.0433,-0.011,-0.0424,-0.0402,-0.0543,-0.0216,-0.081,-0.2008,-0.1375,-0.1332,-0.0487,-0.0828,0.0148,0.0244,0.0094,0.0278,0.0242,-0.0103,0.0835,-0.0065,-0.0633,-0.0972,0.0442,0.0826,-0.074,0.0196,0.0526,0.0182,-0.0183,-0.0808,0.0407,-0.0525,0.0389,-0.0193,-0.0708,-0.0844,-0.071,-0.1254,0.1207,0.1042,-0.0096,-0.0221,0.0365,-0.0045,0.0397,0.0074,-0.0812,-0.0221,-0.1115,0.048,-0.0508,-0.1227,-0.145,-0.0338,-0.0309,0.036,0.0513,-0.0023,-0.0206,-0.0577,-0.0385,0.0886,0.0103,0.0334,0.029,-0.0184,-0.0284,0.0643,0.0632,-0.0337,0.0633,0.1126,0.0306,0.125,0.1595,0.1043,-0.0257,-0.0036,-0.0154,0.1307,0.1374,0.0309,0.0345,-0.0716,0.057,0.0108,0.0127,-0.0396,-0.0148,-0.0282,0.0322,0.0431,-0.127,-0.0422,0.038,0.0525,-0.1309,-0.0431,-0.0363,-0.0252,-0.0573,-0.0206,-0.0418,-0.0939,0.1605,0.2611,0.2068,-0.0008,0.0572,0.0752,0.0426,0.1313,-0.0404,0.0825,0.126,0.0385,0.0495,0.0262,0.0142,0.0265,0.0225,0.0394,-0.0123,-0.0175,-0.0465,-0.0575,0.0013,-0.0525,0.0031,-0.0248,-0.0162,0.0285,-0.0697,-0.0875,-0.0151,0.0022,-0.1392,-0.02,-0.0957,0.0164,0.107,0.0273,-0.0259,-0.0366,0.1131,-0.0132,-0.1549,-0.0655,0.0588,0.0921,-0.0272,-0.0258,0.0925,0.0306,0.0265,0.115,0.1127,0.0499,0.0331,0.049,0.0438,0.0252,0.048,0.0743,0.0774,-0.0833,0.0468,-0.0793,0.0902,-0.0003,-0.0697,0.0012,0.0633,0.0304,-0.1608,0.022,0.0593,0.0073,0.002,0.1038,0.0282,0.0278,-0.0375,-0.1002,-0.0931,-0.0203,0.019,-0.0319,-0.0599,0.0925,0.039,-0.0573,0.0741,0.0571,0.0124,0.038,0.0415,-0.0119,-0.0742,-0.0279,0.0491,-0.0557,0.0796,0.0289,-0.0082,0.0223,-0.0539,0.0699,0.054,-0.1044,-0.019,0.0435,-0.0403,0.0289,-0.039,-0.038,0.0443,0.0324,0.0697,-0.0506,0.045,-0.071,-0.0183,0.1125,0.0654,0.041,0.0508,0.0991,-0.0169,0.0059,-0.3067,-0.249,-0.0914,-0.0626,-0.0438,0.0329,-0.0294,0.0412,0.0617,0.04,0.0391,0.0531,0.0493,0.0408,-0.0341,0.0336,0.0031,0.088,0.071,0.0609,-0.0002,-0.0082,0.1095,0.0951,-0.0675,0.0072,-0.0684,-0.016,0.0194,-0.0185,-0.05,-0.2151,0.0509,0.0231,0.0196,0.1381,0.0191,-0.0044,0.1051,0.0736,0.09,0.0749,0.0355,0.1052,-0.0031,0.0727,0.0186,0.065,-0.0708,-0.0083,-0.0324,-0.0848,0.061,0.0304,-0.016,0.0207,-0.0421,-0.0645,0.0119,0.1174,0.1392,-0.0708,0.0469,-0.055,0.0817,0.0421,-0.004,-0.0575,-0.0492,-0.2205,0.0645,0.0025,0.1632,0.0963,-0.0312,0.0859,0.1754,0.043,-0.029,0.0278,0.0574,-0.0486,-0.2041,-0.0286,-0.0059,0.0633,0.1076,-0.2164,-0.0788,-0.1609,-0.0767,-0.0225,-0.1109,0.0548,-0.149,0.0238,-0.0012,0.0117,-0.0199,-0.0801,0.0307,0.0731,-0.1461,0.0327,-0.0372,0.0488,0.0696,-0.0603,0.0114,-0.0108,-0.1173,0.0909,0.0071,0.0013,0.006,-0.0543,0.025,0.0158,-0.0054,0.0127,0.0049,0.1115,-0.017,0.0214,0.0335,0.1231,0.0579,0.0691,0.0086,0.0527,0.0591,0.0069,0.015,-0.0159,-0.0461,0.0381,0.0358,0.1614,0.1624,-0.012,0.1943,0.0725,0.0204,-0.0385,0.0387,0.0169,-0.0744,0.0383,0.1414,0.1278,0.0968,0.0464,0.051,0.0897,0.1224,-0.0406,-0.0327,0.0048,-0.058,-0.0,-0.0159,-0.06,-0.0783,0.0858,0.0349,0.1029,0.0833,0.0215,0.0131,-0.0348,0.0858,0.0179,0.0402,-0.0532,0.0387,0.0177,0.0718,-0.0793,0.1241,0.1582,0.1407,0.1128,-0.0331,-0.0478,0.0018,-0.045,-0.0043,-0.1013,-0.0082,-0.0952,-0.0166,-0.0688,0.0938,0.0365,-0.0847,0.0659,-0.0858,-0.1109,-0.0742,0.0272,-0.0516,0.0403,-0.0623,0.0665,0.0377,0.085,0.0862,0.0445,0.0585,-0.0588,0.0281,0.0104,0.014,-0.0216,0.0269,0.0669,-0.0532,0.0553,0.0042,0.0193,-0.0442,-0.0582,-0.0103,0.0876,0.0399,0.0951,0.0973,0.0544,0.0223,-0.0636,0.0299,-0.0138,-0.0307,-0.0158,-0.0391,-0.1316,-0.078,-0.0547,-0.0465,-0.0346,-0.091,-0.0185,-0.1201,-0.0547,-0.1041,-0.0104,0.034,0.0769,0.1056,-0.0425,-0.0221,-0.0106,0.2238,0.102,0.0901,0.0907,0.1152,-0.0181,-0.0075,0.0001,0.0448,0.0112,0.1259,-0.0718,-0.0033,0.0491,0.0145,0.0429,-0.0486,-0.0007,0.0091,0.0201,-0.0197,-0.006,0.0286,-0.0093,-0.0053,-0.0899,0.021,0.0452,0.0481,0.0739,0.1726,0.1146,0.1368,0.0072,-0.0261,0.0934,0.1111,0.1188,-0.097,-0.1521,0.0694,0.0747,-0.0578,0.1128,0.0357,0.0517,-0.2766,0.0513,-0.0371,0.2216,0.1474,0.1945,0.1882,0.1599,0.06,-0.0612,0.0506,0.0602,-0.0084,-0.0268,-0.0154,0.0694,0.023,0.064,-0.0217,-0.0328,-0.119,-0.0713,0.0289,-0.0623,0.1069,0.0774,0.0177,0.0041,0.0579,0.0179,-0.0071,0.0076,0.0409,-0.0679,-0.0199,0.0453,0.0609,0.0666,0.0888,-0.0137,0.0637,-0.0434,-0.0476,0.0125,-0.0318,0.0097,-0.0097,-0.0276,-0.0299,-0.0339,0.0769,0.0605,-0.1922,-0.0547,-0.0631,-0.1291,0.0155,0.0134,-0.019,-0.0463,-0.0385,0.0039,0.0033,-0.0134,0.0069,0.0161,-0.0276,0.0387,0.0369,0.1011,0.1334,0.1264,0.0538,0.0499,0.0397,0.0748,0.0725,0.0622,0.0816,0.0954,-0.0191,-0.0207,-0.0108,0.013,0.0011,-0.0283,-0.0056,-0.03,-0.0245,-0.0984,0.0608,0.0966,0.084,0.0256,-0.0338,-0.0286,0.0021,-0.002,0.0564,-0.0211,-0.024,0.0231,-0.0348,-0.0294,-0.0196,-0.0159,-0.0566,-0.0144,-0.0168,0.0097,0.1069,0.1242,0.108,0.1738,0.1451,-0.0729,-0.0231,-0.0479,-0.0222,0.0084,-0.0394,0.089,0.0808,-0.017,0.0108,-0.0228,0.0089,0.0069,0.0097,-0.0208,0.0298,0.0273,0.0386,-0.018,0.0256,0.1009,0.1154,0.1106,-0.009,-0.0777,0.0093,0.0231,0.0151,0.0736,0.0487,0.0357,0.0252,0.0067,-0.0353,0.0298,-0.0298,-0.1912,-0.05,0.043,0.0896,0.0041,0.048,0.0432,0.0251,-0.0145,-0.16,-0.2087,0.1928,0.1146,0.1271,0.0934,0.0323,0.0978,0.0628,0.065,-0.0625,0.0043,-0.1046,-0.0074,0.0197,0.0726,-0.0214,-0.0122,-0.0958,-0.0353,-0.018,0.0422,0.0241,-0.042,-0.0151,-0.0707,0.0794,-0.1448,-0.0396,0.038,-0.0052,0.044,0.0527,0.0747,-0.0639,0.0085,0.0505,-0.0199,0.034,0.0886,0.0458,0.0224,-0.0226,0.0039,0.0467,-0.0159,-0.0024,-0.0391,-0.2014,-0.0289,-0.0586,-0.0307,-0.0146,-0.0343,0.0596,0.0337,-0.0096,0.0143,-0.1547,-0.1245,-0.1429,-0.0908,-0.1016,-0.0728,-0.1386,-0.0781,0.1183,-0.0466,-0.0645,-0.027,-0.0224,0.0148,-0.0063,-0.0612,-0.024,0.0562,-0.0213,0.0585,-0.0038,-0.0094,0.0562,-0.1197,-0.1153,-0.0093,-0.0603,0.0357,0.1005,-0.0094,0.0305,0.0848,0.0209,0.0522,-0.0395,-0.0582,-0.0767,0.0635,0.0861,0.0438,0.0427,0.0163,0.0137,-0.071,-0.1483,0.0071,-0.0064,0.0415,0.0355,-0.0571,0.0226,-0.0944,-0.1408,0.0518,-0.0861,-0.1856,-0.2867,-0.1876,-0.2252,-0.087,-0.0361,0.0785,0.0041,0.0096,-0.0694,0.0945,0.0544,0.058,-0.1632,-0.0244,0.0466,-0.0237,0.0294,-0.0173,-0.0566,0.0259,-0.1376,-0.2147,-0.0507,0.0465,0.0079,0.0829,0.0153,-0.1073,-0.0589,0.1137,0.1101,0.0298,0.0689,-0.1134,-0.074,0.0868,0.0039,0.0788,0.1212,0.0886,-0.0115,-0.1055,0.0284,0.1003,0.1571,0.0718,-0.0416,0.0674,0.0651,0.0766,-0.0204,0.0801,0.0964,0.0524,0.0204,0.168,0.0527,-0.0089,0.1099,0.0859,0.1198,0.0083,-0.1106,0.008,0.0167,-0.0711,-0.0219,-0.0492,0.0308,-0.0465,0.0103,0.1083,0.1016,0.0128,-0.023,-0.0752,-0.0691,-0.0626,-0.0719,0.1271,0.0216,0.0919,0.0922,0.135,-0.0047,-0.097,-0.0892,0.1067,0.0914,0.0088,-0.1398,0.0917,-0.032,0.0138,-0.0518,-0.0224,-0.102,0.1217,0.0934,0.0848,-0.1478,0.0274,0.0566,-0.0094,-0.0094,0.0972,0.0258,-0.0279,-0.0103,-0.023,0.0671,-0.0061,-0.2416,0.105,0.1177,0.0555,0.008,0.0722,0.0884,0.0447,-0.0213,-0.0769,0.1168,0.0753,-0.0128,-0.1449,-0.0487,-0.0131,-0.0248,0.0147,-0.028,0.0511,-0.0611,-0.0409,0.0939,0.0608,0.0576,0.0574,0.061,-0.1415,-0.0831,0.0105,-0.3207,-0.2257,-0.2089,-0.0142,-0.2382,0.054,0.0568,0.0713,0.1472,-0.0634,0.0735,0.049,0.0094,0.0634,0.1276,-0.1317,-0.0567,0.0574,0.0092,-0.1194,0.0486,-0.0261,-0.1033,0.0176,-0.0881,0.0054,0.0172,0.0302,-0.0648,-0.1325,-0.1525,-0.0689,-0.1154,-0.1076,-0.0177,-0.1264,-0.1283,0.05,0.0612,-0.0068,0.1034,-0.0554,0.0222,0.0169,0.0632,0.0389,0.1011,0.0093,-0.0293,-0.1165,-0.0479,0.0201,-0.0201,-0.0019,-0.0083,0.1238,0.1316,0.1259,-0.073,0.0356,0.0353,-0.0126,-0.0174,-0.1523,-0.0711,-0.0094,0.0678,0.091,-0.0329,0.0198,0.0371,-0.0779,0.0054,-0.1786,0.0914,0.0387,-0.0749,0.0028,-0.075,-0.0346,0.0246,0.0231,0.0659,-0.0448,-0.025,0.092,-0.1222,-0.0126,-0.0645,-0.1672,0.0046,0.0265,-0.0575,-0.053,-0.1306,-0.0013,-0.0658,0.0727,0.0666,0.1233,0.0897,0.0904,0.0657,-0.0162,0.061,0.1209,0.0236,0.0343,-0.0169,0.0336,0.0227,0.0076,-0.0143,-0.0225,0.0131,0.0103,0.0213,-0.0168,0.1216,0.0347,0.0148,0.092,0.0157,-0.0483,-0.02,-0.054,0.0142,0.0539,0.0599,-0.0458,-0.0409,0.0804,0.0809,-0.0278,-0.1322,-0.2551,0.0582,0.0288,0.0623,-0.0127,-0.0201,-0.0193,0.0429,0.0087,-0.0207,0.1262,-0.029,-0.1608,-0.0342,-0.0417,-0.0074,0.0461,0.0505,0.1232,0.038,0.054,0.0435,-0.0838,0.0066,0.0844,-0.0256,-0.011,-0.0318,-0.0134,-0.0255,-0.0262,0.0393,0.0315,0.0474,-0.0093,0.0393,0.0337,0.0314,-0.0561,-0.0157,-0.2377,-0.2063,0.0246,0.0196,-0.0346,-0.0094,0.01,0.043,-0.0809,-0.0456,-0.0741,-0.0742,-0.0909,-0.0289,-0.086,-0.0365,0.049,-0.1713,-0.0079,0.0869,0.1272,-0.058,-0.0164,-0.088,0.0656,0.0799,-0.0097,-0.0149,-0.0386,-0.0208,0.0471,-0.0348,0.0263,-0.1198,0.0388,-0.0095,0.0394,-0.0644,0.0584,-0.0636,0.0624,-0.1029,-0.0024,-0.0106,-0.0889,-0.0154,-0.0286,0.0301,-0.0085,0.0373,-0.1122,-0.1027,0.0271,0.0651,-0.0028,-0.0019,-0.075,0.0019,0.0436,-0.0394,0.0422,0.0322,0.0098,-0.0194,-0.0929,0.1372,-0.0424,-0.0307,0.0133,-0.0088,-0.0327,-0.2469,0.0701,-0.031,-0.1149,-0.0031,-0.0018,0.0114,0.0346,0.1204,0.1421,0.0167,-0.1141,0.0575,-0.0142,0.1465,0.0636,0.1942,0.0326,0.0759,-0.076,0.08,-0.0047,0.0405,0.0494,0.0634,0.0259,-0.0409,-0.0092,0.0123,-0.0132,0.021,0.0159,0.0547,0.009,-0.0169,0.0217,0.0702,-0.0033,-0.0009,-0.0065,0.0418,-0.083,-0.0533,0.0923,0.0127,0.0752,0.0545,-0.1709,0.1326,0.1378,0.178,-0.0053,-0.0713,-0.0717,-0.0797,-0.0064,-0.0216,-0.0076,0.0094,-0.0082,0.021,0.0512,-0.0456,-0.0157,0.0169,0.0004,-0.0961,-0.0187,-0.0288,-0.0124,-0.0584,0.0226,0.0065,-0.0303,-0.0402,0.0942,-0.017,-0.005,0.0221,-0.072,-0.2105,0.0276,0.0609,-0.0562,-0.0127,-0.063,-0.1294,-0.0051,0.0258,0.0475,0.0243,0.0392,0.0984,0.0023,0.0069,0.0167,-0.0847,-0.0525,-0.0898,-0.0153,0.0492,0.0949,0.0738,0.0906,0.0761,0.0646,-0.0762,0.0213,-0.0255,-0.042,-0.0999,-0.1499,-0.0442,-0.1459,-0.1386,-0.0464,0.039,0.0429,0.0832,-0.029,0.0441,-0.0334,0.0071,0.1198,0.1149,0.0555,-0.0024,-0.0704,0.0353,-0.2568,0.0209,-0.0861,-0.0791,-0.1252,-0.0584,0.0094,-0.0066,-0.0208,-0.0502,0.0045,-0.052,0.0205,0.0575,0.1497,0.0695,0.1263,0.0092,0.1174,0.1651,0.0233,-0.0209,0.0093,0.0464,0.0188,0.0892,-0.0369,-0.0323,-0.0037,-0.176,-0.0824,-0.0174,-0.048,-0.0193,-0.0216,-0.0442,0.1165,0.0725,0.0414,0.0223,-0.0294,-0.0243,0.0014,0.1228,0.0746,-0.0912,0.1541,0.0814,0.1036,0.0751,0.0586,-0.0584,-0.041,0.0911,0.0974,0.0591,0.0433,0.0156,-0.0797,-0.0445,0.0108,-0.0402,-0.0359,0.0543,-0.0207,0.0465,-0.0224,0.051,0.0301,0.211,0.1257,0.0977,0.0746,0.1813,-0.0506,0.1075,-0.1351,0.0049,0.0306,0.0394,0.0237,0.1166,-0.0715,0.1582,0.2692,0.0557,0.0895,0.141,0.0644,0.1903,0.1889,0.1164,0.0415,-0.0,0.0287,0.0949,-0.0427,0.0845,0.0949,0.0663,-0.0064,0.0486,0.0836,0.0908,0.0751,-0.0446,0.029,0.02,0.0177,0.1349,0.0476,0.0905,0.0684,-0.0378,0.041,0.0682,-0.011,0.1172,0.075,-0.0291,-0.0426,0.0508,0.0566,0.0518,0.0901,-0.0635,0.1236,0.066,-0.0307,-0.184,-0.1133,-0.0226,0.0381,0.077,-0.1084,-0.0736,-0.1271,0.1135,0.1172,-0.0457,-0.0521,-0.0367,-0.0292,0.0307,-0.0134,-0.0101,0.0134,0.0361,0.0097,-0.0661,-0.0031,0.0523,0.0388,0.0458,-0.0332,-0.0247,0.071,-0.1471,-0.0947,0.0089,0.1458,0.0766,0.0636,0.0164,0.1145,0.0883,-0.2095,0.0647,0.0357,-0.3037,-0.1792,-0.2938,-0.2211,-0.1547,-0.1737,-0.0433,-0.1392,-0.0625,-0.0401,-0.1988,-0.2074,-0.2951,-0.2978,-0.1913,0.1652,-0.0337,-0.0291,-0.172,0.0138,0.0895,-0.092,-0.0458,0.0387,-0.0333,-0.2345,-0.0194,-0.0384,-0.1817,-0.0679,-0.0671,-0.1158,0.0548,0.0713,-0.0826,-0.0698,-0.0592,-0.0444,-0.0196,0.0173,-0.105,0.0478,0.0435,0.0373,-0.0156,0.1928,0.0764,0.0715,0.0835,0.0802,0.084,0.1399,0.079,0.0619,0.0467,-0.1074,-0.1287,-0.0188,0.0328,0.1127,-0.0343,0.0543,-0.0241,0.0237,0.0779,-0.0958,0.0858,0.0565,0.1068,-0.0218,0.1162,0.0449,-0.0262,-0.0955,-0.0911,-0.1381,-0.0945,0.0622,0.0963,0.0395,0.0453,0.0255,0.0399,0.0487,0.0212,0.0253,0.1331,-0.0857,0.0159,0.0075,-0.0061,-0.1049,-0.0984,0.0239,0.0874,0.0321,-0.0318,-0.0193,0.0322,0.0407,-0.0323,-0.0084,0.0441,0.0025,-0.0529,-0.0495,0.0058,0.0758,0.0494,0.0496,0.0356,0.0406,0.0304,-0.1623,-0.0977,0.067,0.0631,-0.1346,-0.2653,-0.0075,-0.1341,-0.0939,-0.1886,0.1124,0.1122,0.0464,0.0215,-0.1157,-0.1037,-0.0656,0.0253,0.0072,-0.0608,-0.1221,-0.1244,-0.1658,0.0454,-0.0309,0.008,-0.0752,-0.0155,-0.1269,0.1123,0.0162,0.0365,0.0989,0.1034,0.112,-0.0066,0.0352,-0.0094,-0.0869,-0.025,0.0368,0.0485,-0.1934,-0.0341,-0.1794,-0.0093,-0.0355,-0.0233,0.0505,0.0228,0.09,-0.0617,0.0921,0.1578,0.1437,-0.0505,-0.111,-0.0033,-0.0192,0.0276,-0.0332,-0.0563,0.0292,-0.0907,0.0076,0.1123,0.1605,-0.1805,-0.0157,-0.0129,-0.0167,-0.0498,-0.1004,-0.1314,-0.0517,-0.0541,-0.0168,-0.0187,-0.1878,-0.1309,-0.1183,-0.0122,0.0324,0.0265,-0.0094,-0.0295,0.0239,0.0083,0.0869,0.049,0.0786,0.0122,0.0275,-0.0528,0.0004,-0.0508,0.0364,0.0466,-0.0221,-0.0285,0.0176,0.0358,-0.0431,0.0662,-0.0573,0.0217,-0.0636,-0.0594,0.024,-0.0034,0.0534,-0.0087,-0.0917,-0.0645,-0.0219,-0.0098,-0.0283,-0.0341,0.0147,-0.057,-0.0124,0.0102,0.0448,-0.0681,0.0008,-0.0178,-0.1732,-0.1869,-0.0791,-0.0978,0.1756,0.0463,0.1013,0.0931,0.1264,-0.096,-0.0115,0.0176,0.0328,-0.0672,-0.0912,0.0647,-0.0188,-0.1288,0.0478,-0.0203,-0.1514,-0.1145,-0.1122,-0.2536,-0.114,-0.0925,0.1033,0.0485,0.0332,-0.0926,0.0285,-0.0037,-0.0225,-0.0125,-0.0265,-0.1228,-0.0352,0.0188,0.0674,0.137,0.1711,0.1168,0.0656,0.0716,0.0288,0.219,0.0358,-0.0682,-0.0203,-0.0639,-0.1178,-0.0274,-0.0413,0.0258,-0.1466,-0.0047,0.0333,0.0577,-0.1103,-0.0103,0.0567,0.0219,-0.038,-0.17,-0.159,-0.0886,0.0081,-0.0205,-0.0226,0.05,0.0261,0.0017,0.0065,0.0433,0.0107,-0.0715,-0.0118,-0.0113,-0.0256,0.0889,0.0927,0.0324,0.1206,0.0667,0.0603,0.0448,0.0204,-0.1523,-0.0673,-0.1082,0.1589,0.07,0.0272,0.1472,0.1324,0.0786,0.0361,0.0361,0.0039,0.0097,-0.0364,0.0407,-0.0749,-0.1429,-0.1155,-0.0361,-0.0452,0.1581,-0.0539,-0.1284,0.0586,0.0083,-0.0489,-0.1526,-0.0437,0.0664,0.0413,-0.0526,-0.0814,-0.0289,-0.0197,-0.1078,-0.0933,-0.0558,-0.0263,0.0109,0.0055,-0.1672,-0.0923,-0.0183,0.069,0.0686,-0.0053,0.0688,0.0138,0.0542,0.0727,-0.0557,0.0362,-0.0138,-0.0464,-0.0259,0.0757,-0.0226,-0.0175,0.341,0.1169,0.3298,0.1193,0.0559,0.132,0.0866,-0.3113,-0.321,-0.1779,-0.142,-0.09,-0.0777,0.0061,0.0098,-0.0558,-0.0551,-0.0293,-0.0735,-0.0601,-0.0447,0.0963,-0.0319,-0.0744,0.0608,0.0682,0.01,-0.0222,-0.3334,-0.1332,-0.2874,-0.2055,-0.2188,-0.1389,-0.2656,-0.0548,-0.0939,-0.0116,0.0265,-0.0345,-0.0487,0.0584,0.0278,0.0964,0.0545,-0.0384,0.0315,0.1082,0.137,0.0148,0.0088,0.0882,0.0137,0.1343,0.0631,-0.0102,-0.0472,-0.1339,-0.0537,-0.0965,-0.135,0.0077,-0.0035,0.0343,0.0516,-0.0771,-0.0478,-0.0419,0.0146,-0.0803,-0.14,-0.1739,0.0553,0.0343,-0.0876,0.0118,0.0367,-0.0247,0.0098,0.0299,-0.0021,-0.0227,-0.0266,0.0131,-0.0272,-0.1068,-0.119,0.1213,0.1091,0.119,0.0881,-0.1528,-0.0251,0.0181,0.1317,0.0209,0.096,-0.0327,0.0852,-0.0534,-0.0165,-0.1362,-0.0183,0.0127,0.0372,-0.0256,0.084,0.0765,0.0632,-0.0495,-0.0932,-0.0261,0.0003,-0.0352,-0.0136,-0.0873,-0.0257,-0.1022,0.0265,-0.0036,0.0426,-0.0117,0.054,0.0526,-0.0509,0.0645,-0.0485,-0.1217,0.0148,0.0323,-0.0098,0.0299,0.0444,0.0414,0.0235,-0.0377,-0.0426,-0.07,0.0223,0.0416,0.1459,0.2023,0.1113,0.0589,0.0358,0.042,0.0467,0.1033,0.0571,0.145,0.042,-0.0241,-0.0119,0.0035,0.1941,-0.095,-0.0505,-0.0715,-0.0626,-0.009,0.0293,-0.0687,0.0254,0.0051,0.0342,0.0185,0.054,0.0238,0.1249,-0.0217,0.0067,0.0505,0.0781,-0.0132,0.0092,0.032,0.0534,-0.0301,0.0373,-0.0428,0.0817,0.0346,-0.0297,0.122,0.0709,0.1458,0.0847,-0.1372,0.0036,0.0392,0.0702,0.0189,0.0058,0.1263,0.0981,0.1037,0.1118,0.0426,0.0087,-0.005,-0.0048,-0.0284,-0.0578,0.0119,-0.0113,-0.0337,0.0254,-0.0316,0.0442,0.0313,0.0108,-0.0403,0.1167,0.1194,0.1398,-0.0077,-0.1404,0.021,-0.0917,0.0186,-0.1135,-0.1135,-0.1266,0.0283,0.02,0.1336,-0.0664,0.0002,-0.1914,-0.14,-0.0552,-0.0067,-0.0085,-0.0113,0.0141,-0.0072,-0.0073,0.0297,0.1298,0.0323,0.0246,-0.0688,0.0476,0.0451,-0.0851,-0.0595,-0.0305,-0.0376,-0.0465,0.0273,-0.0374,0.0348,0.0168,0.0035,-0.0353,0.0145,0.111,-0.0929,-0.0593,0.0109,-0.0772,-0.0421,0.066,-0.0323,-0.0019,0.0175,-0.044,-0.0184,-0.0692,0.0115,-0.0066,0.1234,0.1451,-0.1179,-0.052,-0.041,-0.0523,0.0317,0.2006,0.1148,0.0731,0.0925,-0.044,-0.0392,-0.0436,0.1001,-0.0392,-0.0003,0.1067,0.0122,0.0361,0.1022,-0.1168,0.0226,-0.0231,0.1974,0.0986,-0.0007,-0.1026,0.029,0.0245,0.0463,0.0116,0.0978,-0.0506,0.0581,-0.0211,0.1105,0.094,-0.0488,-0.0397,-0.2613,-0.0565,-0.0855,0.0521,0.0874,0.0626,0.0381,0.1174,0.0364,-0.1136,0.0992,0.0585,0.0141,0.0382,-0.0449,0.0358,-0.0183,0.0007,0.0385,-0.021,-0.0049,0.1333,-0.0231,0.0119,0.0734,0.1337,-0.086,-0.0664,-0.0019,-0.0042,0.0349,-0.0248,-0.2571,-0.2651,0.0909,0.0566,0.0717,0.0488,-0.0814,-0.0182,-0.0207,0.0702,0.0622,0.0596,-0.1176,-0.0461,-0.0086,-0.1305,0.0998,0.1252,0.0929,0.1164,0.0517,0.0337,0.0988,0.0619,0.0395,-0.0963,-0.0646,-0.0663,-0.0939,-0.0095,-0.2935,-0.2601,-0.2773,-0.0527,-0.053,-0.1634,0.1138,0.0939,0.046,-0.0172,-0.0716,-0.0984,-0.0275,-0.0884,-0.1324,-0.0468,-0.1516,-0.0256,-0.0113,0.0952,0.0071,-0.0605,-0.035,-0.0198,-0.0174,0.0231,0.0438,0.0219,-0.0052,0.0533,0.0123,0.0566,0.0189,0.0344,-0.0029,-0.0573,-0.0224,-0.0415,-0.0085,-0.0331,0.0271,0.0287,-0.0243,-0.0952,0.0527,-0.0676,-0.079,-0.0245,-0.0527,-0.0402,0.031,-0.0469,-0.2636,-0.0353,-0.0548,-0.1082,-0.0921,-0.0967,-0.0509,0.0115,0.0514,-0.1002,-0.0076,-0.0094,-0.0775,-0.2862,-0.1536,0.0715,-0.044,-0.0048,-0.1384,-0.02,-0.0103,-0.07,-0.1279,-0.049,-0.0835,-0.1193,-0.1651,-0.0719,-0.12,-0.1659,0.0574,0.1136,0.0144,-0.0167,-0.0866,-0.0852,-0.0732,0.0199,0.0284,-0.0022,0.008,-0.2145,-0.0686,0.0219,0.0394,0.04,0.1295,0.0502,0.0817,0.0338,0.039,0.0054,0.0052,0.1411,-0.333,-0.2894,-0.2408,0.0907,-0.1803,-0.1744,-0.0062,-0.0669,-0.0239,0.0287,-0.1691,-0.0638,-0.1013,-0.0209,0.0283,-0.1247,-0.0069,-0.0844,-0.0361,-0.0425,0.0066,-0.1081,-0.0763,-0.0259,0.0381,-0.0154,-0.0277,-0.0978,0.0555,0.0157,0.049,-0.125,-0.0812,-0.158,-0.0561,-0.0394,0.0006,-0.1016,-0.082,-0.082,0.0758,0.0121,0.0153,-0.0848,-0.0098,0.0117,0.133,0.1416,0.0609,0.0542,-0.178,0.037,0.081,-0.0142,-0.1342,-0.2254,-0.2458,-0.1331,-0.174,-0.1116,-0.2082,-0.014,0.013,0.0232,0.0123,0.0657,0.0068,0.1556,0.1242,0.1193,-0.1564,-0.0801,0.0058,0.0594,0.094,0.035,0.0803,0.0453,-0.153,0.0063,-0.0257,-0.0405,0.0785,0.0909,0.0869,0.0433,0.0869,0.0148,0.0493,0.0069,0.0059,-0.1452,0.0318,0.0099,-0.0026,-0.1045,-0.0049,0.0589,-0.1429,0.0646,0.0195,0.0493,0.0934,0.0224,0.0476,0.0617,0.0618,-0.0538,0.0873,0.0497,-0.0035,-0.1,-0.0015,-0.0343,0.0461,0.027,0.1553,0.1161,-0.0198,-0.0946,-0.0763,-0.0077,0.0682,0.0071,0.0526,0.0385,-0.058,-0.2092,-0.0413,-0.129,-0.1439,-0.0065,-0.1844,0.056,-0.0857,-0.0907,-0.1296,-0.1587,-0.2346,-0.2379,-0.0132,0.0513,-0.0278,-0.0695,-0.053,-0.1603,-0.1583,-0.1164,-0.0919,-0.0192,0.025,-0.0585,0.0184,0.0799,0.0936,0.0555,0.122,-0.0195,-0.02,0.0821,0.0391,0.0039,-0.0236,0.0166,0.0257,0.0488,-0.2994,0.0015,0.129,-0.2391,-0.1003,-0.1174,0.0276,-0.0376,0.0543,-0.0393,0.0424,0.0145,0.0442,0.0081,-0.0424,0.0347,0.0255,-0.0355,0.0555,0.0618,0.0275,-0.0303,-0.0369,0.0425,-0.0584,-0.0048,-0.0409,-0.0804,0.0337,-0.0799,-0.1079,-0.0416,-0.0228,0.094,0.022,-0.0325,0.0745,0.0744,-0.1329,-0.159,0.0444,-0.0278,0.0205,0.0276,0.0446,0.0795,0.1055,0.1022,0.07,0.0582,0.0355,0.0091,-0.0117,0.1096,-0.0065,0.0035,0.0981,-0.0285,-0.0495,0.0771,0.0623,0.1268,0.1063,0.0009,-0.0311,0.0701,0.1671,-0.0369,0.0241,0.0992,0.1138,0.0636,0.0567,-0.0274,-0.0455,-0.112,-0.0831,-0.0377,-0.0191,-0.0356,0.0092,-0.112,0.0148,-0.1554,0.0687,0.0359,-0.0034,-0.08,-0.118,0.0611,-0.1169,-0.1038,0.0034,0.086,-0.2882,0.0628,0.0661,-0.0688,0.0484,0.0411,0.0642,-0.0584,0.0201,-0.0951,-0.1405,0.1453,0.1562,-0.0997,-0.1299,-0.0004,-0.0955,-0.0199,0.0256,0.0614,0.0954,0.0476,0.0418,0.0873,0.0682,0.051,-0.0245,-0.0086,0.0509,-0.0748,-0.1286,0.062,0.0127,0.0462,-0.0387,-0.0227,0.0241,0.0081,0.0192,0.0634,0.0289,0.116,0.0516,0.0661,0.0549,0.0612,0.0512,0.0456,-0.0241,0.0422,-0.0175,0.014,0.0215,-0.0345,-0.0695,-0.1204,-0.1271,0.0015,0.0329,0.0177,-0.029,0.0457,0.0802,0.0053,0.0402,-0.1048,0.0787,-0.1418,0.0231,-0.0676,0.0181,0.0398,-0.0112,-0.0633,-0.0064,-0.1067,0.0336,0.0426,-0.0493,0.0444,0.0211,0.0142,-0.0622,-0.2091,0.0905,0.0381,0.0457,0.0307,-0.0699,0.1158,0.1027,0.0147,-0.0794,0.0247,-0.0134,0.0379,0.1095,-0.0059,-0.0706,-0.0349,-0.0238,-0.0166,-0.0094,-0.0292,0.0887,-0.0016,-0.0533,0.059,0.0194,0.0337,-0.2929,0.1033,-0.038,0.1521,0.1442,0.1263,0.1177,0.0182,0.1282,0.0605,0.0678,-0.0681,-0.0633,0.1301,0.0719,-0.0115,-0.1519,-0.1518,-0.1241,-0.0201,-0.0312,-0.0854,0.0562,0.0095,-0.1186,-0.1807,-0.0422,-0.114,-0.1014,-0.0381,-0.0454,-0.1009,-0.1001,-0.1906,-0.1291,0.0212,-0.0648,-0.0619,-0.0855,-0.077,-0.223,-0.0472,-0.1187,-0.1496,-0.0011,0.039,0.1184,0.0997,-0.146,-0.0508,0.0907,0.0906,0.0576,-0.2027,-0.1491,0.0972,0.1132,0.0068,-0.0831,0.0139,0.1196,-0.1075,-0.0058,0.0606,-0.0015,0.0202,0.0058,0.0093,0.0289,0.026,-0.0243,0.122,0.1243,-0.0618,-0.0262,0.017,-0.0093,-0.0125,0.0104,0.0926,0.0236,0.0582,0.0397,-0.0587,0.0844,-0.0319,0.0233,0.0314,0.1512,0.1465,0.0255,0.1201,-0.0611,0.0623,0.0102,0.0654,0.0055,-0.1527,0.1288,0.0849,0.0589,0.0503,0.056,-0.0234,auditory word recognition
trm_558c7439832d9,0.037,0.0126,0.0352,0.0534,-0.0106,0.0128,0.011,0.0201,0.02,0.0379,-0.0006,-0.014,0.0303,0.0358,0.0729,0.0224,0.0415,0.053,0.0323,-0.0015,0.0451,-0.0015,0.0553,-0.0181,0.0056,-0.01,-0.01,0.041,0.0512,0.0227,0.053,0.0146,0.0517,0.0292,0.0002,0.0634,0.004,0.0123,0.0533,0.0158,0.0232,0.0337,0.022,-0.0388,0.023,0.0238,-0.0529,0.0387,-0.0057,0.0166,0.0295,-0.0177,0.0051,-0.0132,0.0212,0.0242,0.0602,-0.0046,-0.0129,0.0129,0.0298,0.0162,0.0357,-0.0241,0.0257,-0.022,0.0703,0.0774,0.0719,-0.0074,-0.0219,0.0122,-0.0463,0.0212,0.0633,-0.038,0.0368,-0.0058,-0.0244,-0.0133,-0.0432,-0.0172,-0.0075,0.0465,0.0016,-0.0147,0.0291,0.0208,-0.0303,0.0724,0.0344,0.0384,-0.0365,-0.01,-0.0575,-0.023,-0.025,0.0218,-0.0442,-0.0326,0.005,-0.0123,-0.0328,-0.0306,-0.0302,0.0203,0.0688,-0.1145,0.0337,0.037,0.0087,0.0389,-0.023,-0.0342,-0.027,-0.0249,0.0775,0.0026,0.0018,0.0354,0.0528,0.0759,0.0395,-0.0262,0.0253,0.0384,0.0528,0.0138,-0.0455,-0.0106,-0.0096,0.0336,-0.0456,0.0483,-0.0311,0.0573,-0.001,0.0135,0.0023,0.0195,0.0115,0.058,-0.0861,0.0175,0.0566,-0.0145,0.0385,-0.0101,0.0153,-0.0487,0.0121,-0.0029,0.0486,0.0535,-0.0484,0.0001,-0.0289,0.0391,-0.0076,-0.0012,0.0216,0.0041,0.0827,0.0767,-0.0044,-0.0609,0.0003,0.0832,0.079,-0.0049,-0.0104,0.02,-0.0393,0.0206,0.045,0.0518,0.0201,0.0424,0.0021,0.0335,0.0384,-0.0904,0.0033,-0.0008,0.0528,0.0544,0.0001,-0.0291,-0.0418,0.06,0.0529,0.0025,0.0367,0.0704,0.0549,0.0803,0.0823,0.0087,-0.0364,0.0422,0.045,-0.0123,0.0417,0.0669,0.0214,0.0194,-0.0304,0.0331,0.0395,-0.0131,0.0374,0.0016,-0.0278,-0.0355,-0.0518,0.0176,-0.0338,0.0364,0.0592,-0.0214,-0.041,0.0492,0.0329,0.0369,-0.021,-0.0058,0.0572,-0.0256,-0.0196,-0.0238,0.0471,0.0055,-0.0206,0.0848,0.0863,-0.0411,-0.0226,-0.0481,-0.0038,0.0282,0.0313,0.0713,0.0221,0.0058,0.0473,0.037,-0.0257,0.0388,0.0287,0.0319,-0.0083,-0.0283,0.0077,-0.0061,0.0414,0.0632,-0.0102,0.0341,-0.063,-0.0491,0.0241,-0.007,0.085,0.0108,-0.0218,-0.0611,0.0002,0.0314,-0.0453,-0.0146,0.0349,0.0373,0.0264,-0.0091,0.0413,-0.0558,0.023,0.0276,0.0509,-0.0028,-0.0556,-0.0106,-0.0135,0.0539,0.0396,0.0419,-0.0611,-0.0571,0.053,0.0738,-0.0096,0.0292,0.0358,0.0181,0.0337,0.0302,-0.0193,-0.0458,0.0014,-0.0422,-0.0199,0.0466,0.0223,-0.0055,0.0476,0.0457,0.0302,0.0119,-0.0215,-0.0494,0.0207,0.0069,0.0671,-0.0257,-0.0424,0.0521,-0.0478,-0.0265,-0.0163,0.0688,-0.0029,-0.018,0.0147,0.0229,0.0486,0.0541,-0.0172,0.0251,0.0609,0.0487,-0.015,0.0235,0.0144,-0.0092,-0.0304,-0.0287,-0.0619,0.0377,-0.0565,0.0458,0.0509,-0.015,-0.0066,0.0047,-0.0335,-0.0024,0.0748,0.059,0.0344,0.0385,0.05,-0.0499,0.0287,0.0185,-0.0264,0.0422,0.0044,0.0367,0.052,0.0221,0.0194,0.0364,0.0366,0.0195,0.0031,-0.0183,0.054,-0.0009,-0.0493,0.0586,0.0108,0.0364,0.0103,-0.0251,0.0587,0.0204,0.0274,-0.0419,-0.1147,-0.0898,-0.1349,0.017,0.058,0.0187,-0.032,-0.04,0.0263,-0.0309,-0.0084,0.0176,0.0272,0.0277,0.0536,0.037,-0.0299,-0.013,0.0219,0.0525,0.0299,0.0261,0.0008,-0.0253,0.0333,0.0149,0.0306,-0.0032,-0.028,0.0057,0.0735,0.0349,0.0494,0.0201,0.041,-0.0679,0.0285,-0.0181,-0.1403,-0.0064,0.0435,0.0333,0.0125,0.0687,0.0517,0.1259,0.0871,0.0758,0.0702,0.0606,0.0704,0.0771,0.0281,-0.0336,0.0026,0.0093,0.0058,-0.0557,-0.0178,-0.0084,0.1058,0.0665,-0.0225,-0.0117,0.0194,-0.0404,0.01,0.0668,-0.0159,-0.0021,0.0281,0.0861,0.0595,-0.0042,0.0468,0.059,0.0232,0.0537,-0.0437,0.0447,0.0128,-0.0004,0.0076,0.0587,0.0205,-0.0503,0.0601,0.0582,-0.0091,-0.1451,0.0596,-0.0016,0.02,-0.0073,0.016,0.0143,-0.0353,0.0438,0.0082,-0.0544,-0.0005,0.0387,-0.0097,0.0397,0.0211,-0.022,-0.0155,-0.0354,0.0002,0.0242,-0.003,0.0396,-0.0468,-0.0243,0.0544,0.0658,0.0021,-0.0231,0.0286,0.032,0.0007,0.0475,0.0414,-0.0062,0.0598,0.0559,0.0431,0.0245,-0.0398,-0.0054,0.0365,-0.0008,0.0741,-0.0019,-0.0,0.0206,-0.0262,-0.0404,0.0413,0.0292,-0.0477,0.0295,0.052,0.0337,-0.0526,0.0519,-0.0423,-0.0489,-0.0228,-0.0487,-0.0736,-0.0441,0.024,-0.0215,0.0297,0.0729,-0.0083,-0.0063,0.0523,0.061,-0.0059,0.0306,-0.0094,-0.0224,-0.0095,0.0158,0.0546,0.0075,0.0268,-0.0073,-0.006,0.0509,-0.0624,0.003,0.0394,0.0012,0.0142,0.0572,-0.0788,-0.0037,-0.0938,0.0544,0.0286,-0.0443,0.0088,-0.0283,0.0138,-0.0322,-0.0279,-0.0417,0.0057,-0.0094,0.0418,-0.0068,0.1028,0.0213,0.0114,-0.0048,-0.0437,0.0096,-0.0136,-0.0068,-0.0102,0.0682,0.0284,0.0549,-0.0117,0.0374,0.0398,-0.007,0.0125,-0.004,0.0101,0.0441,-0.008,-0.0415,0.0526,0.025,0.0619,0.0113,-0.0143,0.0172,-0.0084,-0.0139,0.0101,-0.0196,0.0154,0.0193,-0.0026,0.06,0.0586,0.0187,0.0558,0.0013,-0.0196,-0.0167,0.1043,0.044,0.0488,-0.0066,-0.0193,0.0528,0.0273,0.102,-0.0262,0.0224,0.0188,-0.0142,0.0339,0.022,0.0505,-0.0131,-0.0184,-0.0251,0.015,0.0051,0.0469,0.0113,-0.0281,0.0652,0.0279,0.0516,0.0284,-0.0188,0.0263,0.013,0.0509,-0.0017,0.0375,0.0349,-0.0244,0.058,0.0312,0.0407,0.0027,0.0299,-0.0102,0.0745,-0.0091,0.0218,0.0134,0.0602,0.0442,0.0126,-0.0696,0.0069,0.0091,0.0065,0.0413,0.0513,0.0277,0.0129,-0.0129,0.0076,0.0454,0.0246,0.0366,0.0293,-0.0958,0.0358,-0.0306,0.0157,0.0049,-0.0327,-0.0153,0.0246,-0.0534,0.0904,0.0293,-0.0262,0.0004,0.0382,-0.0134,-0.0535,-0.0325,-0.0436,-0.0196,-0.0114,-0.0486,0.0384,0.0283,0.0178,-0.0188,-0.0274,-0.0175,0.0339,0.0334,0.0173,0.0558,0.0592,0.032,-0.0092,-0.0181,-0.0312,0.0082,-0.0555,-0.024,-0.0105,0.0288,-0.0209,0.0434,0.0015,-0.0735,0.0213,0.0902,0.0888,0.0575,-0.0022,0.0488,0.0816,-0.007,0.0332,-0.0163,0.0112,0.0424,0.0255,0.0222,-0.0138,0.0604,0.016,0.0002,-0.0611,0.0429,-0.0131,0.0487,-0.0269,-0.0293,0.0508,-0.0144,-0.0204,0.034,0.0183,0.0105,-0.0464,0.0436,0.0531,0.0315,0.0363,-0.0032,-0.0587,-0.0159,0.0457,-0.0233,0.0128,0.001,-0.0184,-0.0244,0.0116,0.036,0.0493,0.0281,-0.0212,-0.0301,-0.0187,0.0123,0.021,-0.0365,0.0138,-0.0197,0.0276,0.068,-0.0273,0.033,0.0338,0.0072,-0.0559,-0.094,-0.0605,-0.0089,-0.0196,0.0044,-0.0353,0.0055,0.0536,-0.0514,0.0131,-0.0174,-0.0147,-0.0275,0.0011,-0.0109,0.063,0.0759,0.0095,-0.0632,-0.0437,0.0158,-0.0396,-0.0419,0.0176,0.0309,-0.0346,0.011,0.0046,-0.0727,-0.0753,-0.015,-0.0227,-0.0705,-0.0655,0.014,-0.0239,-0.044,0.0856,0.0624,0.0052,0.0001,-0.1141,0.076,0.0739,0.0582,0.0681,0.0526,-0.0082,0.0014,-0.0429,0.0273,0.0262,0.0559,-0.0608,0.0029,-0.0131,-0.0405,-0.0212,-0.0143,-0.013,0.0033,0.0255,0.0216,0.0046,0.0439,-0.0156,-0.0063,0.0124,-0.0015,0.0295,0.0219,-0.0201,0.0557,0.1,0.0457,0.0233,-0.0424,-0.0252,0.0066,-0.0089,-0.0121,0.0065,0.0414,0.037,0.0365,0.0034,0.0062,0.0688,0.0101,0.0411,0.0383,0.036,0.0378,0.0338,0.0802,0.0645,0.0302,-0.0118,0.0316,0.0256,0.0596,0.022,0.0162,0.0451,0.0266,0.0543,-0.0072,0.0085,-0.052,-0.0395,0.0002,-0.0089,0.0766,-0.016,-0.0201,-0.0732,0.0239,0.0169,-0.0197,-0.006,-0.0276,-0.1124,0.0042,0.0117,0.0203,-0.0013,0.0119,-0.0127,-0.0259,-0.0479,-0.0919,0.0077,-0.0092,0.0345,-0.0055,-0.0683,0.0341,0.0089,0.0145,0.0515,0.0464,0.0208,0.0024,0.0014,0.026,0.0332,0.0093,-0.0414,0.0134,0.0149,-0.0017,-0.0472,0.0305,0.0167,0.0314,0.058,0.0664,0.0175,0.0367,0.0238,0.004,0.0007,0.046,0.0455,0.0014,0.0314,-0.0237,-0.0056,0.0455,0.003,-0.0173,-0.0294,-0.0246,-0.0149,-0.0052,0.0011,-0.029,-0.0342,-0.0498,-0.038,-0.0621,0.0022,0.0515,0.0113,0.0045,-0.0421,-0.0163,0.0103,0.0343,-0.067,-0.0121,-0.059,-0.0009,0.0365,0.013,0.0079,0.0091,0.0064,0.0712,0.0086,0.0486,0.0081,-0.0059,-0.0487,-0.0115,-0.0194,-0.0337,-0.0504,-0.0572,0.0405,0.0041,-0.0028,0.0286,-0.0132,0.0214,0.0136,0.078,0.0672,0.0252,-0.0546,-0.0489,0.0557,0.0386,0.0325,0.0438,0.0038,-0.019,-0.0173,-0.0188,-0.0746,-0.0189,0.0217,0.007,-0.0138,0.0081,0.0287,-0.0196,-0.0457,-0.0109,-0.0062,-0.0126,0.0052,0.0588,0.0066,0.0459,-0.006,0.043,-0.0186,-0.0102,-0.0388,0.0278,-0.0148,0.0455,0.0433,0.0284,0.0171,-0.0016,0.0265,-0.0196,-0.023,-0.0096,0.0164,0.0324,-0.0042,0.0153,-0.0074,0.0155,0.0056,0.0131,0.0503,0.0414,-0.0882,-0.0179,-0.0409,0.0472,-0.0771,-0.0482,-0.0132,-0.0189,-0.0273,-0.023,-0.0045,-0.0162,0.0594,0.028,-0.0018,0.0485,0.0235,-0.0019,0.006,-0.0627,-0.0951,-0.0127,-0.0091,0.022,-0.0304,0.0199,0.0114,-0.0242,0.0218,0.0363,0.0061,0.0168,0.008,0.027,0.0321,-0.1616,-0.0546,-0.0417,0.0121,0.0163,0.0137,-0.0243,-0.1098,0.0569,-0.2431,-0.2301,-0.169,-0.1422,-0.2077,-0.1139,-0.0956,-0.0981,-0.0187,-0.0699,-0.0155,-0.0307,-0.0336,0.0806,-0.0085,-0.0138,-0.0376,-0.0494,0.0428,0.0325,-0.0727,-0.0426,0.0175,0.0292,0.0337,-0.0358,-0.0066,-0.0144,0.0215,0.0546,-0.0226,-0.0331,-0.0506,-0.0257,-0.0843,0.0436,0.0075,0.0172,0.0109,0.0165,-0.2188,0.0463,-0.0153,0.0158,0.0177,-0.0035,0.048,0.001,-0.0134,-0.0086,-0.0104,-0.0536,0.0236,0.0286,0.0008,0.0344,0.0661,0.0166,0.0042,-0.0371,0.0127,0.0414,0.0131,0.0283,0.0133,-0.0117,0.0057,0.0574,0.0033,-0.0777,-0.0055,0.0002,0.0305,-0.0658,0.0156,-0.0171,0.0616,0.0687,-0.0279,0.0535,0.0448,0.0402,0.0175,-0.0057,-0.0138,0.0259,0.0282,0.0167,-0.0008,-0.0028,-0.0059,0.0252,-0.0364,0.0059,0.008,0.0295,0.0174,-0.0369,0.0283,0.0262,-0.0298,-0.0358,0.0084,0.0425,-0.0082,0.0925,0.0419,0.0821,0.0123,-0.0345,0.0297,0.0083,0.0016,0.0467,0.0109,0.0419,0.0077,0.0111,0.0581,0.0474,-0.0393,0.0145,-0.2414,-0.2091,-0.1449,-0.2009,0.0546,0.0123,0.0514,0.0154,0.0553,0.021,0.0463,-0.0899,-0.0197,-0.0025,-0.028,0.011,0.0126,-0.0851,-0.0113,-0.0058,-0.0,-0.0391,-0.0026,-0.0078,-0.0044,-0.0447,0.0078,0.0102,0.0304,0.0304,0.0643,0.0112,0.0301,0.002,0.0187,-0.0237,0.0378,-0.044,0.0894,0.0862,-0.0061,-0.0046,0.0817,0.0835,0.065,0.0385,0.0254,-0.0167,0.0334,0.0171,0.0107,-0.039,-0.0789,0.0392,-0.0691,0.0046,-0.0173,-0.0484,0.025,0.0038,-0.0141,0.0205,0.0218,-0.01,-0.0143,-0.0376,-0.0169,-0.0041,0.0075,-0.0326,-0.0094,-0.0405,-0.0221,-0.0015,0.0204,0.0433,0.0182,0.0662,0.0859,0.0203,-0.0165,0.0508,0.0344,0.0077,0.0697,0.0053,0.0287,0.0014,0.0631,0.0219,0.0456,0.0632,-0.0018,-0.005,0.0083,-0.0685,-0.0283,-0.0016,0.0086,-0.007,0.0057,-0.0402,0.0318,0.0262,-0.0138,0.0501,0.0132,0.0611,0.0192,0.0116,-0.0054,0.023,0.0219,0.0445,0.0233,-0.0256,0.022,0.0077,-0.0324,0.0047,-0.0131,0.0595,0.0083,0.0461,0.0418,-0.0189,0.0507,0.0523,-0.0084,-0.0122,-0.0061,0.0248,0.0233,0.047,0.0803,-0.0075,0.0468,-0.0128,-0.0138,0.0468,0.0278,0.0544,-0.0392,-0.0598,0.0028,-0.008,-0.049,0.0009,-0.1443,-0.0134,-0.0423,-0.0241,0.0491,-0.052,0.0292,-0.0259,0.0004,-0.1159,-0.024,0.0499,0.0257,-0.0347,0.0384,0.0242,0.0378,-0.0078,0.0402,0.0302,-0.0525,-0.0036,0.0205,0.0491,0.0645,-0.0388,-0.0597,-0.0157,-0.0383,0.0461,-0.0289,0.0045,0.052,-0.0032,0.0148,0.0627,0.0119,0.0408,0.0416,0.0284,0.0361,0.0226,-0.0534,-0.0075,-0.023,0.0101,0.023,0.036,-0.0023,0.0385,0.0255,0.0668,-0.0108,0.03,0.002,-0.0212,-0.0436,-0.0207,0.003,0.0086,0.0314,-0.0134,-0.0021,-0.0043,0.0293,0.0045,0.0389,-0.0254,-0.0234,0.0125,0.039,0.0242,0.0235,-0.0564,-0.0139,-0.0236,-0.2616,-0.0024,-0.0319,-0.0025,-0.0834,0.0061,0.018,-0.0603,-0.0536,0.0434,-0.0125,0.0288,0.0463,0.0518,0.0343,-0.027,0.0399,0.0172,-0.0276,-0.0676,0.0261,0.0104,0.0113,-0.0009,0.0033,-0.0367,0.0658,0.0253,0.0247,0.0776,0.0463,-0.0846,-0.0059,-0.0305,-0.0039,-0.0819,-0.0152,0.0559,0.0256,-0.0063,0.007,0.0698,0.0344,0.013,0.0218,0.0501,-0.0691,-0.001,-0.0057,-0.0537,-0.0178,-0.0341,-0.0,0.0368,-0.0292,0.0194,0.0179,0.0353,-0.0387,-0.0118,0.0009,-0.0575,-0.0766,0.014,-0.0068,0.0025,0.0274,0.0607,-0.0487,-0.045,0.0479,0.0629,-0.0091,0.0075,0.0081,-0.0175,0.0423,-0.0649,0.0051,-0.021,0.0187,0.0053,-0.0747,0.0413,-0.0061,-0.0677,-0.0102,-0.023,-0.0341,0.0258,-0.0017,-0.0521,-0.0145,-0.019,-0.0531,-0.0146,0.0536,-0.0573,-0.0124,0.0104,-0.0067,-0.0599,-0.0167,-0.0437,0.0031,-0.0037,0.0251,0.014,-0.0326,0.0279,-0.0107,-0.0646,-0.0071,0.0026,0.0067,-0.0466,0.0773,0.0019,-0.0353,0.0503,-0.0368,0.0294,-0.049,-0.0597,0.0433,0.022,0.0279,-0.0325,0.0082,-0.0064,-0.0219,-0.0448,0.0072,-0.0617,0.0423,0.002,-0.1718,0.0182,0.0421,0.0398,0.0215,-0.0111,-0.0165,-0.0466,0.0332,-0.029,0.0109,0.0169,0.0162,-0.0093,-0.0081,0.016,-0.0263,-0.0333,-0.0746,-0.0731,-0.1166,-0.0935,-0.0207,0.016,0.036,0.0232,-0.0332,-0.0335,-0.0396,-0.0191,-0.0328,-0.004,-0.0469,0.0452,0.0689,0.0671,0.02,-0.0224,0.0417,-0.0062,0.0095,-0.0886,-0.0682,-0.0067,0.0262,0.0404,-0.0134,-0.0117,-0.0404,0.0414,0.0437,0.0537,-0.0641,0.0497,0.0357,-0.0045,0.0323,0.0125,-0.0394,-0.03,-0.0297,-0.0449,-0.0359,0.006,0.0088,0.0228,-0.0376,0.0101,0.0028,0.0486,-0.0341,-0.0488,0.0455,0.0407,-0.0006,0.0305,0.0325,0.0323,0.0435,0.0126,-0.0591,0.0772,0.0175,0.0047,0.0064,0.0002,0.0352,0.0539,0.036,0.0279,0.0009,0.0117,0.0131,0.0016,0.0041,0.0187,0.0741,0.0265,0.0591,-0.0098,-0.0193,0.0202,0.0241,-0.0073,0.0501,-0.0173,-0.0634,-0.014,0.0067,-0.0522,0.0141,-0.0142,0.0153,-0.0122,0.0076,0.0247,0.0898,0.0496,0.0137,0.0077,0.0266,-0.0269,-0.0509,-0.1664,-0.1102,-0.0124,-0.0516,0.0195,0.1038,0.0588,0.0791,0.0548,0.02,0.0073,0.0167,0.0337,0.0679,0.0538,0.0263,-0.0356,-0.0324,-0.0074,0.0365,-0.0246,0.0115,0.094,0.0687,0.0478,-0.0178,0.0333,0.019,0.0663,0.0521,0.0504,0.0188,0.0784,0.0197,-0.0021,0.0131,0.0545,0.0321,0.0318,0.0434,0.0438,0.0327,0.0117,0.0098,-0.0302,0.0216,-0.0327,-0.0325,0.016,-0.0277,0.0183,0.004,0.0297,-0.0125,0.054,-0.0062,0.0498,0.0498,0.0003,0.0606,0.0259,0.016,0.0316,0.0463,-0.0283,0.0395,-0.0384,-0.0335,0.0607,-0.0295,-0.0079,0.0388,0.0217,0.03,-0.0014,0.0419,-0.0062,0.0261,-0.0445,0.0047,-0.0225,0.0772,0.0425,0.057,0.0498,0.0511,0.0508,-0.0069,-0.0323,-0.0144,-0.0392,0.0334,-0.0046,-0.0375,-0.0662,-0.0245,0.0869,0.0987,0.0625,-0.0087,-0.0043,0.0191,-0.0179,0.0265,-0.0193,0.046,-0.0105,0.0016,0.0637,0.0395,0.0187,-0.0259,0.0398,-0.0164,0.0712,0.0168,0.002,-0.0225,0.0099,0.0292,0.026,0.0534,0.0324,0.0716,0.0169,-0.0815,0.0121,0.0383,0.0029,-0.0155,0.0204,-0.016,0.0106,0.0163,-0.0418,-0.0018,0.0172,-0.0177,0.0291,0.0277,0.0292,-0.0108,-0.0404,0.042,0.0009,-0.0003,-0.0377,0.0049,0.0098,-0.0628,-0.0178,0.0095,0.0369,-0.0205,-0.0153,-0.0255,0.0341,0.03,0.0254,0.0123,0.0312,-0.0551,-0.0994,-0.1033,-0.0105,-0.0313,-0.0589,-0.0272,0.0023,-0.0671,0.0128,-0.0216,-0.0154,0.0777,0.0241,0.0644,0.0391,-0.0046,0.0312,0.0587,0.0215,-0.0012,0.0177,0.0571,0.0384,0.0423,0.0558,0.0985,0.0131,0.0764,0.0208,-0.0428,0.0541,0.0101,0.0815,0.0246,-0.0352,0.007,0.0389,-0.0022,0.0323,-0.0209,-0.0359,-0.0126,0.0202,0.0348,-0.0314,-0.0617,-0.0063,-0.0577,-0.0034,0.0284,-0.0256,0.0179,0.0041,0.0503,0.0514,0.0451,0.0277,0.0181,-0.008,0.0349,0.0458,0.0093,0.0294,-0.0293,0.0493,0.0262,-0.0355,-0.0378,-0.0007,0.004,-0.0087,0.0654,0.0088,0.0487,0.0456,0.0165,-0.0453,-0.0359,0.0479,-0.1395,-0.0986,0.0803,0.0197,-0.1386,-0.0617,-0.0464,-0.0569,-0.0569,-0.0496,0.0441,0.0426,0.0311,0.0544,-0.2263,-0.1538,-0.1779,-0.0915,-0.0191,-0.145,-0.1861,-0.1943,-0.1849,-0.0245,0.0225,0.0338,0.0136,0.0248,0.0049,0.0325,-0.0199,0.0042,0.0075,0.0625,0.0656,-0.0627,0.0164,0.0285,0.0266,-0.03,-0.0321,-0.0377,0.0273,0.0525,0.0426,0.0194,-0.0207,0.0069,0.0342,0.0151,-0.0051,0.0144,0.056,0.0537,0.045,0.0252,0.0447,0.0175,-0.074,-0.004,-0.0386,-0.0262,-0.0272,-0.1411,0.015,0.0485,0.0637,-0.0038,-0.0079,-0.0032,-0.0433,0.0261,0.0012,-0.0001,0.0307,0.0349,0.0403,0.0363,-0.0067,0.0861,0.0595,0.0083,-0.0473,-0.0945,0.0304,0.0019,-0.0404,0.0201,0.0159,-0.0152,0.029,0.0619,0.0462,0.0197,0.0203,0.0304,0.0131,0.0469,-0.0254,-0.0055,0.0034,0.0184,-0.01,0.0036,0.0494,-0.0157,-0.0304,-0.0556,0.0025,-0.0035,-0.008,0.0206,0.0055,-0.0061,0.0145,0.012,0.0497,0.0525,0.0314,0.0059,-0.024,-0.0144,-0.0196,-0.0006,-0.0017,-0.0385,-0.0654,-0.0316,-0.0779,-0.0478,0.0438,0.049,0.0119,0.0444,0.0412,-0.0373,0.0028,-0.0455,-0.0088,-0.0471,-0.0259,0.0735,0.0047,-0.0245,-0.0313,-0.0258,-0.068,-0.0291,-0.039,-0.1231,-0.1567,-0.0242,0.0277,0.069,0.018,-0.039,0.059,0.0297,0.0654,-0.0192,0.0543,0.0169,0.0423,0.0222,0.0137,0.0533,0.0594,0.0339,0.0299,0.0658,0.0493,0.0397,0.0465,0.0154,-0.0074,0.0228,0.0424,0.0452,-0.0741,-0.0428,-0.0585,0.0405,-0.0787,-0.055,0.0165,-0.0317,0.0514,0.024,0.0063,0.0137,0.0209,0.0147,-0.0486,-0.0633,-0.025,0.0663,0.0283,-0.015,-0.0045,-0.0457,0.0199,0.0,0.0184,0.0236,-0.0627,0.0259,0.0331,-0.0016,0.0453,0.0068,0.0062,-0.0253,0.0207,-0.051,-0.018,0.019,0.0862,0.0451,0.0718,0.0742,0.0615,0.0454,0.0577,0.0577,0.0125,0.0171,0.0202,0.0726,-0.0204,0.0536,0.0537,0.0244,-0.0267,0.0991,-0.0387,0.0375,0.0159,-0.0339,0.0078,-0.0529,-0.0293,0.0397,0.0767,-0.0181,-0.0573,-0.0176,0.0056,-0.0216,0.0231,-0.0268,-0.0211,-0.0313,-0.0561,0.0431,0.0179,-0.0002,0.058,0.0476,0.008,0.0368,0.0086,0.0139,0.0075,0.0013,0.0152,0.0216,0.0095,-0.0398,0.0147,-0.0553,-0.0018,0.0765,0.0277,0.0798,0.045,0.043,0.0248,-0.0059,-0.0104,-0.0101,0.0336,-0.0239,-0.0126,0.0144,-0.0624,-0.0068,-0.1306,-0.0758,0.004,-0.0121,0.0337,-0.009,-0.0425,-0.0153,0.0398,-0.0189,-0.0109,-0.0023,-0.0054,0.015,0.0446,0.022,0.0158,-0.0157,-0.0071,0.045,-0.0627,0.0376,-0.0476,-0.0549,-0.0436,0.0134,-0.0355,0.0522,0.0535,0.0197,-0.0457,0.002,-0.0194,0.0214,0.0608,0.0161,-0.0224,-0.0333,-0.0155,-0.041,-0.0099,0.0092,-0.0698,0.0537,-0.0346,-0.0446,0.0389,0.0399,0.0319,0.0211,0.0349,0.017,-0.0027,0.055,-0.0262,-0.0277,-0.0404,-0.0036,-0.0,-0.0199,0.013,0.0422,0.0256,0.043,0.0267,-0.0156,-0.0234,-0.0276,-0.0265,-0.0259,-0.0391,-0.0331,0.0218,0.0072,0.0343,0.0366,-0.0347,-0.0194,-0.0416,0.0184,0.0254,0.0714,0.0315,0.0295,-0.0031,-0.0245,0.0354,-0.0315,0.0367,0.0004,-0.0109,0.0056,0.0346,-0.0373,0.032,0.0256,0.0409,-0.0476,-0.0108,0.0607,0.0009,-0.0099,0.0165,-0.0004,0.0394,0.0515,0.0641,0.0465,0.0598,0.0426,0.0185,0.0398,0.0429,-0.0042,-0.0114,-0.0045,0.0261,0.0222,-0.0598,-0.0976,-0.1622,-0.0446,0.0289,-0.0157,0.0194,0.0364,0.0165,0.0691,0.0364,-0.0053,-0.0345,0.0245,0.0616,-0.0846,0.0132,-0.0083,-0.0994,-0.0245,-0.0625,0.0259,-0.0332,0.0426,0.0539,0.0121,-0.0177,0.0279,-0.0243,-0.0046,0.008,0.0116,0.0355,0.0084,-0.0027,0.0469,0.0262,0.0064,0.0095,-0.0255,0.002,0.0293,-0.0094,0.0184,-0.0226,0.0845,0.0039,0.0382,0.0562,0.005,0.0657,0.0478,0.0739,0.0461,0.0284,-0.0177,0.0533,-0.0155,0.0307,0.0147,0.0048,-0.0184,0.0644,0.0701,0.0259,0.0227,-0.0389,-0.0391,0.0439,0.0152,0.052,-0.0279,-0.0146,-0.0026,-0.0063,-0.0114,-0.0048,-0.0078,-0.0363,0.0375,0.0303,0.0058,0.0088,-0.0025,-0.0386,-0.0567,0.0463,-0.0603,-0.0419,0.0015,-0.0282,0.0154,0.0494,0.0488,-0.014,-0.0666,-0.0761,-0.035,-0.0207,-0.0498,0.0282,-0.0318,-0.0757,-0.0261,-0.0437,0.0496,0.0106,0.0462,-0.0066,0.0176,0.0146,-0.0031,0.0219,-0.0528,0.0093,-0.0585,-0.0067,-0.0412,-0.0015,0.0609,-0.0083,-0.0239,0.0012,-0.0083,-0.0387,-0.0169,-0.0146,-0.0056,0.0043,0.0359,0.0377,-0.0768,-0.0838,-0.0553,-0.0426,-0.031,-0.0089,0.0714,0.1414,0.133,-0.0331,-0.0482,0.0521,0.0107,-0.0041,-0.0175,0.0325,0.0362,0.0642,-0.0143,0.0206,-0.0134,0.0049,0.0138,0.0195,0.0448,0.0087,0.067,0.0441,0.0049,0.0145,0.0042,0.0884,0.0101,0.0151,0.0156,0.011,-0.0404,0.0305,0.0642,0.061,-0.0749,0.0377,-0.0096,-0.0073,-0.0039,-0.011,0.0055,0.036,0.0061,0.0124,-0.0116,-0.0164,-0.0284,-0.0426,-0.0197,0.0251,0.0676,0.0789,0.0192,0.015,-0.0308,-0.0339,0.016,0.0197,0.0534,0.0425,-0.0002,-0.0202,0.0268,0.0201,0.0491,0.0044,0.0452,-0.1207,-0.0379,0.0332,0.0177,-0.0046,-0.0351,0.0407,0.0434,0.0904,0.0948,0.0469,0.0372,-0.0239,0.0035,0.0186,-0.0348,0.0113,0.0082,-0.1566,-0.0146,-0.0336,-0.1213,0.0765,0.0448,0.0309,-0.04,0.0123,0.0014,0.0298,0.0228,-0.0008,0.073,0.0632,0.0044,-0.104,-0.0019,0.0122,0.0097,-0.0068,-0.014,-0.1145,0.0197,0.0191,0.0229,0.0162,-0.0072,0.0011,-0.0273,-0.0323,-0.0404,0.0301,-0.0066,0.0071,-0.0117,-0.0016,0.0302,-0.0193,0.0342,0.0152,-0.0348,-0.023,-0.0326,-0.0127,0.0279,-0.0055,0.054,-0.0017,0.0835,0.0331,0.0325,0.0342,-0.1087,0.0263,-0.099,-0.0049,-0.0179,0.017,0.0105,-0.0359,0.0635,-0.039,-0.0469,-0.0261,-0.0284,-0.0201,-0.003,0.0405,0.002,0.0283,0.0286,-0.0383,-0.0336,0.0373,-0.0214,-0.0181,0.0049,0.0012,-0.0067,0.0323,0.0246,-0.0156,0.0399,-0.04,0.0264,-0.0311,-0.0091,-0.0265,0.0006,-0.0046,-0.0412,0.0078,0.031,-0.0236,-0.0599,0.0048,-0.0042,0.0132,-0.0409,0.0223,0.0267,0.0209,-0.0149,-0.0242,-0.0114,0.0494,0.0287,0.0493,0.0349,0.0133,-0.0072,0.0038,0.0316,0.029,0.0428,-0.0077,0.0005,0.0103,0.0165,0.0171,-0.0125,0.038,-0.0126,0.0457,0.0293,0.0499,0.0118,0.0009,0.0508,0.0445,-0.0247,-0.0286,0.0015,0.0388,-0.0108,-0.0611,-0.0233,0.0639,-0.0467,0.0298,0.0218,-0.0317,-0.0043,-0.0384,-0.0827,-0.0479,-0.0038,-0.0303,-0.0176,-0.0503,0.0708,0.0188,-0.0087,0.0107,0.016,0.0201,-0.0238,0.054,-0.0271,0.089,0.0472,0.0045,0.0072,0.0465,-0.0022,-0.0251,-0.0314,0.0205,0.0644,0.1451,0.1153,0.0703,0.1048,-0.0696,0.0202,0.0167,0.0017,0.0077,0.013,0.0518,0.0556,-0.1294,-0.0509,-0.0757,-0.0019,-0.0137,0.0351,0.0275,-0.0143,-0.0161,-0.0048,-0.0068,0.0067,-0.0515,-0.0084,0.0534,0.0894,0.0694,0.0604,0.0561,0.0151,0.0247,-0.0052,0.0006,0.0065,0.0127,0.0106,0.0554,0.0212,0.0628,-0.0022,0.0532,0.0686,-0.0109,-0.0313,0.0532,-0.0009,0.0305,0.055,0.0507,0.0507,0.0035,0.0405,0.0728,0.0106,-0.0022,0.058,0.0506,0.0021,-0.0108,0.0303,0.0315,0.0177,0.0402,0.0293,-0.0393,-0.0398,0.0246,-0.0879,0.0194,0.0423,-0.0226,-0.0243,-0.0752,-0.0421,0.0181,-0.0182,0.0036,0.0006,-0.0207,-0.0573,-0.0423,-0.036,-0.0344,-0.0287,-0.0178,0.0267,-0.0691,0.0658,-0.0322,-0.0101,0.0068,-0.0001,-0.0364,0.0289,0.0204,0.0046,-0.0136,0.0323,0.0317,-0.0347,-0.0407,0.0145,0.0271,-0.0198,-0.0329,0.0082,0.0907,0.0636,0.0286,-0.0064,0.0306,0.0333,0.0355,-0.0011,0.0003,0.0145,0.0349,0.0289,0.0189,-0.0045,0.0676,0.0175,-0.0361,-0.0005,0.0483,0.0151,-0.0637,-0.0106,0.0016,-0.0138,0.0491,-0.0351,-0.0582,-0.0173,0.0463,-0.0658,0.0001,0.0089,-0.071,-0.0576,-0.0173,0.0496,0.0256,0.0037,-0.0344,-0.0705,0.0141,-0.0238,0.0199,-0.0224,0.034,0.035,-0.0264,-0.0567,0.0507,0.0125,-0.0414,0.0209,0.0563,-0.0107,0.0131,0.0611,0.0478,0.0307,0.0353,0.079,0.0454,-0.0537,-0.0828,-0.01,0.0174,0.0002,-0.006,0.0326,0.0189,0.05,0.071,-0.0354,-0.0185,0.05,0.0322,0.0039,-0.0515,0.0452,0.0062,-0.0058,-0.0072,0.0264,0.0582,0.0274,0.0298,0.0297,0.0562,0.0486,0.0278,-0.0278,0.0461,0.0114,-0.0501,-0.0082,0.027,0.0513,0.0515,0.0645,0.0497,0.0481,0.0445,0.015,-0.0061,-0.0445,0.0141,0.0332,-0.0128,0.019,0.0303,0.0007,0.0555,0.0344,0.0557,-0.0468,-0.0118,-0.0308,0.0302,0.0809,0.0473,0.0282,0.0352,0.0197,-0.0015,-0.0427,0.0555,0.0313,0.0262,0.0205,0.0266,0.0614,0.047,0.0418,0.014,0.0054,0.0498,-0.0006,-0.06,-0.0129,-0.001,-0.0067,-0.0279,-0.0567,-0.0675,-0.0038,-0.0104,0.0492,0.0364,0.0502,0.011,0.0537,0.0394,-0.0129,0.0185,0.0562,0.0259,0.0432,-0.0066,0.0185,-0.0074,0.0018,-0.0949,0.0,-0.1054,-0.0254,-0.0496,-0.0178,-0.0691,-0.0103,0.0199,0.0401,0.0278,-0.0668,-0.0183,0.0184,0.0169,0.0296,0.0514,0.035,0.0246,-0.0012,-0.0298,-0.0367,0.0512,0.057,0.0067,0.0555,0.0049,0.0284,-0.1133,-0.0445,0.0348,0.0178,-0.0163,0.0494,0.0539,0.008,0.0561,0.0909,-0.0474,-0.0441,0.0246,0.0132,0.0334,-0.0148,-0.0782,0.0156,-0.0252,0.0072,0.0132,-0.0387,0.0299,-0.0016,-0.0312,0.0385,0.0083,0.0617,-0.0527,0.0526,-0.1716,0.0028,-0.0047,0.0336,0.0274,-0.0291,-0.0262,0.0191,-0.021,-0.0482,0.0149,0.0265,-0.0331,-0.0173,-0.0179,-0.0249,-0.074,-0.0645,-0.083,-0.1427,0.0173,-0.0004,-0.0957,-0.1811,-0.0566,-0.112,-0.1505,-0.0789,-0.1061,-0.0957,-0.0293,-0.0935,-0.0658,-0.0641,-0.1094,-0.02,-0.0712,-0.1337,-0.1135,-0.1728,-0.035,-0.0223,0.0021,0.0639,0.0647,0.0472,0.0373,-0.0102,0.0641,0.0781,0.0288,0.0327,0.0413,0.0771,0.0685,0.0546,-0.008,-0.0134,0.0271,-0.0223,0.0102,0.0222,0.0292,0.0486,0.0011,0.0156,0.0216,0.0486,-0.0887,0.054,0.076,-0.0248,0.0161,0.0337,-0.015,-0.0192,0.0501,0.0194,-0.0059,0.0175,-0.1115,-0.1266,-0.0507,-0.0631,-0.0874,0.0321,0.0034,0.0026,-0.0043,0.0242,-0.0586,0.0032,-0.027,0.033,0.0202,-0.1006,0.0433,0.0456,0.0163,-0.0066,0.0119,0.0321,visual letter recognition
trm_557b4aeaeb744,-0.1366,-0.1311,-0.1275,-0.0871,0.0042,-0.042,-0.0986,-0.0441,0.0009,-0.0582,0.0116,-0.0001,-0.1244,-0.0177,-0.1217,-0.0732,-0.1264,-0.0693,-0.0489,-0.0159,-0.0721,-0.0083,-0.0614,0.0465,-0.0384,-0.0025,-0.0032,-0.0683,-0.1237,-0.0814,-0.0963,-0.0668,-0.1038,-0.0878,-0.0756,-0.1285,-0.1161,-0.0616,-0.1251,-0.0345,-0.1254,-0.1137,-0.0832,0.0523,-0.0531,-0.0476,0.0849,-0.0922,0.0319,-0.0923,-0.0373,0.035,0.0835,0.0781,0.0179,-0.046,-0.1347,-0.0178,0.0143,-0.0657,-0.0512,-0.0152,-0.1087,0.0929,0.0726,0.0033,-0.1792,-0.1885,-0.0857,-0.023,0.1006,-0.0133,0.2088,-0.0771,-0.0903,0.0809,-0.1321,0.0202,0.0714,-0.0897,0.024,0.096,0.004,-0.096,0.06,0.0317,0.0275,-0.0349,0.0153,-0.2699,-0.1251,-0.0997,-0.0394,0.1108,0.1055,0.0975,0.1034,0.027,0.1443,0.0008,0.03,-0.0041,0.0825,-0.0675,0.0553,-0.1737,-0.123,0.1813,-0.0703,-0.0292,0.0064,-0.0712,0.1066,0.1364,0.0301,0.0629,-0.0457,-0.0577,0.0187,-0.0753,-0.0644,-0.1158,-0.0683,0.0197,-0.0311,-0.0787,-0.0596,0.0116,0.0538,-0.0104,0.0194,-0.0678,-0.0533,-0.1448,0.0079,-0.1563,-0.024,-0.0714,-0.0581,-0.051,-0.0855,-0.0829,0.0942,-0.0152,-0.065,0.0457,-0.0956,0.0447,-0.0768,0.1148,-0.0393,-0.0918,-0.1469,-0.0962,0.137,-0.0802,0.0583,-0.024,-0.0005,-0.0968,-0.0465,-0.1025,-0.1506,-0.2249,-0.0009,-0.0099,-0.0322,-0.1217,-0.109,0.0589,-0.1408,-0.1182,-0.0286,-0.0529,-0.0723,-0.0991,-0.0724,-0.0324,0.0128,-0.0442,-0.1352,0.0413,-0.0792,0.0384,-0.1205,-0.0637,-0.1506,0.0043,0.0685,-0.0204,0.0035,-0.0992,-0.0654,-0.1427,-0.116,-0.1728,-0.142,-0.0453,0.0277,-0.1102,-0.0701,0.0806,-0.0881,-0.1636,0.0991,-0.0974,-0.0129,-0.0444,-0.0789,0.0037,-0.0963,-0.0372,0.0091,0.0156,0.0852,0.0438,0.0735,-0.1442,-0.2101,-0.0048,0.0627,-0.0955,-0.1562,-0.0858,0.0608,-0.0116,-0.0543,0.0691,-0.0253,0.2479,-0.1525,-0.1002,0.1013,-0.1722,-0.1734,0.0003,0.0053,0.1397,0.0171,-0.0458,-0.0538,-0.1522,-0.063,-0.0148,-0.0598,-0.0605,0.001,-0.1127,-0.0796,-0.0326,0.0446,0.0275,-0.0074,0.0876,-0.0356,-0.1072,0.0173,-0.045,0.1487,0.1815,0.0622,0.1856,-0.0582,0.1021,0.123,0.267,0.122,0.0227,0.0112,0.0171,-0.0389,-0.0993,-0.043,0.0338,-0.136,-0.0428,-0.2196,-0.2737,-0.2375,-0.075,-0.0247,-0.0137,0.0004,-0.1119,-0.0759,-0.1147,0.0475,0.096,-0.1269,-0.113,-0.0764,-0.046,-0.0426,-0.0462,-0.1204,-0.0357,0.0073,0.1057,-0.014,0.1539,0.0806,-0.0868,-0.1359,-0.1328,-0.0904,-0.0846,-0.1379,-0.045,-0.0822,0.0464,0.0055,-0.0054,-0.0842,0.1386,0.0546,-0.0378,0.1287,0.026,0.0959,-0.075,0.0637,0.0596,-0.0347,-0.0255,-0.0956,-0.063,0.021,-0.0716,-0.0766,-0.1807,0.0477,-0.0636,0.0149,0.0294,0.0778,0.0438,0.1117,0.0473,0.0471,-0.0402,-0.0377,-0.0223,-0.0691,-0.0393,0.0465,0.0507,-0.2618,-0.1984,-0.1936,-0.128,-0.1201,0.0323,-0.1589,-0.0778,-0.0735,-0.1333,-0.0513,-0.0918,-0.1693,-0.0729,0.0211,-0.0257,0.0286,-0.0538,-0.0563,0.0355,-0.1578,0.2413,0.0088,-0.1515,0.021,0.102,-0.0544,0.0833,-0.0777,-0.0368,-0.0858,0.0898,0.1714,0.0688,0.1696,-0.0601,-0.0457,0.058,0.0656,0.0924,-0.0393,-0.0218,0.057,-0.0377,-0.0716,-0.0658,-0.1463,-0.0137,0.0692,-0.0256,-0.1679,-0.1834,-0.1287,-0.0459,-0.0146,0.0277,-0.0103,-0.0714,-0.0062,0.1111,0.1066,0.0027,-0.1256,-0.0672,-0.0659,-0.129,-0.0426,0.2511,-0.0935,-0.0028,0.2731,0.0418,-0.0249,0.0281,-0.0109,-0.2209,-0.167,-0.2835,-0.2339,-0.1173,-0.1932,-0.1135,-0.1042,-0.1217,-0.022,0.0499,0.0296,0.0058,-0.0087,0.0794,-0.032,0.0045,-0.2832,-0.0982,0.017,0.0678,-0.072,0.0854,-0.1012,-0.1202,0.0443,0.0324,0.0345,0.1246,0.1232,0.0713,-0.0801,-0.0374,0.0605,-0.0579,0.0186,-0.0053,0.0718,0.0149,0.0462,-0.0671,-0.0389,0.0685,-0.1099,-0.1463,0.0199,0.326,-0.1255,-0.1116,-0.0156,-0.0181,0.08,-0.0176,0.0254,-0.0333,0.0021,-0.0152,-0.0201,-0.0366,-0.0134,-0.0277,-0.0637,0.0998,0.1268,0.1374,-0.0567,-0.0389,-0.0418,-0.0493,-0.0031,0.0947,-0.1103,-0.1357,0.0371,0.0151,-0.0061,-0.0527,0.0309,-0.0241,-0.0157,0.0551,-0.0911,-0.1236,-0.0701,-0.0816,0.1061,0.0873,-0.0373,0.0507,-0.1408,-0.0206,0.0283,0.0002,0.0238,0.0739,-0.0748,-0.0693,0.014,-0.044,-0.0245,-0.0853,0.0813,0.1284,0.2163,0.0505,0.1107,0.103,0.0274,0.0842,-0.0481,-0.0411,-0.1257,-0.1736,0.0074,0.0023,-0.1298,-0.0958,-0.0567,-0.1218,-0.0064,0.022,0.0129,-0.0781,-0.0527,-0.0381,0.0444,0.0597,0.0153,-0.0894,0.0557,0.0142,0.0179,-0.0611,-0.0298,-0.127,0.0826,0.1007,0.0282,-0.0835,-0.0601,0.0247,-0.0299,0.0049,-0.0506,-0.0019,0.052,0.0669,0.02,0.022,-0.008,0.0666,-0.1598,-0.0282,-0.1712,-0.1195,0.0072,0.0148,0.0694,0.1109,0.0386,-0.1017,0.0157,-0.0609,0.116,0.067,0.0318,0.0681,0.046,-0.0104,-0.1317,0.0426,0.116,0.1521,-0.0365,-0.0612,-0.1609,0.0169,0.1222,-0.0857,0.0192,0.0641,0.0625,0.0607,-0.0048,-0.0904,0.0266,-0.1624,-0.1515,0.141,-0.1527,-0.0757,0.1039,0.0051,-0.2142,-0.0468,-0.0592,0.0832,-0.006,-0.2095,-0.0641,-0.2135,-0.0142,-0.0045,-0.1027,0.0124,-0.0625,-0.0705,-0.0769,0.0319,0.0244,0.0323,-0.0303,0.0676,0.0742,-0.0197,0.0807,-0.0742,-0.0263,0.0089,-0.0734,0.0175,-0.0163,-0.1421,-0.0816,-0.0436,-0.0529,-0.0591,0.1083,-0.1621,0.1249,-0.1233,0.0957,-0.1235,0.0238,-0.0902,-0.0362,-0.084,-0.0623,-0.0771,-0.1229,-0.1139,0.1366,-0.1117,0.01,0.0519,-0.1537,-0.1597,-0.1228,-0.0076,-0.0539,-0.049,-0.0987,-0.1155,-0.0365,-0.0595,0.0912,-0.1058,0.006,-0.0427,0.0734,0.0194,0.0796,-0.0132,0.0354,-0.1085,-0.1084,0.0523,0.0308,-0.0247,0.098,0.1543,0.1185,0.0649,-0.0591,0.0356,0.0301,-0.0515,-0.0553,0.0606,0.0765,0.0589,-0.0592,-0.0443,-0.0233,-0.0347,-0.1364,-0.1783,-0.1893,0.0781,0.1183,0.1001,0.0207,0.082,0.1286,0.0494,-0.0376,0.0118,-0.1246,0.028,0.093,-0.0411,-0.2166,-0.2245,-0.1398,-0.0071,0.0214,-0.0551,0.1194,-0.0475,0.0125,-0.0059,-0.0964,0.0352,0.0632,-0.0214,-0.1854,0.1437,0.1341,0.3125,-0.0776,-0.0038,-0.0794,0.0083,0.0334,-0.1311,0.1186,0.0471,-0.0387,0.044,0.0337,0.0589,-0.0702,-0.1444,-0.1184,-0.0772,0.0147,0.1412,-0.0022,-0.1681,-0.0027,-0.0449,0.0641,-0.0276,0.0313,-0.0299,-0.0457,-0.0711,-0.1121,0.1344,0.0395,0.0559,-0.1161,-0.0361,0.0223,-0.0698,0.0038,-0.0658,-0.1234,0.0121,-0.0933,-0.1255,-0.069,0.0876,0.1034,0.059,0.018,-0.0487,0.0392,0.1472,-0.0476,-0.0327,0.0789,-0.0122,0.0153,-0.0316,0.1,0.0037,0.1773,-0.1433,-0.1423,0.063,0.133,0.0851,-0.0184,-0.0055,0.075,-0.0035,0.0146,0.0969,-0.0317,0.0477,0.0768,0.1166,-0.0002,-0.0238,0.1033,0.16,-0.1888,0.0489,0.0957,-0.1681,-0.0959,-0.0588,-0.1155,0.0621,-0.1211,-0.0261,-0.1106,-0.11,-0.1242,-0.0168,-0.0304,0.0925,-0.0693,-0.0705,0.0819,0.0376,0.0794,0.0721,0.0674,0.1049,0.0024,0.0737,0.0173,0.0251,0.0659,0.1117,-0.0976,0.1217,0.0931,-0.081,-0.0377,-0.0674,-0.0171,0.1453,0.0985,-0.2178,-0.0525,-0.0046,0.0635,0.1667,0.1118,0.1,0.0352,-0.0405,-0.041,-0.0676,0.0426,0.0007,0.0533,-0.0755,-0.0631,-0.059,0.097,0.2209,0.106,0.1994,-0.0569,-0.0372,-0.0583,0.1098,-0.0506,-0.0561,-0.11,0.0406,-0.0538,-0.0948,-0.0312,-0.1209,0.0415,-0.0845,0.0417,0.0752,0.0483,-0.0015,-0.1128,-0.0112,-0.0326,0.0942,-0.0664,0.0049,0.0295,0.042,0.1025,0.2067,0.0823,-0.0605,-0.049,-0.0549,-0.0098,-0.1394,0.0088,0.0681,0.1573,0.0258,-0.0163,-0.1086,0.0986,0.1767,0.0097,-0.0454,0.0051,-0.0478,-0.2521,-0.1318,-0.0906,-0.0841,0.0108,-0.1263,-0.0752,0.1013,-0.0118,-0.0681,-0.0261,0.0524,-0.0627,-0.0494,-0.0635,-0.118,-0.121,-0.0693,-0.0244,-0.0674,0.0436,0.0228,-0.0564,-0.0806,0.0108,-0.0808,0.0178,-0.0795,-0.0817,-0.0285,0.0071,0.0754,0.0809,-0.0569,0.0422,-0.0617,0.0463,0.0146,0.1127,0.1736,0.1217,-0.0371,-0.0652,-0.0148,0.0212,0.1032,0.1113,0.0692,-0.0279,0.1187,-0.0523,0.0909,-0.0515,-0.0653,-0.0844,0.0082,-0.0541,0.0198,-0.1243,-0.0386,-0.0288,-0.0015,0.0039,0.0329,0.1036,-0.0021,0.0943,0.122,0.0718,0.0411,0.0657,-0.0471,0.0018,0.0214,-0.0257,-0.0732,-0.0718,-0.156,-0.0319,0.1262,0.1162,-0.1474,-0.0944,-0.0318,-0.1226,-0.0095,0.1469,0.0286,0.1664,0.0717,0.0674,-0.0356,0.0543,0.1128,-0.0116,-0.0226,-0.019,0.045,-0.0377,-0.1692,-0.0126,0.0923,-0.08,-0.0322,-0.082,0.0693,-0.1312,0.0066,-0.0299,0.065,0.1805,0.1538,0.0814,0.0754,0.0148,0.0535,-0.0079,-0.0317,-0.0252,0.0064,-0.0385,-0.0135,-0.0474,0.0812,-0.0349,-0.053,-0.1173,-0.1252,-0.1412,-0.0815,-0.0818,0.1709,-0.0191,0.0163,-0.1283,0.1276,0.1125,0.0094,0.003,-0.0045,0.0824,0.0002,-0.004,-0.1175,-0.0405,-0.0077,-0.0049,-0.0558,-0.0486,-0.0457,0.0335,0.0864,-0.0316,-0.0496,-0.0616,0.0185,-0.135,-0.053,-0.0039,0.0513,-0.1269,0.017,-0.0332,0.0418,-0.0425,-0.0706,0.2933,0.1347,0.1544,0.0935,0.1098,-0.0275,0.1295,0.0833,-0.1173,0.3584,0.2968,0.2505,0.1766,0.2947,0.0799,0.0395,0.0612,0.042,0.0545,0.0605,0.0441,0.0394,-0.1111,0.0161,0.0191,0.0188,0.0308,0.0029,0.0069,0.1665,0.0956,-0.0275,-0.0029,-0.0676,0.0933,-0.0417,0.1065,-0.0401,-0.1378,-0.0236,0.0362,0.0496,0.0838,0.0706,-0.1471,-0.0776,-0.1321,-0.0985,-0.0492,0.3158,-0.0834,0.0837,0.0597,-0.0039,-0.0216,-0.1412,-0.0855,0.0059,-0.0515,0.0887,0.0552,0.031,0.0814,0.072,-0.1465,-0.139,0.0471,-0.0531,-0.0261,0.003,-0.0778,-0.0667,-0.1005,-0.0494,-0.0856,-0.0456,-0.202,-0.1022,0.1598,-0.0023,-0.0091,0.0231,0.1878,-0.0417,-0.0106,-0.1527,-0.1392,-0.0387,-0.0634,-0.1878,-0.2366,-0.0773,0.0023,0.0405,0.1962,0.1272,0.0408,0.1285,0.0038,0.1025,0.083,0.1178,0.0047,0.1798,-0.0189,0.2005,0.2653,0.0477,-0.0249,0.2435,0.1831,0.0626,-0.0605,-0.0261,-0.1199,-0.0503,-0.1836,-0.0309,0.0365,-0.1109,-0.078,0.0115,-0.0982,-0.0402,-0.0654,-0.0912,-0.0639,-0.0249,0.067,0.074,-0.0438,0.3586,0.3178,0.2103,0.3016,-0.06,-0.0379,-0.0378,-0.0464,-0.0112,-0.1098,-0.0859,0.1209,-0.0294,-0.0233,0.0806,-0.125,0.0229,0.0795,0.0292,-0.0265,-0.0343,0.0341,0.0192,0.0013,0.0326,0.0891,0.0581,-0.02,-0.0585,-0.0585,-0.122,0.083,0.0252,0.0458,-0.0883,0.0824,-0.1029,0.0757,-0.2283,-0.2023,0.1313,-0.0415,-0.1836,-0.1778,-0.175,-0.0311,-0.1095,0.0063,0.019,-0.0462,0.0446,-0.0611,0.0758,-0.0825,0.1003,-0.0636,0.125,0.0552,-0.0532,-0.0008,0.0311,0.0126,-0.0031,-0.022,-0.1264,0.015,0.0553,-0.0864,-0.081,-0.0031,-0.0162,0.0038,-0.0267,-0.0275,0.0416,-0.0295,-0.0949,-0.1277,-0.2082,-0.0054,-0.0248,-0.1249,-0.1006,-0.0805,-0.1363,0.0269,-0.1446,0.0285,-0.189,-0.1029,-0.1093,-0.2093,-0.024,0.0576,-0.048,0.1433,0.0272,-0.0239,0.0594,-0.1107,-0.0593,-0.0333,-0.2591,-0.2583,0.052,-0.0745,-0.0218,-0.0567,-0.0834,0.0226,0.0559,0.0183,-0.1279,-0.04,0.0013,0.0731,-0.0773,-0.0199,-0.0158,-0.0029,-0.0584,-0.1184,-0.0166,-0.0929,-0.0373,-0.0627,-0.1612,-0.1641,-0.0077,-0.0122,-0.0713,-0.0511,0.0297,-0.0755,-0.049,0.0581,-0.1315,0.0081,0.0065,-0.0411,-0.2234,-0.1344,0.0544,0.1137,0.012,-0.0391,-0.0103,-0.0444,0.2521,0.126,0.0383,0.006,-0.1518,0.0422,-0.0202,0.0183,-0.0502,0.1344,0.0369,-0.1043,-0.0537,0.0822,-0.0929,-0.0575,-0.0103,0.0308,-0.0466,-0.0301,0.055,0.1014,-0.0221,-0.0653,-0.0153,0.0287,0.0143,-0.0172,-0.0014,-0.1217,0.0087,0.0132,-0.1254,0.0696,-0.0952,-0.063,-0.0818,-0.0147,-0.0606,-0.0612,0.0062,-0.056,-0.0104,0.0073,0.0942,-0.0192,0.0084,-0.066,-0.0128,-0.037,-0.0108,-0.1668,0.0477,-0.1526,-0.1151,0.0572,0.0869,0.082,0.0545,0.0562,-0.085,0.0176,-0.0638,-0.0551,-0.1207,-0.0362,-0.2387,-0.0529,-0.0701,-0.0816,0.0189,-0.051,0.0069,0.2121,0.1375,0.0333,0.2789,0.1076,0.1081,-0.0037,0.1776,-0.006,-0.0566,0.068,0.2047,0.0267,0.0173,-0.0271,-0.0983,-0.0381,-0.0611,0.0522,-0.0469,-0.0365,-0.016,0.0229,-0.1193,-0.0791,-0.0571,0.059,0.076,0.1109,-0.2625,-0.1313,-0.0618,-0.2505,-0.2123,0.0768,-0.002,-0.0091,0.0559,-0.0337,0.0469,-0.1228,0.0178,-0.0427,-0.0507,-0.2559,0.0184,0.0439,-0.0141,-0.1081,0.1262,-0.0107,0.0275,-0.0089,0.0527,0.0524,0.204,-0.0709,0.094,-0.0452,0.0207,-0.1368,0.0469,-0.0145,-0.0141,-0.0011,0.1234,0.0326,-0.0022,-0.0529,-0.0835,0.0226,0.2917,0.2873,-0.189,-0.1311,0.0427,-0.0625,-0.1409,-0.0176,-0.1585,0.0073,-0.0113,-0.0422,0.0038,-0.0142,0.1773,0.059,0.0818,0.0655,0.0123,0.0996,0.2706,-0.2008,-0.0352,0.2019,-0.0088,0.0426,0.0854,0.0437,-0.0846,0.1873,0.1556,-0.0186,-0.098,0.1493,0.056,0.2091,0.1366,0.092,0.0443,0.021,0.0855,-0.0792,0.0144,0.1654,0.0164,0.0318,0.0014,-0.0272,-0.1492,-0.0415,0.0791,-0.0512,0.101,-0.0356,0.0994,0.1251,-0.0253,-0.0064,0.016,-0.0004,-0.0235,0.0892,0.0383,0.0517,0.0474,0.2153,0.0981,0.0406,0.2926,-0.0466,-0.039,0.1646,-0.0883,0.029,0.0463,0.1027,-0.0983,-0.0035,0.0281,-0.0526,-0.0308,0.0073,0.0076,0.0,0.0107,0.065,0.0654,0.0986,0.2204,0.226,-0.0854,-0.1715,-0.0617,0.012,0.0767,0.0328,0.0543,0.0308,0.0746,0.0258,0.0787,-0.1598,-0.2215,-0.0844,-0.0364,0.0812,-0.1165,-0.0989,0.0282,0.0729,0.0675,0.0772,0.0128,-0.003,0.0419,-0.0114,0.0802,-0.1879,-0.172,-0.2258,0.0548,-0.0191,0.0568,0.275,-0.0325,-0.0118,0.0576,0.0947,0.1111,0.1284,-0.1032,-0.0902,-0.06,-0.0459,0.0593,0.0283,0.1045,-0.05,0.0762,0.1297,0.0087,-0.092,0.0779,-0.2075,-0.005,-0.0432,-0.1577,-0.0486,0.0162,-0.0783,-0.1512,-0.06,-0.0677,-0.0599,-0.0775,-0.1926,-0.0243,-0.0148,0.0036,-0.0689,0.0736,0.1212,0.0624,0.1899,-0.1438,-0.0879,-0.0881,-0.0607,0.0932,0.0002,-0.0864,-0.0564,-0.1231,-0.0282,0.186,0.0737,0.1034,0.0684,0.0138,-0.0577,-0.095,-0.0122,-0.0521,-0.0475,-0.2376,-0.057,-0.0743,-0.0274,-0.0373,-0.0006,0.0518,0.2886,0.2192,0.1614,0.1116,-0.1246,-0.2242,-0.1186,-0.1988,-0.1461,-0.0014,-0.0475,-0.0327,-0.0519,-0.1214,-0.1458,-0.0517,0.0476,0.0056,-0.0647,-0.1041,-0.0447,-0.0929,-0.1625,-0.143,-0.0724,0.0627,0.0192,-0.0324,-0.1048,0.0255,-0.0622,-0.0732,-0.1504,0.0095,0.004,-0.18,-0.1103,-0.0415,-0.0096,-0.0233,-0.0798,-0.1962,-0.0365,0.2467,0.0948,0.1899,0.1148,0.1172,0.0501,0.1618,0.154,0.2177,-0.077,-0.0141,0.0172,0.0518,-0.0658,-0.0844,-0.0436,-0.1027,-0.0498,-0.0916,-0.0995,-0.0854,-0.1216,-0.0442,0.0356,0.0366,-0.1978,0.0393,0.0358,-0.0633,-0.0844,-0.0776,0.0229,-0.154,0.093,0.0647,0.0587,-0.0427,0.0253,-0.2064,-0.0736,-0.072,-0.1083,-0.0722,-0.0511,0.0019,0.019,0.0449,-0.0568,-0.061,0.036,0.017,0.1113,0.0834,-0.2191,-0.245,-0.0981,0.0262,-0.0562,-0.0682,0.0723,-0.0742,0.0328,-0.0518,-0.0321,-0.0977,-0.0876,-0.0783,-0.0737,0.0203,-0.1125,-0.0043,-0.0644,0.0646,0.0466,0.0651,-0.0693,-0.0617,-0.0646,-0.1412,-0.0686,-0.1867,-0.0602,0.1618,-0.0098,-0.0629,-0.1079,-0.0371,-0.1879,-0.067,-0.0722,-0.0777,0.1735,-0.0649,0.0149,0.0208,-0.1485,-0.0979,-0.1566,-0.0402,0.0981,-0.0575,-0.0435,0.0023,0.1326,0.0167,-0.0065,0.0189,-0.0628,-0.0095,0.0097,-0.0947,-0.0399,0.0062,-0.2113,-0.1511,-0.1607,-0.051,-0.0562,0.0999,0.0954,0.1799,-0.056,0.0093,0.0564,0.0703,-0.0183,0.1008,0.048,0.032,0.0331,-0.1502,-0.0576,-0.1087,-0.0371,0.0505,-0.0763,-0.0888,-0.0694,0.0307,-0.0392,-0.2543,-0.2177,0.0159,-0.1354,-0.2253,0.0609,-0.0927,-0.0085,0.0281,-0.1133,-0.0226,-0.1176,-0.0487,0.0601,-0.0859,-0.0176,0.0475,-0.1447,0.052,0.0427,-0.0025,-0.098,-0.0693,0.1262,0.0063,-0.0072,0.071,0.0003,-0.0294,0.0712,0.0003,0.05,-0.1921,-0.0953,-0.0552,-0.0108,-0.1371,-0.1092,-0.1248,-0.0252,-0.0096,-0.069,0.0379,-0.0836,-0.0484,0.0813,0.0412,0.025,0.0333,-0.0181,-0.1892,-0.0084,-0.066,-0.0933,0.1653,0.2504,0.2332,-0.0797,0.2972,0.1816,-0.1388,-0.0941,0.308,0.1002,0.0902,0.0913,0.1321,0.0717,-0.0298,-0.0239,-0.0539,-0.1006,0.3151,0.2515,0.2068,0.0204,0.0802,0.1968,0.3429,0.3516,0.3184,0.0425,-0.0436,-0.0419,-0.0538,-0.0588,-0.1083,-0.0693,-0.0832,-0.0615,-0.0606,-0.0767,-0.0707,0.1127,0.0149,-0.0264,-0.1656,0.0029,0.1622,0.2082,-0.1215,-0.0123,-0.16,-0.0826,-0.0925,-0.0468,-0.0161,-0.0897,0.0066,-0.0599,-0.0925,-0.1047,-0.0915,-0.0122,-0.1159,-0.0173,0.1282,0.0647,0.148,0.0026,0.0958,0.2538,-0.1225,-0.0964,-0.1039,-0.0954,0.1003,-0.0733,0.1267,0.0734,0.0669,-0.0099,-0.1986,-0.1928,-0.1288,-0.1165,-0.0382,-0.2981,-0.2148,-0.0005,-0.0073,0.171,-0.0585,-0.0813,0.0959,0.0359,-0.0641,-0.0013,-0.0941,-0.1415,-0.1517,-0.0385,-0.0253,-0.0993,0.0636,-0.0354,0.0668,0.2159,0.2337,0.1116,0.1536,-0.0068,-0.0252,0.0958,0.1049,0.1292,0.23,-0.0005,0.0631,-0.0328,0.0269,0.0076,-0.0365,-0.0326,-0.0291,-0.0123,-0.0676,-0.0108,-0.0239,0.004,0.0505,-0.0095,0.0305,0.0303,0.0631,-0.1039,0.1344,0.0482,-0.0422,-0.1481,-0.0485,-0.0777,-0.1183,0.0018,-0.0706,-0.0578,0.0027,0.1374,-0.0506,-0.2155,-0.0674,-0.1012,0.023,0.0246,-0.0154,0.0163,0.0757,0.0557,0.2497,0.1648,0.1878,0.0385,-0.0084,0.0394,-0.1207,-0.1106,-0.0759,-0.0022,-0.1056,-0.1307,-0.0594,-0.0726,0.0053,-0.0675,-0.0821,-0.0965,-0.0153,-0.0371,-0.1299,0.119,-0.0799,-0.0698,-0.0258,-0.0967,-0.1317,-0.1004,0.1788,0.0376,-0.0384,-0.1283,0.1383,0.1166,-0.2074,0.0605,-0.12,-0.0767,0.0769,-0.2256,-0.2237,-0.0864,0.0412,0.0178,0.0139,-0.0498,-0.0459,-0.0272,0.0029,0.0324,-0.1304,0.0036,0.0096,0.0705,0.0286,-0.0949,-0.0301,0.0078,-0.0284,-0.0391,-0.0164,-0.0906,-0.0544,0.0145,-0.0019,-0.0143,-0.2043,-0.0801,-0.1524,-0.1357,-0.1019,-0.0956,-0.1113,-0.1113,-0.0558,-0.046,0.0462,-0.1728,-0.0593,-0.2158,-0.1917,-0.0577,-0.0354,-0.2558,0.1325,-0.2693,0.063,0.0754,0.1496,0.0324,-0.0008,-0.12,-0.1044,-0.0336,-0.0284,-0.0398,0.1084,-0.03,0.0503,0.1957,0.1732,0.0419,0.0569,-0.0648,-0.0505,0.0007,-0.1338,-0.0706,-0.07,-0.096,-0.0162,0.0243,0.0273,0.0273,-0.0157,-0.0835,0.0186,0.0386,-0.0215,0.1211,-0.0176,0.1141,0.0182,0.0613,0.0369,0.0268,0.1958,-0.0196,-0.0135,-0.0336,-0.045,0.0433,0.0564,-0.0853,0.156,0.0314,0.2633,0.0934,-0.0123,0.0438,-0.1187,0.0204,0.1305,0.0647,-0.1169,0.0286,0.0785,-0.0114,-0.0001,-0.2903,-0.2614,-0.1997,-0.2008,-0.114,-0.1631,-0.2537,0.0997,-0.0079,0.0558,0.116,-0.0512,-0.0039,0.0403,-0.1078,-0.045,0.0124,0.002,0.1437,0.0318,0.0915,-0.1285,0.0041,0.1527,0.0605,0.1722,0.0873,0.0301,-0.1274,-0.0088,-0.1187,-0.0485,-0.0714,0.0239,-0.0894,-0.0765,-0.0246,-0.1129,-0.0654,0.0225,-0.0818,0.0329,-0.0649,-0.0052,0.046,0.1107,0.0637,0.0385,-0.04,-0.1155,-0.1206,-0.0625,0.0463,0.0232,-0.0393,-0.037,-0.0184,0.0379,-0.0004,-0.0601,-0.0402,-0.0845,-0.0903,-0.0799,-0.004,0.0888,-0.0594,-0.0791,-0.1215,-0.0376,-0.0345,-0.0393,-0.016,-0.1554,0.0993,-0.0838,-0.0883,-0.0887,0.1107,-0.0326,0.0358,0.0113,-0.0189,-0.1784,0.0645,-0.0492,-0.085,-0.0036,0.0663,-0.0423,0.042,-0.1014,-0.1111,-0.1078,-0.1401,-0.1626,-0.0669,-0.09,-0.0296,-0.0353,0.0952,0.0972,0.0914,-0.1073,-0.0944,0.1075,0.2161,0.2556,0.0191,-0.0919,-0.0033,0.0086,0.0098,0.1431,-0.0435,-0.0495,-0.0533,0.0342,-0.107,-0.1,0.2383,0.0717,0.0535,0.2237,0.0088,0.1271,-0.0222,-0.1334,-0.1021,-0.0998,-0.0982,0.0153,0.1234,0.0504,0.0259,-0.0659,-0.0014,-0.0843,-0.0035,-0.0608,-0.1243,-0.0404,-0.0193,-0.0522,0.0277,-0.0094,0.047,0.0402,-0.0206,0.0768,-0.2191,-0.1245,-0.1179,-0.167,0.0085,-0.0713,-0.0715,-0.1378,-0.0399,-0.1582,0.1239,-0.1619,0.0052,-0.0802,0.0447,0.1477,0.1242,-0.0871,-0.1084,-0.0347,-0.0617,0.0433,0.1122,-0.0761,-0.0581,-0.0332,0.0547,0.0286,0.033,0.0812,0.0368,-0.0223,0.0503,0.0125,0.0613,0.0747,0.015,-0.0707,-0.0551,0.0219,0.0531,0.0217,0.0795,0.0909,-0.0423,0.0407,-0.0182,-0.0889,-0.1778,-0.0297,0.0556,0.1676,0.0607,0.0232,0.0102,-0.0059,0.2214,0.1458,0.1153,0.1378,-0.0975,0.0024,-0.0564,-0.023,-0.0569,0.055,-0.0593,-0.0327,0.0463,0.0233,0.0324,-0.0501,0.053,0.0979,-0.1473,0.1679,0.0499,-0.0031,0.0829,0.0925,0.0816,0.047,-0.0201,-0.0026,0.0464,0.0665,0.1842,0.2219,-0.041,-0.0078,0.0352,-0.0349,-0.2116,-0.3257,-0.302,0.0032,0.0321,0.0145,-0.0885,0.0409,0.1247,-0.0193,-0.0941,-0.1154,0.0503,-0.0863,-0.047,0.047,-0.007,-0.0081,-0.0868,-0.0471,-0.1293,-0.0656,-0.0552,-0.0733,-0.0293,-0.1162,-0.0459,-0.0528,-0.0826,0.0329,0.1203,0.033,-0.0545,-0.0609,0.1666,-0.1095,0.108,0.1393,0.1425,0.006,0.0327,-0.2079,0.1162,0.079,-0.0735,-0.0557,-0.019,0.0371,-0.0438,-0.0979,-0.2311,-0.1766,-0.0839,-0.0443,-0.0323,0.0689,0.0109,-0.065,-0.0863,-0.1716,0.0125,0.0243,-0.0787,-0.0818,-0.0119,-0.0849,-0.1427,0.1848,0.094,-0.0905,0.0272,0.0905,0.1382,-0.2536,-0.2713,-0.1085,-0.2075,-0.0741,-0.0949,-0.0354,0.105,-0.0113,0.136,-0.0244,0.1573,0.2724,0.1045,0.1512,0.2247,-0.2003,-0.1234,-0.0645,0.1244,0.0448,-0.0158,-0.0194,0.0473,0.1212,-0.2223,-0.1823,-0.0613,0.1186,-0.1029,-0.1875,-0.1816,-0.1755,0.0207,0.0843,-0.1252,0.0255,0.0125,-0.006,0.0696,0.0448,0.0407,0.0245,-0.0027,-0.03,0.0712,-0.0239,0.0795,-0.0151,-0.0485,-0.0273,-0.077,-0.0098,-0.0181,-0.0064,0.1407,0.0542,0.0268,0.0318,-0.0369,-0.0267,-0.1658,-0.1143,-0.0525,-0.1144,0.255,-0.0243,0.2048,0.1146,0.0711,0.0047,0.0001,0.0893,-0.1009,0.1801,0.1485,0.058,0.1174,0.0428,0.0241,-0.0972,-0.0941,-0.2048,-0.0155,0.0547,0.0873,-0.1499,-0.0402,-0.0061,0.0532,0.0152,-0.0862,-0.0725,-0.1179,-0.0152,-0.2595,-0.0265,-0.0538,0.074,0.0513,0.0094,0.0494,-0.0449,-0.0224,-0.1264,-0.07,0.0532,0.0569,-0.1116,-0.0517,-0.1061,-0.0059,0.0131,0.0455,-0.0164,0.0965,0.0321,-0.0722,-0.1519,-0.0421,-0.143,-0.1106,0.0221,-0.0019,-0.0786,-0.0347,-0.116,-0.1257,-0.0015,-0.0215,0.0037,-0.0213,-0.0243,0.0154,-0.0948,0.1409,-0.3206,-0.2694,-0.2667,-0.0053,-0.1666,-0.2569,-0.1411,-0.068,0.0304,0.0141,-0.2042,0.1321,0.1737,0.0494,-0.0355,-0.063,-0.0608,-0.1246,-0.001,-0.0814,0.0686,0.1285,0.1857,-0.0124,0.0502,0.0401,0.0681,-0.2445,-0.048,-0.0254,-0.017,-0.1901,-0.1466,-0.16,-0.1658,-0.0366,-0.1895,-0.1659,0.0869,-0.0577,-0.2174,-0.0237,0.0962,0.0703,-0.0461,-0.0562,-0.3264,-0.2466,-0.1229,-0.2186,0.1176,-0.097,-0.0353,0.0285,-0.1521,-0.1439,-0.287,-0.1312,0.1236,0.086,0.1043,0.1368,0.1362,0.0136,0.0443,0.1501,0.0353,0.1111,0.1196,0.0727,0.0953,0.0635,-0.1708,-0.2256,-0.1167,-0.0578,-0.095,0.0148,-0.1436,0.0374,0.0216,0.0562,0.1164,0.0821,-0.1771,-0.0579,-0.1304,-0.018,-0.1652,-0.2333,0.0041,-0.0047,-0.0234,-0.0625,-0.0502,-0.1776,-0.0936,-0.1462,-0.1083,-0.0972,-0.0319,-0.0253,0.0579,-0.0444,-0.0635,0.0742,0.0805,0.0084,-0.0342,-0.0735,-0.1307,-0.0586,0.1363,0.0407,-0.0296,0.223,0.0618,0.0343,0.053,0.0155,0.0088,-0.0269,0.0021,0.0317,0.0123,0.0072,0.1133,0.1771,0.274,0.0019,0.0088,-0.0061,-0.035,-0.0027,0.1321,-0.1066,0.1534,-0.146,-0.0461,-0.0555,0.1227,0.0654,-0.0177,-0.0475,-0.031,-0.1065,-0.0925,0.0026,0.0114,-0.0779,-0.0854,0.02,0.1499,0.1343,-0.1502,-0.1139,-0.1063,-0.0111,-0.1826,0.0124,-0.0118,0.0701,0.034,-0.0313,-0.0962,-0.1256,-0.1593,0.0686,-0.0406,-0.0836,0.1337,-0.0379,-0.0382,0.09,0.3374,0.1173,0.1084,0.2014,-0.051,0.0354,0.178,0.1643,-0.0594,0.2162,0.0941,0.0972,0.0953,0.2861,0.0202,-0.1343,-0.1673,-0.0917,-0.0473,0.0964,-0.0559,0.0038,-0.1053,-0.0893,-0.0197,-0.0859,-0.0406,0.0917,-0.0247,-0.0733,-0.0214,-0.2237,-0.0371,-0.0215,-0.0663,-0.0536,-0.0239,-0.0505,-0.0246,-0.1518,-0.1105,0.1692,0.258,-0.0189,-0.0772,0.0783,0.0608,-0.071,-0.0284,-0.1753,-0.1867,0.0717,0.1264,-0.0403,-0.0562,-0.0951,-0.0102,-0.1382,-0.0449,-0.0355,-0.0717,-0.0287,-0.0796,-0.0344,0.0372,-0.129,-0.1513,-0.0977,-0.1119,0.0905,-0.1344,-0.0034,0.1561,-0.0102,-0.1451,-0.1201,-0.0507,-0.1399,-0.0718,-0.1575,-0.1939,0.0823,0.0175,0.0642,-0.0628,-0.0777,-0.1404,-0.0002,0.0246,0.0414,-0.1495,-0.0645,-0.1541,0.0182,0.0631,0.0738,-0.1076,-0.1327,-0.0853,-0.0777,-0.0802,-0.0356,0.0107,0.0835,-0.0229,-0.0482,-0.0831,-0.0724,-0.0975,-0.1796,-0.0897,-0.0659,0.0466,-0.013,0.172,-0.0472,0.1411,0.0053,0.0676,-0.0049,0.0663,0.1321,0.0975,-0.0073,-0.0186,-0.0471,0.0527,0.0063,0.0462,-0.0641,-0.0712,-0.0035,0.0641,-0.0806,-0.0722,-0.0556,-0.0419,-0.0852,-0.0515,-0.0062,0.1582,-0.1233,0.0205,0.0005,0.0376,-0.026,-0.0053,0.0715,0.0068,-0.1388,-0.0424,0.1035,0.1417,-0.0765,-0.0674,-0.0926,-0.1624,-0.0508,-0.0244,-0.1165,0.1111,0.0707,-0.1784,-0.1523,-0.0245,-0.1123,-0.0349,-0.0701,0.2069,0.1406,-0.0908,0.0938,-0.0577,-0.0369,-0.1189,-0.0949,-0.1666,-0.1751,-0.0154,-0.0257,-0.1136,0.0403,-0.061,-0.1119,0.1448,-0.0038,0.0327,-0.0259,0.0078,0.019,-0.0775,-0.0458,0.0811,-0.1152,0.1185,-0.1806,0.0215,-0.1009,0.2749,0.1506,0.1431,-0.1223,-0.1173,0.0992,0.2181,0.0088,0.2037,0.0371,-0.0133,0.1223,0.0737,0.0648,0.0164,0.0351,0.0938,0.1141,0.1497,0.21,-0.0187,0.0382,0.1464,0.3234,0.1126,0.1011,0.2139,0.107,0.095,0.1589,0.1118,0.1451,0.0802,0.1834,0.2008,0.0714,0.1267,0.2699,0.1856,0.2334,0.173,0.0276,0.1566,-0.1713,-0.019,-0.1298,-0.2184,-0.0743,-0.2175,-0.1811,-0.1081,-0.1266,-0.1369,-0.2374,-0.1744,-0.177,-0.1079,0.0256,-0.0797,0.0885,-0.0224,-0.047,-0.0062,-0.1066,-0.0764,-0.0414,-0.0702,-0.1492,0.1109,-0.1715,-0.1839,-0.0239,-0.0276,-0.0201,-0.0039,-0.0022,-0.1792,0.1651,0.1473,-0.0565,0.2442,0.2578,0.1017,0.1034,0.1465,-0.1084,0.3214,0.3215,-0.0527,0.0106,0.137,-0.0318,-0.0008,-0.1319,-0.0047,0.0938,-0.0357,-0.0707,0.0369,-0.0132,-0.0375,-0.0287,tool maintenance
trm_558c7b14c076e,-0.0489,-0.0671,-0.0538,-0.0546,0.0333,-0.0059,-0.0479,-0.0006,-0.0127,-0.0706,0.0082,0.0232,-0.0816,-0.0789,-0.0959,-0.0453,-0.0422,-0.1155,-0.051,-0.0875,-0.046,0.0408,-0.0238,0.0048,0.0187,0.0505,0.0428,-0.0998,-0.1241,-0.0376,-0.1043,-0.0938,-0.1286,-0.0352,-0.1501,-0.0815,-0.0037,-0.0236,-0.1021,-0.0236,-0.0701,-0.0974,-0.0568,0.0155,-0.0716,-0.1209,0.1663,-0.0642,0.0628,-0.0634,-0.0479,-0.0135,0.0058,0.0055,-0.0819,-0.056,-0.0861,-0.0147,0.0134,0.0152,0.0255,0.1023,-0.1129,0.0732,0.0153,0.1059,-0.1765,-0.2262,-0.1362,0.0266,0.0292,0.0758,0.0988,-0.082,-0.0696,-0.0242,-0.0945,0.0749,0.0224,-0.0381,-0.0037,0.088,-0.0798,-0.1275,0.0723,0.1,0.0194,0.0607,-0.0164,-0.1506,-0.0615,-0.0234,-0.0028,0.2078,0.1589,0.1831,0.1106,0.0039,0.2204,0.1805,0.061,-0.0007,0.1088,0.1304,0.0781,-0.113,-0.1418,0.0973,-0.0157,-0.0127,0.016,-0.1027,0.0833,0.1555,0.0185,-0.0159,-0.0875,0.1081,-0.0502,-0.0426,-0.0833,-0.1347,-0.1079,-0.0346,-0.0993,-0.1565,-0.1034,0.088,0.0943,0.0598,-0.1067,-0.0475,-0.036,-0.2486,-0.0177,-0.1665,0.0119,-0.0937,-0.0361,-0.0049,-0.0902,-0.0958,-0.0236,-0.0601,-0.014,0.0744,-0.0324,0.0162,-0.0707,0.0592,-0.0611,-0.0922,-0.1117,-0.1428,0.1333,0.033,0.1047,0.0167,0.0589,-0.0111,-0.0536,-0.0627,-0.1839,-0.1571,-0.0156,0.0314,0.0091,-0.161,-0.1537,-0.069,0.026,-0.1065,0.1508,-0.2337,-0.1234,-0.1801,-0.1349,-0.1416,-0.115,0.0058,-0.1375,0.0732,-0.0408,0.008,-0.069,-0.011,-0.0647,-0.1097,-0.1043,-0.061,-0.0689,-0.0659,-0.0256,-0.1894,-0.1827,-0.1533,-0.1278,-0.0411,-0.0805,-0.0779,0.017,0.294,-0.1435,-0.1085,0.0339,-0.0558,-0.2015,-0.0133,-0.0413,0.0051,-0.1699,-0.0776,-0.0469,0.045,0.0188,0.006,0.1154,-0.0974,0.003,0.0138,0.1248,-0.0987,-0.094,-0.024,0.1021,0.02,-0.064,0.1258,-0.0447,0.1175,0.0794,-0.1324,0.1789,-0.0827,-0.0693,0.0517,-0.0497,-0.0061,0.0265,-0.0845,0.0553,-0.1506,-0.0253,0.0143,-0.0639,-0.1017,-0.0991,-0.1053,-0.0566,-0.1238,0.0138,-0.0025,-0.0138,0.0348,0.0068,-0.1487,-0.0005,-0.0569,0.069,0.2119,0.0744,0.2782,-0.1,0.132,0.2047,0.2895,0.1142,-0.036,0.0504,-0.0497,-0.0601,-0.0116,-0.1679,-0.017,-0.0508,0.0225,-0.0569,-0.1076,-0.0706,0.0086,0.0358,-0.0709,-0.0452,-0.2108,-0.1776,-0.072,0.0189,0.0297,-0.0594,-0.0942,-0.0742,-0.0935,0.0012,-0.0472,-0.0676,0.0762,-0.0184,0.0409,0.0076,0.112,0.0081,-0.1518,-0.0725,-0.0648,0.0217,0.0459,-0.0749,-0.0121,0.0034,-0.0356,-0.0064,-0.017,-0.0801,0.014,0.0462,-0.0511,0.0964,0.0111,0.0504,-0.1297,-0.0069,0.0258,-0.1154,-0.1709,-0.0455,-0.0352,-0.0267,-0.0482,-0.0364,-0.0234,0.0352,-0.0747,-0.0163,0.006,0.0067,0.1247,-0.0114,-0.0511,-0.0616,-0.1458,-0.1185,0.0454,0.0842,0.0217,0.0736,0.0434,-0.1355,-0.0867,-0.0769,-0.0576,-0.0788,0.0623,0.0446,0.0248,-0.0229,0.0434,-0.0187,-0.1236,-0.1181,-0.0911,-0.0141,-0.0174,-0.0964,0.0271,-0.0,0.1336,-0.0766,0.1659,0.0543,-0.1329,-0.0247,0.1021,0.0145,0.1243,-0.1145,-0.0475,-0.1046,0.0688,0.0519,0.1159,0.0954,0.1479,-0.0798,0.0437,0.0097,0.0161,-0.058,-0.0256,0.0202,-0.0217,-0.007,-0.0007,0.0904,-0.0671,0.1693,0.1371,0.0387,-0.0866,-0.0462,-0.042,-0.0685,0.0162,0.0349,0.0282,0.1048,0.0366,0.0037,-0.0038,-0.0815,-0.0014,0.0126,-0.115,-0.018,0.099,-0.1257,-0.0743,0.1047,-0.0015,-0.0853,-0.0412,0.0615,-0.1614,-0.0984,-0.2243,-0.2169,-0.0742,-0.116,0.0083,-0.1154,-0.0587,-0.0146,0.0513,-0.0253,-0.0073,-0.046,0.0418,0.0178,0.0111,-0.173,-0.1061,-0.0019,0.0762,0.0515,0.0456,-0.0086,-0.0491,0.0371,0.1398,-0.1491,-0.0575,0.0197,0.0457,-0.0863,-0.0888,0.0418,-0.1525,0.0344,-0.055,-0.0443,0.0506,0.1127,-0.04,-0.0445,0.0298,-0.106,-0.0929,0.0461,0.2862,-0.065,-0.0203,0.0373,0.0666,0.0963,-0.0417,-0.131,-0.049,0.0683,0.057,-0.0137,-0.0207,0.1334,0.0464,0.0801,0.0573,0.0581,0.1103,-0.0043,0.0354,-0.084,-0.0357,0.092,0.1115,-0.0593,-0.0785,0.1238,-0.0105,-0.2195,0.0114,0.0312,-0.111,-0.0972,0.0161,-0.0269,-0.0843,-0.1209,-0.094,-0.044,-0.0974,-0.0379,0.1551,-0.1535,0.0684,-0.0922,0.0187,0.0995,0.0521,-0.0986,-0.074,0.1709,-0.0464,-0.0754,-0.03,0.0506,0.091,0.1139,0.0454,0.1138,0.1336,0.0491,0.0541,-0.0665,-0.0497,-0.0099,-0.1623,-0.0899,-0.0112,-0.1182,-0.0474,0.0147,-0.1053,-0.0559,0.0409,0.0149,-0.0151,-0.0624,-0.005,-0.0034,0.0108,0.0093,-0.0096,0.1022,-0.0717,-0.0424,0.023,-0.0254,-0.138,0.1214,-0.0081,0.0956,-0.0126,-0.0849,0.0146,-0.1213,0.0582,-0.1103,0.0228,0.0928,-0.1192,-0.0293,-0.0891,-0.1024,-0.0487,-0.0298,0.0316,0.2019,0.1572,0.0725,0.0431,0.0514,0.0353,-0.0333,-0.0942,-0.0461,-0.0248,0.1112,0.0462,0.0798,0.0314,0.0863,-0.0305,-0.0532,0.0309,0.079,0.0645,-0.01,0.0351,-0.1816,-0.0284,0.1416,-0.0532,0.0019,0.039,0.0725,0.0165,0.0629,0.192,-0.0685,-0.1367,-0.1329,0.0614,-0.1035,-0.0326,0.0278,-0.0703,-0.1906,-0.0582,-0.0921,0.0373,0.0159,-0.1719,-0.0539,-0.1286,0.0817,0.024,-0.0104,0.1199,-0.061,-0.1525,-0.0371,0.0264,0.0754,0.1225,-0.091,-0.0185,0.015,0.089,0.0671,0.0013,-0.0727,-0.0602,-0.0403,0.1226,0.0509,0.1305,-0.0619,-0.0093,-0.2016,-0.1861,0.127,-0.1337,-0.0165,-0.1123,0.2389,-0.08,-0.0732,-0.0058,0.1835,-0.0498,0.0047,-0.0989,-0.1367,0.1334,0.1801,0.0843,0.062,0.1245,-0.044,-0.1011,0.0667,0.0086,-0.0241,-0.0709,-0.0203,0.0109,-0.027,-0.083,0.1732,-0.076,0.0195,-0.043,0.0138,0.0748,0.064,0.0486,0.142,-0.1548,-0.0855,-0.0237,-0.0043,0.0158,0.0692,0.1798,0.1416,0.0903,0.1844,-0.0569,0.08,-0.0205,-0.0871,-0.0168,0.011,-0.0351,-0.0519,-0.0897,-0.0993,-0.06,-0.1046,-0.0139,-0.0233,0.0072,0.0516,-0.004,-0.0082,-0.0035,-0.0353,-0.0809,0.0345,0.0027,-0.0767,0.0436,0.083,-0.0837,-0.1953,-0.1855,-0.1569,-0.0126,-0.0677,-0.0971,-0.0381,-0.0325,0.0852,-0.0415,-0.0042,0.1344,0.1287,0.0218,-0.0581,0.0981,0.1092,0.1379,-0.1717,-0.0112,-0.0621,-0.0235,-0.0395,-0.0966,0.0612,0.069,-0.0289,0.0106,-0.03,0.0152,-0.1698,-0.2465,-0.2049,-0.1514,0.057,0.1508,0.0161,-0.0836,-0.0495,0.0992,0.0705,0.0777,0.0612,0.0529,-0.0951,-0.0801,0.0218,0.0726,0.1233,0.1749,-0.0007,-0.0268,0.054,-0.0706,0.0846,-0.062,-0.107,-0.0739,-0.1569,-0.1198,-0.0913,0.0783,0.0486,0.0103,-0.0366,-0.0162,-0.0131,0.0842,0.001,-0.1046,0.0265,-0.0044,0.0213,0.027,0.057,-0.1016,0.0853,-0.202,-0.1926,0.1229,0.0852,0.1949,-0.0473,-0.0253,0.0398,-0.0289,0.0638,0.2338,0.0723,0.0975,0.1047,0.1413,0.0682,0.0292,0.1815,0.1709,-0.0343,0.0209,0.0338,-0.1507,-0.1239,-0.017,-0.0765,-0.0504,-0.2535,-0.0825,-0.1511,-0.1042,-0.1762,0.0185,0.0015,0.0299,-0.0381,0.018,-0.0466,0.0713,0.1046,0.0067,0.0253,0.1343,0.051,0.0886,0.0501,-0.0362,0.1127,0.1559,-0.1035,0.1575,0.0602,-0.002,-0.051,-0.0779,-0.0741,0.0448,0.0113,-0.1981,-0.1409,-0.0619,0.0582,0.0693,-0.0199,-0.0142,0.0032,0.1034,-0.0326,-0.0791,0.2041,-0.044,0.0796,-0.1376,0.2804,-0.0686,0.0993,0.0602,-0.0341,0.0739,-0.227,-0.222,-0.0884,0.22,-0.0579,-0.0883,-0.0675,0.1097,0.0088,-0.1352,-0.0451,-0.1529,0.0485,-0.0451,-0.0056,0.0506,-0.0533,0.1612,-0.1294,-0.1263,-0.0418,-0.0093,-0.112,0.0376,0.1218,0.0646,0.087,0.2985,0.1239,-0.1104,-0.0571,-0.1054,-0.0901,-0.0318,-0.0811,0.0201,0.1168,0.1061,0.0069,-0.1033,0.118,0.1574,0.0888,-0.0084,-0.0358,-0.0067,-0.0312,0.0069,0.011,0.0907,0.0309,-0.1224,-0.0082,0.0848,0.0246,-0.0583,-0.0483,0.059,-0.0575,-0.0284,-0.0363,-0.096,-0.094,-0.2829,-0.187,-0.2938,-0.0558,-0.0571,-0.0983,-0.1264,-0.1207,-0.1877,-0.1728,-0.2487,-0.1176,-0.1689,0.0242,0.0221,0.0981,-0.0378,0.045,0.0396,0.0589,0.088,0.0757,0.0844,0.05,-0.0438,0.0057,0.0533,-0.0344,0.0608,0.0339,0.0995,-0.0106,0.0046,-0.0337,0.0699,-0.0505,-0.0538,-0.0201,0.0674,-0.0313,0.0784,-0.1602,-0.1072,-0.0589,-0.1245,-0.0892,0.074,0.0565,0.0818,0.0644,0.1343,0.1252,0.0524,0.0141,-0.0019,-0.0172,0.0349,-0.0148,-0.0026,-0.0216,-0.0624,-0.0227,0.0819,0.0611,-0.0644,-0.0718,-0.0979,-0.1863,-0.1284,0.1752,0.1032,0.1134,0.0972,0.0574,-0.094,-0.0821,0.0167,-0.0621,-0.039,-0.0208,0.0155,-0.0757,0.0172,0.0087,0.0239,-0.0796,-0.0142,-0.0876,0.0345,-0.0855,0.0647,0.1756,0.303,0.0693,0.0496,0.0224,0.0168,-0.0128,-0.0437,-0.0646,-0.0919,0.0406,-0.0211,0.0677,-0.0198,0.0058,0.0207,0.0086,-0.0536,0.0585,-0.1354,-0.1444,-0.1564,-0.1116,0.137,0.0585,0.1183,-0.1304,0.2077,0.0689,-0.0189,-0.0235,-0.0262,-0.0193,-0.0429,0.1172,-0.0667,-0.1141,0.0032,-0.0565,-0.1642,-0.0616,-0.0898,-0.0416,-0.1215,-0.0561,-0.0584,-0.0507,0.0331,0.1127,-0.0003,0.024,0.0346,-0.0342,0.0737,-0.0757,0.0047,-0.0096,-0.068,0.3388,0.2943,0.3366,0.2525,0.2635,0.1177,0.2909,0.1514,-0.1808,0.0554,0.0904,0.0577,0.0351,0.015,-0.1278,-0.0279,-0.1175,-0.0742,-0.0029,-0.0326,0.0401,0.0217,-0.12,0.0644,0.0748,-0.0077,0.06,-0.0354,-0.1165,0.017,0.0039,-0.1138,-0.0049,-0.1029,0.0897,0.0499,0.1708,-0.0471,-0.1323,-0.149,-0.1069,-0.0246,0.0715,0.0409,0.0651,-0.0909,-0.2168,-0.1543,-0.083,0.0904,-0.0992,0.3149,0.2593,-0.0703,0.0234,0.0574,0.2788,0.2684,0.2296,0.2024,0.1216,0.0141,0.0875,0.0436,-0.0012,-0.1131,0.0064,-0.0843,0.1559,0.0319,-0.0434,-0.0149,-0.0976,-0.05,0.0046,-0.0547,-0.0498,0.1485,0.0656,-0.0708,-0.0442,-0.0414,0.0695,0.0892,0.0668,-0.1744,-0.1891,-0.0795,-0.0944,0.0375,-0.0503,-0.0635,-0.0257,-0.0414,0.0527,0.0287,0.0842,0.2982,-0.0283,-0.1118,-0.0709,0.0727,0.02,0.1752,-0.1372,0.1553,0.3045,0.0314,-0.1896,0.2327,0.1986,-0.0738,-0.1859,0.0181,-0.1476,-0.0649,-0.1679,-0.0414,0.1652,-0.035,-0.0102,0.0515,-0.0285,-0.0315,-0.0785,-0.0217,-0.0347,-0.0809,0.0257,0.0777,-0.0101,0.1521,0.0856,0.1626,0.1167,-0.099,0.0018,-0.0928,-0.0809,-0.077,-0.0203,0.0453,0.158,-0.1415,-0.1019,0.0677,0.1395,-0.0255,0.0751,0.0561,0.0541,0.0165,0.1232,-0.0961,-0.1078,-0.0971,0.0539,0.0336,-0.0198,0.0246,0.0246,-0.1839,0.0801,0.054,0.0548,0.03,0.0743,-0.0205,0.3293,-0.2699,-0.2567,0.014,-0.0637,-0.1995,-0.207,-0.1559,-0.0094,-0.0165,-0.057,0.0043,0.022,0.2298,-0.0264,-0.0351,-0.0422,0.012,0.0209,-0.0584,-0.0058,-0.0591,-0.0887,-0.0397,-0.109,-0.0725,-0.0558,-0.0415,0.0436,-0.0214,0.2694,0.1638,0.2148,0.0085,0.2392,-0.1616,-0.084,0.0027,-0.1182,0.0291,-0.1449,-0.1737,0.0034,-0.0968,-0.1732,0.087,0.01,-0.1757,-0.0237,0.0088,0.0104,-0.1873,-0.0871,-0.0669,-0.1069,-0.0561,0.0545,-0.0059,0.211,0.0687,0.1417,0.0627,0.0393,0.1336,-0.0556,-0.108,-0.1034,-0.0178,-0.0975,-0.0543,-0.0903,-0.0076,0.0556,0.0303,-0.0343,-0.1309,-0.1182,0.0199,0.0059,0.0207,0.0148,-0.0331,0.0636,-0.0579,-0.0866,-0.1095,-0.1906,-0.0998,-0.0394,-0.0933,-0.0978,0.0525,0.0546,0.0392,0.0424,-0.004,-0.0812,-0.0891,0.0573,-0.1532,0.0309,0.0273,0.0324,0.024,-0.0771,-0.0071,0.1351,-0.0604,0.004,0.024,-0.046,0.0603,-0.0677,0.0401,0.0211,-0.1751,0.0655,-0.0252,0.1053,0.2146,0.0584,-0.0001,-0.0508,0.0453,0.1538,-0.035,0.0512,-0.1118,-0.0296,-0.1314,-0.1221,-0.0599,0.1102,0.0096,-0.0601,-0.158,0.0104,-0.0545,0.0168,-0.0549,-0.1094,-0.0151,-0.0086,-0.0582,0.0708,-0.0531,-0.0192,-0.0385,-0.0789,-0.0719,-0.0609,-0.0705,-0.016,0.0177,-0.0501,0.0725,-0.0542,-0.0304,-0.0099,0.0894,0.0539,-0.0435,-0.1086,0.0784,0.0413,0.1974,-0.0094,0.0216,0.0131,0.0354,0.0303,-0.0734,-0.0913,-0.0957,-0.0058,-0.227,0.0318,-0.0407,-0.001,-0.0345,-0.0352,-0.0482,-0.1329,-0.1491,-0.0073,-0.086,-0.0531,0.1453,0.0903,-0.0055,0.0851,0.0199,-0.0022,-0.0106,0.0017,0.1679,0.0296,0.0196,0.0116,-0.0453,-0.0403,-0.1065,0.003,0.0663,-0.0018,0.1237,0.1071,-0.054,-0.0505,-0.0041,0.0558,0.1227,0.0569,-0.1616,-0.0626,-0.0092,-0.1227,-0.0849,0.0227,0.1451,0.0144,0.0124,0.0506,-0.0048,-0.1468,-0.0528,0.0236,-0.0417,-0.132,-0.0806,-0.0604,-0.1338,-0.022,0.1171,-0.0355,-0.0652,-0.0111,0.0219,0.1055,0.1899,0.0191,0.0355,0.0692,-0.002,-0.0655,-0.0906,0.0582,0.0262,-0.0242,0.1362,0.1301,0.0738,-0.0643,-0.0649,0.044,0.4042,0.3999,-0.1169,-0.0783,0.0541,-0.0964,-0.0152,0.0017,-0.1734,0.0337,-0.0204,-0.0615,-0.0053,0.0509,0.1833,-0.0725,0.1598,0.032,0.0395,0.0714,0.3445,0.1195,-0.0893,0.2096,0.0364,0.0722,0.0444,0.0241,-0.0672,0.063,0.0344,0.0037,0.0355,-0.0492,0.0011,-0.0186,0.0137,-0.0915,-0.0673,-0.0588,0.1143,-0.121,0.0532,0.082,-0.0791,-0.0982,0.0038,-0.0006,-0.0888,-0.0293,0.0424,-0.0755,-0.1191,-0.1781,-0.0341,0.0047,-0.0129,-0.0318,0.0552,0.0091,0.0166,0.1341,0.1576,0.1425,-0.0151,0.1247,0.0264,0.048,0.308,-0.1436,-0.1016,0.0284,-0.156,0.0442,0.0009,0.0652,-0.0357,0.0591,0.0108,-0.002,0.0458,0.047,-0.0193,0.0493,-0.0006,0.0399,0.035,0.1021,0.1709,0.1787,-0.0537,-0.0493,-0.096,-0.009,-0.0417,-0.0223,-0.0662,0.0002,-0.0235,-0.0038,0.145,0.0943,-0.2149,-0.0693,-0.007,0.0709,0.1109,0.1349,0.0641,0.2108,0.1841,-0.0914,-0.0323,-0.0869,-0.0182,0.0113,0.0757,-0.1135,-0.1431,-0.1699,0.0453,0.0018,-0.0011,0.2045,-0.0993,-0.0936,0.0013,0.1852,0.047,0.1783,0.0194,-0.0022,0.0221,0.0594,0.1532,0.2331,0.2145,-0.0258,0.0391,-0.0021,0.068,-0.1089,0.0821,-0.1841,-0.0698,-0.0506,-0.0956,-0.0085,0.0704,0.0035,0.1632,-0.0508,0.0974,0.0882,0.1028,-0.0071,-0.0039,-0.0038,-0.0106,0.0173,0.0619,0.2206,0.1533,0.1784,-0.2164,-0.13,-0.159,-0.02,0.0405,-0.029,-0.1377,-0.1138,-0.1112,-0.0684,0.0618,-0.0182,0.1647,0.0682,0.0094,0.0941,0.0234,0.0546,0.0422,0.0027,-0.1724,0.024,-0.1143,-0.0446,-0.0982,0.0025,0.1023,0.1607,0.0514,0.0161,0.0147,-0.0826,-0.3072,-0.1665,-0.2119,-0.1534,0.0205,0.0088,0.1182,-0.136,-0.1654,-0.1039,-0.0522,-0.0946,-0.0356,0.0142,-0.0103,0.0269,0.0403,-0.1431,-0.1043,-0.0676,0.0724,-0.0032,-0.0101,-0.248,-0.0495,-0.1051,-0.1419,-0.3126,0.0409,-0.0705,0.0239,-0.0541,-0.0292,-0.0256,-0.0156,-0.1154,-0.0367,-0.1549,0.0463,-0.0063,0.1523,-0.0137,0.0796,-0.1212,0.0178,0.0358,0.1883,-0.0649,-0.0351,-0.0136,0.1723,-0.2065,-0.2251,-0.1915,-0.0169,-0.0844,-0.1326,-0.0874,-0.0562,-0.0528,-0.0588,0.0273,0.037,-0.1988,-0.0186,-0.0623,-0.0833,-0.0961,-0.0842,-0.1332,-0.1214,0.0001,-0.0855,0.1426,-0.0595,-0.1883,-0.1527,-0.0581,-0.1403,-0.0166,-0.2456,-0.1861,0.0339,0.1081,0.0416,0.0121,-0.0448,-0.0141,0.1592,0.1748,0.1366,-0.1605,-0.1872,0.0095,0.0652,0.0147,0.0079,0.0347,-0.0501,0.0078,-0.0169,-0.0555,-0.0916,0.0402,-0.0769,-0.0813,0.015,-0.0722,0.0176,0.0273,0.094,0.1623,0.1281,-0.0511,-0.1474,-0.1883,-0.1528,-0.1197,-0.2519,-0.1544,0.2196,-0.0498,-0.0842,0.2262,0.1198,0.1482,0.1725,0.1059,0.1418,0.1626,0.0783,0.1282,0.0599,0.0401,0.1657,0.2041,0.271,0.2248,-0.1959,0.0556,0.0756,0.266,-0.1128,-0.0855,0.0724,-0.0393,0.0261,0.0734,0.1149,0.0094,-0.0293,-0.0217,-0.0849,-0.087,0.0829,-0.0638,0.0228,0.0699,0.0719,-0.0254,0.0031,0.0524,0.1384,0.0725,0.047,0.0336,0.0234,0.0389,-0.308,-0.1192,-0.1365,-0.1638,-0.1333,-0.15,-0.1361,-0.078,-0.0115,-0.0813,-0.0883,0.0209,0.0678,-0.0321,-0.2125,0.0945,0.0024,0.0034,0.0519,-0.1105,0.0354,-0.129,-0.0778,-0.0442,-0.0638,-0.0671,0.0278,-0.0915,0.0355,0.1511,0.1073,0.0488,-0.1087,0.0034,-0.0515,-0.1878,-0.0565,-0.1201,-0.0998,0.1145,0.0327,-0.0238,-0.0717,-0.0698,0.0099,0.06,-0.0176,-0.0579,-0.089,-0.0681,0.0177,-0.0238,0.0897,-0.1233,-0.051,0.0565,-0.0475,-0.0547,-0.014,0.0321,-0.1244,0.0102,-0.0681,-0.1254,0.1791,0.2251,0.1873,-0.0433,0.315,0.1841,-0.1558,-0.0636,0.2562,0.1676,0.0373,0.0751,0.0799,0.0916,-0.1122,-0.1074,-0.0315,-0.0365,0.3625,0.3134,0.1877,0.0667,0.1444,0.1333,0.2716,0.2573,0.2221,-0.0164,-0.0207,-0.0207,-0.0005,-0.0291,0.0642,-0.2075,-0.0977,0.0128,-0.0104,-0.0865,-0.0902,0.0958,-0.0013,0.0693,-0.0037,0.0847,0.1353,0.1853,0.0431,-0.0891,-0.0114,0.0319,0.0025,0.001,0.0029,-0.0743,-0.0208,-0.0271,-0.1539,-0.2378,-0.2216,0.0771,-0.0189,-0.0034,0.1917,0.0529,0.195,0.1407,0.0807,0.1234,0.0265,-0.1453,-0.1713,0.0748,0.0634,-0.0721,0.1264,0.0807,0.135,0.0595,-0.0755,-0.0757,-0.0626,-0.0427,0.1895,-0.1429,-0.0754,0.0092,-0.0281,0.0356,0.0246,0.0304,0.0937,0.0269,-0.0579,0.0115,-0.0832,-0.1242,-0.1338,0.0734,0.0267,0.0159,0.0379,-0.017,0.0621,0.3241,0.2951,0.1251,0.2262,-0.1068,0.1004,0.082,0.1704,0.2163,0.2385,0.093,0.0657,-0.0173,0.1922,0.1672,0.0272,0.0101,-0.1196,-0.0891,-0.0298,0.0149,0.0053,0.0405,-0.001,0.016,0.0425,-0.0081,0.1757,-0.0267,0.0533,0.0672,-0.1593,-0.115,-0.0917,-0.1246,-0.1784,0.1037,-0.0443,-0.0845,-0.0496,0.1621,0.0731,-0.1416,-0.0263,0.0444,-0.1658,-0.004,-0.0123,0.0486,0.0993,0.0924,0.281,0.2579,0.1837,0.0021,0.016,0.149,-0.078,-0.1213,0.0281,0.0547,0.0248,0.1105,-0.0984,-0.0483,-0.132,-0.201,-0.2162,-0.1678,-0.1275,-0.0499,-0.127,-0.0949,-0.0659,0.0696,0.026,-0.0325,-0.0409,-0.0869,0.0533,-0.0085,0.0287,-0.0558,-0.0082,-0.0802,-0.0557,0.0236,-0.1484,-0.0723,0.1739,-0.0839,-0.0888,0.0198,0.0082,0.0077,0.0225,-0.0387,-0.0364,-0.0816,-0.0151,-0.0126,-0.1473,0.075,-0.0131,0.1271,0.0259,-0.2196,-0.1233,-0.0127,-0.0918,-0.0282,-0.0177,-0.1156,-0.0126,0.0563,0.003,0.0945,-0.2918,-0.1381,-0.0968,-0.2261,-0.1743,-0.115,-0.0873,-0.0873,-0.0907,-0.047,0.0616,-0.1585,-0.0393,0.0243,0.0013,-0.0318,-0.0335,-0.2605,0.0433,-0.1009,0.032,-0.1162,0.302,-0.0711,-0.1051,-0.1219,-0.0481,0.0484,0.1166,-0.0272,0.2378,0.0925,0.1314,0.2152,0.1669,-0.0228,0.0255,0.0784,0.0038,0.0166,-0.0612,-0.124,-0.0212,-0.1119,-0.0303,-0.0053,-0.0185,0.0523,-0.0239,-0.0405,0.0993,0.0551,-0.0443,0.0558,-0.0336,-0.1581,-0.0021,-0.1892,-0.0234,-0.0429,0.0702,-0.1038,0.2674,0.2638,0.0641,0.2394,0.199,0.0008,0.0762,-0.0109,0.1701,0.0924,0.0182,0.1687,-0.1008,0.0581,0.0209,0.0421,0.0066,-0.0863,0.0272,-0.0098,-0.0018,0.1348,-0.0965,0.1356,0.027,0.162,0.0361,0.0459,0.2772,0.0588,0.0417,-0.0162,0.0564,0.0022,0.0237,-0.0601,-0.1533,-0.0402,0.1318,0.0762,-0.0319,0.0045,-0.0604,0.0316,0.0396,0.0502,0.0501,0.0211,0.0351,-0.0163,0.0842,-0.0448,-0.0303,-0.0011,-0.0237,-0.0584,-0.0501,-0.0908,-0.064,0.0242,0.0353,-0.1092,0.0964,0.0193,0.0946,0.0554,0.0465,0.1171,0.0683,-0.0123,-0.0187,-0.1063,-0.09,0.0471,0.0498,-0.0264,-0.0419,-0.0102,-0.0263,-0.1118,-0.1305,-0.1151,-0.1498,-0.1431,0.0246,-0.017,0.0002,-0.1406,-0.098,-0.1265,-0.0154,-0.072,-0.0087,0.0455,-0.0029,0.1037,-0.0828,-0.1226,-0.022,-0.0041,-0.0872,-0.0711,0.1365,0.0943,-0.126,0.0479,0.0435,-0.0181,0.0939,0.0425,0.0321,0.0436,-0.0228,-0.1745,0.017,-0.1367,-0.2029,0.063,-0.1031,0.1308,0.1853,0.1611,0.1261,0.1723,-0.1171,-0.1614,-0.0662,0.0423,0.069,0.0068,-0.0114,-0.0267,-0.0166,-0.1367,-0.0321,-0.1228,-0.1033,-0.0399,-0.0233,-0.0736,-0.1297,0.0262,-0.0401,0.0126,0.034,-0.0038,-0.0115,-0.1208,0.0272,0.0135,0.0517,-0.0028,-0.0117,0.0431,0.0683,-0.0549,-0.0719,-0.0346,-0.0812,-0.0309,-0.0043,-0.2028,-0.0306,-0.0028,-0.0044,-0.0682,0.0072,0.0304,0.0132,-0.0826,0.0691,-0.1266,-0.0551,-0.1576,-0.0951,-0.0309,-0.1672,-0.1215,-0.2853,-0.1373,0.023,0.1391,-0.1006,-0.0411,-0.0242,0.078,0.0163,0.0626,-0.0783,-0.1777,-0.1122,-0.02,0.0033,0.0811,-0.0342,-0.0483,-0.0671,0.0487,0.0959,0.0275,0.1438,0.0056,-0.0364,0.0644,-0.0405,0.0232,0.0008,-0.0438,-0.047,0.0867,0.0234,0.0919,0.0146,0.0792,0.091,0.1028,0.0061,-0.0223,-0.1735,-0.068,0.0073,0.2066,0.1962,0.1058,-0.003,0.0059,0.0447,0.2577,0.119,0.1203,0.1612,-0.2319,-0.012,-0.0392,0.0939,-0.0734,0.0422,0.0896,0.014,-0.0041,0.0762,0.051,-0.0524,0.1266,0.0524,-0.0695,0.1635,0.0975,0.0198,-0.005,0.0815,0.025,0.0137,-0.0202,0.0429,0.0195,0.1721,0.1548,0.1754,-0.0705,0.005,-0.0216,-0.0392,-0.0439,-0.2263,-0.2243,0.0983,0.082,0.0964,-0.0117,0.0267,-0.0548,-0.0875,-0.0749,-0.121,0.0444,-0.0394,-0.0392,-0.022,0.1038,-0.0141,-0.1405,-0.0188,-0.1186,-0.0864,0.0634,-0.1355,0.0172,-0.1867,-0.0781,-0.0187,0.0058,0.0016,0.0517,-0.0286,0.0467,-0.0766,0.2481,-0.068,0.1202,0.1144,0.0713,0.0156,0.0705,0.08,0.2702,0.2484,-0.1524,-0.0728,-0.0189,-0.0331,-0.1211,-0.113,-0.1198,-0.1733,-0.0787,0.0084,-0.0758,0.0343,-0.0569,-0.0122,-0.102,-0.1242,0.0495,-0.0121,-0.1954,-0.0908,0.0239,-0.075,-0.2033,0.0238,0.1768,-0.0818,0.068,0.1161,0.0405,0.025,-0.0096,-0.1548,-0.1248,-0.0917,-0.0733,0.0545,0.0717,0.0321,0.0447,-0.0146,0.1836,0.2182,0.2146,0.0512,0.1946,-0.2167,-0.1961,-0.1311,-0.1482,-0.0703,-0.0959,-0.1526,-0.0908,-0.0338,-0.0711,-0.085,-0.0359,0.0999,-0.1521,0.1405,0.1468,0.145,0.1489,0.0847,0.0865,-0.211,-0.1311,-0.1934,0.0342,0.1538,0.2006,0.0397,0.0228,0.1753,0.1125,0.199,0.069,0.0007,-0.1179,0.0099,0.0332,0.0363,0.0144,0.0531,0.0949,0.0191,0.042,0.0579,-0.0265,-0.0225,-0.1711,-0.1308,-0.1027,-0.0688,0.3165,0.0331,0.1757,0.1306,0.0793,-0.0216,-0.0186,0.1221,-0.0033,0.1828,0.1856,0.0374,0.1084,0.1104,0.0249,-0.0368,-0.0168,0.0533,0.0407,0.1991,0.0565,0.0129,0.0744,0.0068,-0.0117,0.0072,0.0343,-0.0749,-0.0446,-0.0039,-0.0246,0.0123,-0.0662,0.0679,0.0431,0.1894,0.0319,-0.024,-0.0197,0.0622,0.032,0.1164,0.1853,0.074,0.1209,-0.021,0.1147,-0.1102,-0.118,-0.0173,0.1222,0.1329,0.0173,-0.0568,-0.0428,-0.0952,-0.0841,0.0546,0.1873,-0.0191,-0.0005,-0.0442,-0.1067,-0.2749,-0.1779,-0.1639,-0.1662,-0.1143,-0.0706,-0.0611,0.0699,0.0453,0.0236,0.0081,-0.0819,-0.011,-0.1153,-0.0579,0.0477,0.1261,0.0194,-0.0044,0.3289,0.2971,0.1822,0.0104,0.1161,0.0357,-0.128,-0.0378,-0.084,-0.017,0.1381,0.1384,-0.0353,-0.0288,0.0414,0.1207,-0.092,-0.0987,-0.0829,-0.0309,-0.1559,-0.1038,-0.0656,-0.1204,0.0956,-0.0937,-0.0301,0.2268,-0.0754,-0.1536,0.0189,0.1224,0.1479,-0.0684,-0.0876,-0.2855,-0.2083,-0.0761,-0.2267,0.0967,-0.107,-0.106,0.0393,-0.0824,0.0803,0.0269,0.0679,0.1153,0.1212,0.2961,0.1491,0.2046,-0.0386,-0.0132,0.1164,-0.0054,0.0278,-0.0093,0.0117,0.211,0.1557,-0.088,-0.1933,-0.1229,-0.0511,-0.1049,-0.0578,0.0389,-0.0083,0.0217,-0.0155,0.0622,0.0138,-0.1816,-0.0245,-0.1445,-0.0956,-0.1786,-0.1901,-0.0181,-0.0742,0.0081,-0.0498,-0.0189,-0.0656,-0.0866,-0.1547,0.0031,-0.1237,-0.0327,-0.0818,-0.0956,-0.045,-0.0709,0.033,0.0739,0.0703,-0.0832,-0.0762,-0.1267,0.0363,0.0527,0.0832,-0.0716,0.1863,-0.0843,-0.1157,0.0261,0.0682,-0.0389,-0.0047,-0.0533,0.0629,-0.0416,-0.0491,0.1447,0.2513,0.3309,-0.0835,-0.0677,0.0627,0.0404,0.0137,0.2229,-0.0205,0.3419,-0.1495,0.2017,0.178,0.0528,-0.0477,-0.0076,0.0283,0.0369,0.0289,0.0437,0.1313,0.0568,-0.007,-0.0793,0.125,0.1554,0.1172,-0.1844,-0.1487,-0.1742,0.0097,-0.1267,-0.2045,-0.023,0.0371,0.0209,-0.052,-0.1063,-0.1268,0.166,-0.0338,-0.0991,0.2104,0.3274,0.0941,-0.0495,0.2169,0.3278,0.1599,0.0485,0.1291,-0.0416,0.0236,0.1576,0.1952,-0.0699,0.1856,0.0915,0.0433,0.0318,0.2863,0.1025,-0.1338,-0.051,-0.0633,-0.1883,-0.0581,-0.1428,-0.0096,-0.1064,-0.1724,-0.0694,-0.1997,-0.0925,0.0675,-0.132,-0.2099,-0.1432,-0.0888,-0.0426,-0.0924,-0.1206,-0.1315,-0.1218,-0.0736,-0.0659,-0.2072,-0.1484,0.0761,0.1557,-0.0177,0.0091,-0.0111,0.0346,-0.0193,-0.1015,-0.0475,-0.0869,-0.0077,0.0057,-0.2295,-0.2572,-0.0625,-0.0352,-0.1043,-0.1849,0.026,-0.0782,-0.0797,-0.1325,-0.0914,-0.0988,-0.0588,0.0546,0.0544,0.0093,0.1484,-0.0542,0.0844,0.1871,0.1184,-0.1531,0.082,-0.1877,-0.1108,-0.0873,-0.0286,-0.0221,0.0258,0.1239,0.1196,0.015,-0.0564,0.1341,-0.0879,-0.021,0.1588,-0.1494,-0.1174,-0.1646,0.0317,0.0284,0.1303,0.0417,-0.2244,-0.1874,0.0826,0.1003,0.0207,0.1937,0.1187,0.0007,-0.1068,-0.1376,-0.0514,-0.1402,-0.2317,-0.1047,-0.076,0.1312,0.0161,0.1595,-0.013,0.1462,-0.0125,0.0066,0.0293,0.0656,0.0767,-0.0014,-0.0253,0.0041,-0.0584,0.0361,-0.0201,-0.0326,-0.0396,-0.0512,-0.0358,-0.0356,-0.0455,0.0093,-0.0868,-0.0233,-0.1477,0.0204,0.0045,0.0081,0.007,0.0496,0.0253,0.0225,-0.0266,-0.0021,-0.0397,-0.0591,-0.1494,-0.1038,0.2352,0.1178,0.0887,-0.0865,-0.0305,-0.1074,-0.08,0.0278,-0.0392,0.0918,0.0985,-0.1287,-0.1649,0.0497,-0.1088,-0.0625,-0.0181,0.3267,0.2388,-0.2379,0.0446,-0.0525,-0.0394,-0.0317,-0.1379,-0.1254,-0.129,0.0881,0.0162,-0.0715,-0.0431,-0.1383,-0.0267,0.1504,0.0569,0.0379,0.0142,-0.0133,0.0273,-0.1786,-0.0369,0.0571,-0.0996,0.0561,-0.1431,0.2248,-0.1515,0.1932,0.0028,0.0313,-0.2138,-0.178,-0.03,0.0803,-0.0452,0.114,-0.0565,0.1153,0.0337,0.0158,0.0897,0.0448,0.0292,0.0158,0.046,0.0186,0.0535,-0.101,0.1147,0.2719,0.4547,0.2435,0.144,0.3382,0.1571,0.1972,0.2922,0.2241,0.2145,0.1296,0.197,0.2012,0.1851,0.1921,0.1041,0.3356,0.1518,0.2885,0.2833,0.2221,-0.1714,-0.1178,-0.158,-0.1264,-0.1022,-0.2239,-0.2011,-0.0911,0.1526,0.0524,-0.2661,-0.2413,-0.1312,-0.0217,-0.0542,-0.1532,0.0469,-0.0339,-0.0966,0.0376,-0.0724,-0.0533,-0.0245,-0.0303,-0.1086,0.096,-0.2234,-0.2302,0.1377,0.0052,-0.031,0.0435,0.0547,-0.1346,0.1133,0.106,-0.151,0.0041,0.0896,-0.0132,-0.0004,-0.0492,-0.0709,0.2153,0.2197,-0.0527,-0.0797,0.0013,-0.0638,0.0031,-0.0989,-0.0538,0.1018,-0.0413,-0.0924,0.0623,0.0132,-0.0332,-0.0118,auditory sentence recognition
trm_4a3fd79d0a775,0.0165,0.0458,0.0205,0.0545,0.0089,-0.0132,-0.0082,0.0113,-0.0153,0.0185,-0.0026,-0.0089,0.0258,0.024,0.012,0.0378,0.0326,0.0234,-0.0198,0.0135,0.0112,-0.0122,0.0164,0.0083,-0.0084,-0.0085,-0.0096,-0.0012,-0.0168,0.022,0.0163,0.0026,0.0112,0.0599,0.0184,0.0731,0.0162,0.0215,0.0552,0.0053,0.0525,0.0832,-0.0198,-0.0124,0.0374,0.0311,-0.0424,-0.0334,-0.0276,0.0012,0.0235,-0.046,-0.0111,-0.0282,0.0309,0.0073,-0.0146,0.0215,0.0004,0.0037,0.0161,0.0029,0.0758,0.0152,0.01,-0.0455,0.0621,0.0244,-0.0,-0.0168,-0.0131,0.0113,-0.0142,0.0484,0.1438,-0.0288,0.0217,-0.0225,-0.0502,-0.0215,0.0287,0.0248,0.0388,0.0301,-0.0078,0.0003,0.0,-0.0297,-0.0203,-0.021,0.0437,-0.0376,0.0395,-0.049,-0.0424,-0.0369,-0.0392,-0.0145,-0.0633,0.0143,-0.0359,0.0082,-0.0327,-0.0247,-0.0248,0.067,0.0451,-0.0488,0.0527,0.0561,-0.0052,0.036,-0.025,-0.0591,-0.0066,0.0081,-0.0121,-0.0615,-0.0104,0.0166,0.0458,0.0564,0.0345,-0.0034,0.0548,0.0244,0.0307,-0.007,-0.0072,0.012,0.0482,0.0086,-0.0346,0.0861,-0.0075,0.0567,-0.0346,0.0476,0.0416,-0.018,0.0043,-0.0096,-0.0064,-0.0088,0.0762,0.0034,-0.0259,0.0135,0.0028,0.0172,0.0251,0.0282,0.033,0.0115,0.0046,-0.0094,-0.0161,-0.0098,-0.0123,-0.0168,0.0152,0.0459,0.0524,0.0651,-0.0221,0.0306,0.0349,0.0267,0.0245,-0.0021,0.0303,0.0343,-0.0069,0.0373,0.0517,0.0548,0.0374,0.0082,-0.0132,-0.0215,0.0578,-0.0074,-0.0039,-0.0024,-0.0528,-0.0057,0.0085,0.0207,-0.0091,0.0107,0.0208,-0.0023,-0.0283,-0.0367,-0.0429,0.1604,0.1883,-0.0207,-0.0048,0.045,0.0105,-0.0548,0.0669,0.076,-0.0174,-0.0217,-0.0205,0.0175,0.035,-0.014,0.0561,-0.0156,-0.0483,-0.004,-0.018,-0.0298,-0.0201,0.0365,0.013,0.0537,-0.0175,0.0299,0.0793,0.0393,-0.0007,0.0041,0.0391,-0.0342,0.0031,-0.0501,-0.0046,0.091,-0.0272,0.0445,0.0484,-0.0577,0.0423,-0.0202,-0.0179,0.0171,0.0232,0.0379,0.0389,-0.0258,0.0296,0.0229,0.0511,0.0226,-0.0031,0.0294,0.0029,-0.0247,0.0004,-0.0319,-0.051,-0.0085,0.0165,0.032,-0.0283,-0.0612,-0.0192,-0.017,-0.0088,0.0263,-0.0238,-0.0443,-0.0082,0.0294,0.0633,0.0127,0.0432,0.0058,0.0328,-0.0008,-0.0479,-0.0496,-0.05,-0.0241,-0.0182,-0.0355,-0.0557,0.0388,0.0353,0.0562,0.0489,0.0031,0.01,-0.0417,0.0434,0.0247,-0.0074,0.0036,0.0085,0.0592,0.0169,-0.0014,-0.0344,-0.02,0.0735,-0.054,-0.0511,0.0654,0.065,-0.0006,-0.0315,-0.0271,0.0579,0.0055,0.0359,0.0049,-0.0263,0.0073,0.1084,-0.0041,-0.0079,-0.0018,-0.0297,0.0038,0.0185,0.0379,0.0242,-0.0398,0.0191,0.0577,0.0734,0.0589,-0.0028,0.0446,0.0157,0.0477,0.0225,0.0047,0.0175,0.0272,-0.0027,-0.0704,-0.0303,-0.0559,-0.0037,0.0243,0.0274,-0.0134,0.0002,-0.0255,-0.0353,-0.0352,0.0414,0.0532,0.0244,0.013,0.0316,-0.0422,0.0245,-0.0142,0.0523,0.0373,0.0121,-0.0082,0.0188,0.0232,0.0101,-0.0077,-0.0663,-0.0011,-0.0127,0.0159,0.0317,-0.0465,0.0471,-0.0335,0.0121,0.0243,0.0229,-0.0327,0.0187,-0.0013,0.012,-0.0356,-0.0453,-0.023,-0.0433,0.0193,0.0118,0.001,-0.0436,-0.0551,0.045,0.0028,-0.0316,-0.0092,-0.0412,-0.0079,0.0398,0.0227,-0.0509,-0.0479,0.0005,0.0534,-0.0247,-0.0011,0.0238,-0.0237,-0.015,0.0145,0.0263,-0.0029,-0.0025,-0.0181,0.0123,0.0032,0.0241,0.0988,0.0327,-0.0422,0.0229,-0.0063,-0.0274,0.0392,0.0541,0.0437,0.0004,0.0534,0.0224,0.2174,0.1974,0.0725,0.1111,0.0325,0.0749,0.043,0.0527,-0.0218,-0.0072,-0.0095,-0.0019,-0.0187,0.0095,-0.019,0.0666,0.0374,-0.033,0.0407,0.025,-0.0109,-0.0138,-0.0163,-0.0122,-0.0271,0.058,0.0597,0.0359,-0.0167,0.0613,-0.0114,0.0126,0.0261,-0.0236,0.0373,0.0699,0.0517,0.0181,0.074,0.0118,0.0974,0.0035,0.029,0.0246,-0.0479,-0.011,0.0209,-0.0235,0.0108,-0.0081,0.0121,0.0047,0.0147,-0.0017,0.0219,-0.024,-0.0059,-0.0416,-0.036,0.0134,-0.0065,0.0132,-0.0156,-0.0062,-0.027,0.0601,-0.0052,-0.0271,-0.0638,0.1028,0.1438,0.0252,-0.0245,-0.0568,0.0207,-0.0039,-0.0064,-0.0157,0.015,-0.0033,0.0223,-0.0156,0.0432,-0.026,-0.0303,0.0211,-0.0758,0.0376,0.0074,0.0012,-0.0162,0.0025,0.0098,0.0108,-0.0003,-0.0255,0.022,-0.0125,-0.0144,-0.0423,0.0007,-0.019,-0.0203,-0.0161,-0.0071,-0.0181,-0.0152,0.0327,0.0078,0.0055,0.1018,0.0122,0.0112,0.0588,0.0961,0.0196,0.0233,0.0188,0.0242,-0.0284,0.0025,0.0162,0.0072,0.0146,-0.017,-0.0042,0.0297,-0.0444,0.0009,0.0357,-0.0216,-0.0129,0.0459,-0.0099,-0.0478,0.0118,0.0007,0.0165,0.0262,0.0229,-0.0438,-0.0076,-0.0301,-0.031,-0.0352,-0.0314,0.0041,0.0208,0.0199,0.0013,-0.0258,-0.0276,-0.0185,-0.0061,-0.0142,-0.0411,-0.0338,-0.0025,0.0562,0.0308,0.0299,-0.0429,0.0299,-0.0079,-0.0099,-0.0349,0.0014,0.0301,0.0005,0.0124,-0.0263,0.024,0.0084,0.0595,0.0497,-0.0396,0.0341,0.0116,-0.0576,-0.0077,-0.0213,-0.0337,-0.0115,0.0435,-0.0243,-0.0335,-0.0069,0.0114,-0.0099,-0.0311,-0.0072,0.0883,0.027,0.0046,0.0367,-0.0025,0.0815,0.0126,0.0501,-0.0042,-0.0214,0.0058,-0.0177,0.13,0.032,0.0573,0.0195,-0.0094,-0.0475,0.0232,0.0406,0.0404,0.012,-0.0113,-0.0059,0.0197,0.0032,0.0425,-0.0023,0.0105,-0.0049,0.0715,0.0153,0.13,0.0381,-0.0056,0.0854,-0.0316,0.0694,-0.047,0.0546,-0.0105,0.0191,-0.0208,0.0177,0.033,0.0343,0.1251,-0.0553,-0.0475,-0.0075,-0.0372,-0.0044,0.0088,0.0047,0.0053,-0.0138,0.005,0.0115,0.0381,0.0768,0.0785,0.0087,-0.0334,0.0521,-0.0391,0.0216,-0.0319,-0.0279,-0.0355,-0.0243,-0.0494,0.0385,0.0089,-0.0124,0.001,0.0004,-0.0465,0.0046,-0.0326,-0.0081,0.0096,0.0481,0.0486,-0.004,0.0195,0.0615,-0.0013,-0.0049,-0.0377,0.0376,0.0152,0.0018,0.0537,0.1394,0.1017,-0.0412,0.0074,0.0519,0.0802,-0.0297,0.0398,-0.0278,0.0063,-0.0331,0.0233,-0.0071,-0.0455,-0.0037,0.1724,0.1733,0.0889,-0.0036,-0.0353,-0.0071,0.0029,0.0351,-0.0187,0.0048,0.0023,-0.0026,0.0192,-0.0006,0.008,-0.0117,0.0125,-0.0194,0.0023,0.0313,0.0293,0.0366,-0.0178,-0.0214,-0.005,0.0548,-0.0092,-0.023,0.0075,-0.0385,0.0437,0.0754,0.0566,0.0402,-0.0099,-0.0256,0.0202,0.0311,0.0037,-0.0323,-0.0245,-0.0308,0.0041,0.0008,-0.0087,0.007,0.002,-0.0453,-0.0498,-0.0498,-0.0239,-0.0312,-0.0328,0.0235,0.0126,0.0101,0.0318,0.0125,0.0102,0.01,0.0459,0.0104,0.0292,0.0394,-0.0089,-0.0173,-0.0423,-0.0216,-0.0109,0.0334,0.0144,-0.0011,0.0107,0.0143,-0.0078,0.0638,-0.0126,-0.0381,-0.0379,0.0063,0.0015,-0.0536,-0.005,0.0211,-0.0153,-0.0064,0.0433,-0.054,-0.0265,-0.0095,-0.0127,-0.021,-0.0156,-0.0137,-0.0709,-0.0442,0.0426,0.0063,-0.019,0.0396,0.0569,0.0047,0.0084,0.0423,0.058,-0.0176,0.0282,0.0819,0.0646,0.02,0.0299,-0.0131,0.0368,0.0424,0.0102,-0.0265,-0.0009,-0.0124,-0.0117,-0.0236,-0.0417,0.0286,-0.0138,0.0035,-0.0288,-0.0468,0.0366,0.0042,-0.0044,-0.0364,0.0028,0.0046,-0.0061,-0.0414,0.0475,0.1546,0.0614,0.0025,-0.0518,-0.0422,-0.0034,-0.0086,-0.0409,-0.0178,0.0402,0.0322,0.0397,0.0959,0.0216,0.0762,-0.0274,-0.0007,-0.0216,-0.0067,-0.0082,0.0055,0.0364,0.0331,0.0071,-0.0345,0.0216,0.0185,0.0393,0.0182,-0.0034,0.0378,0.0711,-0.0149,0.0063,0.0244,0.0182,-0.0713,-0.0121,0.0218,0.0744,0.0404,0.0086,-0.0475,0.0719,-0.0501,0.0131,-0.0424,0.0043,-0.0402,-0.0382,-0.0068,-0.034,0.084,0.0387,-0.0006,0.0061,-0.0131,-0.017,0.0129,-0.0288,0.001,-0.0118,-0.0288,-0.0356,-0.0095,0.0282,0.0412,0.0162,0.0128,0.0106,-0.0171,-0.0093,0.0233,0.0059,-0.0177,-0.0127,0.0307,-0.0192,-0.0239,0.0261,-0.0255,0.0029,0.0045,0.005,0.0748,0.0193,0.0761,0.0055,0.0197,0.0349,0.0586,0.0462,0.0355,0.0418,0.0662,0.0261,0.0296,-0.0282,-0.0078,-0.0288,0.0275,0.0086,0.0104,-0.0112,-0.0252,-0.0102,-0.0335,0.0205,0.0176,-0.0031,-0.0233,0.0012,-0.0055,0.0174,-0.0209,0.0395,-0.0456,0.0124,0.0008,-0.0086,0.0152,0.0113,-0.0356,-0.0058,-0.0098,-0.0165,-0.001,0.0279,0.0227,0.0174,-0.032,-0.0443,-0.0573,-0.0423,-0.0163,0.0005,0.0211,0.0255,0.0054,0.006,-0.0039,0.013,-0.0051,0.034,0.0487,0.0367,0.011,0.0174,0.03,0.0175,0.0384,0.0922,0.0558,-0.0198,-0.0119,-0.0262,-0.0048,-0.0017,0.0482,0.0014,0.0008,-0.0227,-0.0241,-0.0258,0.0149,-0.0131,0.0222,-0.0215,-0.0094,0.031,-0.0233,0.0293,-0.005,0.0519,-0.0237,-0.0631,-0.0405,0.0067,-0.0039,0.0093,-0.0214,0.0043,-0.0036,0.018,0.048,0.0086,-0.0188,-0.014,-0.0144,0.051,-0.0092,0.0067,0.0222,-0.0119,0.0589,0.0549,0.0534,0.0295,-0.0198,0.0082,-0.0043,0.0088,-0.0103,-0.0246,-0.0102,0.0227,-0.015,-0.0045,0.0273,-0.0263,0.0028,0.0276,0.0444,-0.0012,0.0005,0.0478,0.0231,0.0366,-0.0272,0.0067,0.0466,0.0133,-0.0052,-0.0046,0.0072,-0.0216,0.0063,0.0323,0.0508,0.0209,-0.0209,0.0259,0.0171,-0.0679,-0.0361,-0.0656,-0.0507,-0.0292,-0.0306,-0.0627,-0.0366,-0.0431,-0.0429,-0.0253,-0.0104,-0.0019,-0.0195,0.0047,0.0123,-0.0224,-0.0056,-0.0009,-0.0172,0.0252,-0.0044,-0.0051,-0.0211,-0.0227,-0.0048,0.0025,0.0533,0.0221,-0.0203,0.0148,0.0273,-0.0079,-0.0451,-0.0381,-0.0036,-0.0087,0.017,0.0585,0.0367,0.0031,0.0118,-0.0307,-0.0165,-0.0067,0.0567,0.0627,0.0423,0.0018,-0.0264,-0.0378,-0.0531,-0.0383,0.01,-0.0089,-0.0347,-0.045,-0.0482,-0.0367,-0.0433,-0.0386,-0.0275,0.0104,-0.0065,0.0289,0.0559,-0.0159,-0.0308,-0.0412,0.016,0.012,0.0172,0.0436,0.0482,0.0058,0.0162,0.0611,-0.006,-0.0249,0.0065,-0.0152,0.0021,-0.0058,-0.0265,-0.0067,-0.0288,-0.0361,0.0529,-0.0018,-0.0019,0.0091,-0.0059,0.007,0.0186,-0.0427,0.0111,-0.0472,-0.0458,0.0059,-0.0453,0.013,-0.0164,-0.0427,-0.0259,-0.0055,-0.0303,-0.0526,0.0233,0.0119,-0.0221,-0.009,0.0142,-0.0066,0.0071,0.037,0.0029,0.1087,0.0393,0.0085,0.0412,0.0953,-0.0212,0.0419,-0.0251,0.0039,0.0267,0.0491,0.0744,-0.0163,-0.0016,-0.0096,-0.048,-0.0254,-0.0276,-0.0376,0.0337,0.0407,0.0102,0.0597,0.0489,0.0316,-0.0243,-0.0263,0.029,-0.0189,0.0143,0.0424,0.032,0.0265,0.0152,0.0078,0.0172,-0.0227,-0.0002,-0.0281,-0.0117,-0.0399,0.0185,0.0055,-0.0215,-0.0215,-0.0152,0.0374,0.0538,-0.0049,0.0014,-0.0248,0.0706,-0.0455,0.0146,0.0121,0.0159,0.008,0.0041,0.0037,0.0217,0.0166,0.0043,0.0333,-0.0176,0.0002,-0.0145,0.0005,-0.0618,0.03,-0.0009,-0.0205,-0.0507,-0.0263,0.0189,0.013,0.0048,-0.0157,0.0283,0.019,-0.0418,-0.0597,-0.016,-0.03,-0.0424,-0.0695,-0.0306,-0.045,0.0093,0.0164,-0.0236,0.0511,-0.0148,0.0499,0.0625,0.039,0.0427,0.0624,-0.0044,-0.0051,0.0528,-0.0268,0.002,-0.0336,-0.0063,-0.0393,0.0159,0.0484,0.0579,-0.0127,0.0155,-0.0414,-0.111,-0.0882,-0.0978,0.0033,0.0091,-0.0011,-0.0383,-0.0364,-0.0343,-0.0111,-0.0459,0.0179,0.0104,0.0431,0.0056,-0.0153,-0.0262,-0.0018,0.004,-0.0282,-0.039,0.0133,0.01,-0.0282,-0.0001,0.056,-0.0029,0.0243,0.0326,-0.0141,0.0282,0.0274,-0.0053,-0.0001,-0.0094,-0.0203,0.0469,0.0417,-0.0082,0.0106,0.0239,0.0122,-0.0039,-0.0064,-0.0158,0.13,0.0011,-0.0586,0.027,0.0488,-0.012,-0.0066,-0.0313,-0.061,0.0009,0.0243,0.0562,-0.0336,-0.0122,-0.0447,-0.0207,-0.0288,-0.015,-0.0118,-0.0104,-0.0469,0.0525,-0.0213,-0.0308,0.0072,0.0175,0.001,0.0061,-0.0286,0.024,0.0125,0.0137,0.0081,0.0041,0.0068,0.0159,-0.0109,0.0129,0.0326,0.0163,-0.033,0.0131,0.0283,0.0013,0.0387,0.0343,0.0434,0.0164,0.0427,0.0061,-0.0148,-0.0245,0.0023,0.0178,0.0018,-0.0044,-0.0204,0.0858,0.1428,-0.0342,-0.014,-0.0403,-0.0068,0.037,0.005,-0.003,-0.0441,0.0173,0.0106,0.0364,0.0033,0.0521,0.0118,0.0415,-0.0181,0.0364,0.0435,0.0174,0.0241,0.0486,-0.102,-0.0642,-0.0226,-0.0359,-0.0446,-0.0065,-0.0101,-0.057,-0.0284,0.0278,-0.008,-0.0644,0.0144,-0.0024,0.0233,0.0631,0.0333,-0.0158,0.0027,-0.024,-0.0055,-0.0547,-0.038,0.0257,0.0217,-0.0064,-0.0475,-0.0099,-0.0375,0.0769,0.0819,0.0102,0.0372,0.0305,-0.0155,-0.0305,-0.0274,0.0129,-0.0315,0.0013,0.0261,-0.0213,0.0308,0.0318,0.0611,0.0146,-0.006,0.0166,0.0575,-0.0308,0.0315,0.0497,0.0506,-0.0218,-0.052,-0.0342,-0.0239,0.0165,0.0116,0.0337,0.0314,0.0408,-0.029,-0.0326,0.0128,-0.0183,-0.0286,-0.0474,-0.0217,0.033,0.01,-0.0791,-0.0834,0.0663,0.1024,-0.04,-0.0083,-0.0219,0.0051,0.0951,0.0011,0.0282,0.0331,0.0098,0.0333,-0.0602,0.0559,-0.0064,-0.0123,0.0543,-0.0265,-0.0733,-0.0225,-0.0071,-0.0539,0.0047,-0.0169,0.0222,0.0141,0.0302,-0.017,-0.0132,0.0183,0.0258,-0.0242,0.0406,0.0122,-0.0278,0.0417,-0.0086,-0.0148,-0.0042,0.0773,0.0232,-0.0065,0.0293,0.0076,-0.0134,-0.0293,0.0268,0.0331,-0.0266,-0.0168,-0.0871,-0.0183,-0.0383,-0.0472,0.0485,0.0496,0.0171,0.0096,-0.0327,0.0155,-0.0618,-0.0111,-0.0301,-0.0214,-0.0175,0.0041,-0.0643,0.0229,0.0894,0.0315,-0.0024,-0.0273,-0.0437,-0.0737,0.0061,-0.0373,-0.0237,0.0382,0.0128,-0.0071,0.0326,-0.0384,-0.0319,-0.0543,-0.0553,-0.0154,-0.0249,-0.0602,0.0156,0.0369,0.0003,0.0203,-0.0501,-0.002,0.0464,-0.0234,-0.0243,0.0044,-0.006,-0.0281,0.103,0.0693,0.0001,-0.0182,0.0213,0.0145,-0.0114,-0.039,-0.0226,-0.0547,0.01,0.0131,-0.0357,0.0068,-0.0275,-0.0309,-0.0303,-0.0221,-0.0008,-0.0077,-0.0137,-0.0164,-0.0296,-0.0238,-0.0232,-0.051,-0.0315,-0.0309,-0.0164,-0.0407,-0.049,-0.0366,-0.0293,-0.0442,-0.0589,-0.0122,-0.0275,-0.0122,0.0017,-0.0221,-0.0211,0.0635,0.0281,0.0021,0.0288,0.0091,0.0014,0.0134,-0.0104,0.0152,0.0145,0.0208,-0.029,0.0007,0.0492,-0.0172,-0.0016,-0.0226,-0.034,-0.0043,0.0071,-0.0428,0.034,0.055,0.0366,0.0313,-0.0045,0.0912,0.019,0.0039,-0.0054,-0.0339,-0.0378,-0.0307,-0.0167,-0.0141,-0.015,0.0064,0.0109,-0.0001,-0.0145,-0.0337,0.0044,-0.017,0.0516,-0.0031,0.0117,-0.0076,0.0094,-0.0257,-0.0092,-0.0187,-0.0202,0.0308,-0.0164,-0.012,0.0072,0.007,-0.0191,0.0122,0.0122,-0.0037,0.0322,0.0075,-0.0014,-0.0274,-0.0251,-0.0087,0.0308,0.0087,-0.0139,0.0111,-0.0036,0.0402,-0.0113,-0.0217,0.0089,0.1356,0.0538,0.0322,0.0411,0.1802,0.0148,-0.0119,0.0374,0.0545,0.0102,0.013,-0.0272,0.0162,-0.0138,0.0348,-0.0086,-0.019,-0.0186,0.0227,-0.0306,0.0188,0.0369,-0.0279,-0.0015,0.0307,0.0239,0.0393,-0.0184,0.018,0.0511,0.0557,0.0336,0.0395,0.0587,0.0088,0.045,0.0291,0.0102,0.0666,0.0636,0.0492,0.0177,0.0123,0.0313,0.0613,-0.0182,0.0017,0.094,0.0123,-0.0223,-0.0243,0.0067,-0.027,0.1412,0.04,0.0234,0.015,0.0676,0.0302,0.0741,-0.0513,-0.0533,0.0395,0.0062,-0.0063,-0.0462,-0.0388,-0.0653,0.171,0.1652,0.002,-0.0115,0.0124,0.0589,0.0139,0.0482,0.0143,-0.0003,0.0164,0.0373,0.0005,0.0011,0.0524,0.0097,0.1423,-0.0118,-0.0073,0.0391,-0.0152,-0.0575,0.0297,0.019,0.0831,0.0075,-0.0048,-0.0096,-0.0007,-0.0493,0.0301,0.0444,-0.0363,-0.0237,-0.0054,-0.0199,-0.0049,-0.0264,-0.026,-0.0235,-0.042,-0.0065,-0.0033,-0.0123,-0.0424,-0.0629,-0.0612,0.1394,-0.0485,-0.0347,-0.0459,-0.0234,-0.0237,-0.0161,0.0028,0.0235,0.0114,-0.0419,0.0734,0.0086,0.0163,-0.0235,-0.0021,-0.0469,0.0155,-0.0454,-0.0556,-0.0697,-0.0188,-0.0219,-0.0052,-0.0195,-0.034,0.0017,0.0192,0.0049,0.0064,0.0945,0.0215,0.0529,0.0271,0.0435,0.0427,0.0602,0.0385,0.0012,-0.0023,0.0245,0.0509,0.0776,0.0836,0.1511,-0.0026,0.128,0.051,-0.0086,-0.0132,-0.0123,0.0442,0.0679,0.0594,-0.0374,-0.0068,0.0137,0.0137,-0.0558,-0.0241,-0.0398,-0.0113,0.0265,-0.0173,0.0433,0.0466,-0.013,0.0261,0.0272,-0.02,0.029,-0.0085,0.0634,0.0619,0.0343,0.0071,-0.062,-0.0025,0.006,0.0101,-0.0222,0.0217,-0.0124,0.0436,0.0002,-0.0162,-0.0322,-0.0262,-0.0093,-0.0168,0.0444,-0.0487,0.0181,0.0317,-0.0181,-0.0511,-0.0363,-0.0269,-0.0814,-0.036,0.0173,0.0107,-0.0724,-0.0465,0.0094,-0.0345,-0.037,-0.0272,-0.0096,-0.0099,-0.0321,-0.0208,-0.0705,-0.0443,-0.0457,0.0157,-0.0318,-0.0336,-0.0655,-0.057,-0.0609,-0.0201,0.0159,-0.0158,-0.0165,-0.0057,-0.0057,0.065,-0.0082,0.026,0.0504,0.0456,0.0256,-0.0123,0.0171,0.0236,-0.0359,-0.007,-0.0081,-0.0633,-0.0142,-0.0456,-0.0357,0.0067,0.0176,0.0145,0.0183,-0.0054,0.0642,-0.031,0.0209,0.0366,0.0322,-0.049,-0.035,0.0412,-0.0298,-0.0057,-0.0393,-0.0101,-0.0601,-0.0683,0.0076,0.0761,0.0688,-0.0339,-0.016,0.0444,-0.0499,-0.0349,-0.0317,-0.0264,0.0265,0.0239,0.0114,0.0134,-0.0332,0.0736,0.0461,-0.0161,0.0195,-0.0022,-0.0215,0.016,-0.0149,0.0229,0.0051,-0.0209,0.0212,0.0651,0.078,-0.0099,-0.0279,-0.0242,-0.0239,-0.0154,-0.0323,-0.0586,-0.0496,0.0028,-0.0433,0.0002,0.0088,-0.038,-0.046,-0.0048,-0.0251,-0.0012,-0.0156,-0.0049,-0.0439,-0.0313,0.0057,0.0056,-0.0583,-0.0456,0.0351,-0.0123,0.0443,0.0168,-0.0306,0.0261,-0.0273,-0.0102,-0.0424,-0.0049,-0.032,-0.0441,0.0293,0.046,-0.0126,0.0124,0.0456,-0.037,-0.0237,-0.0251,-0.0248,-0.007,0.0055,0.1156,0.0046,0.0048,0.058,-0.0091,0.0054,-0.0334,-0.0605,-0.068,-0.0801,-0.0357,0.0123,0.0462,0.009,-0.0351,0.0325,0.0171,0.0077,-0.0016,0.0285,-0.0203,-0.0139,0.027,0.0369,0.0565,0.0781,0.055,0.017,0.0081,-0.0118,0.0297,0.0313,0.0117,-0.0162,0.0234,0.0016,-0.0448,-0.0734,0.0384,-0.0228,0.0514,-0.0361,0.0086,-0.0444,-0.0456,0.0316,0.0335,-0.0668,-0.0485,-0.0477,0.0009,0.0082,-0.0049,-0.0007,-0.0112,-0.0012,0.0108,0.0053,0.0031,0.0645,-0.015,-0.0046,-0.0192,0.0103,0.0358,0.0001,-0.0285,-0.0197,0.0203,0.0103,0.0303,0.0537,-0.0386,0.0156,-0.0508,0.1094,0.0107,0.0455,0.1146,0.0553,0.0387,0.0046,0.0046,-0.0063,0.0324,0.0006,0.0442,-0.0131,-0.0253,-0.0171,0.0342,0.0469,0.1754,-0.0443,0.0474,0.0306,-0.048,-0.0347,-0.0515,-0.0304,0.028,0.0311,-0.0058,0.0307,0.0054,-0.0493,-0.003,-0.0397,-0.0413,-0.0372,0.0244,-0.0112,-0.0477,-0.0363,-0.0356,0.095,0.0382,0.0218,0.0184,-0.0009,0.02,-0.0095,-0.0203,-0.0191,0.0008,-0.0079,0.0322,0.0872,-0.0239,-0.007,0.1009,0.0564,0.1148,-0.0152,0.0197,-0.0409,0.017,-0.0619,-0.0631,-0.0522,0.0019,-0.0088,-0.0174,-0.0428,-0.0331,-0.0792,-0.0074,0.0382,-0.0115,-0.0092,-0.037,-0.0077,-0.0226,0.005,0.0136,-0.0046,0.0046,0.0264,-0.0052,-0.0384,-0.006,0.0016,-0.0001,0.0294,0.0174,-0.0423,-0.016,-0.0009,-0.0289,0.0901,0.0062,-0.0214,0.0283,0.0211,0.0011,-0.0004,-0.03,-0.0045,0.0017,-0.0172,-0.0258,0.0104,-0.0487,0.0442,0.0098,0.0418,-0.0207,-0.039,0.0494,-0.0143,-0.0465,-0.0188,-0.0338,0.0301,-0.0187,-0.0085,0.0234,-0.0267,0.0131,-0.0133,-0.0143,-0.0346,-0.0079,-0.0137,-0.0284,0.0319,0.0271,-0.0052,0.0352,0.0112,-0.0045,-0.0353,0.0257,0.0268,0.0186,-0.0442,-0.0085,0.0238,0.0495,0.0518,0.045,0.0149,0.0438,0.0333,0.046,0.0373,0.0985,0.0144,0.0376,-0.0378,0.0072,-0.0138,-0.0497,0.0241,0.0161,0.0103,-0.0134,0.0172,0.0345,-0.0347,-0.0178,0.0323,0.0156,0.0236,0.0397,0.0014,-0.0434,0.0033,-0.0018,0.0035,0.0449,0.043,0.0613,0.0402,-0.0372,0.03,-0.0321,-0.0205,0.0057,0.0146,-0.0366,0.0447,0.0254,-0.0257,-0.0365,-0.0663,0.0065,0.036,0.0039,0.0073,-0.0004,0.0559,-0.0082,0.0376,0.0025,0.0095,0.008,0.0097,-0.0274,-0.0123,-0.0047,-0.0224,0.0267,-0.0164,0.0168,0.0199,0.0308,-0.0513,0.0291,-0.0084,-0.0073,-0.0062,-0.0438,0.0234,0.0111,0.0202,0.0004,0.0513,0.1542,-0.0181,0.0496,0.0305,-0.0061,-0.0294,-0.0118,0.0007,0.0178,-0.0223,0.0461,0.013,-0.0237,0.037,-0.024,0.0192,0.0107,0.0686,0.0338,-0.0044,-0.057,0.0278,0.0524,0.0109,0.0279,-0.045,-0.0064,0.02,0.0348,0.0057,0.029,-0.013,-0.0248,0.0061,0.0244,0.0077,-0.0211,0.0069,-0.0221,-0.0269,0.0229,0.0178,-0.0018,-0.0511,0.0048,0.0122,0.0168,0.0093,-0.0024,-0.023,-0.037,-0.025,-0.0394,-0.0161,-0.0541,-0.0034,-0.0194,0.0643,-0.0012,0.0182,-0.0366,-0.066,-0.0093,0.0088,0.0446,0.016,-0.0424,-0.0479,0.0257,0.0079,0.038,-0.0059,0.005,0.0114,-0.0054,-0.0201,0.021,0.0127,-0.0364,0.0309,0.0113,0.0135,-0.0152,-0.0206,0.0265,-0.0477,-0.0178,0.0189,0.0104,0.0111,0.0134,0.0245,-0.0474,0.0236,-0.0104,-0.025,0.0001,-0.0177,0.0236,-0.0283,-0.0122,0.022,0.0793,0.131,0.1219,-0.0347,-0.0085,-0.025,0.0086,0.0249,-0.0021,0.0246,0.0363,0.0281,-0.0071,-0.0159,0.0352,0.0446,-0.0125,0.0261,0.083,0.038,0.0604,0.0874,-0.0487,-0.0068,0.0099,0.0553,0.0518,0.026,-0.0119,-0.0138,-0.031,0.0085,0.0587,0.0568,-0.0118,0.0463,0.0239,0.0297,0.0442,0.0277,-0.0065,0.001,-0.0221,-0.0428,0.0397,0.0805,0.0897,0.0298,0.0464,0.0414,0.0026,0.0698,0.0258,-0.0011,-0.0028,0.0028,-0.0052,-0.0259,-0.0048,0.0308,-0.0372,-0.0051,0.0428,0.0263,-0.011,-0.0026,0.0366,-0.0459,-0.0506,-0.0113,-0.0035,-0.0436,-0.0462,0.0251,0.0162,0.0385,0.0807,0.0046,0.0368,0.0274,-0.0322,-0.0307,-0.0107,-0.0317,-0.045,-0.0914,-0.0319,-0.0055,-0.0545,0.1309,0.155,0.0349,-0.0408,-0.016,-0.0194,-0.0056,-0.0013,-0.0534,-0.0133,0.0238,0.0185,-0.0451,0.0078,-0.005,-0.0118,-0.0289,-0.0217,-0.0168,0.0015,-0.0531,-0.0416,-0.0478,-0.0104,-0.0334,-0.025,-0.0237,-0.0147,-0.0596,-0.0891,-0.0424,-0.0528,0.0047,0.0017,0.0098,-0.0119,-0.0027,-0.0076,0.0014,0.0058,-0.0135,-0.0264,0.01,-0.023,-0.0107,0.0716,0.0215,0.0369,0.0364,-0.0387,0.0375,-0.0203,-0.0397,-0.0347,-0.0217,-0.0196,-0.0179,-0.0061,-0.0271,-0.0263,-0.0464,-0.0296,0.027,-0.0245,0.0378,-0.0168,0.0051,-0.0443,-0.039,-0.0661,0.0295,0.0369,-0.0151,0.0202,-0.0083,0.0025,0.0485,0.0762,-0.028,0.0059,-0.0595,0.031,0.0209,-0.0445,-0.0457,0.0005,-0.0143,-0.0214,0.0166,0.0246,-0.0551,-0.0385,-0.0247,0.0321,-0.0286,-0.0544,0.0021,0.0383,-0.0101,-0.0338,-0.0172,-0.0289,0.0216,0.0228,0.0278,0.0049,0.0049,-0.0284,-0.0039,-0.0356,0.0982,0.0763,0.0747,0.0482,0.0368,0.0397,0.0678,0.0084,0.0217,0.0118,0.0288,0.0216,0.0427,0.0653,-0.0296,-0.0331,-0.0001,-0.0089,-0.078,-0.0148,0.0071,-0.0567,-0.049,-0.0446,-0.01,-0.0327,0.0036,-0.0298,-0.0439,-0.0504,-0.0177,-0.0356,-0.0503,-0.0059,0.0239,-0.0374,-0.0212,0.0101,0.0331,0.0224,0.0223,-0.0633,-0.0401,-0.0413,-0.0317,0.0193,0.0471,0.0167,-0.045,-0.0572,0.0736,0.0172,-0.0306,0.0078,0.0014,0.0379,0.1409,0.0728,0.0724,0.1005,-0.0391,-0.0351,0.0329,-0.0332,-0.0359,0.0005,-0.0227,-0.004,-0.0325,-0.0254,-0.0268,-0.0394,0.012,0.0139,0.012,-0.0328,-0.0156,0.0065,-0.0445,-0.0064,-0.0573,-0.0437,0.0673,0.0746,0.0857,0.0171,0.0568,0.0334,-0.0136,-0.0045,0.0003,-0.011,-0.0136,-0.0074,-0.0148,-0.0002,-0.0036,-0.0459,0.0196,0.0609,-0.0323,-0.0553,-0.0087,0.0564,0.0247,-0.0132,-0.0093,0.0387,-0.008,0.0487,-0.0084,0.0132,-0.0059,-0.025,-0.0107,0.0054,0.0104,0.013,0.0313,-0.0169,0.0078,0.0053,-0.0126,-0.0184,0.0289,-0.0717,-0.0026,0.0008,-0.0379,-0.0509,0.0252,-0.0122,0.0121,0.01,-0.001,-0.0415,-0.0386,-0.0834,-0.0769,-0.0051,-0.0555,0.0095,-0.0722,0.0179,-0.0382,0.0136,-0.059,-0.0389,-0.0243,-0.021,-0.0357,0.0124,0.0214,0.0504,0.0448,-0.0427,-0.0304,-0.0647,-0.0041,-0.0313,-0.0169,0.0184,-0.0261,-0.0191,0.0549,0.0528,0.0465,-0.0222,0.0023,-0.0558,0.0286,0.0119,0.0258,-0.0153,-0.0104,-0.0148,-0.0367,-0.0095,0.0587,-0.0332,-0.0401,-0.0097,0.0096,-0.0202,-0.0194,-0.0286,-0.0435,0.0162,0.03,0.0184,-0.0453,0.0035,0.0705,-0.0654,-0.0036,-0.0039,-0.0175,-0.0386,-0.0073,0.0207,0.0086,-0.0191,-0.0535,-0.057,-0.0295,-0.0354,-0.0207,-0.0382,-0.0128,-0.0317,0.0111,-0.0434,-0.0373,0.0203,-0.0394,-0.0477,0.069,-0.0289,-0.0108,0.0194,0.0309,0.0045,0.0068,-0.0396,-0.0205,-0.0339,-0.0567,0.0438,0.0163,0.0006,-0.0307,0.0063,-0.0266,0.0254,0.0232,0.0305,0.0145,0.0626,0.0558,-0.0134,-0.0044,-0.007,0.0486,0.0423,0.0688,0.0592,0.066,0.0151,-0.0235,-0.0189,0.0619,0.011,0.0794,0.0207,0.0341,-0.0207,-0.0307,-0.0612,0.0011,-0.0272,0.0342,0.0077,-0.0234,-0.0287,-0.0402,-0.0026,-0.0357,-0.0501,0.0153,0.0058,-0.0093,-0.0197,-0.0003,-0.0063,-0.0395,-0.0413,-0.0268,-0.023,-0.0462,-0.0509,-0.0362,0.0896,0.0762,-0.029,-0.0281,-0.0496,-0.0482,-0.0147,-0.0206,-0.0124,0.0759,0.0459,0.0604,0.0538,0.0137,0.0443,0.0456,0.0636,0.0102,0.0171,-0.0288,0.0281,-0.0392,-0.0185,-0.0058,-0.0423,0.0216,0.005,-0.0284,-0.0006,0.0089,0.0008,0.0278,0.0011,-0.004,0.0478,0.0054,0.054,0.0038,0.0329,0.0432,0.0286,0.0311,-0.0126,-0.0012,-0.0314,-0.0436,0.0221,-0.0192,0.0373,0.0011,-0.0225,0.0142,0.0515,0.0147,-0.0229,-0.027,-0.0299,0.001,0.0204,0.0431,0.0137,-0.0211,0.0184,-0.0018,-0.0072,0.0849,0.0101,0.0244,0.0216,-0.0494,-0.0145,-0.0624,-0.0574,0.0746,-0.0271,0.0026,-0.013,0.0235,0.0967,0.0698,0.0374,-0.0132,0.0334,0.0462,-0.0354,0.03,0.0213,-0.0263,0.0021,-0.0268,0.0031,-0.0274,-0.0148,0.0014,0.0073,0.0361,0.0578,0.0072,0.1178,-0.0561,0.0944,-0.029,-0.0258,-0.0085,0.1083,0.1161,-0.0407,-0.0788,-0.0028,-0.0609,-0.0452,-0.0381,-0.0032,0.023,-0.0404,-0.0489,-0.0446,-0.0453,-0.0191,-0.0186,-0.023,0.005,-0.0074,-0.0478,-0.0794,-0.0374,-0.0448,-0.0534,-0.0513,-0.0305,-0.0451,-0.0232,-0.0546,-0.0263,-0.0213,-0.0406,-0.0375,-0.0401,-0.0415,-0.0426,-0.059,-0.0757,-0.0284,-0.0388,0.0089,0.0142,0.1307,-0.0347,-0.0311,0.0121,0.0097,-0.0153,0.0074,-0.0072,-0.0024,-0.008,0.0066,-0.0005,0.0309,0.0562,-0.0369,0.0252,0.0017,0.0141,0.0678,0.0013,0.0312,0.0267,-0.0247,0.0198,-0.0362,-0.0319,0.0086,0.0037,-0.0258,0.0086,-0.0016,0.0104,-0.0153,0.0051,0.0483,-0.0626,-0.0471,0.0586,-0.0379,-0.049,0.0081,-0.0459,-0.0444,0.0207,0.0279,-0.0451,0.0041,-0.0046,0.0263,0.0116,-0.0253,0.0177,-0.0246,-0.0021,0.0536,0.0659,-0.0244,language comprehension
trm_557b482a7c62b,-0.1402,-0.1051,-0.131,-0.1352,-0.0245,-0.0075,-0.1008,-0.1136,-0.0787,-0.1114,-0.0027,0.0117,-0.1247,-0.0634,-0.122,-0.065,-0.0826,-0.0678,-0.0896,0.0121,-0.0581,0.0456,-0.0252,0.067,-0.0277,-0.0007,-0.0047,-0.1101,-0.1608,-0.103,-0.1016,-0.0592,-0.1305,-0.1112,-0.1001,-0.0956,-0.0704,-0.07,-0.1278,-0.0387,-0.0872,-0.1097,-0.0631,0.0782,-0.0664,-0.0514,0.1921,-0.1352,0.025,-0.1158,-0.0669,-0.0326,0.026,-0.0177,-0.0286,-0.0875,-0.1193,0.0001,0.0225,-0.037,0.0209,0.04,-0.1049,0.0588,0.0175,-0.0223,-0.1665,-0.2095,-0.1234,0.0176,0.0666,0.0388,0.1621,-0.0539,-0.1396,0.0862,-0.1456,0.0602,0.055,-0.0342,0.0393,0.0857,-0.0319,-0.1237,0.0331,0.0408,-0.0364,0.003,0.0181,-0.2204,-0.0748,-0.1065,0.0177,0.0778,0.1068,0.0957,0.0986,-0.0356,0.1036,0.0319,0.0725,0.0344,0.0595,-0.0432,0.0378,-0.1032,-0.1155,0.146,-0.0526,-0.0508,0.019,-0.0958,0.1084,0.1139,0.004,0.0556,-0.0771,0.0121,-0.0225,-0.0711,-0.0399,-0.1188,-0.0612,-0.0146,-0.0739,-0.0822,-0.0271,0.0511,0.0677,0.0164,-0.0164,-0.0869,-0.0372,-0.1846,0.0271,-0.1493,-0.0554,-0.0951,0.0169,-0.0573,-0.1133,-0.1444,0.0836,0.0004,0.0002,0.0516,-0.1427,0.0297,-0.0706,0.0755,-0.0734,-0.0375,-0.1003,-0.1054,0.1803,-0.0459,0.0669,0.0202,0.0417,-0.0427,-0.0762,-0.0376,-0.1618,-0.2051,-0.0221,0.0477,0.0197,-0.1141,-0.1048,0.0149,0.0015,-0.0623,0.0535,-0.1283,-0.1167,-0.1219,-0.0914,-0.0815,-0.0529,-0.0461,-0.1202,0.0918,-0.0274,-0.0246,-0.1111,-0.0521,-0.1003,0.0006,-0.0041,0.0182,0.0292,-0.0536,-0.0372,-0.1662,-0.1505,-0.2161,-0.1886,0.0139,0.0578,-0.1939,-0.1343,0.1354,-0.0644,-0.1049,0.0377,-0.0791,-0.0304,-0.0459,-0.0918,-0.0054,-0.1138,-0.038,0.0021,0.0086,0.0788,0.0603,0.117,-0.1382,-0.2045,0.0499,0.1086,-0.0888,-0.0819,-0.0231,0.0352,0.0478,-0.0355,0.145,0.016,0.1901,-0.0882,-0.0992,0.1331,-0.1177,-0.1137,-0.0245,-0.0111,0.0647,0.0065,-0.055,-0.0161,-0.1638,-0.0757,-0.0358,-0.0787,-0.0645,-0.0085,-0.1116,-0.0991,-0.0462,0.0155,0.0307,0.0132,0.0469,-0.0191,-0.1291,0.0033,-0.0866,0.1417,0.2375,0.0484,0.2248,-0.0901,0.1271,0.1476,0.2909,0.1116,-0.0078,0.0787,0.0329,-0.0446,-0.0742,-0.0939,0.0229,-0.0965,0.0163,-0.1496,-0.1545,-0.166,-0.0328,0.0297,-0.0119,-0.0014,-0.0713,-0.026,-0.0933,0.0689,0.0907,-0.1674,-0.1106,-0.0569,-0.09,-0.043,-0.0318,-0.1131,-0.0328,0.0053,0.0573,-0.0309,0.1042,0.0361,-0.1076,-0.0992,-0.0515,-0.1387,-0.133,-0.1353,-0.0765,-0.0467,0.0005,-0.0179,-0.0226,-0.1301,0.0598,0.0643,-0.0765,0.0951,0.0018,0.0721,-0.126,-0.0067,0.0309,-0.0646,-0.0721,-0.081,-0.0658,0.0139,-0.0149,-0.0798,-0.0705,0.0146,-0.1174,-0.0013,0.043,0.0414,0.0337,0.0783,-0.0014,0.0203,-0.1062,-0.0914,0.0641,-0.0596,-0.0834,0.0707,-0.0026,-0.2481,-0.1538,-0.1701,-0.1212,-0.1143,0.0256,-0.1204,-0.0874,-0.0422,-0.0856,-0.0626,-0.1003,-0.1656,-0.1055,-0.0064,-0.0247,-0.0665,-0.0515,-0.0734,0.0285,-0.1419,0.1727,0.0919,-0.1742,0.0458,0.059,0.0115,0.0689,-0.0952,-0.065,-0.0726,0.1101,0.202,0.15,0.2133,-0.0227,-0.1026,-0.0079,0.0146,0.0424,-0.0592,-0.0481,0.0489,-0.0514,-0.0949,-0.0003,-0.0892,-0.0223,-0.0373,-0.1118,-0.1636,-0.1307,-0.0985,-0.0442,-0.0538,0.0199,0.0133,-0.0232,0.0385,0.0739,0.0808,0.0009,-0.087,-0.0446,-0.0535,-0.1103,-0.0101,0.2448,-0.0577,0.0074,0.2577,0.0186,-0.0561,-0.0301,0.02,-0.2367,-0.1592,-0.2811,-0.2342,-0.135,-0.1749,-0.1259,-0.1517,-0.1563,-0.0003,0.0536,-0.0146,-0.0571,0.0457,0.0797,-0.0153,0.0331,-0.229,-0.1405,0.0358,0.0534,-0.0176,0.0806,-0.0345,-0.1057,0.0368,0.0762,-0.0457,-0.033,-0.0121,0.0584,-0.1098,-0.0796,-0.0116,-0.0819,0.0469,-0.0718,-0.0081,-0.0054,0.0669,-0.0426,-0.0106,0.1421,-0.0743,-0.0905,0.0599,0.3422,-0.1025,-0.0596,-0.0154,0.0178,0.0125,0.0055,-0.0327,-0.0516,-0.0177,0.0238,-0.0289,-0.0662,0.0087,-0.0458,-0.0153,0.0347,0.0868,0.099,-0.0281,-0.0068,-0.0275,-0.0685,0.0786,0.0492,-0.0177,-0.0558,0.1151,0.0775,-0.059,-0.0524,0.0671,-0.0802,-0.07,0.0528,-0.0505,-0.1131,-0.1263,-0.0592,0.075,0.0952,-0.0035,0.0695,-0.171,-0.017,-0.0003,0.0313,0.0805,0.0458,-0.1282,-0.1258,0.0317,-0.1045,-0.0921,-0.0765,0.1014,0.0387,0.1489,0.0623,0.0926,0.0835,0.0054,0.0607,-0.0623,-0.0425,-0.1016,-0.1597,-0.0335,0.0217,-0.0824,-0.0686,0.011,-0.0759,-0.0084,0.055,-0.0087,-0.0517,-0.0762,-0.0396,0.0175,0.0478,0.0256,-0.0154,0.0411,-0.0194,0.02,-0.0846,-0.0111,-0.0844,0.1088,0.0232,0.0907,-0.0529,0.0092,0.0538,-0.0126,-0.0015,-0.0483,0.0493,0.0954,0.0494,0.0019,-0.0042,-0.0552,0.0474,-0.1515,0.0036,-0.0788,-0.0739,0.0215,0.0105,0.0552,0.0715,0.0107,-0.0732,0.0001,-0.0612,0.064,0.064,-0.0693,0.0499,0.0093,-0.0125,-0.0673,-0.0078,0.0657,0.0835,-0.0938,-0.0768,-0.1857,-0.0158,0.1323,-0.0107,0.0502,0.0408,0.0517,0.0387,0.03,-0.0745,0.01,-0.1743,-0.1742,0.0608,-0.1715,-0.0608,0.0723,-0.0502,-0.2363,-0.0326,-0.0791,0.0373,0.057,-0.1461,-0.0886,-0.1591,0.0535,0.043,-0.0292,0.0273,-0.1122,-0.1076,-0.1194,0.0134,0.0329,-0.0609,-0.0327,-0.0097,-0.0211,-0.0088,0.0388,-0.0544,-0.0386,-0.0788,-0.0941,0.0431,-0.009,-0.0842,-0.0555,-0.0118,-0.1119,-0.1069,0.0479,-0.1035,0.0067,-0.0518,0.1251,-0.031,-0.0075,-0.074,-0.0412,-0.1158,-0.0081,-0.0983,-0.0645,-0.0543,0.1348,-0.1043,-0.034,0.0934,-0.1951,-0.061,-0.0934,-0.1025,-0.0659,-0.0538,-0.0547,0.0003,-0.0554,-0.0836,0.1146,-0.0611,0.0387,-0.0582,0.0463,0.0513,0.0763,0.0227,0.0893,-0.1297,-0.0952,0.046,0.0014,-0.0162,-0.0114,0.1368,0.1096,0.1027,0.1089,0.0521,0.0527,-0.0447,-0.1027,-0.0173,0.0283,0.0058,-0.0366,-0.0625,-0.0684,-0.0701,-0.0738,-0.0456,-0.0364,0.0435,0.1207,0.0695,0.0068,0.0726,0.0905,0.0376,-0.0154,0.036,-0.058,0.026,0.0661,-0.0781,-0.1266,-0.134,-0.0681,-0.0054,-0.0352,-0.0911,0.0288,-0.0751,0.0927,-0.0088,-0.0744,0.045,0.0677,0.0057,-0.168,0.1002,0.099,0.1918,-0.0904,-0.0039,-0.1237,-0.0095,0.0767,-0.108,0.0924,0.0395,-0.0075,0.0183,0.0222,0.0307,-0.1214,-0.1599,-0.1309,-0.1063,0.0586,0.2423,0.048,-0.1212,0.0193,-0.047,0.0571,0.0832,0.0365,0.017,-0.0337,-0.1004,-0.0576,0.0758,0.0946,0.1278,-0.08,-0.0524,0.0013,-0.0618,0.0714,-0.0685,-0.095,-0.0081,-0.1235,-0.0938,-0.0396,0.0792,0.1404,0.0746,-0.0061,-0.0571,-0.0161,0.1516,-0.0447,-0.0812,0.0993,0.0127,0.0165,-0.0119,0.0846,-0.0262,0.0927,-0.1703,-0.1751,0.0988,0.1682,0.1904,0.0036,-0.0071,0.0346,-0.0189,0.0317,0.1386,-0.025,0.0398,0.0941,0.1569,0.0697,0.0142,0.1366,0.151,-0.0843,0.049,0.0932,-0.1619,-0.0923,-0.0469,-0.0817,0.0642,-0.1868,-0.0682,-0.1164,-0.0784,-0.13,0.053,0.0132,0.1041,-0.0763,-0.0873,0.0146,-0.0033,0.0744,0.0896,0.103,0.1469,0.043,0.0723,-0.0068,-0.0067,0.0792,0.1102,-0.0847,0.1097,0.0599,-0.033,-0.0503,-0.0975,-0.0447,0.0679,-0.0194,-0.1322,-0.0862,-0.0496,0.0851,0.1518,0.0674,0.0329,0.0055,-0.0277,-0.0681,-0.0828,0.0562,-0.0497,0.082,-0.0852,-0.0177,-0.0735,0.1017,0.0379,0.0347,0.0389,-0.1127,-0.0787,-0.0493,0.1896,-0.0747,-0.0835,-0.0698,0.0663,-0.009,-0.1446,-0.0016,-0.13,0.0228,-0.0923,0.038,0.0345,0.0312,0.1208,-0.1602,-0.0808,-0.032,0.0396,-0.1072,-0.0088,0.1595,0.0483,0.0849,0.3756,0.091,-0.0643,-0.0632,-0.0371,-0.0496,-0.0368,-0.0129,0.0444,0.1241,0.0383,0.0252,-0.1185,0.1017,0.1515,-0.0166,-0.0473,-0.0412,0.0125,-0.1836,-0.0747,-0.0627,-0.0093,0.0562,-0.1055,-0.0855,0.1309,-0.0053,-0.1159,-0.0374,0.0932,-0.0087,-0.0102,-0.0417,-0.1066,-0.1066,-0.1489,-0.1117,-0.1421,0.0202,-0.0153,-0.0393,-0.1111,-0.0397,-0.1121,-0.0048,-0.1198,-0.0885,-0.1024,0.0104,0.0688,0.0836,-0.0249,0.05,-0.0424,0.069,0.0466,0.1953,0.1766,0.1286,-0.0408,-0.0603,-0.043,0.0028,0.1612,0.0751,0.0929,-0.0191,0.0828,0.0239,0.1406,-0.0208,-0.0591,-0.0589,0.1072,-0.0332,0.0888,-0.1551,-0.042,-0.0199,0.0542,0.0568,0.0178,0.044,-0.0101,0.12,0.2077,0.1578,-0.0375,-0.0127,-0.0129,-0.0524,0.0055,-0.022,-0.0468,-0.0717,-0.0931,-0.0328,0.0876,0.0773,-0.1121,-0.0938,-0.041,-0.1421,-0.0507,0.1368,0.0494,0.0739,0.1161,0.1126,-0.013,0.0188,0.0589,-0.0306,-0.0495,-0.0035,0.0378,-0.0638,-0.1069,-0.029,0.0756,-0.0881,0.0044,-0.0582,0.0472,-0.1451,-0.0082,0.005,0.0526,0.0377,0.0677,0.0238,-0.0257,-0.0037,-0.0067,-0.0121,-0.0557,-0.0097,-0.0101,0.0202,-0.0393,-0.0568,-0.0018,-0.0211,-0.0213,-0.0949,-0.066,-0.1293,-0.0678,-0.0942,0.1486,0.0189,0.0734,-0.0961,0.1852,0.0955,-0.0203,0.0079,0.0342,0.1152,-0.0006,0.0435,-0.1192,-0.0729,0.0352,-0.0434,-0.0606,0.0207,-0.0627,0.0292,0.0184,-0.0611,-0.0406,-0.0505,0.0353,-0.0481,-0.0054,0.0153,0.0249,-0.0975,-0.0028,-0.0324,0.0746,-0.0201,-0.0203,0.3646,0.2528,0.1767,0.0749,0.1109,0.005,0.1601,0.1621,-0.1588,0.2994,0.3008,0.204,0.1533,0.2511,0.0163,0.0502,-0.0032,0.0528,0.0706,0.0243,0.0258,0.03,-0.091,0.0207,0.0426,0.0359,0.0677,-0.0193,-0.0608,0.1562,0.1129,-0.0535,-0.03,-0.1041,0.0373,0.0123,0.1087,-0.0237,-0.0883,-0.0613,-0.0057,0.0354,0.1487,0.1525,-0.1195,-0.077,-0.1404,-0.1038,-0.0904,0.2922,-0.1336,0.1321,0.131,-0.0379,0.0181,-0.0678,-0.0618,-0.0337,-0.0534,0.1468,0.0693,-0.0109,0.03,0.0304,-0.0614,-0.0739,-0.019,-0.0548,0.0274,0.0121,-0.0805,-0.0836,-0.1005,-0.0412,-0.0433,-0.0152,-0.1655,-0.0877,0.2037,-0.0132,0.0195,0.0143,0.162,0.0265,-0.016,-0.1558,-0.1647,0.0179,-0.1026,-0.1047,-0.1043,-0.027,-0.0292,0.0008,0.0619,0.0293,0.0113,0.1199,-0.0354,-0.0307,-0.0165,0.0943,-0.0518,0.1239,-0.0621,0.1244,0.2319,-0.0024,-0.0794,0.1882,0.1664,-0.0147,-0.1275,-0.0051,-0.1272,-0.0725,-0.1609,0.0019,-0.0027,-0.0645,-0.036,-0.0045,-0.0375,-0.0177,-0.1059,-0.0368,-0.0147,-0.0451,-0.0699,0.0671,-0.0208,0.3968,0.2755,0.2723,0.3405,-0.0745,-0.0409,-0.0648,-0.0619,-0.0776,-0.0137,-0.1337,0.1614,-0.0744,-0.0516,0.0746,0.0213,0.0221,0.1095,0.0557,-0.0214,0.0009,0.0271,-0.0269,-0.0228,-0.0375,0.1137,0.0029,0.0417,-0.0901,-0.0901,-0.151,0.11,0.0335,0.0533,-0.085,0.1034,-0.037,0.157,-0.2503,-0.2164,0.0826,-0.0351,-0.2068,-0.1983,-0.1944,-0.0867,-0.0722,0.0027,-0.0165,-0.034,0.0602,0.0138,0.0817,-0.0713,0.1007,-0.0422,-0.001,0.0306,-0.0795,-0.0266,-0.019,-0.026,0.0064,-0.0181,-0.0859,0.0308,0.0451,-0.0148,-0.0279,-0.0214,0.0062,0.0319,-0.0659,-0.039,0.0045,-0.0853,-0.0136,-0.1244,-0.2752,-0.0158,-0.0496,-0.1479,-0.077,-0.0864,-0.1446,-0.021,-0.1277,0.008,-0.2001,-0.0714,-0.108,-0.235,-0.0157,0.0174,-0.0422,0.2376,0.0316,-0.043,0.0122,-0.0306,0.0459,-0.0237,-0.1653,-0.1632,0.0552,-0.07,-0.0078,-0.0406,0.0027,0.0565,0.0389,0.0322,-0.1058,-0.0576,-0.0169,0.0133,-0.0636,-0.0252,-0.0004,0.0425,-0.0134,-0.0802,-0.0071,-0.0711,-0.0822,-0.0292,-0.0908,-0.1,0.0382,0.0359,-0.0059,-0.0239,-0.0097,-0.0915,-0.0846,0.0039,-0.158,0.0566,0.0042,-0.0578,-0.1438,-0.0432,0.0393,0.1087,0.0918,0.0688,0.0314,-0.0061,0.2153,0.0013,-0.0396,-0.0601,-0.1338,0.096,-0.0249,0.0834,0.0169,0.1462,-0.0071,-0.1127,-0.0414,0.0885,-0.0568,-0.0002,-0.0704,-0.0044,-0.0865,-0.0407,0.0321,0.0528,-0.0498,-0.0327,-0.0751,0.0286,0.0433,0.003,0.0145,-0.1563,-0.0111,0.0107,-0.0993,0.0431,-0.0528,-0.0614,-0.0117,-0.0487,-0.0841,-0.081,-0.0055,-0.0433,-0.0078,-0.0121,0.0504,-0.0436,-0.0126,-0.0263,-0.0052,-0.0365,0.0342,-0.0656,0.0554,-0.1413,-0.0595,0.0055,0.0924,0.0889,0.0021,0.0384,-0.0943,-0.0259,-0.0425,-0.0529,-0.1485,-0.0076,-0.191,-0.0141,-0.0123,-0.0606,-0.0305,-0.0607,-0.0269,0.0776,0.0207,-0.0309,0.3294,0.0055,0.0704,-0.0044,0.2295,0.0072,-0.0459,0.0769,0.2279,-0.0248,-0.0044,-0.0894,-0.1471,-0.0907,-0.065,0.0423,-0.0536,-0.1159,0.0291,0.0881,-0.0452,-0.0671,-0.013,0.0076,0.0677,0.0949,-0.2905,-0.1596,-0.0753,-0.2767,-0.2341,0.107,0.074,0.0377,0.0366,0.0176,0.0523,-0.1814,-0.0344,-0.0244,-0.0904,-0.228,-0.0114,-0.0011,-0.0479,-0.0868,0.1477,-0.0156,-0.0277,0.0057,0.0219,0.1127,0.1061,-0.0589,0.1074,-0.0418,-0.0084,-0.0955,-0.0297,0.0232,-0.0092,0.0289,0.1227,0.0219,-0.0165,-0.0575,-0.0937,0.0158,0.3335,0.3279,-0.089,-0.0851,-0.0164,-0.0881,-0.0809,-0.0091,-0.1737,0.0565,-0.0448,-0.0323,-0.0519,0.0037,0.0999,-0.0225,0.0436,0.0677,0.0039,0.0391,0.2964,-0.1466,-0.0534,0.2483,0.0035,0.0398,0.0876,0.0891,-0.0492,0.1748,0.1311,-0.0784,-0.0289,0.0592,0.0632,0.1915,0.1148,0.0614,0.0113,0.0161,0.1109,-0.0995,0.0498,0.1899,0.0118,0.0666,0.0043,-0.0204,-0.1289,-0.0052,0.0425,-0.0963,0.0193,-0.0655,0.0629,0.1075,0.0042,0.0379,0.0292,0.0694,0.003,0.1569,0.0445,0.1093,0.0651,0.1713,0.0014,0.0289,0.4369,-0.0823,-0.0072,0.0346,-0.0793,-0.0025,0.0317,0.055,-0.0581,-0.0062,-0.0033,-0.0425,0.0202,-0.0144,-0.0253,-0.0291,-0.0123,0.0424,0.0806,0.0925,0.2365,0.2215,-0.0915,-0.16,-0.0791,-0.0202,0.0517,0.056,0.0699,0.0135,0.0782,-0.0092,0.0533,-0.1328,-0.2149,-0.0713,-0.0174,0.1147,-0.0235,0.052,0.018,0.2143,0.1476,0.0002,-0.0019,-0.0504,-0.0076,0.0309,0.0591,-0.128,-0.1415,-0.198,0.0807,-0.0054,0.0232,0.1389,-0.04,-0.0029,0.0646,0.0519,0.0419,0.0478,0.0086,0.0302,-0.0519,-0.0116,0.0889,0.1397,0.1793,-0.0848,0.077,0.1159,-0.0164,-0.1219,0.0257,-0.1669,-0.0467,-0.012,-0.0672,-0.0044,0.0959,-0.1071,-0.0857,-0.0275,-0.0876,-0.0837,-0.0377,-0.0816,-0.0304,-0.026,-0.0389,-0.1122,-0.0102,0.1457,0.0464,0.105,-0.1451,-0.1016,-0.1162,-0.0297,0.0765,-0.0061,-0.1119,-0.0464,-0.143,-0.0194,0.1492,0.0532,0.1224,0.1038,0.0293,0.0077,-0.0132,0.0359,-0.0543,-0.0613,-0.1834,-0.0635,-0.0926,-0.0658,-0.0647,0.0459,0.0793,0.3281,0.2509,0.1179,0.0907,-0.1388,-0.2674,-0.1377,-0.2047,-0.1261,0.0363,-0.0433,0.0479,-0.062,-0.1297,-0.162,-0.0875,0.0541,0.0478,-0.0494,-0.0629,0.0123,-0.0305,-0.1869,-0.1109,-0.039,0.0524,-0.0308,-0.0404,-0.1134,-0.0514,-0.0849,-0.0882,-0.1707,0.0392,0.0309,-0.0861,-0.0722,-0.082,-0.0608,-0.0477,-0.1201,-0.0721,0.0002,0.1729,0.1534,0.0771,0.1072,0.0849,0.0025,0.0529,0.036,0.1199,-0.0979,-0.0368,0.022,0.1112,-0.0991,-0.0939,-0.0583,-0.0919,-0.0577,-0.0959,-0.0533,-0.0691,-0.0451,-0.0487,0.0297,0.0298,-0.2062,0.0106,-0.0352,-0.0979,-0.1116,-0.1183,-0.0176,-0.1214,0.0057,-0.0138,0.2018,-0.0266,-0.0169,-0.1254,-0.0975,-0.0731,-0.0966,-0.1137,-0.0783,0.0475,0.0271,0.0246,-0.0007,-0.0674,0.027,0.073,0.1677,0.1,-0.1295,-0.1467,-0.1034,0.0244,-0.0048,-0.1,0.0573,-0.0584,0.0455,-0.061,-0.0707,-0.1011,-0.0319,-0.101,-0.0827,-0.0031,-0.0438,-0.035,-0.0478,0.0138,0.0618,0.0412,-0.1275,-0.1106,-0.0928,-0.1409,-0.0843,-0.2004,-0.0961,0.2604,-0.0681,-0.1035,-0.0923,-0.0516,-0.13,-0.0692,-0.0819,-0.0832,0.092,-0.0906,-0.0082,-0.0518,-0.1591,-0.0839,-0.1154,-0.0178,0.1354,-0.1044,-0.0549,0.026,0.2544,-0.0222,0.0164,0.0542,-0.0112,0.0122,-0.0606,0.0483,0.0201,0.0203,-0.1819,-0.1617,-0.1764,-0.0814,-0.0851,0.0911,0.1376,0.177,0.0607,0.0495,0.1203,0.1726,0.0802,0.0965,0.0228,0.0352,0.0532,-0.1845,-0.0947,-0.1062,-0.085,-0.0068,-0.1018,-0.0953,-0.0651,0.0455,-0.0463,-0.2189,-0.1628,-0.0,-0.0581,-0.1503,0.0008,-0.081,-0.043,0.0657,-0.1101,-0.018,-0.1389,-0.061,0.0337,-0.1034,-0.0298,0.0313,-0.1409,0.0338,0.0414,0.0659,-0.0336,-0.0725,0.0736,0.031,-0.0428,0.043,-0.0205,-0.0355,0.0961,0.0516,0.0119,-0.2071,-0.0827,-0.0129,-0.0026,-0.0542,-0.0704,-0.1076,-0.0556,-0.058,-0.0585,0.0891,-0.0985,-0.0463,0.027,0.0278,-0.0271,0.0846,0.0476,-0.2439,-0.076,-0.1394,-0.122,0.1386,0.192,0.1974,-0.0763,0.4313,0.2683,-0.1829,-0.0941,0.4231,0.089,0.0506,0.1103,0.1582,0.0614,-0.0867,-0.0824,-0.0641,-0.1066,0.5052,0.3992,0.3125,0.0931,0.1982,0.2375,0.4323,0.4188,0.3551,0.0195,-0.0152,-0.0626,-0.0353,-0.0871,0.0119,-0.105,-0.0749,-0.0111,0.0344,-0.0536,-0.0403,0.1367,-0.0014,-0.0069,-0.102,0.1138,0.1212,0.1641,-0.0861,-0.0756,-0.1694,0.0008,0.0145,-0.0274,-0.0552,-0.0784,0.0192,-0.0617,-0.1025,-0.1695,-0.157,-0.0465,-0.0828,0.0296,0.2188,0.0658,0.1447,0.0681,0.1004,0.2306,-0.0285,-0.1248,-0.122,-0.1024,0.1021,-0.013,0.1568,0.0591,0.0778,-0.0533,-0.165,-0.1703,-0.1261,-0.112,-0.0476,-0.2891,-0.2098,0.0366,0.0057,0.1718,-0.0901,0.029,0.0809,0.0091,0.0351,0.0767,-0.0264,-0.1113,-0.1572,0.014,-0.0012,-0.0701,-0.0513,-0.1018,0.0553,0.1997,0.1786,0.0771,0.1626,-0.0279,0.0092,0.0556,0.0999,0.0971,0.2046,0.0932,0.0492,-0.013,0.1022,0.1614,-0.0275,-0.0297,-0.0945,-0.0756,-0.0281,0.0166,0.0072,-0.0119,-0.0593,0.0365,0.0216,0.0432,0.0849,-0.0545,0.1368,0.1232,-0.0415,-0.1337,-0.1188,-0.1212,-0.1296,0.0794,-0.0456,-0.0463,-0.0572,0.1164,0.0008,-0.1325,-0.0425,-0.001,-0.0046,-0.012,-0.0048,0.0449,0.1238,0.1106,0.3512,0.0997,0.0868,-0.0214,-0.0446,0.0442,-0.0986,-0.151,-0.0749,0.0263,-0.0736,-0.049,-0.0656,-0.0813,-0.0151,-0.0879,-0.1309,-0.1024,-0.0521,-0.0438,-0.1351,0.0065,-0.0966,-0.0522,-0.0399,-0.0453,-0.1002,-0.1191,0.0987,0.0795,-0.0192,-0.1142,0.1396,0.0975,-0.1584,0.1117,-0.1689,-0.099,0.0711,-0.1485,-0.1501,-0.0164,0.0448,0.0185,0.029,-0.0951,-0.0479,-0.0052,-0.0148,0.0424,-0.1239,0.0319,0.0096,0.0879,0.0455,-0.1409,-0.061,-0.0118,-0.0638,-0.05,-0.0277,-0.0556,-0.0046,0.0123,-0.0077,0.019,-0.2056,-0.1073,-0.1053,-0.1498,-0.1405,-0.1078,-0.1005,-0.1005,-0.0148,-0.0485,0.0193,-0.1816,-0.0259,-0.1141,-0.0964,0.037,0.0176,-0.1763,0.1163,-0.1838,0.0624,0.0259,0.1814,-0.0057,-0.0081,-0.0935,-0.0584,0.0259,0.1103,-0.0178,0.1254,-0.0142,-0.0384,0.0661,0.0889,-0.0062,0.0329,-0.0968,-0.1041,-0.0383,-0.0293,-0.04,-0.0619,-0.0972,-0.0382,-0.0238,-0.0457,0.0289,-0.0514,-0.023,0.0015,0.126,-0.0106,0.1201,0.0473,-0.0569,0.0207,-0.088,-0.0191,-0.0567,0.0268,-0.0539,-0.0321,-0.0337,-0.0661,0.0687,0.1034,-0.0222,0.0979,0.0279,0.2916,0.125,0.0367,0.0377,-0.1654,0.0333,0.0892,0.0807,-0.0604,0.0177,0.0415,-0.0092,0.034,-0.1618,-0.1574,-0.1318,-0.1609,-0.0642,-0.046,-0.1687,0.2651,-0.0258,0.0952,0.1184,-0.0123,0.0001,0.0379,-0.0528,-0.1055,-0.022,0.0711,0.086,0.012,0.0375,-0.0877,-0.033,0.1191,0.1193,0.124,0.0776,0.0106,-0.0954,-0.0013,-0.0747,-0.0196,-0.0598,-0.0438,-0.0455,-0.0699,-0.0805,-0.1106,-0.0298,0.0162,-0.0841,0.0469,-0.0321,0.0611,0.033,0.0658,0.0887,0.0214,-0.0513,-0.0262,-0.0991,-0.0705,-0.0007,0.0454,-0.0248,-0.0095,-0.0144,0.0362,-0.0567,-0.0836,-0.0645,-0.1452,-0.0963,0.011,-0.0309,0.0268,-0.0872,-0.0771,-0.094,-0.0771,-0.0823,-0.0185,0.0556,-0.1817,0.113,-0.0528,-0.0824,-0.0728,0.0379,-0.1187,0.0035,0.0655,-0.0064,-0.1672,0.0805,0.0236,-0.0429,0.0378,0.0527,-0.0061,0.0776,-0.1147,-0.0937,-0.1125,-0.1314,-0.1799,-0.0792,-0.09,0.0004,-0.0063,0.0747,0.068,0.083,-0.1247,-0.1042,0.0762,0.177,0.2459,0.0896,-0.0293,0.0575,-0.0151,-0.0796,0.0846,-0.0783,-0.0737,-0.0679,-0.0279,-0.0899,-0.1404,0.2442,0.0767,0.0767,0.1924,0.0645,0.065,-0.0034,-0.0171,-0.0513,-0.0481,-0.0804,0.0065,0.0481,0.0498,-0.0118,-0.0547,-0.0418,-0.0781,-0.0112,0.0134,-0.0894,-0.036,-0.0256,0.0003,0.0252,0.0055,0.0288,0.0807,-0.0197,0.0669,-0.1722,-0.0829,-0.1225,-0.101,-0.0521,-0.1295,-0.1094,-0.2127,-0.1167,-0.1201,0.0156,-0.1007,-0.0192,-0.0644,0.0528,0.1062,0.1293,-0.0964,-0.1035,-0.043,0.0086,0.0948,0.1313,-0.0809,-0.0313,-0.0563,0.0636,0.0546,0.0454,0.131,0.0094,-0.037,0.062,-0.0325,0.0551,0.0871,0.0578,-0.0645,-0.0568,0.013,0.1151,0.0008,0.1283,0.1378,-0.0516,0.0246,0.001,-0.1358,-0.1128,-0.0084,0.1238,0.2315,0.0646,0.0226,0.0566,0.0055,0.1971,0.1703,0.115,0.1221,-0.0938,-0.0081,-0.0687,0.0596,-0.0589,0.0049,-0.0807,-0.0493,0.0197,0.0366,0.0819,-0.05,0.1094,0.0211,-0.1096,0.1409,0.0964,0.0255,0.0439,0.041,0.0979,0.0089,-0.0312,-0.0169,-0.0479,0.0102,0.1778,0.1742,-0.0551,-0.0038,0.0678,-0.0673,-0.1125,-0.2343,-0.2127,0.0347,0.0573,-0.0033,-0.0333,0.0243,0.1185,0.0057,0.0296,-0.0247,0.0603,-0.0766,-0.0205,0.014,0.0244,-0.0074,-0.1217,-0.0343,-0.1194,-0.0741,-0.0704,-0.0477,0.0112,-0.1398,-0.05,0.0042,-0.0996,0.0179,0.0642,0.0279,-0.1112,-0.0745,0.215,-0.0474,0.0925,0.111,0.0959,0.0098,0.0685,-0.1545,0.1052,0.0805,-0.0952,-0.0272,-0.0102,0.0239,-0.0376,-0.1231,-0.1713,-0.1342,-0.0625,0.0055,0.0155,0.0376,-0.0144,-0.0867,-0.1252,-0.1737,0.1594,0.1543,-0.0993,-0.0695,-0.1009,-0.0956,-0.1679,0.1846,0.1061,-0.102,0.0236,0.1094,0.0667,-0.2241,-0.2325,-0.1297,-0.1634,-0.0588,-0.0956,0.0039,0.0318,0.0224,0.1143,-0.0516,0.1046,0.3625,0.1942,0.1301,0.3066,-0.1864,-0.0832,-0.1095,0.0827,0.0232,0.0126,-0.0389,0.0121,0.0571,-0.1946,-0.1774,-0.0042,0.2103,-0.0977,-0.1228,-0.0996,-0.0395,0.0646,0.1381,-0.0612,-0.0552,-0.029,-0.0644,0.0198,0.0993,0.0968,0.0464,0.0334,-0.0563,0.0003,-0.0541,-0.0004,-0.0043,-0.0853,-0.014,-0.0605,-0.0059,-0.0037,0.0104,0.1437,0.0539,-0.0003,0.0127,-0.0512,-0.0072,-0.1643,-0.1493,-0.0666,-0.1134,0.3851,0.0402,0.2406,0.1071,0.0573,-0.0512,-0.0442,0.1191,-0.0794,0.2032,0.1346,0.0446,0.0492,0.0332,0.0218,-0.0772,-0.064,-0.1466,-0.0751,0.2128,0.0822,-0.1291,-0.003,-0.0153,-0.0185,-0.0128,-0.0023,-0.0467,-0.0929,-0.0428,-0.2064,0.0167,-0.0304,0.1178,0.0986,0.0311,0.0297,-0.0005,-0.013,-0.0911,-0.0306,0.0431,0.1189,-0.0146,0.0254,-0.0914,0.0244,-0.0203,-0.0422,-0.0519,0.1528,0.0427,-0.0636,-0.2078,-0.1025,-0.1074,-0.1104,-0.0073,-0.0657,-0.0482,-0.0313,-0.0408,-0.0789,-0.0944,-0.0684,-0.0544,-0.0804,-0.026,-0.0096,-0.0914,0.0988,-0.221,-0.2027,-0.2052,-0.0485,-0.0634,-0.1706,-0.066,0.0475,0.1362,0.0383,-0.1,0.247,0.2189,0.1414,-0.0352,0.0603,-0.0348,-0.1127,-0.0196,-0.0401,0.0858,0.1562,0.1905,0.0085,0.0617,0.0604,0.0643,-0.1343,-0.047,-0.0122,-0.0405,-0.1729,-0.1388,-0.1012,-0.1361,-0.0193,-0.1331,-0.1551,0.1031,-0.0526,-0.1416,0.0515,0.0949,0.0977,-0.056,-0.0844,-0.262,-0.196,-0.0897,-0.1929,0.1068,-0.076,-0.0265,0.0646,-0.1128,-0.0689,-0.2018,-0.0474,0.1612,0.1049,0.1889,0.1133,0.1171,-0.0719,-0.0446,0.0501,0.0765,0.1057,0.0052,0.0126,0.2027,0.1028,-0.1341,-0.2031,-0.0901,-0.1205,-0.1366,0.0403,-0.1188,0.0545,0.052,0.0436,0.0574,0.0168,-0.1653,-0.0065,-0.1336,-0.0377,-0.1418,-0.2222,-0.0266,-0.021,-0.0219,-0.0249,-0.0601,-0.2112,-0.1008,-0.1524,-0.0825,-0.0899,-0.09,0.0035,0.0293,-0.0097,-0.0696,0.0502,0.0267,0.0108,-0.0694,-0.0626,-0.1145,-0.0533,0.1023,0.0291,-0.099,0.1559,0.0039,0.0027,0.0678,0.0129,0.0303,0.0495,0.0309,0.0246,-0.0127,-0.0184,0.1532,0.2314,0.2838,-0.0445,-0.0104,0.0113,-0.0052,-0.0295,0.1005,-0.1025,0.2012,-0.1233,-0.0808,-0.0919,0.0801,0.0037,-0.0388,0.0235,0.0283,-0.0736,-0.0597,0.0886,0.0697,-0.0272,-0.075,0.0318,0.115,0.116,-0.1763,-0.1284,-0.1423,-0.0037,-0.1653,-0.0901,0.0189,0.0193,0.008,-0.0304,-0.135,-0.1381,-0.0476,0.0218,-0.0893,-0.0863,0.1912,0.0465,-0.0313,0.0982,0.2412,0.0629,0.0412,0.1531,-0.1048,0.0465,0.1749,0.1153,-0.0447,0.1793,0.0582,0.0503,0.0723,0.2065,0.0538,-0.1357,-0.0733,-0.0875,-0.0247,0.1267,-0.0367,0.0595,-0.0901,-0.0801,-0.0585,-0.074,-0.0021,0.1267,-0.0402,-0.1265,-0.0365,-0.1501,-0.0361,-0.0213,-0.0647,-0.0463,-0.0363,-0.0739,-0.0465,-0.1816,-0.1194,0.1314,0.234,-0.0189,-0.0694,0.0873,0.0446,-0.0608,-0.0961,-0.1371,-0.2187,0.0989,0.0725,-0.0839,-0.1011,-0.0815,-0.0103,-0.0648,-0.0537,-0.0597,-0.0687,-0.0291,-0.0729,-0.0759,-0.0433,-0.1341,-0.0589,-0.0301,-0.0056,0.1068,-0.0981,-0.0371,0.1242,-0.0491,-0.1186,-0.0676,-0.0771,-0.1074,-0.0808,-0.1263,-0.1359,0.0873,0.0803,0.1228,-0.0473,-0.1086,-0.0185,0.0029,0.0106,0.0685,-0.198,-0.0922,-0.1598,0.0524,0.0314,0.0804,-0.0934,-0.1697,-0.1281,-0.0459,-0.0411,-0.0073,0.0462,0.1095,-0.0071,-0.0734,-0.0661,-0.0766,-0.0908,-0.2212,-0.1105,-0.0666,0.0542,0.0058,0.082,-0.0128,0.089,0.0209,-0.0119,-0.018,0.0772,0.1667,0.0613,-0.0025,-0.0018,-0.1025,-0.0042,-0.0246,-0.0107,-0.0336,-0.0287,0.0135,0.0047,-0.0963,-0.0376,-0.0644,-0.0158,-0.0807,-0.0217,-0.0218,0.1512,-0.0767,0.0695,0.0239,0.0398,0.012,0.0138,0.0087,-0.0473,-0.1676,-0.0211,0.1343,0.0808,-0.0693,-0.0397,-0.0885,-0.0678,-0.0597,-0.0335,-0.0817,0.0346,0.0497,-0.1142,-0.1531,-0.0237,-0.0992,-0.0796,-0.0429,0.3973,0.2168,-0.1125,0.0534,-0.03,-0.0293,-0.0836,-0.0614,-0.1487,-0.1729,0.0381,0.0185,-0.0915,-0.0058,-0.0735,-0.0363,0.1344,0.009,-0.0084,0.0218,-0.0266,0.0349,-0.1244,-0.0064,0.1432,-0.0804,0.0938,-0.0788,0.0447,-0.1214,0.3758,0.0556,0.0778,-0.1022,-0.0807,0.0178,0.0662,-0.0335,0.0394,0.0058,-0.0577,0.0286,0.0938,-0.0239,0.0535,0.07,0.1128,0.153,0.1663,0.213,-0.069,0.1166,0.3286,0.5038,0.2137,0.1578,0.3676,0.2304,0.2271,0.2448,0.1342,0.2162,0.1638,0.215,0.276,0.1306,0.2242,0.3087,0.258,0.2599,0.2382,0.0908,0.2012,-0.1764,-0.1022,-0.0707,-0.2155,-0.0838,-0.2175,-0.178,-0.0985,-0.0764,-0.1116,-0.2203,-0.1891,-0.1459,-0.0514,0.0327,-0.1096,0.1258,0.0028,-0.0938,0.0138,-0.0803,-0.0884,-0.0842,-0.0398,-0.1487,0.0796,-0.1969,-0.2103,0.0487,-0.0128,-0.091,0.0325,0.0263,-0.1205,0.0617,0.1015,-0.1195,0.1963,0.2991,0.0963,0.1154,0.1373,-0.0684,0.1644,0.1668,0.0163,-0.0021,0.1206,0.003,0.0362,-0.1077,-0.0316,0.1402,-0.0247,-0.0759,0.014,0.0594,0.0201,-0.0937,emotional face recognition
trm_557b4b7e68727,-0.0134,0.0284,0.0505,0.0165,-0.0208,0.0249,0.0301,-0.0807,-0.0597,-0.0142,-0.0194,0.0143,0.0489,0.0767,0.0705,-0.0126,0.0608,0.1257,-0.0051,0.1073,0.0424,-0.0131,0.0687,0.0086,0.0357,-0.0051,-0.003,0.1157,0.1127,0.0178,0.1076,0.1251,0.1164,0.0144,0.1859,0.1533,-0.0003,0.0153,0.0605,0.002,0.0819,0.0491,0.0262,-0.0357,0.0563,0.1262,-0.0587,-0.0255,-0.1056,0.04,0.0199,-0.1375,-0.0598,-0.1748,0.0562,0.0509,0.0762,0.0495,-0.0437,0.0243,0.0304,-0.0181,0.1574,-0.1002,-0.0535,-0.1651,0.1851,0.2325,0.0752,0.0499,-0.1058,-0.0188,-0.0974,0.1288,-0.0267,0.0275,0.0684,-0.0338,-0.0569,0.0857,0.0539,-0.1089,0.0693,0.1139,-0.1059,-0.0682,-0.0509,0.0069,0.0274,0.1899,0.0955,-0.0268,0.0339,-0.2951,-0.1873,-0.1806,-0.1447,-0.0793,-0.3289,-0.2017,-0.0473,-0.0174,-0.1592,-0.1979,-0.1601,0.1033,0.226,-0.1339,-0.0015,-0.0293,-0.0262,0.0843,-0.1175,-0.2092,-0.0215,0.011,0.0593,-0.107,-0.009,0.0166,0.148,0.1537,0.1697,0.03,0.0723,0.2032,0.0784,-0.0844,-0.0952,0.0117,0.1779,0.0481,0.0504,0.3075,0.0237,0.1876,-0.0561,0.1352,0.0753,0.0224,0.0495,0.0359,0.0375,0.0674,0.0123,-0.1126,-0.0726,-0.0572,0.0818,-0.034,0.034,0.1466,0.1821,0.1325,-0.1301,-0.0185,-0.0818,-0.047,0.0139,0.0712,0.0204,0.11,0.2017,0.1679,0.0392,0.0152,0.0516,0.2584,0.2449,0.0414,0.0941,0.1563,-0.0667,0.3528,0.1673,0.2838,0.2047,0.1724,0.1362,0.0167,0.1864,-0.0086,0.0885,-0.0991,0.0656,0.0654,0.146,0.243,0.1633,0.0787,0.0671,0.068,0.0523,0.1316,0.122,0.0935,0.0496,0.1537,0.0548,-0.0953,-0.0996,-0.3177,0.2495,0.1716,-0.147,0.1528,0.3739,-0.0212,-0.0321,-0.0426,0.2061,0.1077,0.0232,0.0247,0.001,0.035,-0.0056,0.0715,-0.0167,0.0039,-0.0889,0.1396,0.207,0.0734,-0.1229,0.0055,0.0408,-0.0582,0.0954,-0.2635,0.0127,0.2283,-0.1376,0.0899,0.0808,-0.1553,0.0995,-0.0516,-0.0268,0.1308,-0.0867,0.1661,0.0097,-0.0096,0.0207,0.1157,0.1334,0.1133,0.0195,0.1703,-0.0183,-0.0237,0.0753,-0.0571,-0.0404,0.2147,-0.0557,0.0013,-0.0979,-0.1113,-0.0505,-0.2989,0.0621,-0.1281,-0.2163,-0.3968,-0.2078,0.0042,0.0533,0.091,-0.0141,-0.011,0.2032,0.0742,0.0732,0.0899,0.1009,0.2117,0.0728,0.0104,0.0165,0.1851,0.1488,0.395,0.3182,0.0861,-0.0181,0.0034,0.0519,0.145,0.0889,0.0872,0.0584,0.0927,0.0741,-0.0366,0.0892,-0.1743,-0.015,-0.2429,-0.0935,0.1822,0.0926,0.174,-0.1846,-0.2167,0.0891,0.0567,0.0079,0.0045,-0.0427,0.0198,0.0017,-0.1206,-0.1039,-0.0442,-0.2184,-0.025,-0.0723,0.1001,-0.0009,0.0028,0.1946,0.2353,0.083,0.0239,0.0181,0.0753,0.0483,0.1058,-0.0686,0.0539,0.0376,0.0328,-0.0178,-0.227,-0.0555,0.0146,0.1584,0.127,0.0979,0.0616,-0.1157,-0.0769,-0.0721,-0.0899,0.1597,0.1158,0.0858,0.09,0.1039,-0.0841,-0.0099,-0.0229,0.0587,0.0182,-0.0069,0.1673,0.0212,0.0845,-0.0072,0.012,-0.0752,-0.0462,-0.0676,-0.1134,0.0895,-0.3905,0.0199,0.0853,0.0117,-0.1301,0.0201,-0.1381,0.1236,0.0082,0.0988,-0.0773,0.0544,-0.0853,0.0078,-0.1884,-0.0664,-0.184,-0.038,-0.1108,0.132,0.0107,-0.0849,0.013,-0.0524,0.0352,-0.0505,0.0767,-0.2852,-0.2739,-0.0734,0.1288,0.0326,0.05,0.05,-0.025,-0.0041,0.0255,-0.0547,-0.1101,-0.0206,-0.0505,0.1179,0.018,-0.034,0.1883,0.0612,-0.1526,0.237,0.0908,-0.2029,-0.0716,0.0252,-0.0356,-0.0406,0.1218,0.0437,0.1997,0.1855,-0.012,0.1213,-0.0421,0.0729,-0.0435,0.0975,-0.0149,0.0556,-0.0142,0.0884,-0.0659,-0.0397,-0.0189,0.2105,0.0822,0.0283,-0.0645,-0.0079,-0.0237,0.0918,0.0753,-0.0124,-0.1764,0.1782,-0.0866,-0.2285,-0.129,0.0898,0.003,-0.1288,0.2005,0.0479,-0.0139,-0.0161,-0.0352,-0.1032,-0.0278,0.1376,0.0622,0.1467,0.0913,-0.0634,-0.3343,0.1024,0.042,-0.0486,-0.0119,-0.21,0.0959,0.1952,0.0087,-0.0583,-0.0806,0.0506,-0.0075,-0.1442,-0.0961,-0.1034,-0.123,-0.1237,-0.1341,0.0027,-0.0249,0.1049,-0.0008,0.0346,-0.1767,0.1375,0.2046,-0.0685,0.0558,0.2715,-0.0065,-0.0031,0.0501,0.0374,-0.0068,0.0556,0.0911,0.0051,0.1593,0.0598,0.123,0.0437,-0.1539,0.1292,-0.0954,0.1036,-0.0058,-0.0746,-0.1312,0.068,0.0325,-0.1999,0.073,0.0176,0.0589,-0.0312,-0.2681,-0.1968,-0.0175,-0.1629,-0.1437,-0.0373,-0.081,0.0827,0.0178,0.0588,0.2453,0.1873,-0.0155,0.1987,0.0635,0.0526,0.1775,0.0548,-0.001,-0.0378,0.0435,0.0851,0.0587,-0.0237,-0.0021,0.0446,0.0997,-0.1114,0.051,0.0228,-0.1059,0.0057,0.2023,-0.117,-0.0749,0.0125,0.0155,0.1335,0.0214,0.1963,-0.0491,0.141,0.0475,-0.0348,0.2651,0.0302,0.1225,0.114,0.0917,0.0757,0.0073,-0.1593,-0.1278,-0.0273,-0.0852,-0.0899,-0.0906,-0.0153,0.075,0.0354,0.0054,-0.2432,-0.0611,-0.3379,-0.0729,-0.1355,0.0358,0.1426,-0.132,-0.2261,-0.1739,-0.0951,-0.093,0.1672,0.0744,-0.1872,0.0941,0.0405,-0.0256,-0.0597,0.0195,-0.0895,-0.1879,0.1138,0.1014,0.0853,-0.1795,0.1401,0.0225,-0.0679,0.0288,0.2077,0.0752,0.0574,-0.0058,0.0353,0.2348,-0.0061,0.1746,-0.0547,0.0021,0.1173,-0.0578,-0.029,0.1577,-0.0723,-0.088,-0.1167,-0.2164,0.0925,-0.0775,-0.2152,-0.1407,-0.1297,-0.0354,0.096,-0.067,0.0117,-0.1221,-0.0404,-0.0731,0.0882,0.0429,0.328,0.21,-0.2211,0.2926,-0.1263,0.2339,-0.2513,0.2229,0.0638,0.0657,-0.2131,-0.0364,0.0469,0.0618,0.2666,-0.1421,-0.1613,-0.0856,-0.1128,-0.1387,-0.0746,0.2139,-0.1104,-0.1338,0.0378,0.1061,0.0741,0.044,0.0184,0.04,-0.1855,0.1352,0.0235,0.0408,-0.0685,-0.0812,-0.0463,-0.0341,-0.0904,0.1409,0.0468,-0.0066,-0.0709,-0.0384,-0.2034,-0.2689,-0.2594,-0.0755,-0.0445,0.1215,-0.0181,0.072,0.03,-0.0957,-0.0955,-0.0423,0.0164,0.174,0.1115,0.0085,0.1665,0.1446,0.142,-0.0648,-0.0577,-0.0228,-0.017,0.0201,0.0127,0.05,-0.0339,0.0801,0.1954,-0.0269,-0.0503,0.0659,0.3815,0.356,0.3119,-0.0199,-0.0096,0.0772,-0.0272,-0.0201,0.0755,0.0809,-0.0037,-0.1665,-0.1584,0.0111,0.0127,-0.092,-0.1861,-0.335,0.2525,0.0722,0.007,0.0131,0.0502,0.1468,-0.0827,-0.0004,0.0651,0.0244,0.0263,-0.0028,0.1718,0.295,0.2527,0.1881,-0.0176,-0.0933,0.0257,0.1097,0.1286,-0.1057,-0.1119,0.0283,-0.1085,-0.0364,0.1632,0.0738,-0.0164,-0.1385,-0.1015,-0.0877,0.0472,-0.0214,-0.0473,0.0627,-0.0718,0.1165,0.1537,0.0348,0.1945,0.1547,0.1108,-0.1175,-0.0868,-0.0371,0.0241,0.0111,-0.0647,-0.1308,-0.0459,0.0913,0.0237,0.034,-0.0318,-0.0642,-0.1293,0.133,-0.2004,0.1369,0.1411,-0.1612,-0.0495,-0.0777,0.0397,0.074,-0.0553,-0.0499,-0.0297,-0.1765,-0.036,-0.1358,-0.0694,-0.098,-0.0351,-0.0248,-0.1698,-0.132,0.07,-0.0015,-0.0113,0.1626,0.2009,-0.0656,0.1447,0.1311,0.2207,0.0531,0.1956,0.1272,0.2634,0.034,0.0144,0.0573,0.0493,-0.0399,-0.0727,-0.167,-0.1444,0.0162,-0.066,-0.1508,0.0144,-0.0913,-0.0997,-0.0455,-0.1565,-0.147,0.1515,-0.1878,-0.081,0.0541,0.0773,0.1255,0.0534,-0.1478,-0.2306,0.3643,0.2347,0.0277,-0.0251,-0.13,-0.0594,-0.0389,-0.0624,-0.1168,-0.0811,0.0241,-0.2521,-0.021,-0.0112,0.2406,-0.232,0.0373,-0.14,-0.3521,-0.0575,-0.3495,0.3097,0.3146,0.0501,-0.1839,0.016,0.0405,0.1002,-0.0773,0.0031,0.0769,0.0444,0.1316,-0.096,0.0166,0.0686,-0.1171,0.06,-0.0363,0.1412,0.1134,0.0225,-0.049,0.099,-0.0756,0.0355,-0.1052,-0.1342,-0.0809,-0.1135,0.1251,0.0332,0.1281,0.025,0.1503,0.0498,-0.0518,-0.1769,-0.0833,0.0334,0.0791,-0.136,-0.2119,-0.1657,-0.0359,-0.0186,0.0722,-0.0001,0.0654,0.0657,-0.0328,-0.0168,0.1425,0.0063,0.0109,-0.0007,0.024,0.048,0.0024,0.1655,0.0772,0.0673,0.109,0.1011,0.4022,0.1969,0.4331,0.1084,0.1319,0.1846,0.1942,0.2425,0.2563,0.2921,0.3768,0.1484,0.1542,-0.0115,-0.0382,-0.1327,0.0467,-0.0614,-0.0426,0.0459,-0.08,-0.0097,-0.0404,-0.0209,0.0481,-0.0478,-0.1043,0.0492,0.0016,-0.0825,-0.0914,-0.0077,-0.0436,0.1429,-0.0233,0.111,0.0097,-0.0565,-0.0436,0.0211,-0.0456,0.1903,0.0822,0.0798,0.2178,0.174,-0.1009,-0.1206,-0.133,-0.0696,-0.0467,-0.0009,-0.2071,-0.1489,-0.0078,-0.0368,-0.0971,0.0054,0.0168,0.0589,0.0616,0.0824,-0.0699,-0.0374,0.0904,0.0593,0.1353,0.2333,0.1531,-0.1946,-0.1119,-0.2577,-0.0283,0.0069,0.1438,0.0923,-0.0456,-0.009,0.0831,0.0045,0.021,0.0443,0.0225,0.0149,-0.1171,0.1084,0.0328,0.1032,-0.0295,0.0674,-0.112,-0.1704,-0.3901,-0.2851,-0.1366,-0.0861,-0.1862,0.0193,0.0247,0.028,0.0666,-0.0262,-0.0369,-0.0802,-0.0583,-0.0267,-0.139,-0.0113,0.0854,-0.0857,0.2123,0.1608,0.2544,0.1141,-0.2029,-0.0109,-0.0219,0.2189,-0.1612,-0.0561,0.0219,0.0793,0.0211,0.0595,0.0376,-0.0728,0.0987,0.1131,0.0943,-0.0199,0.1633,0.1064,0.1371,0.1267,0.2163,0.0655,0.1312,0.0678,0.0349,-0.0296,0.0658,0.0013,-0.071,0.0771,-0.1142,0.1502,-0.0032,0.0635,0.151,-0.1627,-0.1204,-0.3123,-0.2928,-0.2981,-0.059,-0.2633,-0.0703,0.1297,0.0785,0.0207,0.0667,0.03,0.1484,0.2153,0.1078,0.1832,0.0823,0.0302,0.0296,-0.0894,-0.0166,0.1498,-0.0103,0.0,0.0289,-0.1016,-0.0126,0.1161,-0.0002,0.0665,0.098,-0.02,0.0311,-0.1079,-0.0219,-0.1859,0.0048,0.2145,0.2318,0.2057,0.1208,-0.045,0.0002,-0.0892,0.0887,0.3017,0.2003,0.0461,0.002,-0.0248,-0.231,-0.2132,0.1093,0.0437,-0.0487,-0.2713,-0.3046,-0.2531,-0.1158,-0.0284,-0.1068,-0.1493,-0.1138,0.077,0.2046,-0.1055,0.0994,-0.1591,0.0086,0.0949,-0.0456,0.1327,0.0864,-0.0442,0.0804,0.0096,-0.1593,-0.0339,0.1007,-0.005,0.023,-0.1203,-0.0286,-0.0874,0.1394,0.1279,0.1472,0.0539,0.0342,0.1368,0.0977,0.0251,0.0269,-0.297,-0.1678,-0.1878,-0.3462,-0.035,-0.0718,0.0119,-0.1461,-0.1312,-0.3273,0.1041,-0.328,-0.4483,-0.155,0.2018,-0.3764,-0.3164,0.0388,0.209,-0.0147,0.1463,0.0912,0.2483,0.0672,-0.2294,0.0219,0.0741,-0.087,0.0402,0.0483,0.0241,0.109,0.0408,0.1103,-0.149,-0.0575,0.0285,-0.0108,0.0147,-0.0634,0.0066,0.144,-0.0238,0.0323,0.0881,0.0088,0.1049,-0.2158,-0.035,0.2025,0.0871,-0.0855,-0.003,-0.0319,-0.0809,-0.0295,-0.0652,0.0086,-0.1987,0.0404,0.0633,-0.0127,-0.076,-0.1202,0.0382,-0.083,-0.083,0.1712,-0.0882,-0.0543,-0.075,-0.0119,-0.0146,0.0522,-0.2558,0.2468,0.2437,-0.0523,0.0842,0.1723,0.1892,0.1321,-0.0241,0.0488,0.1116,0.0236,-0.012,-0.2451,0.1069,0.0367,0.0554,-0.054,-0.0461,-0.064,-0.0858,0.0011,0.1009,-0.0393,0.1221,0.0893,0.11,0.0682,-0.0311,0.0739,-0.2575,-0.1507,-0.2671,-0.0563,-0.2206,0.2592,0.1698,-0.0455,0.1491,0.0595,0.1761,0.1013,-0.0059,0.0956,0.1684,-0.0842,-0.0117,0.1914,-0.0145,-0.0632,-0.0601,0.2063,0.0865,0.0631,-0.0061,0.0916,-0.1454,0.0756,-0.0857,-0.1797,-0.2521,-0.208,0.054,-0.0432,0.0934,0.1967,0.1963,-0.0247,0.1229,0.0571,0.1275,0.0777,0.0193,-0.07,0.0526,0.2016,0.1265,-0.0503,-0.0024,-0.041,-0.0141,0.1391,-0.0282,0.1234,0.1341,0.1908,0.2918,0.0972,0.0767,0.1514,0.1429,0.0086,0.0139,0.0731,-0.0932,-0.0783,0.0895,0.0687,-0.0982,0.182,0.0128,-0.0201,-0.0555,0.0216,0.2142,0.023,-0.1427,0.1207,0.0248,0.0345,0.0642,-0.0341,-0.0711,-0.0661,-0.0463,0.2267,-0.0447,-0.0029,0.0078,-0.254,0.0213,-0.0446,0.0073,-0.0715,-0.1942,0.0846,0.0235,0.1471,0.03,0.1253,0.1676,0.0401,-0.1751,-0.0359,0.1162,0.1644,0.027,0.0986,-0.0061,0.1553,0.1139,-0.0039,-0.0325,0.0239,-0.1006,0.0646,-0.0043,0.055,0.0506,0.0341,0.0234,0.1042,0.0094,-0.018,0.056,-0.1273,0.0461,0.0087,0.0254,-0.1103,-0.044,0.1031,0.2374,-0.064,-0.0652,-0.1493,0.0035,0.0158,-0.0332,-0.0988,-0.0729,0.0708,0.0906,0.1401,-0.0078,0.2797,-0.0244,0.0743,0.0021,0.1174,0.0386,0.0835,0.2083,0.1911,-0.2616,-0.0983,-0.0601,-0.0681,-0.3491,-0.0337,-0.1321,-0.0129,0.0216,0.0482,0.0639,-0.1166,-0.1311,-0.0958,-0.1472,-0.0706,-0.0513,0.1248,0.0035,-0.1288,-0.148,-0.0938,-0.0703,0.0753,0.08,0.0746,-0.1231,-0.1354,-0.0362,0.0679,-0.0454,-0.0659,0.0312,-0.0253,0.0246,-0.1023,0.0118,-0.0019,0.0722,0.0426,0.1125,0.0322,-0.0274,0.0105,0.11,0.1536,0.0473,0.184,0.0043,-0.0725,0.0777,0.0706,0.121,0.006,-0.0848,-0.3825,0.0301,-0.0248,-0.064,0.0022,0.0748,0.1074,-0.0418,-0.0243,0.0359,-0.1514,-0.1825,-0.1017,0.0433,0.079,-0.1252,-0.4931,-0.4956,0.2349,0.1439,-0.1363,0.0483,0.0488,0.026,0.1712,-0.0431,0.0502,0.126,-0.0599,-0.0541,-0.3392,0.0027,-0.3032,0.0073,-0.0627,-0.2444,-0.4417,-0.1116,0.0809,-0.2083,-0.0215,-0.1222,-0.0107,-0.006,0.0814,-0.084,-0.0676,-0.1279,0.04,0.0401,0.0551,0.026,-0.0178,0.1345,0.1152,0.0901,-0.073,0.124,0.0047,-0.0378,0.1668,0.1346,0.0048,-0.048,0.1035,0.0423,-0.0657,0.0382,0.0467,0.207,0.0264,-0.0666,0.0303,0.0974,-0.0204,0.071,-0.0166,-0.043,-0.1237,-0.078,0.0751,-0.1462,-0.1703,-0.0519,-0.1786,0.167,0.1575,-0.215,0.3004,-0.1064,-0.0559,-0.1554,0.0687,-0.0404,-0.0156,0.0278,-0.0419,-0.135,0.0046,-0.059,-0.0426,-0.1082,0.0124,-0.0913,-0.2346,-0.2485,0.046,0.0815,0.0819,0.0169,-0.0234,0.0266,0.176,0.0292,0.0235,-0.0752,-0.1524,-0.0603,0.3168,0.112,0.0289,-0.1342,-0.0114,0.0033,-0.0503,-0.0409,-0.0273,0.0658,0.048,0.0555,-0.0153,-0.0205,-0.0891,0.1982,0.2018,0.2217,0.0337,0.0414,0.0012,-0.392,0.1574,0.1424,0.0892,-0.3748,-0.224,-0.3243,0.1338,0.0284,0.0182,-0.0217,-0.1938,-0.1802,-0.1504,0.0013,-0.0388,-0.0099,-0.1529,0.0655,-0.2133,0.2512,0.0299,0.0754,0.1446,0.009,0.0337,-0.0756,-0.0779,0.0525,-0.1554,-0.1477,-0.0922,0.1256,-0.0264,-0.014,-0.02,-0.0482,-0.181,-0.2422,-0.23,-0.3832,0.2287,0.102,0.2,0.0457,-0.1006,0.031,0.1282,0.1738,0.114,0.087,-0.1113,-0.015,-0.2675,-0.087,-0.0082,-0.0842,0.0081,0.0139,-0.0507,-0.0541,0.1633,-0.0448,0.1296,-0.0103,0.1461,0.0412,-0.0834,-0.1335,-0.0377,-0.0366,-0.06,-0.006,0.2498,0.1572,0.1968,0.1958,0.0025,0.0145,-0.0765,0.1856,0.2051,0.0757,0.0365,0.111,0.0735,-0.0189,0.0431,0.0352,0.052,0.1508,0.1359,0.0936,-0.1462,-0.0924,0.0107,0.4077,-0.0097,0.1505,0.2196,0.4816,-0.0236,0.1626,0.0432,0.0394,-0.0337,-0.0537,-0.0004,0.0898,0.1397,0.3214,-0.1416,0.0575,-0.272,0.0244,-0.1066,0.1178,-0.1013,-0.2013,-0.3941,0.051,0.0223,0.087,-0.1609,0.3136,0.4134,0.3269,0.0178,0.0559,0.1294,0.1634,0.0909,0.1412,-0.0128,-0.0401,-0.0584,0.2352,0.0027,-0.0172,0.0255,0.0015,-0.014,0.0914,0.1115,-0.1904,-0.0139,-0.013,0.0434,0.2504,0.2959,0.1167,0.2033,0.0488,0.389,0.3179,-0.0631,-0.1025,-0.062,0.0216,0.0084,0.0021,-0.1099,-0.152,-0.157,0.3242,0.3615,-0.0754,-0.1284,0.045,-0.0254,-0.0931,0.0818,0.0784,-0.0065,0.0375,0.1118,0.0027,0.0355,0.0523,-0.0449,0.1019,-0.1053,0.0066,-0.1958,-0.1568,-0.1225,0.0036,0.2019,0.3088,0.1492,0.1446,0.2868,0.1499,-0.0758,0.025,0.0637,-0.3062,-0.2113,-0.1068,-0.2549,-0.1462,-0.1828,-0.3092,-0.1157,-0.1935,-0.1118,-0.1505,-0.1769,-0.2109,-0.289,-0.1944,0.3236,-0.1083,-0.0543,-0.1506,0.1448,0.1457,-0.0445,0.1285,-0.0735,-0.1963,-0.0551,0.0837,0.0727,-0.027,0.0922,0.1133,-0.1281,0.0201,0.0319,-0.1185,-0.1143,0.1427,0.16,0.0131,-0.0947,-0.0298,-0.0364,-0.0235,-0.0046,-0.0205,0.3861,0.1639,0.1404,0.21,0.2017,0.1931,0.2444,0.156,0.0703,0.1125,0.0556,0.0547,-0.1128,0.0872,0.3763,-0.1707,0.0052,-0.0314,-0.0311,0.0971,-0.0828,0.1022,0.1111,0.0295,0.075,0.0438,-0.0701,0.0811,-0.0643,-0.1748,-0.1445,-0.0077,0.1576,-0.0442,0.1151,0.3182,0.1584,0.1874,0.1602,-0.1085,-0.0022,0.0032,-0.0639,0.1211,0.0349,-0.0955,0.111,0.0917,0.0885,0.0182,-0.0635,0.0352,-0.0449,0.1385,0.0654,-0.1189,-0.0094,0.0222,-0.0013,0.0066,-0.0209,-0.1297,-0.0736,0.1089,-0.2746,-0.3873,-0.3267,0.0174,-0.21,-0.0505,0.0723,0.0848,-0.1343,-0.1963,-0.0878,-0.0729,0.0079,-0.0717,0.0483,0.0417,0.0728,0.0544,-0.1588,-0.1316,-0.0635,0.0269,-0.0933,-0.0734,-0.2169,-0.2008,-0.1744,0.0742,0.0043,-0.003,0.001,-0.0004,-0.0291,0.2436,0.108,0.0345,0.1058,0.0686,0.076,-0.0825,-0.0142,-0.033,0.0553,0.0418,-0.238,-0.2977,-0.0709,-0.0324,-0.0995,0.0343,0.0448,0.0358,-0.0439,0.0598,0.0707,-0.0048,0.2093,0.2701,0.2366,-0.146,-0.0262,0.0257,-0.0937,-0.0489,-0.2482,-0.0612,-0.0749,-0.1933,0.0761,0.1479,0.1588,-0.1122,-0.0655,0.1376,-0.0954,-0.0937,-0.1649,-0.166,0.0957,0.0839,0.0899,0.0736,-0.236,0.0431,-0.0443,-0.0392,0.0966,-0.082,-0.083,0.0819,-0.1558,-0.0742,0.212,0.0698,0.2074,0.1897,0.2041,-0.0512,-0.008,0.0497,-0.1573,-0.0513,-0.0413,-0.4971,-0.435,-0.2066,-0.2914,0.1802,-0.1462,-0.1024,-0.3335,-0.3241,-0.385,-0.0088,-0.0968,0.0059,-0.192,-0.0975,-0.1103,-0.1008,-0.0035,-0.0324,0.1504,0.0271,0.0894,-0.0757,-0.1228,0.0233,-0.073,0.009,-0.1724,0.0971,-0.0191,0.0245,0.2439,0.1742,0.0671,0.0815,0.1421,-0.0764,0.014,0.1322,0.0028,-0.2117,-0.0948,0.3069,-0.0387,0.0658,0.2651,-0.0099,0.0028,0.0352,-0.0762,-0.0127,-0.2027,-0.354,-0.3848,-0.0706,-0.0849,-0.2144,0.1048,0.0777,-0.0937,-0.0006,0.0229,-0.007,0.0471,0.0571,0.2634,0.2808,0.2894,0.2873,0.111,0.1331,0.1473,-0.0197,-0.0054,-0.0977,-0.0414,0.0383,0.0251,0.0433,-0.2242,0.1285,0.0252,0.0995,0.0627,0.1919,0.0405,0.0151,0.0968,0.0094,-0.3237,0.1257,0.1283,0.03,-0.0033,-0.0089,-0.0515,-0.0238,0.0299,0.0581,-0.0044,-0.0102,0.2367,-0.0522,0.0361,-0.1464,0.0185,0.3731,0.0743,-0.054,0.0847,0.0238,0.0047,0.1611,0.0826,-0.035,-0.0159,-0.0848,0.4201,0.1511,0.1352,0.34,0.1772,0.1059,0.098,0.098,0.1146,0.0471,-0.1654,0.2045,0.0811,0.0439,0.0765,0.118,0.1523,0.4126,-0.1617,0.0842,-0.0642,0.0723,-0.3588,0.0661,0.0933,0.1971,0.0268,0.0382,0.0499,0.0787,-0.2609,-0.0752,-0.2905,-0.427,-0.3474,-0.0092,-0.031,-0.1871,-0.1205,0.0138,0.1713,0.1878,0.0589,0.103,0.0092,-0.0298,-0.051,-0.077,-0.0045,0.0675,-0.1223,0.027,0.1095,-0.0782,0.1217,0.034,-0.0413,0.0963,-0.0297,-0.0875,-0.2872,0.1042,-0.3666,-0.3396,-0.1226,-0.3127,-0.268,0.0814,-0.0837,0.027,-0.0988,-0.0165,0.0146,-0.1577,0.0135,-0.0597,-0.1083,-0.0595,0.0306,0.0854,-0.0378,0.0462,-0.0074,-0.0473,0.1893,-0.0953,-0.0397,-0.1015,0.0019,-0.0323,-0.0733,-0.0649,0.0373,0.0545,-0.0559,0.0335,-0.0256,0.0947,0.102,0.0068,-0.0911,-0.1505,-0.0227,-0.0598,0.1136,-0.0992,-0.0582,0.057,-0.1664,-0.0921,-0.0414,0.0331,-0.0928,0.0491,0.0459,-0.0851,-0.0154,0.063,0.1014,0.0578,0.0535,-0.0564,-0.1053,0.0504,-0.0814,-0.047,0.0709,-0.0997,-0.1144,-0.1491,-0.1093,0.0234,0.0458,0.0373,0.0311,-0.1097,-0.0719,0.0734,0.0617,0.0905,-0.0629,0.133,0.1977,0.1442,0.1368,0.1503,0.0471,-0.0044,-0.0717,0.179,0.1562,0.1556,0.0088,0.0601,-0.0519,-0.0157,-0.1244,-0.1209,0.1771,0.1448,0.0179,-0.0363,-0.0026,0.152,-0.1199,-0.1301,0.1172,0.0077,0.0103,0.0372,-0.0625,-0.0353,-0.0652,-0.0367,-0.0259,0.2401,-0.0172,0.1727,0.2103,-0.0657,0.0887,-0.095,-0.1418,-0.2122,-0.2005,-0.1766,0.0946,0.2058,0.0863,-0.0985,-0.0931,0.0373,0.0448,0.0913,-0.0147,0.0834,0.0077,0.124,0.1879,-0.0332,-0.0215,0.0948,0.0891,0.0616,0.0409,0.0318,-0.0091,0.0658,0.0272,0.1754,0.0512,0.0299,-0.0232,0.0485,-0.0346,-0.1858,-0.1071,0.033,0.0426,0.0431,0.0798,0.0411,0.1057,0.3546,0.092,0.0715,0.0323,0.0902,-0.017,0.0029,-0.0354,0.1024,-0.0169,0.1522,0.0841,0.1723,0.1528,-0.0605,0.1591,0.1104,0.279,0.0909,-0.0059,-0.3295,0.1394,0.0429,0.0176,-0.0469,-0.0943,-0.0648,0.0909,0.203,0.0856,0.1324,0.0743,-0.0884,0.0143,0.1108,0.0758,-0.0771,-0.0797,-0.0447,-0.1217,0.0218,0.0146,-0.1022,0.0451,-0.025,0.0859,0.1529,0.1225,-0.0965,-0.0484,-0.0745,-0.0581,-0.0413,-0.086,-0.1454,-0.0223,0.0564,0.1942,0.1072,0.0571,-0.1706,-0.1738,-0.0204,0.1118,0.0355,-0.0217,-0.3546,-0.1762,-0.1468,-0.2034,0.288,0.0325,-0.0098,0.045,0.1174,-0.1366,-0.1506,-0.0781,-0.0187,-0.072,-0.0402,0.0463,-0.0494,-0.1448,0.1455,-0.2502,-0.0475,-0.0124,-0.0098,-0.0775,0.0197,0.0097,0.0441,-0.0798,-0.2097,-0.2849,-0.1969,-0.2825,0.1198,-0.0609,0.1096,0.0233,0.1605,0.3795,0.3731,-0.0175,-0.1182,-0.159,0.1016,-0.0504,0.0396,0.1374,0.2019,0.2091,-0.01,0.1202,-0.0043,-0.0054,-0.0651,0.0166,0.124,0.0443,0.1364,0.0703,-0.1093,0.2455,-0.0084,0.1746,0.0566,0.0809,0.0133,-0.0299,-0.1091,-0.0079,-0.079,0.1122,-0.229,0.112,-0.2194,-0.2322,-0.2079,0.0117,0.0196,-0.0684,-0.2678,-0.2402,0.2277,0.155,0.0315,0.0859,0.1837,0.0745,0.1169,0.2558,0.1183,0.0427,0.2239,-0.0587,0.0782,-0.0188,0.075,0.168,0.1255,0.1407,0.2066,0.1615,-0.1393,0.0899,0.2203,0.0798,-0.1731,0.0861,-0.1071,-0.0368,-0.0999,-0.0518,-0.0327,0.1409,0.2036,0.0961,0.0223,-0.0218,-0.1483,-0.025,-0.0812,-0.0288,-0.3092,-0.0978,-0.2004,-0.0999,-0.0343,0.3435,0.3486,0.1728,0.1742,0.0905,0.1131,0.199,0.1215,-0.0345,-0.0366,0.0423,0.0493,0.0062,0.1537,-0.1073,-0.0568,-0.0723,-0.0678,-0.0417,-0.0739,0.1875,0.0703,0.2094,-0.0924,-0.1794,-0.1791,-0.0029,0.0132,-0.257,-0.2807,-0.2739,-0.1812,0.0178,0.0808,-0.0276,-0.0142,-0.0418,-0.0223,-0.0723,-0.1683,-0.0766,-0.0805,-0.0748,0.0469,0.0039,0.1656,0.1275,0.1179,0.0634,-0.2613,0.0469,-0.1171,-0.1744,-0.1249,0.0158,0.0267,-0.1678,-0.0284,-0.2669,-0.2232,-0.0302,-0.1902,-0.0843,-0.012,0.0787,0.0648,-0.0591,-0.1366,-0.034,-0.0656,0.0052,0.0358,-0.0402,-0.0909,-0.0189,0.0497,0.0769,0.0792,-0.0598,-0.003,0.023,0.1155,-0.0018,-0.0437,-0.1827,-0.1548,0.0875,0.0819,-0.0563,0.0388,-0.1439,-0.1545,0.0268,-0.0413,-0.0641,-0.0637,0.0878,0.0457,-0.0911,-0.083,-0.1222,-0.0299,0.0202,0.0695,0.1238,0.0995,-0.1246,-0.3376,0.0645,0.0276,0.0974,0.1551,0.4363,0.2839,0.257,0.2305,0.1882,0.1916,0.1037,-0.1113,-0.0118,0.0071,-0.02,0.087,0.0449,0.2118,0.1094,0.066,-0.0615,-0.0413,0.0534,-0.3247,-0.2969,-0.1467,-0.055,-0.0045,0.0804,0.2338,-0.0019,0.0764,0.0559,-0.1026,-0.0989,0.0283,0.0256,-0.0072,-0.1855,0.2196,0.189,0.143,0.0999,0.1699,0.1209,0.0347,0.1304,-0.1005,0.1065,-0.002,-0.2629,0.1403,0.2745,0.0643,-0.1413,-0.1404,0.0958,0.1104,0.4479,0.2995,0.1399,0.3689,-0.0627,0.1327,0.1422,-0.0394,0.1271,-0.0725,-0.044,0.0157,-0.02,-0.0944,-0.2379,-0.1919,-0.2872,-0.1021,-0.1265,-0.2797,0.016,-0.0722,-0.1088,-0.0478,-0.1335,-0.1025,0.1623,0.2327,0.1535,-0.0838,0.052,0.1032,-0.015,0.0039,0.0435,0.0265,-0.233,-0.1575,0.184,0.0486,0.1534,0.0876,0.1625,0.1876,-0.025,0.1884,-0.0287,0.1537,-0.0329,-0.0386,0.0172,0.1941,0.0346,0.1803,0.0262,0.0983,0.1269,0.0682,0.0997,0.0059,-0.1511,-0.0895,0.0441,0.0626,0.103,-0.0245,-0.0831,-0.1134,0.0294,-0.3518,0.0162,0.0861,-0.0156,-0.1171,0.0583,0.0802,0.0829,-0.0893,0.0279,0.0803,-0.0785,-0.233,-0.4361,0.095,0.1433,-0.0328,-0.0337,-0.0622,-0.2816,0.0366,-0.4009,0.238,-0.3453,-0.3232,-0.1198,0.0028,-0.0148,-0.0005,-0.0266,-0.1074,-0.1087,-0.0621,0.0402,0.0807,0.1248,-0.1555,-0.2547,-0.2662,0.1672,0.1611,0.1635,-0.0168,0.1343,0.1022,0.083,-0.0386,-0.0362,0.0302,0.1049,0.142,-0.1304,0.0647,0.1192,-0.2576,-0.3034,-0.0473,0.0881,-0.2071,-0.5181,-0.2509,-0.1357,-0.2243,0.0267,-0.071,-0.1966,-0.2843,0.1301,-0.2769,-0.1299,-0.161,-0.0526,-0.4978,-0.0957,0.1126,0.1276,0.0248,0.3293,0.145,0.1862,0.1257,0.1554,0.2394,0.0214,0.3159,0.2618,-0.007,0.1526,0.3678,0.2449,0.1283,0.0161,0.16,0.1858,0.1915,0.1927,0.0369,0.0732,0.1725,0.1278,-0.1303,-0.1869,0.0528,-0.0151,-0.0687,-0.0254,0.0848,0.0945,0.0153,-0.0261,0.0407,-0.0681,0.3181,0.4112,0.0889,0.0523,0.1766,0.2716,-0.0503,0.1047,0.0808,0.1909,0.1302,0.1277,0.0018,-0.0335,0.0043,0.0378,-0.2164,0.0897,-0.1239,-0.2484,-0.1664,0.1696,-0.0214,0.3185,0.1423,0.0766,0.002,0.0267,-0.0176,-0.0841,-0.0559,-0.0179,0.0217,-0.0591,0.1486,0.0034,-0.1846,0.0701,0.0899,0.1298,0.025,-0.0222,-0.169,-0.1004,0.2905,0.2826,-0.072,-0.0881,-0.0062,-0.1516,-0.0419,-0.0125,0.1074,0.1759,0.0124,0.1428,0.259,0.0962,0.0608,-0.2056,-0.0386,-0.3063,-0.0198,-0.2063,0.0326,-0.0733,-0.0178,-0.0527,-0.0684,-0.0458,0.0236,0.0181,-0.0082,-0.1404,-0.0308,-0.0374,0.0667,0.0734,0.0352,-0.0169,0.036,-0.0099,0.057,0.0918,0.2669,0.036,-0.0683,0.0172,0.0202,0.022,0.0119,-0.0032,0.094,0.0884,-0.0162,0.0093,0.1584,0.1493,-0.2217,-0.2293,-0.0731,0.0642,-0.0272,0.172,0.0806,0.0114,0.0729,-0.1878,-0.09,0.2094,0.1702,-0.07,0.1639,0.0125,0.0306,-0.0794,-0.1289,0.3556,-0.0337,0.1303,0.0234,0.0519,0.2398,0.214,0.146,-0.0126,0.0245,0.0632,-0.0092,0.0993,0.0445,-0.0881,-0.0616,-0.0587,-0.0043,-0.0036,0.045,0.1499,0.0747,0.0101,0.1641,-0.0715,0.3106,-0.291,0.1609,-0.0311,-0.1995,-0.1617,0.3831,0.3327,-0.0434,-0.2766,-0.0837,-0.3268,0.0023,-0.1915,-0.1951,0.0415,-0.2197,-0.0064,0.0104,0.0719,0.0619,0.1455,0.0761,0.0852,-0.1087,-0.1005,-0.2603,-0.1399,-0.0719,-0.1089,-0.0114,-0.0502,-0.1044,-0.1968,-0.1228,-0.018,-0.2037,-0.125,-0.1058,-0.0386,-0.1272,-0.289,-0.1198,-0.2802,-0.2481,-0.2086,0.1952,0.0069,0.3011,0.1179,0.1705,0.2258,0.1979,0.074,-0.1989,-0.0848,0.3095,0.2713,0.1484,0.0289,0.0423,0.2083,-0.041,0.0802,0.0577,-0.0533,0.111,0.0472,-0.0578,0.092,0.118,-0.0955,0.1778,0.1722,-0.062,-0.0278,-0.0351,0.0132,-0.0006,0.1992,-0.3144,-0.2264,0.119,-0.0827,-0.0947,0.0225,-0.001,0.0271,0.0768,-0.5087,-0.5172,0.167,0.0652,0.0093,0.1525,0.0794,0.1167,0.0153,-0.0522,0.0228,0.0517,-0.0992,0.0298,0.0575,-0.0719,visual place recognition
trm_557b48aeb7d58,-0.1083,-0.1207,-0.1348,-0.1521,-0.0023,-0.0553,-0.1139,-0.0651,-0.0562,-0.1156,-0.0195,-0.0121,-0.1337,-0.0966,-0.1441,-0.0655,-0.0829,-0.1442,-0.08,-0.0574,-0.0864,0.0344,-0.0608,0.0301,-0.0143,0.0266,0.0222,-0.1429,-0.1828,-0.0843,-0.13,-0.141,-0.1619,-0.0909,-0.1876,-0.1295,-0.0696,-0.0858,-0.1661,-0.03,-0.133,-0.1356,-0.066,0.0876,-0.1042,-0.0993,0.1969,-0.069,0.0596,-0.1079,-0.0482,0.1035,0.0848,0.0556,-0.0387,-0.0836,-0.1187,-0.054,0.0016,-0.0473,0.0124,0.0526,-0.1863,0.1209,0.0326,0.1102,-0.2428,-0.293,-0.1576,-0.0099,0.0691,0.0309,0.1936,-0.1201,-0.1667,0.0809,-0.1528,0.0546,0.0506,-0.0373,-0.0083,0.0919,-0.0715,-0.1806,0.0763,0.0762,0.0015,0.0133,0.0018,-0.1764,-0.0942,-0.0137,-0.0156,0.2286,0.2178,0.1975,0.1816,0.0352,0.2994,0.1427,0.0916,0.0438,0.1318,0.1114,0.1394,-0.1756,-0.2084,0.1733,-0.0206,-0.0656,0.0075,-0.1476,0.1246,0.2185,0.0543,0.016,-0.125,0.0892,-0.0445,-0.0885,-0.1257,-0.2083,-0.1705,-0.0192,-0.1079,-0.1774,-0.0874,0.0723,0.1022,0.0491,-0.1343,-0.1024,-0.0308,-0.326,0.0014,-0.2293,0.0083,-0.178,-0.0392,-0.0471,-0.122,-0.1417,0.0307,-0.0146,-0.0233,0.0998,-0.0753,0.0349,-0.1113,0.0819,-0.107,-0.1088,-0.1925,-0.1912,0.1892,0.017,0.0757,0.0446,0.022,-0.0643,-0.0796,-0.1014,-0.2669,-0.2615,-0.0375,0.0007,-0.033,-0.2255,-0.213,0.0021,-0.0443,-0.1421,0.0812,-0.2971,-0.1927,-0.2435,-0.1797,-0.176,-0.1095,-0.0362,-0.1929,0.0831,-0.0612,0.0199,-0.064,-0.0729,-0.0893,-0.127,-0.1097,-0.0564,-0.0461,-0.0642,-0.0239,-0.2252,-0.209,-0.2863,-0.2612,-0.0349,-0.02,-0.1337,-0.0372,0.2843,-0.1958,-0.1752,0.0593,-0.0932,-0.1843,-0.0309,-0.0846,-0.0001,-0.2407,-0.1107,0.0122,0.0158,0.0681,0.0271,0.1077,-0.1718,-0.1265,0.0502,0.1174,-0.1418,-0.186,-0.0713,0.0977,0.0163,-0.0594,0.1647,-0.0398,0.2363,-0.0414,-0.2024,0.2055,-0.1516,-0.1408,0.1308,-0.0677,0.0667,0.0474,-0.0941,0.0234,-0.2345,-0.0776,0.0178,-0.0973,-0.1124,-0.1064,-0.148,-0.0665,-0.1214,0.0473,0.0271,-0.0022,0.0578,0.0413,-0.2233,0.0173,-0.0819,0.1498,0.2944,0.0875,0.3345,-0.1369,0.1383,0.2432,0.3856,0.1518,-0.0338,0.0111,-0.0435,-0.0655,-0.0043,-0.1779,-0.0116,-0.047,0.0604,-0.0617,-0.1506,-0.0969,0.0459,0.0869,-0.1028,-0.0781,-0.2594,-0.2005,-0.0894,0.0531,0.0649,-0.1436,-0.1444,-0.1288,-0.1469,-0.0292,-0.0916,-0.1143,0.0232,-0.0144,0.1434,-0.0456,0.189,0.1398,-0.2145,-0.1361,-0.113,-0.0224,-0.0014,-0.1515,-0.024,-0.0209,-0.019,0.0081,-0.0197,-0.1509,0.0778,0.0749,-0.0602,0.1795,0.0268,0.0722,-0.1649,-0.032,0.032,-0.166,-0.1926,-0.123,-0.061,0.0002,-0.0624,-0.0959,-0.121,0.056,-0.1069,-0.0178,0.0121,0.0346,0.175,0.0969,0.0095,-0.0394,-0.1814,-0.1558,0.0371,0.0522,-0.0077,0.1038,0.0554,-0.2987,-0.2185,-0.1915,-0.1385,-0.1252,0.0625,-0.0761,-0.0274,-0.0795,-0.0728,-0.0594,-0.1563,-0.141,-0.1371,-0.0079,-0.034,0.0389,0.0065,0.0127,0.0899,-0.1414,0.2863,0.0383,-0.1859,0.0145,0.102,-0.0003,0.1429,-0.1799,-0.0286,-0.1079,0.1245,0.1572,0.173,0.2176,0.0748,-0.088,0.0635,0.0227,0.0767,-0.1261,-0.0494,0.0478,-0.0448,-0.0437,-0.0097,-0.0245,-0.0478,0.1661,0.0956,-0.0592,-0.2082,-0.0977,-0.0746,-0.0819,0.0388,0.0202,-0.0412,0.0816,0.0862,0.0805,0.002,-0.1432,-0.0391,-0.0037,-0.2198,-0.0441,0.2638,-0.1544,-0.0404,0.2882,-0.019,-0.1333,-0.0513,0.0248,-0.268,-0.1629,-0.4102,-0.3741,-0.1424,-0.1986,-0.0892,-0.1882,-0.1179,-0.0391,0.0821,-0.0306,-0.0203,-0.0176,0.0829,0.025,0.0304,-0.3086,-0.1833,0.0395,0.0582,0.0197,0.0595,-0.0342,-0.1068,0.0401,0.1488,-0.156,-0.0272,0.0476,0.1081,-0.1394,-0.061,0.0349,-0.1805,0.0335,-0.064,-0.0281,0.0268,0.0767,-0.0693,-0.082,0.0537,-0.151,-0.1174,0.0503,0.434,-0.1339,-0.0449,0.0342,0.0443,0.1244,-0.0516,-0.1301,-0.0576,0.0551,0.0688,-0.0395,-0.0444,0.1195,0.0557,0.0213,0.0757,0.1431,0.1646,-0.0124,0.0155,-0.1058,-0.0288,0.0925,0.167,-0.1184,-0.1739,0.1427,0.0471,-0.1033,-0.0269,0.0586,-0.1269,-0.1105,0.0288,-0.0463,-0.1325,-0.1207,-0.1545,0.0385,0.0065,-0.0502,0.1528,-0.1934,0.0481,-0.0295,0.0112,0.1228,0.0991,-0.1497,-0.1293,0.1604,-0.1198,-0.1087,-0.0593,0.1031,0.131,0.203,0.0355,0.2077,0.1543,0.0724,0.0763,-0.1008,-0.0357,-0.1017,-0.2896,-0.1316,0.012,-0.1796,-0.1131,-0.0432,-0.1572,-0.0632,0.0242,0.0257,-0.0335,-0.1198,-0.0419,0.0156,0.0314,0.0155,-0.0297,0.1035,-0.0282,-0.0347,0.0095,-0.0217,-0.1771,0.1333,0.0443,0.0814,-0.0409,-0.0706,0.0232,-0.1031,0.0558,-0.0945,0.0725,0.1168,-0.0633,-0.0025,-0.0753,-0.0987,-0.0202,-0.1145,0.0208,0.0356,0.0079,0.0661,0.0486,0.1208,0.1165,0.0206,-0.1191,-0.0181,-0.0538,0.1645,0.0527,0.0729,0.0528,0.1004,-0.0607,-0.1236,0.0313,0.1391,0.1272,-0.0263,-0.0104,-0.2626,-0.0943,0.2004,-0.0506,0.0319,0.0872,0.0653,0.0564,0.099,0.0743,-0.0411,-0.1912,-0.1859,0.0925,-0.1982,-0.0476,0.0659,-0.0951,-0.3198,-0.0683,-0.0893,0.027,0.0315,-0.2614,-0.0825,-0.246,0.0714,0.0206,-0.0432,0.0532,-0.135,-0.1928,-0.1026,0.0495,0.1081,0.0924,-0.1081,-0.0273,0.0386,0.0678,0.0784,-0.0418,-0.0831,-0.05,-0.119,0.1008,0.0035,-0.0363,-0.1127,-0.0386,-0.3105,-0.2268,0.1498,-0.2375,0.0268,-0.1926,0.2282,-0.1256,-0.0614,-0.0586,0.0741,-0.088,-0.0673,-0.1005,-0.2306,0.0771,0.2096,-0.015,0.067,0.1471,-0.1041,-0.1388,-0.014,0.0075,-0.0692,-0.1124,-0.082,-0.0411,-0.0546,-0.1132,0.2525,-0.1157,0.0322,-0.051,0.0538,0.0705,0.0978,0.0555,0.2008,-0.1926,-0.1132,0.0321,0.0267,0.0235,0.1146,0.2055,0.1967,0.122,0.1887,-0.0653,0.0467,-0.0826,-0.11,-0.0301,0.0493,0.0241,-0.0208,-0.1465,-0.1058,-0.0826,-0.1472,-0.1201,-0.0985,0.0598,0.1274,0.0228,-0.0641,0.093,0.0029,-0.0172,-0.0188,0.0446,-0.136,0.0413,0.1322,-0.0944,-0.3383,-0.3324,-0.2447,-0.0159,-0.0381,-0.143,0.0074,-0.0557,0.0327,-0.039,-0.0547,0.1365,0.1319,0.0065,-0.1562,0.1348,0.1446,0.3108,-0.2029,-0.0514,-0.1042,-0.0254,0.0211,-0.147,0.1327,0.0634,-0.0515,0.0161,-0.0265,0.0638,-0.2363,-0.33,-0.2781,-0.2033,0.0756,0.228,0.0184,-0.1267,-0.0328,0.0639,0.0953,0.1023,0.0749,0.0343,-0.1099,-0.1249,-0.0368,0.1339,0.1141,0.1849,-0.0473,-0.0286,0.0329,-0.1014,0.0858,-0.1041,-0.1589,-0.0118,-0.2021,-0.1979,-0.1131,0.0704,0.1006,0.0291,-0.0338,-0.0426,0.0212,0.1662,-0.0104,-0.153,0.0644,0.0026,0.0339,0.0216,0.1405,-0.0912,0.1741,-0.2274,-0.2357,0.1276,0.1295,0.1962,-0.0306,-0.0479,0.0704,0.0137,0.0244,0.2617,0.0361,0.1068,0.1081,0.1751,0.0603,0.0075,0.2172,0.2058,-0.1266,0.0191,0.0771,-0.2381,-0.1861,-0.0275,-0.1478,-0.0529,-0.3197,-0.1131,-0.2039,-0.1364,-0.2742,0.0266,-0.0204,0.051,-0.0838,-0.0295,0.0164,0.0811,0.1577,0.0526,0.1048,0.1648,0.0365,0.0687,0.0507,0.0002,0.1557,0.1686,-0.1325,0.1825,0.0759,-0.0276,-0.0759,-0.1328,-0.0696,0.1197,0.0341,-0.3435,-0.2069,-0.0622,0.0967,0.2087,0.0627,0.0353,0.0525,0.0462,-0.0498,-0.1149,0.1484,-0.0957,0.0504,-0.2369,0.14,-0.0923,0.1729,0.1276,0.0198,0.1295,-0.2757,-0.2551,-0.1069,0.267,-0.0928,-0.1214,-0.1252,0.0994,0.0149,-0.202,-0.0669,-0.1843,0.0974,-0.0768,0.0089,0.0952,-0.0057,0.133,-0.2248,-0.1379,-0.07,0.1013,-0.1636,0.0417,0.1241,0.084,0.1417,0.3641,0.1493,-0.1306,-0.097,-0.1366,-0.0851,-0.1188,-0.0597,0.0341,0.1694,0.0892,0.0138,-0.1346,0.1336,0.2497,0.1122,0.0084,-0.0379,-0.0531,-0.1583,-0.0717,-0.07,0.0179,0.0629,-0.1501,-0.049,0.125,0.0165,-0.1111,-0.0341,0.1001,-0.0627,-0.0442,-0.0791,-0.17,-0.1675,-0.3423,-0.2091,-0.3562,-0.0357,-0.0565,-0.1221,-0.1842,-0.1678,-0.2258,-0.1647,-0.2917,-0.1581,-0.1567,0.0214,0.0682,0.1306,-0.0309,0.043,0.0176,0.0576,0.1267,0.1322,0.1804,0.116,-0.0542,-0.002,0.034,-0.0069,0.1372,0.1118,0.1479,-0.0133,0.1361,-0.0509,0.1098,-0.0583,-0.0562,-0.0253,0.1159,-0.031,0.103,-0.2047,-0.0881,-0.0612,-0.0873,-0.0546,0.0332,0.123,0.0735,0.113,0.1533,0.1183,0.0301,0.0265,-0.0061,-0.0206,0.0611,0.009,-0.0231,-0.0806,-0.1175,-0.0851,0.1067,0.0847,-0.1433,-0.1158,-0.1083,-0.2653,-0.1543,0.2137,0.1187,0.1687,0.0962,0.0594,-0.1073,-0.0335,0.0634,-0.0014,-0.0436,-0.0233,0.0226,-0.076,-0.0518,0.01,0.0826,-0.1297,-0.0223,-0.1164,0.0555,-0.1746,0.06,0.1458,0.2576,0.1281,0.0986,0.0387,0.0394,-0.0209,-0.051,-0.0688,-0.1094,0.0122,0.0091,0.1124,-0.012,-0.0478,0.026,-0.013,-0.078,-0.014,-0.1593,-0.2141,-0.2014,-0.1473,0.2274,0.0258,0.1013,-0.1821,0.2485,0.1348,-0.0202,-0.0379,0.011,0.0496,-0.0313,0.1225,-0.1363,-0.1398,-0.0371,-0.0385,-0.1636,-0.0498,-0.1092,-0.0334,-0.0874,-0.0692,-0.0854,-0.0724,0.0063,-0.017,0.0182,0.0302,0.0588,-0.1138,0.0219,-0.1317,0.0658,-0.0485,-0.085,0.421,0.3248,0.3831,0.2632,0.2864,0.094,0.3562,0.2042,-0.2115,0.1936,0.2073,0.1181,0.1023,0.1093,-0.1003,-0.0084,-0.0888,-0.0207,0.0356,0.0092,0.0577,0.0379,-0.1553,0.0605,0.0702,0.0213,0.1019,-0.0375,-0.1166,0.1061,0.0588,-0.1035,-0.0097,-0.0928,0.0811,0.0401,0.2007,-0.0242,-0.1967,-0.1991,-0.1207,-0.0475,0.129,0.1301,-0.0469,-0.108,-0.2732,-0.211,-0.1165,0.2121,-0.0891,0.2914,0.2795,-0.0895,0.0201,-0.0086,0.1159,0.166,0.1082,0.2353,0.1116,0.0306,0.1001,0.0745,-0.1072,-0.1927,0.1026,-0.1042,0.0962,-0.0081,-0.0997,-0.0166,-0.163,-0.0754,-0.0128,-0.095,-0.1626,0.0167,0.1945,-0.0534,0.0054,-0.0299,0.1632,0.0632,0.0448,-0.2184,-0.2234,-0.0737,-0.082,-0.0536,-0.1366,-0.06,-0.0517,-0.0377,0.2096,0.0777,0.1006,0.3102,0.0126,0.0274,-0.0546,0.1466,0.015,0.2494,-0.1039,0.2324,0.3641,0.0577,-0.1357,0.2985,0.2631,-0.06,-0.1995,0.0363,-0.22,-0.0905,-0.3017,-0.0595,0.1298,-0.0609,-0.0878,0.0641,-0.0654,0.001,-0.1042,-0.0653,-0.0502,-0.0947,0.0063,0.1113,-0.0339,0.3423,0.193,0.2787,0.3,-0.1547,-0.037,-0.1143,-0.1458,-0.1136,-0.048,-0.0034,0.1796,-0.189,-0.1189,0.1246,0.0577,-0.0222,0.1079,0.0931,0.0149,-0.0053,0.1794,-0.0856,-0.1172,-0.0044,0.136,0.0416,-0.0064,-0.0261,-0.0261,-0.2179,0.0878,0.0253,0.0589,-0.0308,0.0805,-0.0399,0.2848,-0.3328,-0.3046,0.1044,-0.0655,-0.258,-0.2589,-0.2103,-0.0337,-0.0686,-0.0785,-0.0186,-0.019,0.2013,0.0169,0.1116,-0.0847,0.1191,0.0078,0.0711,0.0638,-0.0628,-0.096,-0.0154,-0.0805,-0.0448,-0.0523,-0.0199,0.0902,-0.0013,0.1389,0.0631,0.174,0.0414,0.1766,-0.1948,-0.1214,0.0263,-0.1932,0.0031,-0.2187,-0.3194,-0.015,-0.1185,-0.2543,0.0231,-0.0771,-0.2238,-0.0194,-0.0694,0.0279,-0.2025,-0.0488,-0.1203,-0.193,-0.0772,0.0862,-0.0932,0.2654,0.1683,0.1538,0.1852,-0.0225,0.0865,-0.0782,-0.1629,-0.1608,0.0132,-0.1125,-0.0187,-0.1116,-0.0287,0.0631,0.0624,-0.0025,-0.1733,-0.1305,-0.0205,0.0216,0.0013,-0.0312,-0.0496,0.0871,-0.0792,-0.1363,-0.098,-0.2072,-0.1515,-0.0545,-0.1771,-0.1917,0.0258,0.0283,-0.0147,0.0365,0.0197,-0.1647,-0.1341,0.0632,-0.2117,0.036,0.0163,-0.0089,-0.1225,-0.1739,0.0049,0.1741,-0.021,0.0158,0.0251,-0.0604,0.1854,0.0806,0.0323,0.0066,-0.245,0.0884,0.002,0.0914,0.1871,0.0764,0.0168,-0.0834,0.0114,0.2003,-0.1015,0.0316,-0.1522,-0.0386,-0.1422,-0.121,-0.0177,0.1405,-0.0292,-0.0899,-0.1742,-0.0106,-0.0297,0.0068,-0.0622,-0.182,-0.0072,0.0061,-0.0862,0.0801,-0.0737,-0.0566,-0.0538,-0.108,-0.1045,-0.0901,-0.0838,-0.0451,0.0178,-0.0293,0.1217,-0.0644,-0.0293,-0.0254,0.0563,0.0112,-0.047,-0.2009,0.0634,-0.0929,0.0267,-0.0018,0.0506,0.0712,0.0618,0.0714,-0.0945,-0.0657,-0.1251,-0.0612,-0.2854,0.0111,-0.1905,-0.0188,-0.0692,-0.0779,-0.0612,-0.1362,-0.1352,0.2098,0.1161,0.0077,0.2845,0.1279,0.0853,0.0858,0.1951,-0.016,-0.0694,0.0222,0.2837,0.0007,0.0389,-0.05,-0.1135,-0.0778,-0.0947,0.0381,0.0243,-0.0227,0.1003,0.1365,-0.0667,-0.0814,-0.0481,0.0853,0.1474,0.0869,-0.2984,-0.1326,-0.0429,-0.2347,-0.1828,0.0464,0.154,0.048,0.0326,0.0469,0.0108,-0.2187,-0.0612,-0.0403,-0.1101,-0.2483,-0.1028,-0.0433,-0.1524,-0.0824,0.1409,-0.0479,-0.0748,-0.0502,0.0077,0.1351,0.2629,-0.0645,0.0782,0.0202,-0.0396,-0.1265,-0.0878,0.0596,0.0126,-0.0106,0.2016,0.1328,0.0803,-0.074,-0.1242,0.0417,0.497,0.4931,-0.191,-0.1536,0.0773,-0.0859,-0.0726,-0.0539,-0.2189,0.0751,-0.0417,-0.1,0.0044,0.0323,0.2812,-0.0687,0.2208,0.0484,0.007,0.1148,0.4357,-0.0511,-0.0798,0.3105,0.0474,0.0943,0.0793,0.0651,-0.0761,0.1725,0.1137,-0.0166,-0.0519,-0.0022,0.0151,0.1139,0.1059,-0.05,-0.0507,-0.0705,0.1439,-0.1612,0.0385,0.1694,-0.0911,-0.0262,0.0136,0.0296,-0.1578,-0.0307,0.0526,-0.0754,0.0776,-0.1128,0.0958,0.1611,-0.0415,-0.0434,0.0405,0.0151,0.0166,0.1504,0.1343,0.1464,0.0169,0.1747,0.0737,0.0605,0.4214,-0.1938,-0.1621,0.0818,-0.1675,0.082,0.111,0.1511,-0.0847,0.01,0.0142,-0.0231,0.0543,0.0623,-0.0361,0.007,0.0401,0.0764,0.0591,0.135,0.3287,0.3068,-0.089,-0.1673,-0.1274,-0.024,0.1253,0.0605,-0.0434,0.0421,0.0605,0.0162,0.1089,-0.0461,-0.3322,-0.1274,-0.0214,0.1345,0.0017,0.0631,0.0263,0.2921,0.2225,0.0432,-0.0352,-0.1242,0.0126,0.0511,0.1359,-0.1176,-0.1659,-0.1933,0.0352,-0.0107,0.0202,0.2952,-0.0897,-0.0707,0.0514,0.2157,0.1043,0.2343,-0.0526,0.0037,0.0032,0.0365,0.1604,0.2398,0.248,-0.0322,0.0501,0.0595,0.0846,-0.125,0.1211,-0.277,-0.0995,-0.0536,-0.1265,-0.0093,0.0818,-0.0457,-0.0252,-0.0758,0.0126,0.0135,0.0091,-0.0856,-0.0639,-0.0174,-0.0276,-0.066,0.1016,0.2423,0.1735,0.2618,-0.2668,-0.1629,-0.2204,-0.0547,0.0692,-0.0983,-0.1617,-0.111,-0.1741,-0.0646,0.1507,0.038,0.2203,0.1124,0.0281,0.0614,-0.0049,0.0283,0.0283,0.0123,-0.2189,0.0092,-0.1571,-0.0502,-0.1185,-0.0088,0.1077,0.3092,0.186,0.1175,0.0932,-0.1148,-0.3582,-0.1996,-0.2648,-0.1922,0.0207,-0.051,0.0516,-0.1418,-0.2265,-0.1831,-0.0985,0.0275,0.0217,-0.0445,-0.0777,-0.021,-0.0532,-0.2382,-0.139,-0.1166,0.1017,0.0304,-0.0338,-0.3433,-0.0859,-0.1655,-0.1977,-0.4485,0.0577,-0.0319,-0.0747,-0.0815,-0.0564,-0.0363,-0.0382,-0.1705,-0.091,-0.1616,0.1804,0.0731,0.1784,0.0296,0.1195,-0.1081,0.0627,0.1179,0.2882,-0.1145,-0.0555,-0.0233,0.1946,-0.2143,-0.2658,-0.2048,-0.0861,-0.099,-0.176,-0.1345,-0.1022,-0.0972,-0.0226,-0.0039,0.0108,-0.312,0.0064,-0.0401,-0.1197,-0.0991,-0.1007,-0.0181,-0.1823,0.0658,0.019,0.2031,-0.0252,-0.0807,-0.2678,-0.1273,-0.1635,-0.1054,-0.2921,-0.2082,0.0498,0.1016,0.067,-0.029,-0.0958,0.0227,0.2092,0.2429,0.2326,-0.3162,-0.3373,-0.003,0.1006,0.0121,-0.0968,0.0454,-0.1022,-0.0013,-0.0396,-0.1004,-0.1418,-0.0107,-0.1088,-0.12,-0.001,-0.1228,0.0346,-0.0125,0.0503,0.165,0.1221,-0.0991,-0.2141,-0.2558,-0.1716,-0.1299,-0.3095,-0.1681,0.2999,-0.0905,-0.1432,0.1259,0.0701,-0.0213,0.1101,0.0127,0.0393,0.1882,0.0071,0.0963,0.0449,-0.0183,0.0345,0.0658,0.1928,0.257,-0.3002,0.0235,0.0507,0.3194,-0.0592,-0.0548,0.0569,-0.0412,0.0305,0.0552,0.1311,-0.0289,-0.0161,-0.1366,-0.1271,-0.1564,0.0274,-0.093,0.0901,0.2154,0.2526,0.01,0.0041,0.0996,0.2234,0.0985,0.0548,0.0243,0.0259,0.0399,-0.403,-0.1807,-0.2032,-0.1991,-0.1296,-0.1993,-0.2158,-0.1453,-0.0386,-0.0841,-0.2199,-0.1077,0.0524,-0.0968,-0.3565,0.0957,-0.089,-0.0041,0.0523,-0.1056,0.0379,-0.1932,-0.1246,-0.0221,-0.1132,-0.0812,0.0555,-0.1429,0.0682,0.1015,0.1371,0.0124,-0.162,0.0456,-0.0492,-0.2183,-0.0527,-0.131,-0.1211,0.1204,0.0309,-0.0294,-0.1576,-0.1273,-0.0308,0.0104,-0.0346,-0.0829,-0.1546,-0.1018,-0.0027,-0.0809,0.0999,-0.151,-0.0713,0.0754,0.0641,0.0351,0.0512,0.0364,-0.2242,0.0161,-0.0935,-0.1781,0.2052,0.3197,0.2812,-0.0597,0.4666,0.2404,-0.2001,-0.1294,0.4212,0.2029,0.0688,0.1295,0.1167,0.1093,-0.1337,-0.1256,-0.1047,-0.0993,0.5118,0.4124,0.2979,0.0821,0.2213,0.2195,0.4471,0.4326,0.3809,-0.0218,-0.0063,-0.057,-0.0039,-0.0439,0.0341,-0.2464,-0.1018,0.0097,-0.0291,-0.1102,-0.0988,0.1238,-0.0291,0.0303,-0.0689,0.0843,0.2079,0.297,0.009,-0.0335,-0.078,-0.0041,0.0056,-0.0327,-0.0478,-0.1058,-0.0588,-0.0073,-0.2045,-0.3297,-0.3022,0.0609,-0.0389,-0.01,0.2216,0.06,0.2435,0.0786,0.1292,0.327,-0.0376,-0.2258,-0.2461,0.0058,0.1135,-0.0642,0.192,0.102,0.2007,0.1109,-0.1952,-0.1904,-0.1433,-0.1265,0.1281,-0.2817,-0.1757,0.0649,-0.0617,0.174,-0.0261,-0.0007,0.1319,0.0235,-0.0474,0.0324,-0.091,-0.1836,-0.226,0.0423,0.0087,-0.0782,0.014,-0.0541,0.0755,0.3765,0.3149,0.1397,0.2689,-0.1182,0.0758,0.1095,0.2097,0.2673,0.3296,0.0761,0.0771,0.0091,0.2207,0.1993,0.0045,-0.0044,-0.0364,-0.0335,-0.1096,0.0186,-0.0413,0.0045,0.0091,0.0441,0.0679,0.0104,0.174,-0.0636,0.0995,0.1001,-0.1725,-0.2046,-0.1195,-0.1532,-0.2197,0.1505,-0.0498,-0.1153,-0.0722,0.2165,0.0377,-0.27,-0.0446,0.0059,-0.1802,0.0117,-0.0138,0.068,0.143,0.1497,0.4234,0.2664,0.2311,-0.0144,0.0504,0.1537,-0.1571,-0.1669,-0.0197,0.026,-0.0478,0.0171,-0.0301,-0.1148,-0.1553,-0.2309,-0.2912,-0.2371,-0.1161,-0.0774,-0.1536,-0.0615,-0.0967,0.0144,0.0042,-0.0671,-0.0667,-0.0632,0.2593,-0.0053,-0.0078,-0.1429,0.0918,-0.0456,-0.0697,0.1143,-0.2296,-0.1218,0.2336,-0.0925,-0.0982,-0.0263,0.0228,0.0101,0.0487,-0.0754,-0.0683,-0.0382,0.0133,0.0207,-0.2321,0.0744,-0.0161,0.1473,0.0273,-0.2739,-0.1287,-0.0058,-0.0848,-0.0879,-0.0625,-0.1618,-0.0317,0.0559,-0.0161,0.1036,-0.4169,-0.1737,-0.165,-0.3302,-0.245,-0.1778,-0.1608,-0.1608,-0.071,-0.052,0.1044,-0.2582,-0.0512,-0.1069,-0.1118,-0.0089,-0.0541,-0.3893,0.184,-0.2011,0.0676,0.0188,0.3005,0.01,-0.0216,-0.1957,-0.086,-0.0105,0.0399,-0.044,0.2323,0.0601,0.1127,0.2675,0.2197,-0.0103,0.0389,0.055,0.0085,-0.0136,-0.1081,-0.1344,-0.0809,-0.129,-0.0331,-0.024,-0.0077,0.0756,-0.0424,-0.0358,0.097,0.0977,-0.0949,0.1436,-0.0174,-0.1776,-0.0188,-0.2283,-0.0201,-0.0615,0.1109,-0.1132,0.2114,0.1986,0.0457,0.2185,0.1938,-0.0269,0.1548,0.015,0.322,0.1346,0.0041,0.1642,-0.1637,0.073,0.1182,0.0922,-0.0067,-0.0701,0.0386,-0.0327,0.016,-0.068,-0.1442,-0.043,-0.078,0.0146,-0.0249,-0.1267,0.2947,0.0157,0.0622,0.062,-0.002,-0.0115,0.0229,-0.0705,-0.168,-0.0711,0.126,0.1495,-0.0145,0.0211,-0.1184,0.0302,0.1024,0.0954,0.1479,0.0518,0.0244,-0.0712,0.106,-0.1022,-0.0165,0.0748,-0.0264,-0.0412,-0.1036,-0.1062,-0.099,-0.0099,0.0659,-0.131,0.1051,0.0148,0.096,0.0531,0.0891,0.1449,0.0752,-0.0822,-0.0699,-0.0961,-0.0539,0.0548,0.0654,-0.0589,-0.0686,-0.02,0.1189,-0.085,-0.1965,-0.1527,-0.2037,-0.1715,-0.0136,-0.0448,0.0112,-0.1529,-0.1472,-0.1645,-0.043,-0.1252,0.0288,0.0641,-0.0653,0.1651,-0.1588,-0.1421,-0.0578,0.0458,-0.1011,-0.0859,0.13,0.0839,-0.2151,0.0353,0.0016,-0.0601,0.0716,0.077,0.0291,0.0876,-0.0829,-0.2182,-0.0742,-0.2211,-0.2726,0.0257,-0.1483,0.074,0.0978,0.165,0.1594,0.1673,-0.1686,-0.2182,0.0354,0.2054,0.2978,0.0408,-0.0654,-0.0083,0.0037,-0.1274,0.0314,-0.1047,-0.1748,-0.0624,-0.0387,-0.1123,-0.1926,0.1415,0.0004,0.0251,0.1428,-0.0101,0.0367,-0.1126,-0.0338,-0.0502,0.0246,-0.091,0.0131,0.1251,0.098,-0.0241,-0.0763,-0.0746,-0.1408,-0.0443,-0.0287,-0.3013,-0.058,-0.0404,-0.0085,-0.0537,0.0523,0.019,0.0476,-0.0859,0.1019,-0.2375,-0.1448,-0.1858,-0.1912,0.0153,-0.2099,-0.1731,-0.3556,-0.1666,-0.0608,0.2122,-0.1913,-0.0667,-0.0562,0.0617,0.1252,0.0978,-0.1328,-0.2048,-0.0909,-0.0588,0.0231,0.1315,-0.0688,-0.066,-0.0802,0.1178,0.0839,0.0895,0.1956,-0.0266,-0.0353,0.1099,-0.0318,0.048,0.0257,-0.028,-0.0983,0.0116,0.0261,0.1468,0.0116,0.1614,0.1689,0.0285,0.0197,-0.0264,-0.227,-0.1128,-0.0437,0.1935,0.3072,0.1004,-0.0101,-0.004,0.0258,0.3386,0.2097,0.173,0.203,-0.2676,-0.0264,-0.0565,0.0671,-0.0977,0.1031,0.0165,0.0033,0.0387,0.0565,0.0848,-0.077,0.084,0.0645,-0.1681,0.2432,0.1249,0.0343,0.0124,0.0557,0.0571,-0.0202,-0.0179,0.0047,0.0023,0.1463,0.2168,0.2342,-0.1136,0.0466,0.0087,-0.073,-0.1749,-0.4101,-0.3907,0.0515,0.0952,0.1177,-0.0513,0.0467,0.0501,-0.0766,-0.0784,-0.1296,0.0709,-0.0631,-0.0003,-0.0263,0.0849,-0.0113,-0.2128,-0.0527,-0.1865,-0.1462,0.0265,-0.1372,0.0192,-0.2568,-0.1233,-0.0467,-0.0331,0.009,0.1391,0.0086,-0.0863,-0.1506,0.2794,-0.1281,0.1518,0.167,0.1456,-0.0068,0.0413,-0.0974,0.2792,0.2635,-0.2143,-0.134,-0.0692,-0.0425,-0.1445,-0.1455,-0.1738,-0.2777,-0.1217,-0.0089,-0.0998,0.0781,-0.0368,-0.0352,-0.1276,-0.2189,0.1087,0.0657,-0.1993,-0.1032,-0.004,-0.1247,-0.259,0.1089,0.2009,-0.1271,0.0597,0.143,0.1197,-0.1474,-0.1591,-0.1926,-0.2621,-0.11,-0.1046,0.0259,0.1039,0.0556,0.1163,-0.0117,0.227,0.3425,0.2589,0.1397,0.2802,-0.3598,-0.2952,-0.1908,0.0269,-0.0223,-0.0399,-0.1159,0.0059,0.0848,-0.1551,-0.16,-0.0452,0.1983,-0.1675,-0.0034,-0.024,0.0585,0.1156,0.139,0.0037,-0.0845,-0.0274,-0.0857,0.0354,0.1786,0.1736,0.0687,0.0196,0.1338,0.1713,0.1542,0.1253,0.0046,-0.156,0.011,-0.0161,0.0203,-0.0054,0.0324,0.1751,0.0709,0.0441,0.0474,-0.0376,-0.0217,-0.2336,-0.1876,-0.1458,-0.1547,0.4127,0.0105,0.2485,0.1856,0.1315,-0.0062,-0.0069,0.1901,-0.0105,0.2816,0.2285,0.0797,0.1598,0.0893,0.0398,-0.0987,-0.0691,-0.0877,0.0619,0.2363,0.147,-0.1017,-0.0201,0.0144,-0.026,-0.001,-0.0214,-0.1007,-0.1212,0.0014,-0.1524,0.0439,-0.111,0.1234,0.0941,0.1499,0.0879,-0.0391,-0.0192,-0.0157,-0.0591,0.1155,0.227,-0.019,0.0549,-0.0367,0.0961,-0.0542,-0.1247,0.0019,0.1377,0.1323,0.014,-0.1833,-0.1165,-0.1531,-0.1195,0.0363,0.1456,-0.0771,-0.0255,-0.112,-0.1705,-0.3208,-0.2046,-0.1957,-0.1837,-0.1478,-0.1136,-0.0961,0.1058,-0.1489,-0.1667,-0.1331,-0.0832,0.0084,-0.1492,-0.0897,0.0554,0.1701,0.0889,-0.0598,0.3876,0.3588,0.2255,-0.0063,0.0875,-0.0215,-0.1508,0.0528,-0.021,0.0299,0.2017,0.2095,-0.0448,0.0191,0.1004,0.143,-0.1742,-0.1386,-0.0668,-0.0797,-0.1188,-0.0921,-0.0273,-0.1126,0.0572,-0.1737,-0.1413,0.2183,-0.0125,-0.2694,0.0074,0.1401,0.1606,-0.0955,-0.1225,-0.4503,-0.3531,-0.1555,-0.3287,0.1324,-0.1217,-0.1098,0.0735,-0.0687,-0.0351,-0.1229,-0.0495,0.161,0.1416,0.3039,0.188,0.2291,-0.0574,-0.0269,0.1876,0.0256,0.1073,0.0668,0.03,0.2894,0.1863,-0.1701,-0.2894,-0.1553,-0.0756,-0.1692,-0.0556,-0.0551,0.0505,0.0444,0.0231,0.1272,0.0738,-0.2391,-0.0412,-0.1876,-0.0358,-0.192,-0.2567,0.0085,-0.0382,-0.0154,-0.0995,-0.0172,-0.127,-0.0983,-0.2535,-0.0723,-0.1946,-0.0573,-0.0518,-0.05,-0.0481,-0.0777,0.048,0.0934,0.0595,-0.1073,-0.0986,-0.1508,-0.0074,0.1112,0.1321,-0.1055,0.2814,-0.0545,-0.0837,0.0795,0.0844,-0.0534,-0.0068,-0.0016,0.0452,-0.0061,-0.0317,0.1841,0.3417,0.4283,-0.0634,-0.0211,-0.0044,0.1038,-0.0425,0.2318,-0.0113,0.3743,-0.1139,0.1301,0.1058,0.1182,0.0129,0.0054,0.0063,0.0488,0.0267,0.0308,0.0965,0.0404,-0.0493,-0.151,0.1061,0.1953,0.2141,-0.2436,-0.1961,-0.2329,0.0064,-0.1922,-0.0712,-0.0252,0.0451,0.0224,-0.0484,-0.1625,-0.1772,0.0546,-0.0088,-0.1544,0.0921,0.3301,0.0616,-0.0783,0.1974,0.4212,0.1814,0.1147,0.2139,-0.1032,0.0333,0.2629,0.2076,-0.1301,0.2879,0.1117,0.0721,0.0846,0.425,0.111,-0.184,-0.1472,-0.096,-0.0985,0.0708,-0.121,0.0293,-0.0909,-0.1101,-0.0257,-0.1858,-0.0855,0.1285,-0.1124,-0.2545,-0.0862,-0.0982,-0.0676,-0.0618,-0.1118,-0.127,-0.1318,-0.0789,-0.0885,-0.2513,-0.185,0.1616,0.2814,-0.031,-0.0354,0.0507,0.021,-0.0519,-0.1044,-0.1146,-0.167,0.0396,0.0655,-0.237,-0.2939,-0.1135,-0.0675,-0.131,-0.1959,0.0094,-0.1442,-0.0753,-0.1577,-0.1209,-0.09,-0.1163,-0.0237,-0.0133,-0.0458,0.1815,-0.1057,0.0471,0.2052,0.1065,-0.1845,-0.0187,-0.2113,-0.1921,-0.1021,-0.0519,-0.0507,0.0567,0.1345,0.1668,-0.0209,-0.0925,0.0487,-0.099,-0.0046,0.1661,-0.1954,-0.1062,-0.1874,0.0482,0.0399,0.1599,0.0138,-0.316,-0.2781,-0.0157,0.0051,0.0053,0.1652,0.1132,-0.0047,-0.1472,-0.1598,-0.083,-0.1824,-0.3629,-0.1521,-0.1108,0.1252,-0.0029,0.1975,-0.0247,0.1614,0.0042,0.0271,0.03,0.1099,0.1739,0.0426,-0.0228,0.0039,-0.0951,0.0256,-0.0545,-0.0054,-0.0646,-0.0361,-0.0305,-0.0076,-0.105,-0.0581,-0.0928,-0.0803,-0.196,-0.0457,0.0216,0.1039,-0.0496,0.098,0.0178,0.0599,-0.0408,-0.0231,0.0184,-0.084,-0.2273,-0.1003,0.2149,0.1774,0.0217,-0.0719,-0.0753,-0.145,-0.0994,-0.0206,-0.0767,0.1334,0.112,-0.2286,-0.2017,0.0174,-0.1857,-0.0598,-0.0507,0.4079,0.2817,-0.2928,0.0728,-0.1088,-0.0229,-0.0821,-0.2354,-0.2494,-0.1894,0.0673,-0.011,-0.117,-0.0173,-0.1385,-0.0429,0.1786,-0.0003,0.0726,0.0142,-0.0042,0.0303,-0.1931,-0.0478,0.0728,-0.1613,0.0866,-0.2514,0.2101,-0.2304,0.3068,0.1112,0.113,-0.3189,-0.2789,0.0989,0.2397,0.0511,0.2276,0.0532,0.0967,0.1016,0.0336,0.1229,0.0848,0.0722,0.0867,0.0979,0.0619,0.1161,-0.0989,0.1482,0.3286,0.601,0.2723,0.2344,0.4086,0.2166,0.2526,0.308,0.2294,0.2808,0.1804,0.2742,0.2904,0.1909,0.2427,0.3141,0.3948,0.3034,0.3394,0.2165,0.2787,-0.247,-0.0868,-0.2524,-0.1402,-0.0901,-0.2925,-0.2662,-0.12,0.0398,-0.0462,-0.3379,-0.2939,-0.1921,-0.0294,0.0033,-0.2173,0.1411,-0.0396,-0.1025,0.0335,-0.1238,-0.0916,-0.0657,-0.0949,-0.1751,0.1033,-0.2562,-0.2702,0.0942,-0.0152,-0.0758,0.0187,0.026,-0.1808,0.1904,0.1741,-0.1866,0.2358,0.301,0.0364,0.0987,0.1548,-0.1032,0.3603,0.3643,-0.0619,-0.0818,0.1342,-0.0616,0.0183,-0.154,-0.0596,0.1457,-0.0503,-0.0974,0.0491,0.0135,-0.0417,-0.0329,motion detection
trm_55b6b952c1b4c,-0.0106,0.0259,-0.0062,-0.0572,0.0278,0.0218,0.0195,0.0246,0.0099,0.0206,-0.0162,-0.0206,0.0268,-0.0379,-0.0423,-0.0082,0.0165,-0.0582,-0.0141,-0.0567,-0.0451,-0.0457,-0.0168,0.0074,-0.0091,-0.0171,-0.0159,-0.073,-0.0479,-0.0108,-0.0188,-0.0155,0.0292,0.0056,-0.021,-0.0034,0.0908,0.031,0.0325,-0.0224,-0.015,0.0121,0.0363,-0.0,-0.0342,-0.0499,0.028,0.026,-0.0567,-0.0163,-0.002,0.0427,-0.0143,-0.0411,-0.0583,0.0417,0.0295,0.0027,0.0694,-0.0143,0.0139,0.0186,-0.0531,-0.0012,-0.0403,0.1009,-0.0646,-0.0824,-0.0629,-0.0498,-0.0039,-0.0285,-0.0274,-0.019,-0.0579,-0.0552,0.0429,-0.0131,0.0427,0.0249,0.0346,-0.0003,-0.0058,-0.0733,-0.0362,0.0494,0.0355,0.0441,0.007,0.0182,0.0237,0.0453,0.0596,0.1687,0.1389,0.1592,0.0491,0.0615,0.083,0.1464,0.0285,-0.0123,0.0555,0.1536,0.0651,-0.0197,-0.0927,0.0084,-0.0095,0.0721,-0.027,-0.077,-0.046,0.0775,0.0122,-0.0422,-0.0866,0.1062,-0.0982,-0.0374,-0.091,-0.0729,-0.095,-0.0239,-0.0367,-0.1065,-0.1137,0.0398,0.0513,0.0078,-0.0977,0.0266,0.0394,-0.0483,-0.0716,-0.0296,0.0533,-0.0155,0.0023,0.0944,-0.0046,-0.0043,0.0277,-0.0439,-0.0111,0.0269,0.0095,-0.0467,-0.0353,0.0166,-0.0612,-0.031,0.0593,-0.109,-0.0385,0.0159,0.0901,-0.0005,0.0007,0.0769,0.0019,-0.0303,-0.0707,-0.0538,0.0084,0.0365,-0.01,-0.1238,-0.1294,-0.0607,0.0495,-0.061,0.1056,-0.1028,-0.0631,-0.0613,-0.0202,-0.0857,-0.0518,-0.0124,-0.0137,0.0178,-0.004,0.0345,0.0051,-0.0389,0.073,-0.055,-0.0407,-0.0989,-0.1087,-0.0623,-0.042,-0.0935,-0.0813,-0.1223,-0.1318,-0.081,-0.0164,0.0193,0.0206,0.1451,-0.0566,-0.0398,-0.0511,0.0622,-0.0364,-0.0376,-0.0322,-0.0002,-0.0933,0.0088,-0.0045,0.0183,0.005,-0.0333,-0.0064,0.0503,0.1932,-0.003,0.0332,-0.0822,0.0085,-0.0122,-0.0023,0.0197,-0.076,0.0031,-0.0336,-0.0805,0.1759,-0.0029,0.0508,-0.0291,-0.0227,0.0127,-0.0719,-0.0599,0.0411,-0.0227,0.057,0.0044,0.0523,-0.0103,-0.0268,-0.022,-0.0338,-0.0522,0.043,-0.0702,-0.0099,0.0239,-0.0276,0.0231,0.0447,-0.0748,0.0023,-0.0022,0.0032,0.0338,0.0229,-0.0114,-0.0916,-0.0244,0.0128,-0.0157,-0.0002,-0.0482,0.0179,-0.003,0.0307,0.0086,-0.0442,-0.0529,0.06,0.0918,0.0754,0.0486,0.0588,0.0643,0.0188,-0.045,-0.0609,-0.1341,-0.1144,0.0249,0.0027,0.0207,0.024,0.0103,0.0778,-0.0552,-0.0005,-0.0529,0.0076,-0.0249,-0.0243,-0.0143,-0.0493,-0.0366,-0.0092,-0.1599,0.0644,0.0919,0.0468,0.0579,-0.0095,-0.0035,0.0941,-0.0306,0.0284,0.0179,-0.0627,-0.045,-0.0359,-0.0022,0.0144,0.0411,-0.043,-0.0808,-0.0405,-0.0332,0.0082,-0.0801,-0.005,-0.0494,0.0064,0.0296,0.0265,0.0859,0.025,0.0149,-0.0494,0.0077,-0.0526,0.0427,-0.0187,-0.0683,-0.0104,-0.1212,-0.1135,-0.0179,0.1047,0.0641,-0.0022,-0.0075,0.0244,-0.002,0.0404,0.0272,0.0444,0.1736,0.1213,0.0944,0.0096,0.0848,0.0218,-0.0285,-0.014,0.0113,-0.0194,-0.0361,-0.0538,0.0262,0.0206,0.1213,0.0187,-0.0344,0.0178,-0.0099,0.0103,-0.0147,-0.0212,0.0644,-0.0814,-0.0118,0.0327,-0.0043,-0.0055,0.0227,-0.0161,0.1234,-0.1058,-0.0916,0.0675,0.0454,0.0182,0.0529,0.0035,-0.0207,0.0123,-0.0264,0.0719,-0.0281,0.0556,0.1181,0.11,-0.0088,0.0098,-0.0184,-0.0764,-0.0329,0.0115,0.0263,0.026,-0.0697,-0.0193,0.0044,0.0241,0.0368,-0.0072,-0.0029,-0.036,0.002,-0.0485,-0.0909,-0.013,-0.0143,-0.0807,-0.0613,-0.0088,0.009,0.0383,-0.1173,-0.0995,-0.0137,-0.07,0.0997,-0.0697,0.0451,0.0114,0.0346,-0.0219,0.0036,-0.031,-0.0271,0.1314,-0.0154,-0.0198,-0.0077,0.0903,-0.0103,0.0266,-0.0223,0.0251,0.0272,0.051,0.0834,-0.1152,-0.2143,-0.1578,-0.0465,-0.0216,-0.0737,0.0128,-0.1357,0.0643,-0.0904,-0.1125,-0.0268,-0.0615,-0.0513,-0.0402,-0.0162,-0.0267,0.0115,0.0685,-0.0194,0.0404,0.0657,-0.021,0.0188,-0.0072,0.0143,0.009,-0.0387,0.0906,0.0539,0.0287,-0.0072,0.1182,0.0228,0.0499,0.0114,-0.073,-0.0003,0.0883,0.058,-0.1085,0.0121,0.1328,0.0782,-0.0155,-0.0152,0.0187,-0.0056,-0.0763,-0.0146,-0.0233,-0.0759,-0.0636,-0.0654,-0.0276,0.004,-0.0655,-0.0538,-0.0423,-0.0759,0.0146,0.1016,-0.0273,0.1275,-0.026,0.0092,0.0372,0.0261,-0.0672,-0.0671,0.1138,-0.0422,-0.0526,-0.0405,0.0584,-0.1008,-0.0716,-0.0371,0.001,0.0587,0.0769,0.0019,-0.0204,0.0292,0.1021,0.0188,-0.0669,0.0073,-0.044,0.0125,-0.0128,-0.0097,-0.053,-0.057,-0.0051,0.0403,-0.0555,0.0387,-0.0148,-0.0291,0.0061,-0.0112,0.0722,-0.0883,-0.0348,0.0378,0.0153,0.0139,-0.0062,-0.0402,0.0341,0.0149,-0.0479,-0.0429,-0.0806,0.0209,-0.0222,-0.0055,0.0056,-0.0635,-0.0413,-0.0924,-0.0761,-0.0766,0.017,-0.069,0.3947,0.2108,0.0628,0.0627,0.0206,-0.0276,-0.0224,-0.0296,-0.053,0.0204,-0.0147,-0.0362,-0.034,0.0087,0.0487,-0.0461,-0.0052,-0.0648,-0.0648,-0.0469,-0.0531,0.0493,-0.0829,-0.0261,0.0109,0.0228,0.0028,-0.0233,-0.0139,0.0377,0.0351,0.2529,-0.0653,-0.0152,-0.0099,-0.0863,-0.0123,0.036,-0.0313,0.0067,-0.0448,-0.0745,-0.0164,-0.0623,0.0026,-0.0048,0.0432,-0.0525,0.0691,0.0084,0.041,0.1096,-0.0539,-0.0573,-0.0005,-0.0274,-0.0264,0.1199,-0.0125,-0.0791,-0.0975,0.0663,-0.0193,0.0233,-0.0573,0.0005,-0.0148,0.0701,-0.0139,0.3101,-0.004,-0.038,-0.1093,-0.1001,0.0203,-0.0478,-0.1226,-0.0029,0.0205,-0.0397,-0.0303,0.0076,0.1364,0.009,-0.0276,0.0098,-0.0323,0.1844,0.0593,0.278,0.0362,0.0231,0.0845,-0.0572,0.131,0.0583,0.034,0.0485,0.0075,0.0896,0.004,0.0134,0.095,-0.0375,0.0096,-0.0224,-0.0478,0.0712,-0.026,-0.0322,0.0429,-0.0847,-0.0143,0.0233,0.0203,0.0114,-0.0308,-0.0459,-0.0168,-0.0598,-0.0549,-0.0519,0.0604,-0.0115,-0.0287,-0.0899,-0.011,-0.0175,-0.0198,-0.021,-0.0365,0.0103,-0.0501,0.0249,-0.0124,-0.0831,-0.0097,-0.0887,-0.0807,0.0123,-0.1291,-0.0704,0.0115,0.0195,-0.0045,-0.0479,0.0573,-0.0291,-0.0959,-0.091,-0.0436,-0.0315,-0.0766,-0.0859,-0.0805,0.036,0.0476,-0.0194,0.0309,0.0027,-0.0062,0.0493,0.0265,-0.046,-0.031,-0.0797,-0.0997,0.034,0.0138,0.0908,-0.0596,-0.019,-0.0076,0.0603,-0.0433,-0.0221,-0.0435,0.0197,-0.0869,-0.126,-0.127,-0.1105,0.0276,0.0458,-0.0226,0.0401,-0.0041,0.0574,0.0402,0.0026,0.0185,0.046,-0.0683,-0.0213,0.0363,0.0057,0.0382,0.0648,0.0199,0.006,0.0118,-0.0005,0.0255,-0.0207,-0.0817,-0.0761,-0.0695,-0.0478,-0.0421,0.0052,0.001,0.0048,-0.0114,0.0191,-0.0395,-0.0564,0.0469,-0.0324,-0.0224,0.0124,0.0063,0.0428,-0.0201,-0.0202,-0.0035,-0.0627,-0.0675,-0.0223,-0.0124,0.0604,-0.0431,-0.0355,0.0389,0.0051,0.0154,0.0667,0.0851,0.0041,0.0142,0.0405,0.0698,0.0282,0.0236,0.0002,0.0555,0.0094,-0.0632,-0.0696,-0.0932,0.0871,-0.0408,-0.0307,-0.1476,-0.0816,-0.0915,-0.0441,-0.121,0.0186,-0.0235,0.0282,-0.0181,0.0363,-0.0899,0.0484,-0.0275,-0.0284,-0.0242,-0.0149,0.0017,-0.0092,-0.0202,0.0123,-0.0192,-0.0237,-0.0678,-0.0327,-0.0666,0.0456,0.0165,-0.0231,-0.0295,-0.0506,-0.1072,-0.0961,-0.0709,0.0184,0.0026,-0.0788,-0.0414,-0.0872,0.0705,0.1827,-0.0754,-0.0623,0.067,-0.0857,0.022,-0.0699,0.2303,-0.0662,0.0007,-0.1445,-0.1031,-0.1193,-0.0933,-0.0835,-0.0525,0.0184,-0.0632,-0.0797,0.0031,0.0012,0.0456,-0.0624,-0.0363,-0.0762,0.0335,0.0614,0.1472,0.0758,0.0193,0.0854,-0.0603,-0.0427,0.0153,-0.0283,-0.0707,-0.0366,-0.0162,-0.0524,-0.0425,0.0204,-0.0229,-0.0717,-0.0424,-0.0294,-0.0312,0.1269,-0.0579,0.0226,0.0403,0.0055,-0.0044,-0.0326,0.0347,0.0312,-0.0113,-0.0035,-0.0321,-0.0239,0.0876,0.0534,0.0288,0.0607,-0.0331,-0.0266,0.058,-0.0209,0.0113,-0.0088,-0.0432,0.0002,-0.0299,-0.0032,0.002,-0.0874,-0.0886,-0.1157,-0.0978,-0.142,-0.0818,-0.0697,-0.0477,-0.0621,-0.093,-0.0888,-0.1004,-0.0748,-0.0326,0.0152,-0.0179,-0.0122,-0.0044,-0.0118,0.045,0.0513,-0.0198,0.0434,-0.0295,-0.0919,-0.0637,-0.0108,0.0693,0.0117,-0.0487,-0.0382,-0.0227,0.0228,0.0354,-0.0297,0.0346,-0.0098,-0.0177,-0.0203,0.0432,-0.0014,-0.0269,-0.0426,-0.0486,-0.0588,-0.0883,-0.1412,-0.1278,0.0739,0.017,0.0808,0.0443,-0.014,-0.0233,-0.0507,-0.0482,0.0457,-0.0172,0.0506,0.0215,0.0361,-0.0109,0.0437,-0.011,0.047,0.0171,0.0643,0.0546,-0.0719,-0.0159,-0.0386,-0.0211,0.0591,-0.0325,-0.0129,-0.0501,-0.0828,-0.0531,-0.0481,-0.0449,-0.0292,-0.0065,-0.0109,0.0242,0.1617,0.0227,-0.0482,-0.0508,0.0171,-0.0734,-0.0284,-0.0078,-0.0263,0.2173,0.2202,-0.1246,-0.0793,-0.1017,-0.0713,-0.0282,-0.0504,-0.0609,-0.0652,0.0283,0.0695,0.0283,0.0213,0.0016,-0.0619,-0.0229,-0.0066,0.1092,0.0546,-0.0269,-0.0669,-0.0039,0.0253,0.0439,0.0962,-0.0276,0.1022,0.0246,-0.0322,-0.0244,-0.0357,-0.0723,-0.0354,0.0394,0.0087,-0.0202,0.0147,-0.0331,-0.0808,-0.031,0.0012,0.0037,0.0012,0.0078,0.0089,0.0393,0.0333,0.2084,-0.0006,0.0617,-0.0132,-0.012,0.0713,-0.0696,-0.0415,0.0377,-0.0147,0.0783,0.0631,0.0403,0.0197,0.0249,0.0493,0.0485,0.0372,-0.0826,-0.0192,0.02,-0.006,-0.0221,-0.0698,0.006,0.0566,0.0236,-0.0524,0.0199,-0.0407,0.067,-0.0176,-0.0421,0.0342,0.0346,-0.0298,-0.0214,-0.0251,-0.0606,-0.0419,-0.0416,-0.0763,0.0278,-0.0724,-0.0082,0.0135,0.0603,-0.0233,-0.0603,-0.0724,-0.0549,-0.0477,0.0244,0.0642,0.1155,0.0022,0.0079,-0.0483,-0.0157,0.0095,-0.0185,0.0567,0.0697,-0.048,0.0358,0.0918,0.3467,0.2564,0.2567,-0.0022,0.0488,-0.047,-0.013,-0.0148,0.0344,-0.0488,-0.0592,-0.0245,0.1322,0.0173,-0.0016,0.0132,0.0081,0.0272,0.0843,-0.0969,0.1174,0.1995,0.0115,-0.0914,0.0242,-0.0715,-0.0264,0.0384,0.0352,-0.0792,-0.0906,-0.0239,-0.056,0.1163,0.1167,-0.0437,-0.0229,-0.06,-0.1134,-0.0732,-0.0181,0.0206,-0.0176,-0.0673,-0.1332,-0.0489,-0.0028,-0.0336,-0.0952,-0.0888,0.0089,-0.0617,-0.0739,-0.0298,-0.0078,-0.0898,-0.0507,-0.0116,-0.0682,-0.0718,0.0135,-0.0013,0.0945,0.0461,-0.01,0.0129,0.023,-0.0176,-0.0447,0.0523,0.0057,-0.1003,-0.066,-0.0374,0.0307,-0.0137,0.0114,-0.0249,-0.008,-0.0767,0.0107,-0.0687,-0.0511,-0.0994,0.0378,0.058,0.0351,-0.0694,-0.107,-0.0087,0.1303,-0.0326,0.0121,-0.0303,0.0708,0.0194,0.1014,-0.1241,-0.1242,-0.0838,0.1259,-0.0447,-0.0236,0.0635,0.0635,-0.063,-0.0133,-0.0126,-0.0009,0.0596,-0.059,0.0563,0.1839,-0.0912,-0.0955,-0.0259,0.0294,-0.0588,-0.0777,-0.0242,-0.0083,0.0557,-0.0806,-0.0716,0.0079,0.1032,-0.0008,-0.0495,-0.0199,0.0001,0.0249,-0.0424,0.039,0.0081,-0.0579,-0.0193,-0.0539,-0.0604,-0.0787,0.0633,0.0041,-0.0302,0.3709,0.257,0.265,0.0557,0.3355,-0.0531,-0.0597,-0.0241,-0.069,0.0206,-0.052,0.0079,0.0278,-0.0451,-0.0946,0.1457,0.0801,-0.0372,-0.0106,0.0501,-0.0768,-0.0165,0.0195,-0.0174,0.1109,-0.0419,-0.0181,0.0054,0.0835,0.1387,0.1481,0.0303,0.0412,0.0195,-0.0318,0.04,0.0443,-0.054,-0.0538,-0.009,-0.1111,0.0261,-0.0095,-0.0428,-0.0476,-0.05,-0.0757,0.0083,-0.0124,0.1191,0.0156,-0.0465,-0.0151,0.0314,0.0303,-0.1201,-0.1464,-0.1171,0.0182,0.0045,0.0075,0.006,0.0128,0.072,0.0421,-0.0285,-0.0864,-0.0855,-0.0084,-0.0516,-0.053,0.029,0.0321,0.223,-0.0261,-0.0423,0.0775,-0.0361,0.0408,-0.0145,-0.0272,-0.0095,-0.0538,0.0215,0.0055,-0.0922,0.0959,-0.0476,0.0278,0.1904,-0.0365,0.0344,0.0443,0.0876,0.1311,-0.0348,0.0799,-0.0867,-0.0439,-0.0968,-0.0911,-0.064,-0.043,0.0399,-0.072,-0.12,-0.0551,-0.0459,-0.0222,0.0013,0.0046,0.0045,-0.0279,0.0363,0.0412,0.0076,-0.0199,0.0014,-0.1049,-0.0766,-0.0567,-0.0442,0.0012,0.0393,0.0372,0.0212,-0.0143,-0.0122,-0.0218,-0.0148,0.0315,-0.022,-0.009,0.0204,0.1629,0.2697,-0.0393,0.0279,-0.0312,0.0445,0.0617,-0.0072,-0.0404,-0.0147,0.0215,-0.0797,0.044,0.1262,0.0399,-0.0079,0.0083,-0.0517,-0.0037,-0.0751,-0.0395,-0.0527,-0.0313,0.0525,0.0181,-0.0783,0.0625,-0.0286,-0.0064,0.0078,-0.0123,-0.031,-0.0616,-0.0095,0.0186,0.0691,0.0333,-0.0335,-0.0033,0.0774,-0.0038,0.1162,0.1255,0.0269,0.0099,0.0473,-0.0477,-0.0386,-0.0494,0.0325,0.0333,-0.0086,0.033,0.0512,0.0796,0.0016,0.0053,0.0081,0.1221,0.0105,-0.0584,-0.0923,0.0474,0.0399,0.0433,-0.0491,-0.0241,0.0251,0.1036,0.0138,0.0079,-0.0162,0.0718,-0.0137,0.0634,0.0066,0.1368,-0.0477,0.017,-0.0352,0.0266,-0.0396,0.1059,-0.0046,0.0254,0.022,0.0166,-0.0045,-0.0401,-0.0146,0.0322,0.0817,0.0728,0.0041,-0.0553,0.0701,-0.0344,0.0393,0.0245,0.006,-0.0307,-0.0469,-0.0084,0.0178,-0.0149,0.0558,-0.0974,0.0376,0.056,0.0577,-0.01,0.0065,0.3699,-0.0528,-0.0146,0.1272,0.046,0.0407,-0.0225,-0.0077,-0.0679,-0.0837,0.0157,0.1102,-0.0046,-0.0449,-0.1033,-0.0383,-0.0968,-0.0389,-0.0586,0.0224,-0.037,0.0008,-0.0432,-0.0176,-0.0566,0.0097,0.0194,-0.0209,-0.0205,0.0305,0.0592,-0.0444,-0.0647,-0.0331,-0.0079,-0.0389,-0.0638,0.009,0.0668,0.0374,-0.0204,0.0625,0.0601,-0.0527,-0.0219,-0.0679,0.0059,0.1122,-0.0994,-0.0438,-0.1169,-0.0563,0.1094,0.0092,0.0965,-0.0096,0.0107,-0.0067,-0.0246,0.0164,-0.0131,-0.0768,0.0461,0.0118,0.0622,0.0158,0.0595,-0.0184,-0.0031,0.0059,0.0808,-0.0204,-0.0612,-0.0174,0.0543,-0.0953,-0.0021,-0.0252,-0.0527,0.0531,0.231,-0.07,-0.0542,0.0393,0.0304,0.0962,0.1306,0.0087,-0.0489,-0.0316,-0.0551,-0.0513,-0.1056,0.0121,-0.0225,-0.0372,0.0088,-0.0098,0.0122,-0.0226,-0.0382,-0.0861,-0.0894,-0.1211,-0.0847,-0.0459,0.0737,-0.0334,0.0411,0.0999,0.0493,0.1029,0.0466,0.1082,0.1117,0.0188,0.0093,-0.0494,-0.1136,0.0292,-0.0033,0.0888,-0.0414,-0.0903,-0.1099,-0.0014,-0.0075,-0.0,0.0009,0.3318,0.0262,0.0899,0.0685,0.2081,0.1312,0.0184,0.0118,-0.0092,0.0909,0.0248,0.0165,-0.0148,-0.0727,-0.077,-0.049,-0.1248,-0.0171,-0.0551,-0.0963,-0.0217,0.0166,0.0186,-0.0252,-0.0323,-0.0761,0.0057,0.0614,0.0775,0.1402,0.0436,0.0128,0.0988,0.0547,0.0866,-0.0124,-0.023,-0.0407,-0.0254,-0.0332,0.0255,-0.0057,-0.0151,-0.0802,-0.0134,0.048,-0.1293,-0.0491,-0.0769,-0.0514,-0.0636,0.1139,0.0275,-0.097,-0.1014,0.0251,0.0089,-0.0322,0.048,0.0048,0.025,0.0432,0.0275,0.0064,0.0275,-0.0034,-0.007,-0.0069,0.0316,-0.1858,-0.114,-0.0538,-0.0852,-0.1378,0.0276,-0.0954,0.1562,0.0154,-0.019,-0.0424,-0.0265,-0.0486,0.1395,-0.1246,-0.2026,-0.0854,-0.0641,-0.0887,-0.0956,-0.0989,-0.142,-0.1118,-0.0232,-0.0093,-0.018,-0.093,-0.0106,-0.0841,-0.0825,-0.041,0.0089,-0.0497,-0.0937,-0.0736,-0.0744,0.0617,-0.0286,-0.0144,-0.0246,-0.0853,-0.0343,-0.0362,-0.0505,-0.0139,-0.0424,-0.0507,-0.0122,-0.0372,-0.0492,-0.0099,-0.0128,-0.0381,-0.0328,-0.1009,-0.1172,0.0571,-0.077,-0.0447,0.0242,0.1693,0.1057,0.0457,-0.0298,-0.0494,0.0573,0.0464,0.0637,-0.0691,-0.096,0.0543,0.078,0.0142,-0.0165,-0.0202,-0.056,0.0208,-0.0088,-0.0412,0.0263,0.0815,-0.0207,-0.0894,-0.0662,-0.0514,0.0666,-0.0167,0.0043,0.0693,0.0401,0.0512,-0.1159,-0.0973,-0.0029,0.0114,-0.0834,-0.0567,0.1226,-0.0955,-0.0374,0.3062,0.1298,0.3417,0.2411,0.1734,0.1997,0.0091,0.2173,0.0381,0.0372,0.2167,0.3441,0.2975,0.3037,0.14,-0.1214,0.0176,0.041,0.1213,-0.0251,-0.0824,0.0861,0.0062,-0.0136,0.0318,0.161,0.0393,-0.0027,0.1814,-0.0266,0.0112,0.0666,-0.0116,-0.0715,-0.0025,0.0118,-0.0034,-0.0209,0.0077,-0.0682,0.065,-0.0142,0.0112,-0.0769,-0.0405,-0.1321,-0.067,-0.0144,-0.0851,-0.0503,-0.0499,-0.0908,-0.0382,-0.0601,-0.0541,0.1535,0.1721,0.0041,-0.0053,-0.107,0.0447,-0.0015,0.0351,0.0061,-0.0475,0.0172,-0.0333,-0.0384,-0.0798,0.0111,-0.0656,-0.0113,0.0712,0.0918,0.029,0.0358,0.0934,-0.0302,-0.1015,0.0233,-0.0783,-0.0641,-0.0669,-0.0633,0.0179,-0.0332,-0.0907,0.0641,-0.0081,0.0399,-0.0108,0.0199,0.0417,0.0283,-0.066,0.0019,0.0224,0.0489,-0.021,-0.0601,0.0146,0.0076,-0.0405,-0.0316,0.0066,0.0565,-0.0516,-0.0796,-0.0721,-0.0413,-0.0282,-0.0428,-0.0605,0.0861,0.0356,-0.0457,0.0287,0.0562,0.1845,-0.0072,0.074,0.048,0.1395,-0.0709,-0.0684,-0.0124,-0.0017,0.0694,0.0891,0.0188,-0.021,-0.0636,0.0017,0.0435,0.0476,0.0735,0.0481,0.0089,0.0254,0.0875,0.0733,0.0435,-0.1131,0.0244,-0.0098,-0.0189,-0.0409,-0.0471,-0.01,0.0048,-0.0088,0.0973,-0.0047,0.0148,-0.0359,0.1023,-0.0094,0.0739,-0.0124,0.0046,0.0472,-0.0611,-0.031,-0.0233,0.0078,-0.1023,-0.1509,-0.1376,0.0755,0.0605,0.0269,0.0297,-0.0478,-0.0244,0.0922,-0.0304,-0.0437,0.091,-0.064,-0.1223,0.1494,-0.0367,0.0181,-0.0524,-0.0049,0.0096,0.0911,0.0369,0.0402,0.0257,0.0255,0.2169,0.104,0.0987,-0.0209,-0.0109,-0.0527,0.0635,0.0301,-0.0232,-0.0032,-0.1124,-0.0554,-0.085,-0.0821,-0.0423,0.0995,-0.0088,0.1207,0.026,0.0122,0.019,0.0522,0.0406,-0.0179,-0.0267,-0.0329,0.0143,0.0152,0.053,0.1137,-0.0518,-0.0119,-0.0235,0.043,0.0701,0.0851,0.0517,0.0478,0.0084,-0.0094,0.0156,0.0182,0.0302,0.0366,0.0024,0.0468,-0.0203,0.0176,0.1221,0.143,0.0101,0.0094,-0.1198,0.0491,-0.0905,-0.0448,-0.0788,0.0454,0.002,0.0228,0.0238,0.0521,0.0801,-0.0479,0.0692,0.1318,-0.0604,0.0191,0.0455,0.1021,0.0358,0.1601,0.0819,0.0372,-0.0328,-0.0285,-0.0063,0.1338,-0.0453,-0.002,0.0261,0.004,0.057,0.0633,-0.0111,-0.0256,-0.042,-0.1201,-0.1323,-0.0811,-0.0756,-0.0568,-0.046,-0.1551,-0.0193,0.1323,-0.0254,0.059,0.0972,-0.0152,-0.0485,-0.0391,0.1175,-0.007,-0.0594,-0.0886,0.0254,-0.0247,-0.0679,-0.0237,0.0753,0.0611,0.0614,0.0818,0.0067,0.0683,-0.0181,-0.0141,0.0019,-0.0356,-0.0276,-0.0543,-0.0375,0.0906,0.0176,-0.0106,0.0034,-0.0853,-0.0941,0.0214,-0.0869,-0.005,-0.0327,-0.0204,0.0118,0.0461,0.0257,0.0531,-0.0973,-0.034,-0.0038,-0.0653,-0.0532,-0.0461,-0.0868,-0.0868,-0.0259,0.0057,0.007,-0.0169,0.0216,0.2545,0.2017,-0.0291,-0.0426,-0.1317,0.0091,0.0938,-0.0482,-0.0399,0.0773,0.0842,0.0225,-0.0176,-0.0233,0.1002,0.0883,0.0392,0.0177,0.11,0.0794,0.0471,-0.0114,0.0018,0.0059,0.197,0.1218,0.0337,-0.0916,-0.0797,-0.006,-0.0208,-0.0638,-0.0589,-0.052,-0.0098,-0.0555,-0.0267,0.0276,-0.0093,-0.0758,-0.034,0.0457,-0.2272,-0.0741,-0.2141,-0.0887,-0.0609,-0.0423,-0.0648,0.2677,0.2481,0.1025,0.1146,0.0988,0.0391,-0.0476,-0.0561,-0.0081,0.054,0.0285,0.116,-0.0064,0.1105,-0.0308,0.0155,0.0281,-0.0337,-0.084,0.0438,-0.0164,0.3435,0.0563,0.3284,0.2,0.2507,0.1308,0.2332,0.0259,0.0467,0.0168,-0.0281,0.06,0.0871,-0.0253,-0.051,-0.0342,-0.0676,0.0616,-0.0251,-0.0568,-0.0874,0.0152,0.0086,-0.068,-0.0266,-0.1219,-0.0635,-0.0139,0.091,0.08,-0.0054,0.0491,0.0582,-0.0152,-0.04,-0.0311,-0.0571,0.0704,0.0441,0.0646,0.0017,0.0125,0.0519,0.1403,-0.0728,-0.0384,0.013,-0.0481,-0.0083,-0.0365,-0.013,-0.0083,0.0092,-0.003,0.0062,0.0039,0.0485,0.0434,0.0812,-0.0827,-0.0777,-0.0673,-0.0535,0.039,0.0254,-0.0077,-0.0915,-0.0515,-0.0569,0.0036,-0.0723,-0.0208,-0.0052,0.1072,0.0213,-0.051,-0.0121,0.0555,-0.0753,-0.0303,-0.0426,0.0138,0.0171,0.0122,0.0247,0.0294,0.0192,-0.0104,0.0332,0.0544,0.0061,0.0226,-0.0539,0.0477,-0.0567,-0.0303,0.0207,-0.0309,0.0619,0.1021,0.0244,0.015,0.0157,-0.0372,-0.0613,-0.0466,-0.055,-0.0274,0.0071,0.0359,-0.058,-0.0387,-0.0896,-0.0974,-0.1405,-0.0565,0.0014,-0.073,-0.0195,-0.065,-0.0588,-0.0612,-0.0445,-0.016,0.0083,-0.0225,-0.0825,0.0512,0.0294,0.0968,0.1542,0.0288,-0.0378,0.0351,-0.0323,-0.0314,-0.0673,-0.0113,-0.054,0.0336,-0.0871,0.0397,-0.0061,0.0396,-0.0472,-0.0314,-0.0614,-0.0167,-0.0317,0.0317,-0.0404,0.0043,-0.0769,0.0031,0.0438,-0.1238,-0.0614,-0.1141,-0.0408,0.1491,0.0437,0.0046,-0.0703,-0.0401,-0.0156,-0.0913,-0.0535,-0.0385,-0.0682,-0.0793,-0.0387,-0.015,0.0356,0.0643,0.053,-0.0,-0.0082,0.0106,-0.0534,-0.0148,-0.0415,-0.0228,-0.0025,-0.0094,-0.074,-0.1026,-0.0815,0.0628,0.19,-0.0165,0.0206,-0.0521,0.0116,0.0207,0.1363,-0.028,-0.0591,-0.0719,0.0419,0.0498,0.1937,0.087,0.0563,-0.0105,0.0157,-0.02,-0.0012,0.0036,-0.0062,-0.0437,-0.0965,-0.022,-0.0691,0.018,-0.0396,0.0052,0.0676,0.0207,0.069,0.0273,-0.0237,-0.0196,0.0115,-0.0426,-0.0716,-0.0266,-0.0283,0.0197,-0.0977,0.0574,-0.0231,-0.0084,0.0246,-0.0213,-0.0548,0.034,0.0098,-0.0351,-0.0078,0.0257,0.0514,0.0299,0.0418,-0.0395,-0.0419,0.0489,0.0248,0.0347,-0.0343,0.0239,-0.1367,-0.0701,-0.1062,-0.0911,0.0558,0.0026,0.026,-0.0808,0.0632,-0.0297,-0.1144,-0.0463,-0.0632,-0.0978,0.083,-0.0354,0.0039,-0.1784,-0.0493,0.0249,0.0932,-0.0262,-0.0525,-0.0792,0.0421,-0.0677,0.0309,-0.0475,0.0101,-0.0743,-0.0695,-0.0225,0.0091,0.2088,0.0004,0.011,-0.0399,-0.063,-0.0305,-0.0506,-0.0896,-0.0219,0.0615,-0.0877,-0.052,0.0726,-0.0622,0.0133,-0.0544,0.0167,-0.0146,-0.0172,-0.0525,-0.0764,-0.1193,0.0179,0.013,-0.0169,-0.1144,0.0209,0.0839,0.0031,0.0454,-0.022,-0.014,0.2346,0.2234,-0.0847,-0.0059,-0.0527,-0.052,0.1239,-0.0516,0.0207,-0.039,-0.0247,-0.0097,0.0295,0.0282,-0.0268,0.0225,-0.0285,-0.0839,-0.0518,-0.1119,-0.0286,-0.0429,-0.0807,-0.0306,-0.0167,0.0859,0.0926,0.0257,0.0325,-0.0247,0.318,0.3408,0.2134,0.0251,0.0412,0.1427,-0.079,-0.0607,-0.0601,-0.0416,0.003,0.0516,0.0512,0.0359,0.1084,0.0475,0.2054,0.0423,0.0313,-0.0805,0.0654,0.0157,-0.0443,0.0261,0.0546,-0.0723,0.0368,-0.0444,-0.0148,-0.0674,0.0101,-0.0458,-0.0138,-0.0622,0.0139,0.0564,0.0072,0.0426,0.0075,-0.0406,-0.0768,-0.0727,-0.0384,0.0854,-0.0398,0.0325,0.0785,0.0109,0.0164,0.0129,-0.0399,0.0415,0.1825,0.0173,0.0487,0.0801,0.0256,0.0561,-0.0005,-0.0173,-0.0323,0.0901,-0.013,-0.019,0.0308,0.1199,0.1057,-0.0105,0.013,-0.0223,0.1774,-0.0089,0.0596,0.046,0.0946,0.0622,0.1457,0.0998,0.0473,0.0564,0.1253,0.1001,-0.061,-0.0981,0.0251,-0.0545,0.1048,0.1182,0.0735,-0.0412,0.0037,0.0191,0.0074,0.2096,0.0166,0.004,-0.0074,-0.0298,-0.0947,-0.0377,-0.0722,-0.0544,-0.0458,-0.0201,0.0063,-0.0595,0.3199,0.2805,0.2295,-0.0418,0.0435,0.0577,0.0394,0.0571,0.0696,-0.0055,0.0469,0.0481,0.03,-0.0381,-0.0045,0.1472,0.0302,-0.011,0.0208,-0.0125,-0.0454,0.0543,0.0253,-0.0415,-0.098,-0.0199,-0.0176,0.0599,-0.0486,-0.044,-0.0668,0.0441,0.021,0.0668,0.007,0.0954,-0.0288,0.0697,0.0496,0.019,0.0092,0.068,-0.0431,0.0177,0.026,-0.0207,-0.0511,-0.0533,0.0054,-0.052,0.1159,-0.0094,-0.0355,-0.0159,0.0521,0.1386,0.2448,0.1851,0.0551,0.0366,0.0911,-0.0146,-0.0227,-0.0063,-0.0142,-0.0167,-0.0326,-0.073,-0.0703,-0.0972,0.0507,0.0358,0.03,-0.0371,-0.0552,-0.0362,-0.0888,-0.0595,0.2235,-0.0113,-0.0327,0.036,-0.0842,-0.0895,-0.0419,-0.0292,-0.0842,-0.013,-0.05,-0.0324,-0.0051,0.0699,0.0334,0.0364,0.0085,0.0957,-0.0215,-0.0316,0.1017,-0.0466,-0.0361,-0.0177,-0.0665,-0.0374,-0.0551,-0.034,-0.0449,-0.025,-0.0431,-0.0468,0.0201,0.0593,0.0156,-0.0046,-0.0003,-0.0167,-0.0589,-0.1138,-0.0021,0.0577,0.0138,-0.0141,-0.0742,0.0453,-0.0397,-0.0115,-0.0032,0.1364,0.0254,0.0965,0.0689,0.0793,0.07,-0.0693,0.0903,0.063,0.1088,0.0544,0.2231,0.2397,-0.0465,-0.0462,-0.0086,0.0464,0.0144,0.0909,0.0863,0.0769,0.0556,0.0577,-0.0724,0.0547,-0.0109,-0.0892,-0.0594,-0.0416,-0.0871,0.0153,0.0196,-0.0468,-0.0376,0.0378,0.0147,-0.0065,-0.0316,-0.0418,0.2766,-0.0534,-0.1103,0.237,0.0837,0.0547,-0.0313,0.0295,0.0252,0.0155,-0.0484,0.0295,-0.0326,0.015,-0.0042,-0.0064,-0.0263,0.0227,-0.0129,-0.0075,0.0788,0.029,0.0331,-0.0594,0.007,0.0309,-0.0389,-0.0144,-0.0156,-0.0125,0.0077,-0.0108,0.0019,-0.108,-0.0181,0.0521,-0.0526,-0.0822,0.0863,0.0614,0.0106,-0.0125,-0.0362,-0.0539,-0.0514,-0.0344,-0.0767,-0.0731,-0.0687,-0.0946,-0.0694,-0.0387,0.0608,-0.0582,0.0077,0.0115,-0.0681,0.0249,0.0255,-0.0396,-0.0426,-0.0642,-0.0627,-0.0212,0.0303,-0.0661,-0.1042,0.0431,0.0321,-0.073,-0.1045,-0.0774,-0.0335,0.0112,0.0892,0.0761,0.0953,0.0266,0.0526,0.0599,-0.0012,0.0342,-0.051,0.2033,-0.045,-0.0831,-0.017,0.0139,0.0472,-0.0712,0.1087,0.1111,0.0158,-0.0612,0.2671,-0.0559,-0.0197,0.0455,-0.0135,-0.0147,-0.0767,0.0434,0.0103,0.0305,0.1339,-0.1209,-0.1104,0.1793,0.1993,0.0296,0.0232,0.0027,-0.0169,-0.0757,-0.0775,-0.0518,-0.0332,-0.0798,-0.0523,-0.0268,-0.05,0.0159,-0.0822,0.0457,0.0856,-0.0314,0.0079,0.0438,-0.0189,-0.0397,0.0057,0.0048,0.0086,0.0114,0.0143,-0.0523,0.0068,-0.0433,-0.028,-0.0112,-0.0093,-0.0075,0.0407,-0.0329,0.0149,-0.0273,0.0266,0.0143,-0.0004,0.1843,0.0569,-0.0332,-0.0244,0.032,0.0572,-0.0016,-0.0683,-0.0161,0.017,0.0649,-0.074,0.1665,0.0272,0.1079,0.0051,-0.0193,-0.0182,0.0699,0.0327,0.0561,-0.0167,-0.0322,0.1054,-0.0252,-0.0089,0.0199,0.0324,0.1287,-0.0986,-0.0265,-0.0583,-0.0229,0.0956,-0.0638,-0.0479,0.0213,0.1025,-0.0078,-0.0008,-0.0393,-0.1081,0.0663,-0.0062,0.0243,-0.021,0.0161,-0.0255,0.0078,-0.0595,0.0222,-0.0264,-0.0586,-0.0409,-0.04,0.16,-0.0899,-0.0153,-0.0769,-0.084,-0.0726,-0.0634,-0.0011,-0.1176,-0.0436,-0.0749,0.0347,0.0324,-0.0944,-0.0295,0.0236,0.0972,0.0998,0.0632,-0.0428,-0.0068,0.0452,-0.062,-0.0098,0.089,0.0923,0.0231,0.0492,0.043,0.0372,0.009,0.0518,0.067,0.0992,0.0949,-0.0327,0.0304,0.0063,0.0146,-0.0265,0.16,0.0121,0.0728,0.1131,0.0153,0.0336,-0.0236,-0.042,0.0944,-0.019,-0.0958,-0.0792,-0.0532,0.1286,0.087,-0.0753,-0.0811,0.009,0.0759,-0.0516,-0.102,0.0435,-0.0299,-0.0445,0.0108,-0.0309,0.0242,0.019,-0.0442,-0.0378,0.076,-0.0983,-0.1023,0.0363,0.0048,0.0076,0.0023,0.004,0.019,-0.054,0.0034,-0.088,-0.056,-0.0261,-0.0336,-0.031,-0.0653,0.0262,-0.1071,-0.1087,0.0089,-0.0727,0.0085,-0.0681,-0.0597,0.0039,-0.0209,0.0453,-0.0693,-0.0623,-0.0391,0.0077,-0.0087,0.0566,right toe response execution
trm_4a3fd79d0a1d1,-0.0096,-0.0001,-0.0551,0.0415,-0.0127,0.0269,-0.0148,-0.0386,-0.011,0.0058,-0.0171,-0.0271,0.0129,0.0294,0.0509,0.0237,0.0149,0.0653,0.0032,0.0509,0.0106,-0.0024,0.0296,0.0227,-0.0004,0.0056,0.0073,0.0184,0.0429,-0.0234,0.0395,0.0506,0.0118,-0.0161,0.0283,0.0325,-0.0383,-0.0285,0.0442,0.025,0.0092,0.0157,0.0184,0.0052,0.0056,0.0601,-0.0038,0.0078,-0.014,0.0157,0.036,-0.0344,0.0048,0.0228,0.0394,0.0226,0.0302,-0.0056,-0.0117,-0.0081,0.0122,-0.0088,0.0423,-0.055,0.0205,-0.0685,0.0751,0.1092,0.0583,-0.0161,0.0343,-0.0148,-0.0227,0.0394,0.0668,-0.0068,0.0261,0.0195,-0.001,-0.0079,-0.042,-0.0389,0.0608,0.0472,-0.0148,-0.0459,0.0038,-0.0618,-0.0221,0.03,-0.0095,-0.055,-0.0385,-0.1033,-0.0647,-0.1145,-0.0163,-0.0075,-0.1294,-0.0977,-0.0295,0.0481,-0.0637,-0.097,-0.0006,0.0456,0.0485,-0.0225,0.0337,-0.022,0.0364,0.0508,-0.0044,-0.0471,-0.0166,0.0183,0.0241,-0.0896,0.0319,-0.0109,0.0682,0.0488,0.0345,0.0149,0.0271,0.0635,0.0695,-0.0408,-0.0533,-0.0335,0.0488,0.046,-0.0251,0.0888,0.0505,0.0303,-0.0382,0.0144,0.0268,-0.0209,0.0246,0.0224,-0.0083,0.0356,-0.0152,-0.021,-0.0014,0.0296,0.0313,-0.014,0.0005,0.0539,0.019,0.0758,0.0063,-0.01,-0.047,0.0093,-0.0228,-0.0233,0.0044,0.0445,0.0606,0.0619,0.005,-0.0279,-0.0041,0.0634,0.0601,0.0287,-0.0354,0.0531,-0.059,0.0712,0.0488,0.0463,0.0377,0.0484,0.0393,-0.0427,0.0233,-0.0512,0.0388,-0.0406,0.0174,0.0186,0.0214,0.0305,0.035,0.0396,0.0383,0.0373,0.0264,0.0765,0.0737,0.088,0.0945,0.0127,0.0282,0.0441,0.0157,-0.0997,0.0334,0.0549,0.0492,-0.0026,0.0502,0.0418,0.0343,-0.0033,0.0869,0.0526,0.0006,-0.0165,0.0316,-0.0214,-0.0223,0.0314,-0.0455,0.0369,-0.0282,0.055,0.0433,-0.0019,-0.0272,0.0403,0.0269,-0.0252,0.025,0.0322,-0.0785,0.0498,-0.0082,0.0605,0.0559,-0.0163,0.0108,0.0102,-0.0191,-0.0232,0.0209,0.0294,-0.0191,-0.0354,0.0315,0.0319,0.0243,0.0387,0.0057,0.0451,-0.0281,-0.0078,0.0091,-0.0167,-0.0114,0.0261,-0.0245,0.0028,-0.0116,-0.0328,-0.021,0.0379,0.0334,-0.0017,0.0242,0.0315,0.0566,0.0317,-0.0053,0.03,0.0205,-0.0154,0.0609,0.0207,0.0144,-0.0341,-0.0038,0.0406,-0.0046,-0.007,-0.0174,0.033,0.0182,0.0623,0.0451,0.0008,-0.0132,-0.0349,-0.0069,0.026,-0.0146,0.0198,0.0331,0.0381,0.0195,0.0482,0.0001,-0.0161,0.0153,-0.0448,-0.0248,0.0911,-0.002,0.0279,-0.0343,-0.0463,0.0243,-0.0175,-0.0369,0.0091,0.0095,-0.0047,0.0631,0.0209,0.0139,0.0212,-0.0171,-0.034,0.025,0.0298,-0.0047,-0.0053,0.0291,0.0465,0.0169,0.0264,0.0362,0.0443,-0.0021,-0.0136,-0.0223,0.0241,0.0328,0.0019,0.0177,-0.0422,-0.0372,0.0554,-0.0011,0.0607,0.0492,-0.009,-0.0599,-0.0448,-0.0067,0.0115,0.0144,0.007,-0.0107,0.0188,0.0135,-0.0396,-0.058,-0.0644,-0.0268,-0.0498,-0.0019,0.0349,0.039,0.0338,0.0178,0.0064,0.0439,-0.0287,-0.0249,-0.0883,0.0117,0.0127,0.001,0.0375,0.021,-0.0243,0.0171,-0.0579,0.0562,0.0161,0.0193,-0.035,-0.0397,-0.0585,-0.0513,-0.0782,0.0606,0.0402,-0.0222,-0.0135,-0.0041,-0.0373,0.0112,0.0227,-0.0086,0.0147,-0.0578,0.0555,-0.177,-0.2002,-0.0908,0.0201,0.0007,0.0318,0.0217,-0.0146,-0.0086,-0.0301,0.0052,0.0356,-0.0015,0.0543,0.0172,0.0037,0.0133,0.0104,0.018,-0.0332,0.037,0.0295,-0.0048,0.0345,0.0567,0.0293,-0.022,0.0273,-0.0009,0.1007,0.1119,0.0215,0.0469,-0.0322,0.0298,0.0252,0.0035,-0.0704,-0.0033,-0.05,0.0399,0.0001,-0.0451,0.0238,0.0677,0.0138,0.0024,-0.0236,0.0083,-0.0328,-0.0117,0.0044,-0.0311,-0.0271,0.0863,0.0816,0.0426,0.0112,0.0544,0.057,-0.0004,0.07,-0.0876,0.0078,0.0404,-0.0427,-0.0136,0.0447,0.0129,0.0158,0.0343,0.0652,0.0024,-0.0365,0.0017,-0.0035,0.0169,-0.0111,-0.0294,-0.0185,0.0133,0.0521,-0.0308,-0.047,-0.018,-0.0094,-0.0821,-0.0176,-0.0933,-0.0669,0.0279,-0.0162,-0.0143,-0.0004,0.0684,0.022,-0.0318,-0.0459,0.0469,0.0438,0.0088,0.0088,0.0633,0.013,0.0088,0.0702,0.0675,0.027,0.0358,0.0167,0.0244,0.0182,-0.0375,0.017,0.0324,-0.0341,0.0393,-0.0565,0.0117,0.0188,-0.0267,-0.0296,0.0445,0.0227,-0.0729,0.0173,0.0105,0.0121,0.0051,0.0407,-0.0107,-0.0193,-0.0087,-0.0355,-0.0297,0.0204,0.0375,-0.0424,-0.0271,0.0474,0.0169,0.019,0.0392,0.0248,0.0028,0.0192,0.0411,-0.0142,-0.0096,-0.006,0.0062,-0.0079,0.0241,-0.0173,0.0025,0.034,-0.0694,0.0561,0.0077,-0.043,-0.0141,0.0468,-0.0582,0.0096,-0.0255,0.0009,0.0366,0.0265,0.0711,-0.0246,0.0262,-0.0046,-0.0204,0.0503,0.0259,0.0327,0.0527,0.0208,0.0138,0.0008,-0.1899,-0.1905,-0.0264,-0.039,-0.0251,0.0162,0.0368,0.0472,0.0258,0.0202,-0.0409,0.0088,-0.0003,0.0068,-0.0171,-0.0057,-0.0013,0.0227,0.0254,-0.0042,0.0061,-0.0601,0.0448,0.0016,-0.0858,0.0203,0.008,0.0003,0.0102,0.0178,-0.0017,-0.1673,0.0375,0.0423,0.0375,-0.0087,-0.0459,-0.0228,0.0001,0.0149,0.0604,0.0303,0.0223,0.0081,0.0477,0.0381,0.0045,0.0271,-0.028,0.0236,0.0263,-0.0713,0.0512,0.043,0.0013,0.005,-0.0084,-0.1345,0.0045,0.0554,0.04,-0.0055,-0.0278,0.0122,-0.0136,0.0102,0.0153,-0.0225,-0.0291,-0.1691,0.0465,-0.0254,0.0724,0.0612,-0.0387,0.0191,0.0221,0.0174,-0.017,0.0159,0.0038,0.0243,-0.1436,0.0161,-0.0432,0.0512,0.0448,-0.1056,-0.0692,-0.1328,-0.007,-0.0293,-0.0702,0.0695,-0.0777,-0.0662,-0.0344,-0.0024,-0.0054,0.0257,-0.0024,0.0378,-0.0295,0.0056,-0.0227,0.0104,0.0047,-0.0198,0.0046,-0.0085,-0.0396,0.064,0.0275,0.0491,0.0258,0.0009,-0.0881,0.0032,-0.0214,0.0276,-0.0104,0.0364,-0.0479,0.0286,0.0477,0.0558,-0.0405,-0.0111,0.0127,0.0356,0.023,-0.0259,0.0293,0.0288,0.015,0.0056,0.0319,0.0196,0.0453,-0.0338,0.0367,0.0257,-0.0702,0.0023,0.0424,-0.0252,-0.0425,-0.0083,0.0817,0.0742,0.0543,-0.0007,0.0168,0.0305,0.0396,0.0154,0.0045,-0.0147,0.0305,-0.0012,-0.0005,0.0139,0.0427,-0.0048,-0.0294,-0.0136,0.0635,-0.0266,0.0102,0.0041,0.0385,0.0256,-0.0033,-0.0231,0.0311,-0.0077,0.0361,0.0117,0.0581,0.0958,0.0783,0.0645,0.0022,-0.0366,-0.0095,0.0242,0.0099,-0.0382,-0.0151,0.0278,-0.0128,-0.0198,-0.0078,0.0399,-0.0277,0.0186,-0.0141,-0.07,-0.0158,0.0232,-0.0636,0.0036,-0.0128,0.0267,0.0612,0.0337,0.0516,0.0331,0.0485,-0.0378,-0.0135,-0.0139,-0.0059,-0.0261,0.0473,0.0003,-0.0215,0.0334,-0.0093,0.0103,-0.0237,-0.0522,0.0136,0.0266,-0.0002,0.0754,0.0714,0.0022,0.0058,-0.0222,0.0249,-0.0107,-0.0187,0.0264,0.0328,-0.0012,-0.0118,-0.0333,-0.0693,-0.0381,-0.0453,0.0185,-0.0602,-0.0557,-0.0125,-0.054,0.0096,0.0531,0.0473,-0.0154,0.0124,0.0214,0.1084,0.0264,0.0569,0.0742,0.0617,0.0411,0.0307,0.018,-0.0041,-0.0461,0.0727,-0.0715,-0.0335,0.0096,-0.0063,-0.0158,-0.0323,-0.0272,-0.006,0.0251,0.0006,-0.0274,0.0372,-0.0589,-0.0467,0.0209,0.0037,0.0088,0.0467,-0.0172,0.0497,0.0787,0.0531,0.0614,-0.0149,0.0162,0.0458,-0.0012,-0.0174,-0.1112,0.0474,0.0313,-0.043,0.0441,0.0169,0.046,-0.1803,0.0488,-0.0104,0.045,0.0377,0.0364,0.078,0.078,0.0271,-0.0128,0.0218,0.0267,-0.0026,-0.0295,-0.0014,0.0544,0.0278,0.055,-0.021,0.0135,-0.0274,-0.0394,0.0586,-0.0258,0.0551,0.0422,0.0201,-0.0279,0.0193,0.0039,0.001,-0.0079,0.0155,-0.0402,0.0178,0.0324,-0.0044,0.0415,0.0487,0.0024,0.0201,-0.037,-0.0352,-0.0116,-0.0334,0.0518,-0.0135,-0.0607,-0.0261,-0.0011,0.03,-0.02,-0.0466,-0.0119,-0.0403,-0.056,0.0422,0.0383,-0.0129,-0.0398,0.0087,0.0266,-0.0091,-0.0032,0.0151,-0.005,0.0063,0.0247,0.0289,0.0927,0.0722,0.1011,0.0344,0.0047,0.059,0.0403,0.0266,0.0475,0.0644,0.0634,0.0325,0.0448,-0.018,0.0381,0.0254,0.0208,0.0067,-0.0088,-0.0098,-0.0195,0.0338,-0.0119,-0.0181,-0.0011,0.0093,0.016,-0.0169,-0.0237,0.0058,0.0048,0.0385,-0.0083,0.0091,-0.0023,-0.0024,0.0189,0.0258,0.0291,0.0188,0.0287,0.0564,0.0611,0.0325,0.0509,0.0458,-0.0751,-0.0124,-0.0809,0.0044,-0.023,-0.019,0.0124,-0.0075,0.0109,-0.0118,0.006,-0.0316,0.0107,-0.0261,-0.001,0.0022,-0.0356,-0.0126,0.0201,-0.0088,0.0234,0.0484,0.0541,-0.0396,-0.0219,-0.0419,-0.0546,-0.0081,0.0457,0.0277,0.0064,0.07,0.0221,-0.0088,-0.0196,0.012,-0.0436,-0.0148,0.0338,0.0451,0.0247,0.0321,-0.0196,0.005,-0.0289,-0.1136,-0.1708,0.0342,0.0118,0.0366,0.0554,0.0208,-0.0056,0.0551,0.0405,-0.0669,-0.0246,-0.0266,0.0243,-0.0223,0.0304,0.0274,0.0314,-0.0749,0.0263,0.024,0.0458,0.0118,-0.0569,-0.0028,-0.039,0.0334,-0.0653,-0.0754,-0.0362,0.0076,0.0297,0.0032,0.0129,-0.0243,0.0279,0.0405,0.0413,0.0256,0.0992,0.0487,0.0137,-0.0123,0.0245,-0.0335,0.0336,-0.0167,-0.0301,-0.1514,-0.0077,0.0124,-0.0111,-0.0147,-0.0674,0.0264,0.0018,-0.0034,0.0235,-0.1067,-0.1056,-0.0141,-0.0003,0.0058,0.029,-0.0079,-0.0288,0.0727,-0.0494,-0.0675,-0.0386,-0.0068,-0.0254,0.0265,-0.0116,0.02,0.0025,-0.022,0.0123,-0.0063,0.0016,0.059,-0.0219,-0.029,0.0082,-0.0322,0.0157,0.0383,-0.0311,0.0095,0.0311,0.0077,0.0533,-0.0542,-0.0048,-0.0487,0.055,0.0473,0.0539,0.0392,-0.0007,0.0421,-0.0055,-0.0923,0.0341,0.056,0.0625,0.0378,-0.0626,0.0271,-0.0667,0.0063,0.0174,-0.0317,-0.0741,-0.2666,-0.2247,-0.2254,0.0085,-0.02,0.0002,-0.0201,0.0056,0.0029,0.0594,0.0037,0.0115,-0.0704,-0.0149,0.0084,0.0004,0.0134,0.0242,-0.01,0.0072,-0.022,-0.1667,-0.0389,0.0137,0.0273,0.0125,0.0068,-0.0414,-0.0344,0.0765,0.0758,0.0542,0.051,-0.0166,-0.0023,0.0423,-0.0173,0.0279,0.0677,0.0562,-0.004,-0.0069,-0.0016,0.0445,0.0624,0.0028,0.0005,0.0081,0.0535,0.0346,-0.0278,0.0369,0.0643,0.0244,0.0289,0.0366,0.0417,-0.0023,0.0636,0.0455,0.0436,0.0126,-0.0683,-0.001,0.0144,-0.0377,0.0192,-0.0057,0.0257,0.01,0.032,0.0562,0.0053,0.0149,0.0127,-0.0762,-0.0705,-0.0856,-0.059,0.0604,0.02,0.0499,0.0191,0.0918,0.0309,-0.0464,0.0013,0.0364,0.0567,0.0151,-0.0659,0.001,-0.024,-0.0061,-0.0699,-0.0132,-0.0884,0.0818,0.0461,0.0296,-0.0363,-0.0031,0.0503,-0.0281,-0.0281,0.0854,0.0247,0.0141,-0.0265,-0.0416,0.0107,-0.0081,-0.1618,0.1152,0.1056,0.0119,0.027,0.0546,0.0577,0.0428,-0.0211,-0.0342,0.0258,0.0243,-0.0114,-0.0803,-0.0397,0.0065,0.004,0.0091,-0.0678,0.0287,-0.0147,0.0152,0.0312,0.0429,0.0439,0.029,0.0397,0.0018,0.0052,0.0104,-0.2224,-0.1522,-0.1823,0.0283,-0.136,0.0439,0.0261,0.0021,0.0324,0.0003,0.0542,0.0143,0.0144,0.0408,0.0558,-0.084,-0.0629,0.0711,-0.0174,-0.0324,0.0117,0.0558,0.0472,0.0062,0.0095,0.0351,0.0102,-0.0069,-0.0364,-0.0569,-0.1064,-0.0572,-0.0314,-0.0353,-0.0146,0.0218,0.0179,0.0117,0.0735,0.0694,0.0654,0.0017,0.0045,-0.0102,0.0241,0.0256,0.0586,-0.0233,-0.0472,-0.0089,-0.0015,0.0243,-0.0134,-0.0132,0.0126,0.0419,0.0733,0.0382,0.0016,0.037,0.0309,-0.0003,-0.0019,0.0094,0.0048,-0.0363,0.0046,0.0287,-0.0587,0.0563,0.0176,-0.0588,-0.027,-0.072,0.0437,0.0028,-0.0487,0.0675,0.01,0.0168,0.0262,0.0009,0.031,-0.0739,-0.0583,0.0612,-0.042,0.0382,-0.0774,-0.107,-0.0568,-0.0115,-0.0127,-0.0341,-0.0546,0.0197,-0.0338,0.0352,0.0031,0.0502,0.0533,0.0249,-0.016,0.0011,0.0439,0.0659,-0.0225,0.0382,0.002,0.0155,0.0363,0.0299,0.0286,0.0372,-0.0425,0.0184,0.0331,0.0334,0.0606,0.0272,0.0124,0.0218,-0.0201,-0.0134,0.0491,-0.0068,0.0139,0.021,0.0037,-0.029,-0.0317,0.0335,0.0533,0.0087,-0.1084,-0.1885,0.0133,-0.0082,0.0146,0.0084,0.0064,0.0423,0.0133,0.0388,-0.004,0.0729,-0.0315,-0.0305,0.0056,0.0311,0.0213,0.011,0.0284,0.0505,-0.0056,0.033,0.0171,-0.0472,-0.0444,0.0164,-0.0313,-0.0126,-0.0117,0.0041,0.0207,0.0058,0.0445,0.0196,0.012,0.0308,0.0186,0.041,0.0008,-0.0562,-0.0416,-0.0808,-0.0844,0.0201,-0.0022,-0.0066,-0.0106,-0.0193,0.0068,0.0515,0.0278,-0.0007,0.0479,0.0255,-0.0213,-0.0279,0.0228,-0.0203,-0.0663,0.0161,0.0474,0.0684,-0.0439,0.028,0.0127,0.0682,0.0587,0.0461,-0.014,0.009,0.0066,0.0427,-0.0341,0.0003,-0.0239,-0.0143,-0.0324,0.0009,-0.0477,-0.0055,0.0159,0.0433,-0.0395,-0.0119,-0.0016,-0.0454,-0.056,-0.0101,0.0267,0.0265,-0.0043,-0.0384,-0.0352,0.0631,0.0383,-0.0277,0.0084,0.0091,-0.0604,0.0408,-0.0213,0.0032,0.0186,-0.0072,-0.0201,-0.084,0.0669,-0.0397,-0.0105,-0.0517,-0.0077,-0.0114,-0.1672,0.0463,-0.013,-0.0038,-0.0224,-0.0648,-0.0298,0.0386,0.0186,0.0169,-0.0313,-0.0139,-0.0025,0.0039,0.0342,-0.0116,0.0633,0.0531,0.0508,-0.0392,0.0383,-0.0231,-0.0044,0.0284,0.0409,0.0084,-0.0224,0.0554,0.0729,-0.0324,0.0228,0.0121,0.0374,0.0072,0.0029,0.0417,0.0625,0.0004,-0.0139,0.0056,-0.0105,-0.0572,-0.0747,0.0284,-0.0482,0.0133,-0.0564,-0.1024,0.0671,0.068,0.0241,0.0463,-0.0277,0.0069,-0.0919,0.0194,-0.0233,-0.0121,0.0061,-0.0018,-0.0279,0.0098,-0.0475,0.0191,-0.0463,-0.0148,-0.0598,-0.0466,-0.0535,-0.0122,-0.0195,0.0531,0.0012,-0.0245,-0.0403,0.0048,0.009,-0.0054,0.0302,-0.1144,-0.0945,0.0798,0.0631,0.0269,0.0305,-0.0544,-0.049,-0.0238,0.0161,0.0124,0.0126,0.0403,0.0482,-0.0229,0.0242,0.0127,0.0366,0.0275,0.032,-0.024,0.0112,0.0284,-0.0059,0.0431,0.0456,0.0144,-0.1094,0.0145,-0.1082,-0.0235,0.0128,-0.0343,-0.0275,-0.0728,-0.0139,-0.0329,0.0098,0.0056,0.0291,-0.0081,0.0074,-0.0818,0.0504,0.0576,0.0561,0.0452,0.0199,-0.0017,0.0025,-0.2052,0.0068,-0.0498,-0.0391,-0.0992,0.0385,0.0116,-0.0192,0.0058,-0.0342,-0.0193,-0.0131,-0.0162,0.0099,0.0787,0.0656,0.0647,-0.0075,0.0441,0.0508,0.0408,0.0208,0.0302,0.0252,0.029,0.0096,-0.048,0.004,0.0412,-0.0734,-0.0196,-0.0019,-0.0377,0.0141,0.0598,-0.0127,0.054,0.0265,0.0355,0.0111,-0.0377,-0.01,0.0041,0.0498,0.0218,0.0091,0.118,0.0778,0.0728,0.0629,0.0249,-0.053,-0.0503,0.0576,0.0677,0.0017,0.0005,0.0073,0.0293,-0.0126,0.0346,-0.0185,-0.0404,-0.0028,0.0513,0.0437,-0.0044,-0.0074,0.0271,0.0901,0.0509,0.0177,0.0484,0.0915,0.0422,0.0234,-0.0554,0.0555,-0.0175,0.0125,-0.0147,0.0339,0.0418,0.0353,0.0622,0.0214,0.0065,0.0362,-0.0325,0.0579,0.0504,0.0279,-0.0011,0.0395,0.0189,0.0293,-0.0288,0.0655,0.0532,0.0573,-0.0052,0.0494,0.0565,0.0284,0.0075,-0.0101,0.0453,-0.0007,-0.0037,0.0694,0.0066,0.043,0.0096,0.0168,0.0365,0.0636,0.0516,0.06,0.0222,-0.0007,0.0072,0.0387,0.07,0.0093,0.0807,-0.007,0.0583,0.061,-0.0063,-0.0894,-0.0175,-0.0007,-0.0147,0.0376,-0.0242,-0.0274,-0.0075,0.0653,0.073,-0.0039,-0.0404,-0.0247,-0.0297,0.0329,0.0267,0.0527,0.0142,0.0247,0.0136,0.0055,0.0291,0.0245,-0.0134,0.0552,-0.0269,0.0101,0.0183,-0.0477,-0.0387,-0.0372,0.0359,0.0511,0.04,0.0247,0.096,0.0553,-0.0085,0.006,0.0437,-0.2029,-0.1331,-0.2065,-0.1352,-0.1197,-0.1492,-0.0432,-0.1374,-0.069,-0.0545,-0.0962,-0.1713,-0.1772,-0.1901,-0.0194,0.074,-0.08,-0.0112,-0.0125,0.0166,0.0446,-0.0763,-0.0006,-0.0011,-0.0498,-0.0516,-0.0401,-0.0041,-0.0617,-0.0035,-0.0413,-0.1049,0.0082,-0.0026,-0.06,-0.0172,0.0191,-0.0027,-0.022,0.0191,-0.025,-0.0108,0.0387,0.0159,-0.0148,0.1087,0.0487,0.0219,0.0615,0.0543,0.0471,0.0616,0.0253,0.0198,0.0281,-0.0215,-0.0895,0.0058,0.0093,0.078,-0.028,0.0002,0.0014,-0.0073,0.0372,-0.0254,0.0494,0.0261,0.0187,0.0116,0.0415,0.0059,-0.0295,-0.0025,-0.0951,-0.0379,0.0055,0.0036,0.0145,-0.0232,0.0726,0.0145,0.0694,0.0411,-0.0479,-0.0007,0.0312,0.0166,0.02,-0.0071,-0.0199,-0.0375,0.0045,-0.0104,0.0239,-0.0446,-0.0732,-0.0034,0.0531,0.0219,-0.0638,-0.0128,-0.019,0.0076,-0.017,0.03,-0.0314,0.0351,0.0465,-0.0132,0.0011,0.0195,0.0251,-0.089,-0.0687,0.0623,0.0057,-0.0863,-0.0747,-0.0462,-0.0052,-0.0246,-0.0544,0.0704,0.0687,-0.0108,-0.0416,-0.0772,-0.0507,-0.0392,-0.0106,0.0046,-0.0451,-0.0811,-0.083,-0.1095,-0.006,-0.0128,-0.0017,0.0268,-0.005,-0.0212,0.0737,0.0264,-0.0008,-0.0035,0.0298,0.033,-0.0307,0.0008,-0.0248,0.0229,0.0028,-0.0229,0.0222,-0.0338,0.0239,-0.0258,0.0006,0.0209,0.0084,0.0121,0.0156,0.013,-0.0317,0.0445,0.0811,0.0809,-0.0406,-0.0065,0.0238,-0.0119,-0.0016,0.019,-0.0912,-0.0089,-0.0526,0.0028,0.0535,0.0697,-0.1128,0.0177,0.0202,-0.0243,-0.0093,-0.0601,-0.063,-0.0146,-0.0107,0.021,0.0156,-0.1437,0.0236,0.0174,0.0164,-0.0079,-0.0267,-0.0281,-0.0086,-0.0061,0.0465,0.0111,0.0057,0.0251,0.0557,0.0417,-0.0512,-0.0106,-0.0445,-0.0318,0.0,-0.0141,-0.0433,-0.0517,0.0002,-0.0212,0.055,-0.0096,-0.0265,-0.0526,-0.082,-0.0045,-0.0013,0.0014,-0.0124,-0.0062,0.0086,-0.0282,-0.0214,0.0173,0.0239,-0.0173,0.02,-0.0048,-0.0213,-0.0061,-0.0041,-0.0031,-0.0301,-0.0733,-0.0543,-0.0211,-0.0152,0.0468,0.0243,0.0133,0.0055,0.0761,-0.0026,0.0272,-0.0017,0.0039,-0.0409,-0.0896,0.0474,-0.0124,-0.0381,0.0339,-0.0055,-0.0234,-0.0715,-0.0135,-0.0611,-0.0671,-0.1155,-0.0467,0.006,-0.0389,-0.0837,0.0347,0.0271,0.0127,-0.0053,0.0292,-0.053,0.0235,0.0025,0.0707,0.0567,0.0935,0.0542,0.0408,0.0519,0.0183,0.056,0.0206,-0.003,-0.0248,0.0191,0.0078,0.0291,-0.0514,0.0335,-0.0769,-0.0089,-0.0035,0.043,0.0112,-0.0446,0.0468,-0.0035,-0.0299,0.007,0.0091,-0.0284,0.0221,0.0037,0.0028,0.0476,0.018,0.0174,0.0001,-0.0002,0.0247,-0.0372,0.0125,0.0118,-0.025,0.0327,0.069,0.0057,0.05,0.0149,0.0099,0.0191,0.0173,-0.0487,0.0396,0.0228,0.1025,0.0263,0.0295,0.0861,0.0683,0.048,0.0224,0.0224,0.0278,-0.0115,-0.0012,0.0341,-0.0003,-0.083,-0.0624,0.0292,0.0083,0.1001,-0.0249,0.0361,0.01,0.0158,-0.0519,0.0133,0.0039,0.0267,0.0224,-0.0629,-0.0752,0.0131,-0.0177,-0.0798,-0.046,-0.0703,-0.022,0.0111,-0.0042,-0.0622,-0.0289,-0.0586,0.0662,0.073,0.0083,0.0651,0.0255,0.0044,0.0066,-0.0194,0.0409,0.0623,-0.0599,0.0061,0.0413,-0.0282,0.0148,0.1005,0.0263,0.1078,0.0307,0.0168,-0.0115,0.0244,-0.181,-0.1747,-0.0979,-0.0935,-0.0059,0.0052,-0.003,0.0215,-0.037,-0.0465,-0.0166,-0.0809,0.0117,-0.026,0.0335,-0.0237,0.0093,0.037,0.0166,-0.034,0.0245,-0.18,0.0196,-0.2007,-0.0468,-0.1942,-0.0356,-0.1132,-0.0344,0.0006,-0.0269,-0.006,-0.0239,-0.0445,-0.0203,0.056,0.0855,0.0242,-0.0405,0.0312,0.0421,0.0236,0.0212,-0.0051,0.0495,0.037,0.0244,0.0165,-0.0544,0.0028,-0.0463,0.0024,-0.0102,-0.0741,0.0234,0.0654,0.0062,0.0143,-0.001,-0.005,-0.0815,0.0459,-0.0466,-0.0471,-0.086,0.0198,0.0185,-0.023,-0.0179,0.0037,0.0344,0.0636,0.0376,-0.0278,-0.017,-0.0097,0.028,-0.0346,-0.0369,0.0157,0.0379,0.0324,0.0608,0.0607,-0.0117,0.0042,0.0126,0.0531,0.0115,0.0794,0.0064,0.0357,0.0237,0.007,-0.066,0.0078,-0.0008,0.0361,0.0182,-0.0049,0.0223,0.0179,-0.0263,-0.0458,0.0345,0.014,-0.0422,-0.003,0.0252,-0.0141,-0.0314,0.0095,-0.0053,0.0664,-0.0152,0.0406,0.0707,-0.0774,0.0479,-0.0386,-0.0589,-0.0282,-0.0283,-0.0365,0.0249,0.0638,-0.0129,-0.0151,-0.0636,-0.0217,-0.0129,0.0147,0.0294,0.0351,0.0442,0.0559,0.0307,0.0288,-0.0185,0.0103,0.0669,-0.0207,0.0358,0.0035,0.0186,0.0114,-0.008,0.0576,-0.0379,-0.0136,-0.0,-0.081,-0.0043,0.028,-0.0603,0.0049,0.0234,-0.0291,0.0321,-0.006,-0.0013,0.0504,-0.0025,0.0009,0.0029,0.0215,0.0088,-0.0187,0.0196,0.0171,-0.0376,0.0398,-0.0048,0.0572,0.0336,-0.0166,0.0521,0.0574,0.108,0.0702,-0.054,-0.0908,0.032,0.004,0.0281,0.0064,0.0457,0.0122,0.0239,0.0629,0.0692,0.0117,0.0041,-0.033,-0.0164,0.0142,0.0072,0.0011,-0.0282,0.0086,-0.0274,-0.0076,-0.0066,0.0229,-0.0159,0.0341,-0.0073,0.0388,-0.0282,-0.1327,0.0004,-0.0529,0.0182,-0.0831,-0.0456,-0.1266,-0.0084,0.0203,0.0604,0.0239,-0.0279,-0.131,-0.1109,-0.0681,-0.0181,-0.0142,-0.0017,-0.0332,-0.0754,-0.0273,-0.0309,0.0993,0.0094,0.0535,-0.0267,0.0091,-0.0104,-0.0418,-0.0347,-0.0133,-0.0299,-0.041,0.0125,-0.0452,-0.0209,0.0142,0.0048,-0.0338,0.0372,-0.0174,-0.0257,-0.0172,-0.0032,-0.0378,0.0157,0.0327,-0.0453,0.0034,-0.0303,0.0194,0.0009,0.0307,-0.0049,-0.0156,0.0717,0.0791,-0.1033,-0.0265,-0.0481,-0.0015,0.0146,0.0362,0.062,0.0475,0.0634,-0.0123,-0.0095,0.0053,0.0547,-0.0479,-0.0526,0.0545,0.0,0.0474,0.0342,-0.107,0.0333,0.0004,0.1023,0.0349,0.0148,-0.0465,-0.0019,0.0015,0.0623,-0.0266,0.0552,0.0023,0.026,-0.0205,0.0177,0.0088,-0.0016,0.0091,-0.1175,-0.0154,0.0088,0.052,0.0685,0.0334,0.0297,0.0395,0.0348,-0.0275,0.0756,0.0361,0.0038,0.0096,-0.0129,0.05,-0.0125,0.0265,0.0158,0.0385,0.0303,0.098,0.0612,-0.0354,0.0119,0.0751,-0.0113,-0.0719,0.013,0.0063,0.0042,-0.0297,-0.0858,-0.0523,0.064,0.0546,0.046,0.0143,-0.0626,-0.0038,0.031,-0.0086,0.0244,-0.0398,-0.0442,0.0049,0.0029,-0.0827,0.0591,0.0481,0.0361,0.01,-0.001,0.012,0.0415,0.0151,0.0016,0.0322,0.022,0.0067,-0.0113,0.0754,-0.1933,-0.1965,-0.0951,-0.0446,-0.0196,-0.1356,0.0667,0.06,0.0489,0.0091,-0.0399,-0.0727,-0.0247,-0.0605,-0.111,-0.0231,-0.1742,-0.0337,-0.0116,0.0212,-0.0107,-0.0457,-0.0086,-0.029,-0.0301,0.0267,0.0142,0.0391,-0.0272,-0.0023,0.0234,0.0579,0.0516,0.0677,0.0071,-0.0602,0.0086,-0.0417,-0.0301,0.0088,-0.001,-0.0045,-0.0019,0.0339,0.0197,0.0068,-0.0253,-0.03,-0.0741,-0.0007,0.0073,-0.0106,-0.1189,-0.055,-0.022,-0.0438,-0.0506,-0.1001,-0.0557,0.0224,0.0161,-0.0038,-0.0027,-0.004,-0.0322,-0.0573,-0.0443,0.0288,-0.04,0.0057,-0.1018,-0.0113,0.0014,-0.0223,-0.0268,-0.0169,-0.0618,-0.0494,-0.0634,-0.0226,-0.0396,-0.0854,0.0427,0.0763,-0.0069,-0.0239,-0.1148,-0.0773,-0.0112,0.0163,0.0497,0.0347,0.0062,-0.1459,-0.0514,0.0054,0.0196,0.0584,0.0983,0.0693,0.0661,0.0552,0.053,-0.002,0.018,0.0304,-0.1295,-0.1124,-0.0616,0.0543,0.0099,0.0284,0.033,0.0016,0.0309,0.0289,-0.0566,-0.0185,-0.0056,-0.0212,0.0193,-0.0384,-0.0239,0.0085,-0.005,0.0212,0.0287,-0.063,-0.0557,0.0428,0.0348,-0.0121,-0.0488,0.0146,0.0226,0.0098,0.0213,0.0008,-0.0004,-0.0351,0.0363,-0.0626,0.0658,-0.053,-0.0557,-0.0146,0.033,0.004,-0.017,-0.0142,0.015,0.0369,0.0953,0.0767,0.0016,0.0623,-0.0096,0.0425,0.0414,0.0259,0.0133,-0.0626,-0.0545,-0.0657,-0.0203,-0.0794,-0.0302,0.0311,-0.0398,0.0455,0.0313,-0.0298,0.0186,0.0149,0.0327,0.0436,-0.0315,-0.0246,-0.0208,0.0561,0.0766,0.0194,0.038,0.0369,-0.0903,0.0376,0.0048,0.013,0.0162,0.0267,0.0423,0.0304,0.0705,0.0475,0.0814,0.0632,0.0178,0.0102,0.009,-0.0214,-0.0268,-0.0676,0.0096,0.0409,-0.059,0.045,0.0217,0.0387,0.017,0.0426,0.0376,-0.0024,-0.0159,-0.0088,0.054,0.0216,0.0445,-0.0222,-0.0356,-0.0416,0.0068,-0.0318,0.039,0.0431,0.0193,-0.0062,0.0087,-0.0027,0.0286,-0.0193,0.0121,0.012,0.0102,-0.016,-0.01,0.0059,0.0136,-0.0321,-0.0052,0.0485,-0.1047,0.0038,-0.0912,0.0341,-0.1462,-0.1563,-0.0065,0.0265,0.0196,-0.0188,-0.0335,-0.0481,-0.045,-0.0621,0.0056,-0.022,-0.0014,-0.0471,-0.0074,0.0287,0.074,0.0551,0.0632,-0.0139,0.0255,0.0712,0.0181,-0.0083,-0.0026,0.0099,0.0152,0.0275,-0.1216,-0.0262,0.0329,-0.218,-0.0365,-0.0241,-0.0052,-0.0395,-0.1004,-0.0795,0.0046,-0.008,-0.0096,0.0052,0.0114,-0.0564,0.0309,-0.0211,0.024,0.0256,0.0022,-0.09,-0.0483,0.0495,-0.0003,0.0154,0.0416,0.0005,0.043,0.0088,-0.0098,0.0216,0.0026,0.0641,0.0367,-0.0172,0.0647,0.0353,0.0392,0.0091,0.048,0.0427,0.0488,0.0493,0.0395,0.008,0.0445,0.0736,0.0547,0.0106,-0.0208,0.0069,-0.0222,0.0262,-0.0427,-0.0079,-0.0098,0.0239,0.0048,0.016,0.0281,0.0733,0.0693,0.0157,-0.0072,0.0685,0.0609,-0.0051,0.0075,0.0383,0.0449,0.0559,0.0609,-0.0109,-0.0184,-0.0423,0.0205,-0.047,-0.0117,-0.0256,-0.0354,-0.0924,0.0389,-0.0763,0.0622,0.0324,-0.0059,0.0116,0.0085,0.018,-0.0739,-0.0544,-0.0191,0.0238,-0.0876,0.06,0.0568,-0.0194,0.0141,0.0665,0.0713,-0.0141,-0.0113,-0.0681,-0.0625,0.0856,0.0762,-0.0839,-0.0986,-0.0259,-0.0592,0.0089,0.0243,0.0312,0.0786,0.0317,0.0424,0.0554,0.0394,0.0181,0.0348,0.0251,0.0275,0.0139,-0.0791,0.0431,-0.0155,0.0053,0.01,0.0221,-0.0102,0.0076,0.007,-0.0031,0.0231,0.0131,0.0174,0.0206,0.0187,-0.022,0.0541,0.0351,-0.021,0.0454,-0.0074,0.0396,0.0022,0.0052,-0.0104,-0.0814,-0.054,0.0015,-0.0126,-0.0348,-0.025,-0.0097,0.057,0.0299,0.0311,-0.0478,-0.0142,-0.0888,0.0339,-0.0136,0.0322,0.0313,-0.0584,-0.0083,-0.0453,-0.0457,0.0219,0.0812,-0.043,0.0326,0.0156,0.0302,-0.0222,-0.0356,0.0719,0.0283,0.02,0.0388,-0.007,0.0572,0.0176,0.0305,-0.0689,-0.0404,0.0123,0.0299,0.0742,0.033,-0.0478,-0.0414,-0.0353,0.0123,-0.0042,-0.0026,0.0636,0.0165,-0.0434,0.0517,0.0051,0.0429,-0.1675,0.0563,-0.0411,0.0263,0.0353,0.06,0.0534,-0.0308,0.0093,0.0329,-0.0414,-0.031,-0.1023,0.0374,0.0163,-0.1033,-0.005,-0.0124,0.0012,-0.0158,0.0199,-0.0111,0.0327,0.036,-0.0326,-0.0993,-0.0124,-0.0497,-0.0714,0.0176,-0.005,-0.0634,-0.0611,-0.0405,-0.0359,-0.0205,-0.0141,-0.0093,-0.0447,-0.0534,-0.1569,-0.0874,-0.0666,-0.1113,0.0034,0.0539,0.06,0.0628,-0.0142,0.0087,0.0564,0.0697,0.0305,-0.0819,-0.0728,0.0819,0.0935,0.0333,-0.0281,0.0302,0.05,-0.0086,0.0163,0.039,-0.0311,0.0136,0.0197,-0.0135,-0.019,0.0142,-0.0657,0.096,0.1,-0.0744,0.0139,0.0023,-0.0008,-0.0053,0.0356,0.0339,0.0102,0.0775,-0.0273,-0.0529,0.0113,-0.0326,-0.0174,0.0186,0.0142,0.014,0.005,0.05,-0.0434,0.0299,0.0124,0.0095,-0.0249,-0.0628,-0.0098,0.0291,-0.0369,-0.0006,0.0191,-0.0055,emotional suppression
trm_4a3fd79d09c5b,-0.0255,-0.0562,-0.014,-0.0756,-0.0131,-0.0243,-0.0422,0.0293,0.0213,-0.0313,-0.0177,0.0115,-0.0489,-0.0241,-0.0269,0.014,-0.0795,-0.1026,0.0098,-0.0742,-0.0579,0.0218,-0.029,-0.0469,-0.0054,0.0151,0.0155,-0.0598,-0.0788,-0.014,-0.0539,-0.1015,-0.0811,-0.0301,-0.0771,-0.067,0.0122,0.0029,-0.0893,-0.036,-0.0637,-0.0404,-0.0206,-0.0181,-0.0433,-0.0458,0.0322,0.0088,0.0427,-0.0597,-0.014,0.0657,0.0591,-0.0013,-0.0612,-0.0534,-0.028,-0.0147,-0.0187,-0.0196,-0.0081,0.0443,-0.075,0.0682,0.0158,0.1027,-0.0834,-0.132,-0.105,-0.0089,0.045,0.0526,0.0681,-0.0587,-0.0168,0.0085,-0.0295,0.0448,0.0114,0.0033,-0.0046,0.0068,-0.0171,-0.0652,-0.0003,-0.01,-0.0267,0.0195,-0.0142,-0.067,-0.0611,0.0421,-0.0488,0.1639,0.1385,0.1099,0.111,0.0414,0.1312,0.1259,0.0022,0.0053,0.0552,0.1123,0.0568,-0.1017,-0.0916,0.0961,-0.0074,-0.0788,-0.012,-0.0419,0.0435,0.1048,0.0115,-0.028,-0.0596,0.0566,0.0247,-0.0431,-0.0808,-0.0867,-0.0934,-0.019,-0.0357,-0.0951,-0.088,0.0355,0.0266,0.0406,-0.038,-0.0585,-0.0068,-0.0854,-0.0462,-0.1148,0.0043,-0.0695,-0.044,-0.0053,-0.0636,-0.0851,0.0005,-0.0367,-0.0548,-0.0003,-0.0069,0.0018,-0.0381,-0.0214,-0.0204,-0.0653,-0.0897,-0.1088,0.0607,0.066,0.0217,0.0257,-0.0147,-0.0552,-0.0656,-0.0627,-0.1256,-0.0944,-0.0374,0.0201,-0.0016,-0.1193,-0.1111,-0.0067,0.0044,-0.0743,0.0094,-0.1081,-0.0496,-0.0908,-0.0626,-0.0761,-0.0318,0.033,-0.0972,0.0118,-0.06,0.002,-0.005,-0.0109,-0.0157,-0.0602,-0.0275,-0.0789,-0.0604,-0.0198,-0.0295,-0.1103,-0.1037,-0.051,-0.0549,-0.0346,-0.0544,0.0367,0.0343,0.0948,-0.0769,-0.0799,-0.0234,-0.0335,-0.1246,-0.0164,-0.0026,-0.0006,-0.0966,-0.042,0.0108,0.0219,0.0179,0.0064,0.0389,-0.0024,0.0377,0.0155,0.0348,-0.0415,-0.0931,-0.0079,0.0402,0.0158,-0.0571,0.0816,-0.0233,0.0041,0.1306,-0.0219,0.0307,-0.0312,-0.0307,0.0717,0.002,-0.0031,-0.0309,-0.0289,0.0135,-0.0523,-0.0158,0.0326,-0.0394,-0.0264,-0.0848,-0.0677,-0.0353,-0.1246,0.0058,0.0435,-0.0238,0.0213,-0.0045,-0.1036,0.047,0.0211,0.0929,0.0477,0.0276,0.0754,-0.0515,0.0192,0.0562,0.0887,0.0012,-0.0181,0.036,-0.0123,-0.0412,0.0341,-0.0922,-0.0157,-0.0167,0.0043,-0.0277,-0.0841,-0.0621,-0.0246,0.0205,-0.0484,-0.0197,-0.1466,-0.1241,-0.0248,-0.0009,0.045,0.016,-0.0315,-0.092,0.0034,0.033,-0.0647,-0.0472,-0.0192,-0.0124,0.0249,-0.0255,0.0375,0.0583,-0.1221,-0.0055,-0.1125,0.0829,0.0877,-0.0462,-0.0256,0.0176,-0.0006,0.0071,0.0076,-0.067,0.0113,-0.0136,-0.0254,0.0402,0.0394,0.0106,-0.056,0.0076,0.0154,-0.0936,-0.0864,-0.038,-0.0353,-0.0359,-0.0732,0.0086,-0.0357,-0.0054,-0.021,-0.0035,-0.0048,-0.0277,0.0432,0.0381,-0.0586,-0.0005,-0.0865,-0.072,-0.0291,0.066,0.0687,-0.0121,0.0052,-0.0834,-0.0163,-0.0514,-0.0771,-0.006,0.0886,0.0079,0.0047,-0.0139,-0.0011,-0.0253,-0.0859,-0.0283,-0.0555,0.0399,-0.0037,0.0328,0.034,0.0265,0.0343,-0.0543,0.0395,0.0008,-0.0691,-0.0412,0.039,-0.0041,0.0815,-0.0756,0.0387,-0.0751,0.056,0.0329,0.0249,0.0547,0.1118,-0.0314,0.015,-0.0008,0.0109,-0.0523,-0.0366,0.0048,0.0129,0.0551,-0.0375,0.0782,-0.0489,0.1448,0.1685,0.0774,-0.0169,-0.0286,-0.0734,-0.0226,0.0113,0.0105,-0.02,-0.0107,0.0226,0.0153,-0.0196,-0.0744,0.0213,0.0153,-0.1177,-0.0476,0.0586,-0.0669,-0.0699,0.0738,-0.0506,-0.0855,-0.0204,0.037,-0.0067,-0.0408,-0.1202,-0.1095,-0.0467,-0.0887,0.0114,-0.0412,0.0226,-0.0147,0.019,0.0079,0.0387,-0.0591,-0.002,0.0621,-0.0065,-0.0993,-0.0328,0.0066,0.0592,0.0437,0.0285,0.0121,-0.0433,-0.0062,0.0204,-0.0682,-0.0463,0.0058,0.0223,-0.0578,-0.0636,0.0335,-0.1166,-0.0412,-0.0273,-0.0351,0.0277,0.0508,-0.0138,-0.0059,-0.0306,-0.0932,-0.0905,-0.0073,0.1096,-0.0624,-0.0068,0.0182,0.0549,0.0662,-0.0405,-0.0464,-0.0319,0.0465,0.041,-0.0039,0.0234,0.0764,0.0422,0.0334,0.061,0.0883,0.0318,-0.0342,0.0581,-0.0779,-0.0067,0.033,0.098,-0.113,-0.1374,0.008,-0.0237,-0.0773,0.0164,0.0007,-0.0645,-0.0726,-0.0331,-0.0781,-0.0521,-0.0435,-0.0104,-0.0221,-0.0326,-0.0267,0.0454,-0.081,0.0234,-0.0133,-0.0147,0.0223,0.0416,-0.0313,0.008,0.073,0.0217,-0.0372,-0.0209,0.0123,0.0688,0.0913,-0.0073,0.0592,0.0811,0.0447,0.0519,-0.0225,0.0013,-0.0084,-0.1448,-0.0199,-0.0046,-0.1041,-0.0566,-0.0284,-0.1029,-0.0658,0.0001,0.0678,-0.0328,-0.037,0.0104,-0.0279,0.0076,0.0091,-0.0577,0.0365,-0.0386,0.0078,0.0427,0.0319,-0.0952,0.0761,0.0494,-0.0167,-0.0284,-0.0668,-0.046,-0.0673,0.0542,-0.0247,0.007,0.014,-0.0902,-0.0211,-0.0087,-0.0401,-0.0475,-0.0677,-0.0098,0.1144,0.2111,0.0339,-0.0023,0.0245,0.0234,0.0252,-0.024,-0.0002,-0.0354,0.0592,0.0081,0.0694,-0.0159,0.0439,-0.0584,-0.0528,0.0257,0.0222,0.0383,-0.0016,0.0681,-0.1101,-0.0312,0.0839,-0.056,-0.0492,0.0272,0.0449,0.0171,0.0371,0.1512,-0.0524,-0.0668,-0.0691,0.0106,-0.0408,0.0051,0.0063,-0.0586,-0.0909,-0.0102,-0.0435,-0.057,-0.0521,-0.1021,-0.0283,-0.0975,0.0369,-0.0278,-0.0324,0.0575,0.001,-0.0602,0.0349,0.0109,0.0653,0.0853,-0.0673,0.0238,0.0049,0.0685,0.0269,0.0041,-0.0504,0.0093,0.016,0.0301,0.0743,0.1133,-0.0571,-0.0192,-0.0835,-0.0546,0.0614,-0.1359,0.0071,-0.0836,0.0536,-0.0965,0.0136,0.0083,0.1835,0.0021,0.0085,-0.0432,-0.1285,0.1025,0.1137,0.0696,0.0721,-0.0101,0.0599,-0.0942,0.0528,0.0257,0.0252,-0.0595,0.0205,-0.0744,-0.0303,-0.0496,0.1224,-0.0598,-0.0015,-0.0451,-0.0092,-0.0026,-0.0215,-0.0047,0.0681,-0.0824,-0.0459,-0.0676,0.0066,0.0781,0.0872,0.055,0.0853,-0.0035,-0.0211,-0.0987,-0.0086,-0.0417,-0.0148,0.0255,0.0439,0.0232,-0.0531,-0.0622,-0.0478,0.0046,-0.0635,-0.0959,-0.0529,0.0405,0.0179,-0.0058,-0.0382,0.0137,-0.0181,-0.0494,0.011,-0.0014,-0.0936,0.0331,0.0479,-0.0093,-0.183,-0.1815,-0.1237,-0.0409,-0.0069,-0.052,-0.0195,0.0658,0.005,0.018,0.0209,0.0377,0.0401,-0.0014,-0.0015,0.0252,0.0468,0.1195,-0.1176,-0.0303,-0.0195,0.0308,-0.0102,-0.0803,0.0464,0.0058,-0.0532,0.0078,0.0024,0.0615,-0.0965,-0.1524,-0.1147,-0.0807,0.0176,0.0072,-0.0224,0.0065,-0.0024,0.07,0.0581,0.0103,0.0338,0.0285,-0.0511,-0.0212,0.0151,0.0431,0.0077,0.0408,-0.0158,0.0076,0.0627,-0.0169,0.0248,-0.0814,-0.0772,-0.0732,-0.0902,-0.0893,-0.0416,0.041,0.0123,0.0187,0.0024,-0.0145,0.0189,0.0216,-0.0141,-0.0635,0.0675,-0.0139,0.0252,0.0167,0.0406,-0.078,0.0501,-0.1176,-0.1109,-0.0125,-0.0182,0.0095,-0.0411,-0.0054,0.0166,0.0017,-0.0048,0.126,0.0266,0.1006,0.0784,0.0745,-0.0023,-0.012,0.0663,0.0687,-0.0486,0.0248,0.0045,-0.1081,-0.0832,-0.0455,0.0037,-0.0166,-0.157,-0.0495,-0.0798,-0.0968,-0.0799,-0.0464,-0.0332,0.0148,-0.0459,-0.0083,-0.0167,0.057,0.0551,-0.0164,-0.008,-0.0311,0.0161,-0.0276,0.0547,-0.0383,0.071,0.0721,-0.0704,0.0593,0.0528,0.0086,-0.0613,-0.0278,-0.0307,0.0319,0.0098,-0.1772,-0.0491,0.0142,0.0566,0.0123,-0.0026,0.013,0.0593,0.1036,-0.0413,-0.0572,0.0945,0.004,-0.0362,-0.0069,0.1568,-0.027,0.0898,0.0428,-0.0394,0.0433,-0.068,-0.0697,-0.0534,0.0646,-0.0621,-0.0513,-0.0313,0.0142,-0.0219,-0.0764,-0.0381,-0.0845,0.0136,-0.0107,-0.0228,0.0434,-0.0265,0.018,-0.0979,-0.0589,-0.0439,0.0306,-0.0505,0.018,0.0085,0.038,0.0264,0.0871,0.0458,-0.0263,-0.0144,-0.0437,-0.0616,-0.0693,-0.0598,0.0175,0.0654,0.0508,0.0131,-0.0545,0.0251,0.0506,0.0397,0.0044,0.0045,-0.0193,0.094,-0.0159,0.002,0.0389,-0.0037,-0.0462,0.006,0.0778,0.0076,-0.0298,0.0043,0.0432,-0.0546,-0.0664,0.0422,-0.0174,-0.0183,-0.1169,-0.0703,-0.1054,-0.0198,0.0085,-0.0633,-0.057,-0.026,-0.0604,-0.0573,-0.1185,-0.019,-0.0206,0.0178,-0.0064,0.0387,0.0011,-0.0151,0.0333,-0.004,0.0695,-0.0167,0.0302,-0.006,-0.0663,-0.0298,0.0022,0.0391,0.0161,0.0066,0.0517,0.0275,0.018,-0.0142,0.0325,-0.0272,-0.0311,-0.0008,-0.0125,-0.032,-0.0169,-0.0825,-0.0888,-0.0068,-0.1288,-0.1084,0.0872,0.0797,0.0249,-0.0131,0.044,0.0467,0.0276,0.0021,-0.0229,0.0365,0.0483,-0.0291,-0.019,-0.0039,-0.0772,-0.0425,-0.0137,-0.0205,-0.0804,-0.0374,-0.0192,-0.1046,-0.0677,0.0553,0.0111,0.0898,0.0325,0.002,-0.0496,-0.0549,0.0059,-0.047,-0.0058,-0.0,-0.0071,-0.0121,0.0507,-0.0101,0.0141,-0.0502,-0.013,-0.0296,0.0081,-0.0629,0.0627,0.1309,0.2169,0.0188,0.0321,-0.0053,0.0263,-0.0207,-0.0382,-0.0529,-0.0538,-0.0047,0.0156,0.08,0.017,0.0397,0.0282,0.0149,-0.0449,0.0469,-0.0777,-0.0254,-0.0878,-0.0501,0.0795,-0.0035,0.0407,-0.0475,0.0772,0.039,0.0144,-0.0261,-0.0263,0.0057,-0.0084,0.0186,-0.0628,-0.0656,-0.004,-0.0005,-0.0554,-0.0714,-0.0588,-0.0238,-0.0505,0.0251,-0.057,-0.0185,0.013,0.2181,0.0044,0.0369,0.0159,-0.058,0.0492,-0.0522,-0.0074,0.0077,-0.0678,0.1258,0.114,0.1441,0.1203,0.1083,0.0201,0.1372,0.0775,-0.109,0.0514,0.0548,0.0212,0.0158,0.0114,-0.0496,-0.0364,-0.0491,-0.0152,-0.0432,-0.0107,0.0257,0.002,-0.0752,0.0694,0.0765,-0.0147,0.0263,-0.0458,-0.0425,0.0115,-0.0419,-0.0799,-0.0644,-0.0433,0.0342,0.0285,0.0769,-0.0291,-0.1009,-0.0527,-0.0523,-0.0182,-0.0085,0.037,0.0671,0.0058,-0.0898,-0.0935,-0.052,0.059,-0.0218,0.1104,0.0749,-0.0339,0.0282,0.0293,0.1281,0.1234,0.1052,0.0242,0.0616,0.0037,0.0321,0.0275,-0.0188,-0.0666,0.0442,-0.0642,0.0673,-0.0337,-0.0454,0.0155,-0.084,0.0025,0.0019,-0.0134,0.2808,0.1122,0.0288,-0.013,-0.0192,-0.0104,0.0514,0.0299,0.0203,-0.1123,-0.109,-0.0691,-0.0495,0.036,-0.0481,-0.0546,0.0232,-0.0175,0.0775,0.051,0.0737,0.1293,0.03,-0.018,-0.022,0.0143,0.0947,0.0713,-0.0268,0.0353,0.0858,-0.0016,-0.0452,0.0579,0.02,-0.0187,-0.056,-0.0082,-0.0541,-0.0449,-0.1398,-0.0336,0.108,-0.0643,-0.0679,0.0361,-0.0262,0.0399,-0.0031,-0.0322,-0.0485,-0.052,0.082,0.0859,-0.0003,0.0885,0.0613,0.0823,0.0733,-0.0778,0.0036,-0.0164,-0.0729,-0.0538,-0.0464,0.0859,0.0661,-0.0641,-0.0787,0.0142,0.0049,-0.0465,0.0463,-0.0281,0.0651,0.0177,0.1003,-0.0766,-0.0674,-0.0054,0.0377,0.0458,-0.0246,0.0118,0.0118,-0.1233,-0.0112,0.0124,0.0042,0.0029,0.0324,-0.0827,0.115,-0.114,-0.1189,-0.0036,-0.0012,-0.0779,-0.0882,-0.0857,0.0341,0.0634,-0.0195,0.0018,0.0006,0.0952,0.0148,-0.018,-0.0233,-0.0009,-0.003,0.0494,0.0418,-0.0,-0.0603,-0.0131,-0.0508,-0.0836,-0.0674,-0.0049,0.0183,-0.0251,0.1391,0.1153,0.1246,-0.019,0.0621,-0.067,-0.0512,-0.0175,-0.0876,-0.0031,-0.0991,-0.032,-0.0097,-0.0535,-0.0992,0.0161,0.0147,-0.0831,0.0205,0.0652,0.0251,-0.0359,-0.0317,-0.0319,0.011,-0.0601,0.0244,-0.0063,0.0392,0.0455,0.0682,0.0737,0.0434,0.0403,0.0276,-0.0844,-0.0882,-0.0093,-0.0563,-0.0564,-0.078,0.0227,0.0176,0.0052,-0.0339,-0.0975,-0.0818,-0.0231,0.0342,-0.0267,0.0615,-0.0828,-0.0081,-0.0105,-0.0931,-0.0966,-0.1308,-0.061,0.0175,-0.1038,-0.1112,-0.0061,-0.0029,0.0056,0.0252,0.0033,-0.042,-0.05,0.0331,-0.069,0.0281,0.0033,0.0488,0.0394,-0.1439,-0.0384,0.0834,-0.0585,0.0301,0.0088,-0.0501,0.0188,0.0529,0.059,0.0751,-0.0799,0.0443,0.0394,0.0216,0.1645,0.0329,-0.0034,0.1057,0.0718,0.1,-0.0073,-0.0216,-0.0464,-0.03,-0.0865,-0.0999,-0.0629,0.0244,-0.0386,-0.035,-0.0728,0.0157,-0.0153,-0.0226,-0.0501,-0.0125,-0.0135,-0.0005,0.0257,0.038,-0.0554,-0.0045,-0.0553,-0.0574,-0.0397,-0.032,-0.0458,-0.0221,0.0439,-0.0099,0.0459,-0.0017,-0.0276,-0.0158,0.036,0.0136,-0.0949,-0.1702,0.0366,0.0521,0.0804,0.014,0.0048,-0.0124,0.002,0.0203,-0.0071,-0.0172,-0.0364,0.0139,-0.1036,0.0022,-0.0077,0.0216,-0.0037,-0.0058,0.0022,-0.0398,-0.0645,0.0659,0.034,0.0101,0.0411,0.0461,0.0089,0.0418,0.0242,-0.0045,-0.0544,-0.0153,0.0925,-0.0117,0.0096,-0.0081,-0.0208,-0.0461,-0.0313,-0.0119,0.0339,0.0862,0.1006,0.0831,0.0042,-0.0324,-0.0406,0.0748,0.026,0.0019,-0.0108,0.0131,0.031,0.0241,0.0159,-0.0003,0.049,0.0396,0.0107,0.032,0.0463,-0.0896,-0.0501,-0.0373,0.0053,-0.0335,-0.0883,-0.0379,-0.0914,-0.0595,0.0271,0.003,-0.0393,-0.0531,0.0,0.0405,0.0755,-0.0662,-0.0137,-0.0061,-0.0178,-0.0104,-0.0554,0.0079,0.033,-0.0282,0.0755,0.0797,0.0482,-0.0336,0.0458,-0.0306,0.1082,0.1024,-0.1268,-0.1034,0.0423,-0.0388,-0.0715,-0.0325,-0.0606,0.0496,-0.0142,-0.0347,0.0239,-0.0024,0.1588,-0.0439,0.0487,0.0116,0.021,0.0729,0.0731,0.1045,-0.0388,0.0609,-0.0062,0.0063,0.002,-0.0042,-0.0644,-0.0324,-0.0363,0.0833,0.1034,-0.0051,0.0044,-0.0065,-0.0032,-0.0749,-0.0545,-0.0619,0.0635,-0.0404,0.0388,0.0065,-0.0792,-0.0662,0.0117,0.0139,-0.0499,-0.052,0.0143,-0.0422,0.0354,-0.0391,0.0025,0.0364,-0.0655,-0.0521,-0.0153,-0.025,-0.0815,0.0295,0.0799,0.0107,-0.0635,0.0477,0.0161,-0.0005,0.1227,-0.0583,-0.1267,0.0061,-0.0911,0.0068,0.0486,0.0951,-0.0174,0.0412,0.0417,-0.0241,-0.0158,0.0513,-0.0245,0.0407,-0.0137,-0.0139,0.0058,0.0865,0.0581,0.0549,-0.0193,-0.0419,-0.0453,-0.0439,0.0316,0.0133,-0.0421,0.0069,-0.0071,0.0313,0.1206,0.2172,-0.1381,-0.0353,-0.0212,-0.0226,-0.0145,0.0075,0.0219,0.0231,0.0207,0.0285,-0.0361,-0.0276,-0.015,-0.0207,0.0292,-0.0408,-0.0715,-0.0689,0.0117,-0.043,-0.0121,0.0935,-0.065,-0.0431,-0.054,0.1293,0.0437,0.1355,-0.042,-0.028,-0.0401,0.0334,0.0822,0.0331,0.0267,-0.0175,-0.0054,-0.0004,0.045,-0.0419,0.0833,-0.0937,-0.0331,-0.0448,-0.0741,-0.0167,0.0162,0.071,0.1284,-0.0633,0.0639,0.0686,0.0107,-0.0652,-0.0264,-0.0063,0.0767,0.0222,0.0234,0.0646,0.0652,0.0617,-0.1031,-0.0725,-0.0907,0.0382,-0.0276,-0.0443,-0.0603,-0.0675,-0.0635,-0.0833,0.0318,-0.0424,0.0395,-0.0141,-0.0197,0.0333,-0.0115,-0.0029,-0.0031,0.0098,-0.0958,0.0174,-0.0911,-0.05,-0.0681,0.0485,0.0718,0.0561,-0.0014,-0.0192,0.0023,-0.0363,-0.1394,-0.1156,-0.0622,-0.0774,-0.0216,-0.0045,0.0809,-0.1009,-0.0784,-0.0495,-0.0352,-0.0099,-0.0306,-0.0134,-0.0456,-0.0297,0.0108,-0.09,-0.0864,-0.0248,0.0245,-0.0307,-0.0199,-0.1216,0.0134,-0.0586,-0.0791,-0.1528,0.0384,-0.0649,0.0155,-0.0913,-0.0062,-0.0075,-0.0345,-0.0694,-0.1069,-0.123,-0.044,0.0107,0.0279,-0.048,0.0479,-0.1221,-0.0142,0.0457,0.0642,0.0124,0.0086,-0.0375,0.0998,-0.0958,-0.1071,-0.0887,0.0006,-0.0372,-0.0828,-0.0851,-0.0129,-0.0614,-0.0324,-0.0248,-0.0264,-0.1576,-0.0171,-0.0185,-0.052,-0.0062,-0.0121,-0.0692,-0.0225,-0.0226,-0.0136,0.0105,0.0026,-0.0914,-0.125,-0.0551,-0.1175,0.0045,-0.1391,-0.1135,0.0157,0.0788,0.0448,-0.0007,-0.0183,-0.035,0.0642,0.0722,0.0724,-0.1659,-0.1771,-0.0325,0.0314,-0.0233,0.0222,0.024,0.0086,-0.0533,-0.0101,-0.0367,-0.0407,-0.0109,-0.02,-0.0419,-0.0049,-0.0473,0.0516,-0.0105,0.0348,0.0907,0.0593,0.0012,-0.0734,-0.079,-0.041,-0.0589,-0.1402,-0.1009,0.0991,-0.0132,-0.0749,0.2173,0.1533,0.1702,0.2154,0.1376,0.1303,0.1546,0.0628,0.064,0.0826,0.2181,0.062,0.1886,0.2152,0.1273,-0.0872,0.1037,0.0488,0.0877,-0.0366,-0.0533,0.0376,-0.0361,-0.0088,0.0809,0.021,-0.0518,-0.0195,0.1367,0.0252,-0.0167,0.0652,-0.028,-0.0095,0.0895,0.0683,-0.0419,-0.0043,-0.0013,0.0169,0.0138,0.0152,-0.0248,0.0188,0.0097,-0.1561,-0.0598,-0.0942,-0.0823,-0.04,-0.0931,-0.0821,-0.0435,-0.0194,-0.0619,0.0336,0.0534,0.0069,-0.0679,-0.1733,0.0508,-0.057,0.0191,0.0466,-0.0607,0.0276,-0.0807,-0.0391,-0.0112,-0.0423,-0.0777,-0.0399,0.0114,0.0372,0.0839,0.0554,0.0024,-0.0521,-0.0243,-0.0864,-0.0834,-0.0447,-0.0083,-0.0581,0.0056,-0.0292,-0.012,0.0852,-0.0281,-0.045,0.0083,-0.0109,-0.0389,-0.0648,-0.0743,0.0177,-0.0136,-0.0237,-0.0767,-0.0072,0.0451,-0.0214,0.0079,-0.012,0.0071,0.033,0.04,-0.0118,-0.0629,0.024,0.0719,0.0457,-0.0353,0.1111,0.0294,-0.0267,-0.0628,0.1029,0.1678,0.0227,0.0369,0.0096,0.0633,-0.0756,-0.0715,-0.0375,-0.0475,0.0784,0.1088,0.0437,-0.0314,0.0094,0.0713,0.1253,0.1212,0.1361,-0.0275,0.0148,-0.0164,-0.0182,0.0168,0.0046,-0.0712,-0.0416,-0.0428,-0.101,-0.0514,-0.0398,0.0208,0.0135,0.012,-0.0605,0.0219,0.0322,0.0669,0.0992,0.0906,0.0907,-0.0113,-0.0399,-0.0449,-0.0198,-0.0465,-0.0304,0.0112,-0.0579,-0.1131,-0.1033,0.0404,0.0522,0.0215,0.0277,0.0106,0.0679,-0.0022,0.0217,0.1138,-0.0325,-0.0711,-0.0867,0.1034,0.0045,-0.0661,0.031,0.0648,0.066,0.087,-0.0556,-0.0516,-0.0794,-0.065,0.1124,0.0156,0.0323,0.0027,-0.0633,0.0113,0.0118,-0.0307,-0.0015,-0.0193,-0.0557,-0.0012,-0.0916,-0.0708,-0.0672,0.0066,-0.0106,-0.019,0.0433,0.0234,0.0144,0.0828,0.0847,0.0436,0.0841,-0.0811,0.0093,-0.0101,0.083,0.0875,0.0521,-0.0385,0.0171,-0.0349,0.0233,-0.0314,0.0043,-0.0021,0.0687,0.0906,-0.0359,0.0215,-0.0119,0.0621,0.0525,-0.0189,0.0186,-0.005,0.0906,0.0832,0.0429,0.0053,-0.1043,-0.0476,-0.0236,-0.0448,-0.1011,0.0252,0.0081,-0.0168,-0.0419,0.1228,0.0511,-0.154,-0.0538,0.0257,-0.0681,0.0358,0.0282,0.0028,0.0413,0.088,0.1206,0.1545,0.0527,-0.013,0.0421,0.0782,-0.0336,-0.0059,0.0156,0.0003,-0.027,0.0476,-0.0176,-0.0082,-0.0675,-0.106,-0.0988,-0.0889,-0.0379,-0.0077,-0.0435,-0.0273,-0.0486,0.0379,0.0532,-0.0267,0.0013,-0.0065,0.1104,-0.0195,0.0179,0.0055,-0.011,-0.0365,-0.0421,0.0317,-0.0614,-0.0341,0.1363,-0.028,-0.0282,0.0338,-0.012,0.0142,0.0236,-0.0403,-0.0141,-0.0265,0.0007,0.0199,-0.035,-0.0044,-0.0242,0.0316,0.0117,-0.0986,-0.0701,-0.0306,-0.0538,-0.0477,-0.0134,-0.0646,-0.0517,0.073,-0.0391,0.0177,-0.15,-0.0606,-0.0626,-0.1403,-0.108,-0.0581,-0.0129,-0.0129,-0.0436,0.0023,0.0417,-0.0814,0.0179,-0.0679,-0.1056,-0.1035,-0.0449,-0.2244,0.0353,-0.0322,-0.0113,-0.0067,0.0673,-0.0156,-0.0623,-0.0862,-0.0457,-0.0055,-0.0004,-0.0664,0.0557,0.0712,0.1273,0.2102,0.1473,-0.0255,0.0253,0.0981,0.0873,0.015,-0.1629,-0.1282,-0.0352,-0.0775,-0.0114,0.028,0.0283,0.0408,0.003,-0.035,0.0436,0.022,-0.0448,0.0496,-0.0203,-0.0765,-0.057,-0.1029,-0.0094,0.0057,0.0586,-0.0288,0.1982,0.186,0.0748,0.1636,0.0235,-0.0011,0.0276,0.0173,0.046,0.0214,0.0458,0.0347,0.0057,0.0233,0.0054,0.0329,0.0314,-0.0384,0.0302,-0.0535,-0.0013,0.1078,-0.087,0.1603,0.0432,0.1782,0.061,0.0593,0.1006,0.0454,-0.0261,0.01,-0.0174,0.0167,-0.029,-0.0593,-0.0742,0.0143,0.0363,0.0163,-0.0373,-0.0244,-0.0451,0.0108,0.0174,0.0081,-0.0049,0.0188,0.0644,-0.0523,0.0551,0.0218,-0.0305,0.0434,0.0093,-0.0592,-0.0291,-0.0325,-0.0017,-0.0035,-0.0039,-0.0497,0.1062,0.0503,-0.009,0.0006,-0.0148,0.0554,-0.0029,-0.0667,-0.0194,-0.0333,-0.0496,0.023,0.0305,0.0075,-0.0076,-0.0303,0.0515,-0.0207,-0.1104,-0.0786,-0.0563,-0.0963,-0.0,-0.0131,0.0277,-0.0911,-0.0715,-0.107,0.0109,-0.0206,0.0055,0.0234,0.0663,0.0225,-0.0571,-0.03,-0.0335,-0.0039,-0.041,-0.0396,0.0458,0.0599,-0.0249,-0.0184,0.0054,-0.0517,0.0404,0.0106,0.064,-0.0085,-0.019,-0.0688,0.0239,-0.0451,-0.0511,0.0446,-0.048,0.0415,0.0282,0.0527,0.0426,0.0797,-0.0045,-0.0501,-0.0267,0.0596,0.0831,-0.0056,0.0578,-0.0634,-0.0095,-0.0092,-0.0331,-0.0798,-0.0734,-0.0892,0.0473,-0.054,-0.0956,-0.0331,-0.0769,-0.0198,0.0098,-0.0042,0.0119,-0.1392,-0.0112,0.027,0.0199,0.009,0.0138,0.0415,0.0929,0.0167,0.007,-0.0212,-0.0442,-0.0115,-0.0839,-0.1319,-0.041,-0.022,-0.0271,-0.0165,0.0029,0.0589,-0.0122,-0.0651,0.0252,-0.0901,-0.0219,-0.0555,-0.1048,0.0329,-0.0217,-0.0446,-0.1096,-0.0342,0.0995,0.1307,-0.1114,-0.0174,-0.0121,0.0572,0.021,-0.054,-0.0642,-0.1043,-0.0894,-0.0254,-0.0089,0.0274,0.0046,-0.0407,-0.0064,0.0713,0.0303,0.0131,0.0083,0.015,-0.0276,0.006,0.0445,-0.0513,0.0043,-0.0673,-0.0434,0.0827,-0.0381,0.0897,0.0042,0.0782,0.0458,0.115,-0.0351,-0.0402,-0.0945,-0.0219,-0.0486,0.0986,0.0913,0.0753,-0.0146,-0.02,0.0182,0.0717,0.0616,0.0355,0.0355,-0.1349,-0.025,-0.0159,0.0605,-0.0392,0.0155,0.0693,0.0388,0.0017,0.0413,0.0341,-0.036,0.062,0.039,0.0065,0.1254,0.0252,-0.0066,-0.0437,0.049,0.0496,0.0169,0.0476,0.014,0.0435,0.1215,0.0535,0.0506,0.0179,0.0605,-0.0149,-0.0278,-0.0491,-0.1882,-0.1869,0.0657,0.0842,0.1055,0.018,0.0073,-0.101,-0.113,-0.0901,-0.0971,0.032,-0.034,-0.0156,-0.0329,-0.0026,-0.0498,-0.0792,-0.0042,-0.0576,-0.0765,0.1377,-0.1063,0.0042,-0.1285,-0.0604,-0.0253,-0.0045,-0.0288,0.0091,-0.0223,0.0733,-0.0692,0.0912,-0.086,0.0767,0.0203,0.0284,0.0247,0.003,0.0918,0.1051,0.0717,-0.0964,-0.0581,-0.0425,-0.0294,-0.0924,-0.0567,-0.0593,-0.129,-0.0553,-0.0392,-0.0881,0.0189,-0.064,-0.0127,-0.0017,-0.0466,0.0023,-0.0024,-0.1279,-0.0984,0.0485,-0.0353,-0.0991,0.0254,0.0294,-0.0431,0.0067,0.0173,0.05,0.0945,0.0816,-0.0824,-0.0809,-0.0614,-0.054,0.0202,0.0613,-0.0198,0.0101,-0.0251,0.0694,0.0602,0.0332,0.0287,0.0704,-0.1411,-0.1311,-0.043,-0.0298,-0.0166,-0.0602,-0.0715,-0.0555,0.0324,0.0057,0.0343,-0.0319,0.008,-0.0815,0.157,0.1364,0.0962,0.0439,0.0068,0.0812,-0.0656,-0.0382,-0.0412,0.1092,0.0654,0.056,0.0122,0.0096,0.0938,0.0758,0.0936,0.1124,-0.0471,-0.0611,0.0121,0.0445,0.01,0.0809,0.0115,0.0294,-0.0716,0.0571,0.0248,-0.0277,-0.0123,-0.1006,-0.0595,-0.055,-0.0427,0.0531,-0.0519,0.0266,0.0819,0.0675,0.0285,0.016,0.0373,-0.0248,0.0485,0.093,0.0208,0.054,0.0653,-0.0095,0.0017,-0.0215,0.112,0.064,0.0527,0.0458,0.0288,0.0776,0.0248,0.0255,0.0092,-0.0173,-0.0416,-0.0669,0.029,0.1259,0.0175,-0.0655,0.0234,-0.0207,0.0726,0.0337,-0.0553,0.015,-0.0037,0.0035,0.0551,0.0618,0.0812,0.0518,-0.0324,0.0677,-0.0394,-0.0601,0.0591,0.0221,0.0796,0.049,0.0121,0.0234,-0.0553,-0.0481,0.0365,0.2678,-0.0144,-0.0379,-0.0643,-0.0928,-0.1251,-0.0853,-0.0826,-0.0557,-0.0593,-0.0351,-0.0622,-0.0101,0.0607,0.0643,0.0175,-0.0801,-0.0096,-0.0685,-0.0538,-0.0188,-0.059,-0.0136,-0.0124,0.0372,0.0701,0.047,-0.019,-0.0426,-0.0199,-0.0518,0.0028,0.001,0.0131,0.1239,0.0291,-0.0319,-0.0019,-0.0007,0.0598,-0.0785,-0.0419,-0.011,-0.0038,-0.0497,-0.0403,-0.0353,-0.0811,0.0673,-0.0519,0.0776,0.1215,-0.0022,-0.1385,-0.0505,0.0159,0.04,-0.0302,0.0266,-0.203,-0.1469,-0.0808,-0.0905,0.0916,-0.0907,-0.0661,0.0055,-0.038,0.0846,0.0423,-0.0094,0.0411,0.0605,0.1248,0.0189,0.065,0.0055,0.0307,0.0571,-0.0501,-0.006,0.0279,-0.0178,0.0829,0.0515,-0.0441,-0.1094,-0.1052,-0.0274,-0.0587,-0.0581,0.0939,0.01,0.0064,0.0036,0.0301,-0.0021,-0.0842,-0.018,-0.059,-0.0254,-0.0853,-0.0633,-0.0028,-0.0249,0.0053,-0.0787,0.0031,0.0252,-0.0005,-0.0766,0.0614,-0.0578,0.0096,-0.0267,-0.0104,-0.0083,-0.032,-0.0057,0.0154,0.0539,-0.0724,-0.0441,-0.037,0.0518,0.0257,0.0174,-0.0155,0.0843,-0.038,-0.0735,0.0202,0.0244,0.0247,-0.0651,-0.0246,0.0074,0.012,-0.0496,0.0204,0.0572,0.0704,-0.0046,-0.0184,-0.0205,0.0315,0.0359,0.1109,-0.0017,0.1207,-0.0575,0.2585,0.2573,0.0122,0.0138,-0.0161,-0.0183,-0.0107,0.0174,0.0203,0.0874,-0.0284,-0.064,-0.0232,0.0372,0.0714,0.0386,-0.1194,-0.0711,-0.1245,0.016,-0.0989,-0.0432,-0.0568,-0.0266,0.0484,0.0107,-0.0627,-0.0884,0.0391,0.0099,-0.0436,0.1355,0.0814,0.0165,-0.0032,0.051,0.1331,0.1122,0.0722,0.0728,-0.0134,0.0058,0.0584,0.0529,-0.0458,0.0542,-0.005,0.0109,-0.0274,0.1712,0.0531,-0.055,-0.0411,-0.0239,-0.0877,-0.0075,-0.0602,-0.0467,-0.0097,-0.0784,-0.0133,-0.1032,-0.0868,-0.0105,-0.0953,-0.0926,-0.0623,-0.0282,-0.0641,-0.0406,-0.0725,-0.0854,-0.0756,-0.0146,-0.0681,-0.1166,-0.0937,0.0418,0.0671,0.0358,-0.0171,-0.0356,0.0049,-0.0193,-0.0603,-0.04,-0.0098,-0.0362,0.0188,-0.1235,-0.1356,-0.0412,0.0009,-0.0894,-0.1265,-0.0135,-0.0383,-0.0125,-0.1161,-0.0526,-0.0378,0.0244,-0.0287,0.0666,-0.0812,0.0744,-0.059,0.0366,0.0771,0.1318,-0.0717,0.0078,-0.1135,-0.0359,-0.0498,0.0129,-0.0224,0.0071,0.0365,0.0228,0.0071,-0.0132,0.0248,-0.0892,0.0023,0.0875,-0.0549,-0.0306,-0.0813,0.0424,0.0352,0.071,0.1117,-0.1289,-0.1024,0.0068,0.0139,-0.0132,0.0994,0.017,-0.0363,-0.0722,-0.0998,-0.0253,-0.0825,-0.0904,-0.0345,-0.0839,0.0722,0.0387,0.0684,0.0059,0.1155,-0.0334,0.0368,-0.005,0.0489,0.0713,-0.0072,-0.0536,-0.0313,-0.049,-0.0054,-0.051,-0.0457,-0.038,-0.0417,-0.046,-0.0206,-0.0353,0.0067,-0.0539,-0.0183,-0.0289,-0.0043,-0.0044,0.0111,0.0169,-0.0086,0.0022,0.0023,-0.0442,-0.0215,0.0118,-0.048,-0.0416,-0.0563,0.0788,0.0346,0.1341,-0.0134,0.0222,-0.0806,-0.0477,0.0108,-0.0718,0.0845,0.0541,-0.0873,-0.1043,0.07,-0.0655,0.008,-0.0345,0.083,0.1389,-0.0922,-0.0075,-0.0534,-0.0472,-0.0358,-0.1245,-0.0828,-0.0515,0.0067,0.0234,0.0267,-0.0048,-0.0868,-0.0316,0.0478,0.0068,0.0544,0.0087,0.0112,-0.0198,-0.0954,-0.0245,0.0167,-0.0584,0.0014,-0.1436,0.1735,-0.0971,0.0837,0.0071,0.0075,-0.1535,-0.1454,0.0721,0.0723,0.0159,0.133,0.0175,0.1318,0.0406,-0.0231,0.1241,0.033,0.0226,-0.0008,0.0153,-0.0006,0.038,-0.0112,-0.0049,0.0404,0.1566,0.035,0.0536,0.1086,0.0448,0.0362,0.079,0.121,0.1113,0.0664,0.0697,0.0402,0.0373,0.0957,0.0715,0.1462,0.0781,0.0763,0.1642,0.0198,-0.115,-0.0266,-0.1316,-0.0349,-0.0598,-0.0891,-0.0809,-0.0382,0.1733,0.0917,-0.1745,-0.1383,-0.0966,-0.0055,-0.0157,-0.0964,0.0504,-0.0056,-0.026,0.0151,-0.0077,0.006,-0.0287,-0.0121,-0.079,0.0481,-0.1236,-0.1217,0.0274,-0.0208,-0.0225,-0.0015,0.0003,-0.0966,0.0144,-0.0097,-0.0218,0.0425,0.0567,-0.0591,0.0405,0.0159,-0.0708,0.0909,0.0949,-0.0874,-0.0862,0.0359,-0.0692,-0.0262,-0.0746,0.0082,0.0938,-0.0189,-0.0323,0.038,-0.0523,-0.0589,0.0303,causal inference
trm_4a3fd79d0b89e,-0.0943,-0.0774,-0.1087,-0.1551,-0.0691,-0.0684,-0.0786,-0.1006,-0.0431,-0.0556,0.0234,-0.0142,-0.091,-0.0351,-0.1007,-0.0548,-0.0899,-0.1157,-0.087,0.0323,-0.042,0.0104,-0.0366,0.0522,-0.0181,0.0021,-0.0003,-0.067,-0.1017,-0.0558,-0.0778,-0.0972,-0.0813,-0.0756,-0.0747,-0.1023,-0.0688,-0.0769,-0.1099,-0.0671,-0.0804,-0.04,-0.0369,0.08,-0.0699,-0.007,0.1212,-0.0595,0.0147,-0.0868,-0.0204,0.0499,0.055,0.0074,-0.0255,-0.0496,-0.0808,0.008,0.0365,-0.0277,-0.0044,-0.0323,-0.1029,0.0564,0.0102,0.0193,-0.165,-0.1857,-0.1041,0.0035,0.0561,-0.0205,0.204,-0.0349,-0.1175,0.1501,-0.1161,0.0034,0.0286,-0.0185,0.047,0.0528,-0.0039,-0.0838,0.0143,0.0122,-0.0072,-0.0473,0.0285,-0.1651,-0.0888,-0.0778,-0.0128,0.0769,0.1327,0.0983,0.1071,0.0145,0.0933,-0.0167,0.0502,-0.0004,0.0415,-0.0636,0.0747,-0.127,-0.0607,0.2189,-0.0179,-0.0556,-0.0347,-0.0877,0.0783,0.1276,0.0162,0.0827,-0.0742,-0.0386,-0.0011,-0.0822,-0.0591,-0.0921,-0.0667,0.0053,-0.0529,-0.0396,-0.0251,-0.0176,0.0296,0.0145,0.0401,-0.0885,-0.0019,-0.122,-0.0055,-0.1201,-0.0279,-0.0715,-0.0048,-0.0693,-0.0817,-0.1037,0.0797,-0.0139,0.0098,-0.0009,-0.103,0.0209,-0.0818,0.105,-0.0516,-0.0767,-0.1449,-0.0791,0.1471,-0.0422,0.024,0.0118,-0.035,-0.0886,-0.0503,-0.0796,-0.1491,-0.153,-0.0163,0.0242,-0.0289,-0.0599,-0.0511,0.069,-0.0859,-0.0977,-0.0309,-0.0339,-0.0253,-0.0674,-0.0419,-0.0362,-0.0055,-0.0547,-0.0425,0.0409,-0.0896,-0.0156,-0.0672,-0.0532,-0.1006,0.0067,0.0288,0.004,0.0289,-0.0034,0.0147,-0.128,-0.1081,-0.1552,-0.1622,0.0545,0.086,-0.1028,-0.1036,0.0388,-0.0287,-0.0933,-0.0455,-0.0458,0.0435,-0.1075,-0.0804,-0.0211,-0.0903,-0.0371,0.0151,-0.0355,0.0922,0.0548,0.0745,-0.1222,-0.2051,0.0331,0.0633,-0.0608,-0.1035,-0.0641,0.0192,0.0145,-0.0331,0.1164,0.0223,0.1145,-0.1469,-0.0686,0.0791,-0.1489,-0.1506,0.0117,0.0527,0.0768,0.0102,0.0204,-0.0408,-0.1038,-0.0744,0.0011,-0.0538,-0.0261,-0.0201,-0.101,-0.0611,-0.0205,0.0649,0.0549,0.0031,0.0566,-0.0017,-0.0759,0.0225,-0.0807,0.1874,0.1912,0.0257,0.1392,-0.0798,0.0756,0.0526,0.1895,0.067,0.0171,0.037,0.0521,-0.0406,-0.035,0.0147,0.0637,-0.0413,0.044,-0.1206,-0.1426,-0.1314,-0.0403,0.0373,0.0374,0.0397,-0.0305,0.0132,-0.0822,0.0901,0.1125,-0.1072,-0.0794,-0.1002,-0.0408,-0.0749,-0.0444,-0.0532,-0.0671,0.0251,0.0645,-0.051,0.0971,0.0846,-0.1028,-0.1043,-0.1047,-0.1175,-0.1159,-0.1236,-0.0155,-0.0376,0.0206,-0.0099,-0.0145,-0.1113,0.0846,0.0578,-0.0493,0.1081,0.0264,0.0447,-0.0738,0.0137,0.0028,-0.067,-0.0603,-0.0883,-0.0563,0.017,-0.0084,-0.1011,-0.1358,0.0348,-0.0672,-0.0221,0.0075,-0.003,0.0621,0.0671,0.0288,0.077,-0.0886,-0.0829,-0.0295,-0.0227,-0.0237,0.0716,0.0183,-0.2249,-0.1666,-0.1489,-0.1148,-0.0598,0.0723,-0.1471,-0.057,-0.0596,-0.1251,-0.096,-0.0475,-0.1119,-0.0903,0.0251,0.0178,-0.0142,-0.0848,-0.0433,-0.0097,-0.1348,0.1106,0.0402,-0.1288,0.0376,0.0501,-0.0207,0.0487,-0.0886,-0.0272,-0.074,0.1019,0.2275,0.0917,0.2582,-0.0446,-0.0958,-0.0486,-0.0117,0.0405,-0.0778,-0.0073,0.0106,-0.0655,-0.0788,-0.025,-0.1517,-0.0268,0.0549,-0.0245,-0.1161,-0.1458,-0.1154,-0.1022,-0.0364,0.0358,0.0147,-0.0493,-0.0023,0.0039,0.1469,0.0213,-0.0947,-0.0071,-0.0096,-0.1065,-0.0243,0.2901,-0.046,0.0399,0.2603,-0.0369,-0.0829,-0.0306,0.0171,-0.2085,-0.137,-0.2391,-0.1967,-0.1135,-0.1286,-0.0877,-0.1031,-0.1439,-0.0139,0.0659,0.0287,-0.0059,0.0303,0.0589,0.0265,0.0325,-0.2204,-0.1126,0.0825,0.0153,-0.0552,0.0689,-0.0289,-0.0982,0.0259,0.0615,0.0001,-0.0101,-0.0059,0.0486,-0.0839,-0.0368,0.0073,-0.0531,0.0486,-0.0399,-0.0023,0.0441,0.0293,-0.0215,-0.0667,0.054,-0.0313,-0.0919,0.0306,0.2782,-0.1099,-0.0599,-0.0336,-0.0085,0.0538,0.0317,0.044,-0.0303,-0.0249,0.0395,-0.0385,-0.048,-0.0185,-0.0559,-0.0562,0.0361,0.0127,0.0565,-0.0222,-0.0759,-0.068,-0.0372,0.1026,0.0129,-0.0997,-0.1353,0.0448,0.0648,0.0036,-0.1079,0.0376,-0.0858,-0.0719,0.0427,-0.0949,-0.1267,-0.069,-0.0657,0.1228,0.1559,-0.0276,0.0002,-0.1256,-0.0488,0.0659,-0.0459,0.0529,0.0605,-0.0507,-0.0542,0.03,-0.0657,-0.0494,-0.0602,0.0607,0.0119,0.1309,0.0238,0.1006,0.1021,0.0448,0.0473,-0.0715,-0.0016,-0.1193,-0.1223,0.0079,0.0834,-0.058,-0.0751,0.0024,-0.0777,0.0123,0.0678,0.0313,-0.0504,-0.0707,-0.0201,-0.0001,0.0651,0.0188,-0.0615,0.0634,0.0022,0.0194,-0.0526,-0.0218,-0.0666,0.0891,0.0193,0.0507,-0.0449,0.0276,0.0038,0.0338,0.024,-0.0111,0.0576,0.054,0.0547,0.0063,0.0209,-0.0204,0.066,-0.1879,-0.0208,-0.1737,-0.1274,0.0313,0.0305,0.1148,0.1273,0.0744,-0.0455,0.037,-0.0753,0.062,0.0445,-0.0904,0.0295,-0.0106,-0.0576,-0.0713,0.0035,0.0657,0.0927,-0.0791,-0.0663,-0.1749,-0.0209,0.1135,-0.0746,0.0435,0.0465,0.0249,0.0328,0.0201,-0.1008,0.0299,-0.1317,-0.1288,0.0479,-0.1394,-0.0707,0.0371,-0.0349,-0.1852,-0.0196,-0.0472,0.0151,0.0359,-0.1588,-0.0816,-0.1512,-0.0135,0.0123,-0.0671,-0.0418,-0.0806,-0.0558,-0.0513,0.0088,-0.0012,-0.0451,0.0181,0.0073,-0.0477,-0.0253,0.0151,-0.0822,-0.0287,-0.0068,-0.0641,0.0179,-0.0186,-0.1753,-0.0643,-0.0074,-0.1065,-0.0778,0.0149,-0.0943,-0.0338,-0.0647,-0.0029,-0.0163,-0.0071,-0.0969,-0.05,-0.0959,-0.0376,-0.0692,-0.0756,-0.125,0.1031,-0.123,-0.0077,0.0444,-0.1289,-0.1304,-0.1052,-0.0555,-0.097,-0.0448,-0.0493,-0.057,-0.0252,-0.0856,0.0731,-0.0427,0.0168,-0.0066,0.0178,0.0142,0.075,0.0291,0.0874,-0.1012,-0.074,0.0757,0.01,-0.0459,0.0968,0.0762,0.0761,0.0886,-0.0308,0.0083,0.023,-0.0589,-0.0575,0.0014,0.0379,0.0306,0.0106,-0.0531,-0.0484,-0.06,-0.0398,-0.0613,-0.1055,0.0526,0.0975,0.0047,-0.0902,0.125,0.0358,0.067,-0.023,0.0325,-0.0978,0.028,0.0981,-0.024,-0.1239,-0.1382,-0.0476,-0.0335,0.0188,-0.0833,0.0741,-0.0244,-0.0058,0.0239,-0.0821,0.0002,0.0249,-0.0017,-0.123,0.0481,0.0931,0.2113,-0.0309,-0.0195,-0.08,-0.0093,0.0402,-0.0763,0.0903,0.044,-0.0315,-0.0074,-0.008,0.069,-0.0992,-0.1405,-0.1088,-0.0955,0.0481,0.1469,0.0052,-0.1054,0.0235,-0.048,0.0318,0.0226,0.0613,0.0026,0.0074,-0.0659,-0.1212,0.0925,0.0322,0.0866,-0.0798,-0.0478,0.0057,-0.0726,0.0385,-0.0487,-0.0644,-0.0023,-0.0883,-0.0605,-0.0603,0.1096,0.0958,0.0548,-0.0404,-0.0277,0.0015,0.1164,-0.0305,-0.0421,0.0939,0.0275,0.038,0.0162,0.0752,0.0073,0.1316,-0.1182,-0.1249,-0.0026,0.1509,0.0595,0.0513,0.0281,0.084,0.0236,-0.0084,0.0281,-0.0458,0.0322,0.0852,0.1048,0.0591,-0.022,0.1166,0.077,-0.1035,0.007,0.0791,-0.1461,-0.0506,-0.0938,-0.0856,0.0556,-0.1626,-0.0624,-0.1072,-0.0748,-0.0945,0.0252,-0.0172,0.0883,-0.028,-0.0568,0.0336,0.0367,0.0981,0.0568,0.1192,0.0568,0.0398,0.0541,0.0185,0.0346,0.0611,0.0693,-0.0402,0.092,0.0856,-0.0566,-0.0335,-0.0514,-0.033,0.074,-0.0518,-0.1154,-0.1,-0.0319,0.0715,0.1174,0.0201,0.0557,0.0606,-0.0477,-0.1002,-0.0763,-0.0509,-0.0718,0.034,-0.0866,-0.1058,-0.0365,0.1048,0.0039,0.0,0.0013,-0.0957,-0.0646,-0.0355,0.0591,-0.0549,-0.0666,-0.0776,0.0403,-0.0406,-0.1227,-0.0286,-0.0917,0.0589,-0.0835,0.0432,0.0264,0.0639,0.0318,-0.1394,-0.0513,-0.0442,0.0796,-0.0801,-0.0182,0.0362,0.0182,0.0447,0.1803,-0.0092,-0.0397,-0.0746,-0.0456,-0.0407,-0.1313,0.0129,0.0522,0.1245,-0.0202,0.0387,-0.0999,0.059,0.1546,-0.0214,-0.0158,-0.0532,0.0154,-0.1663,-0.1191,-0.0844,-0.0245,0.0563,-0.0496,-0.0613,0.1098,0.0205,-0.1003,-0.0278,0.0674,-0.0208,-0.0157,-0.0535,-0.0783,-0.0835,-0.0618,-0.0593,-0.062,0.0196,0.0237,-0.0251,-0.0923,-0.0179,-0.0459,0.0247,-0.0777,-0.0395,-0.0119,-0.0164,0.0716,0.058,-0.015,0.0308,-0.0956,0.009,0.0649,0.1044,0.1944,0.1189,-0.0329,-0.0737,-0.041,0.056,0.142,0.1388,0.0744,0.0399,0.1204,0.0465,0.1254,-0.0014,0.0048,-0.0133,0.0739,0.0037,0.04,-0.1204,-0.0011,-0.0638,0.0685,0.0698,0.0122,0.0652,-0.0209,0.1025,0.1047,0.1052,-0.0819,-0.0129,-0.0181,0.0011,0.0105,0.0047,-0.0669,-0.0915,-0.1201,-0.0807,0.1072,0.1062,-0.1258,-0.1035,-0.0231,-0.1166,-0.0427,0.1465,0.0217,0.1505,0.0653,0.0857,0.0277,0.0545,0.0778,0.0418,-0.0058,0.0154,0.0192,-0.022,-0.1028,-0.034,0.0828,-0.0977,0.0212,-0.0591,0.0363,-0.1524,-0.0267,-0.0573,-0.0187,0.0071,0.0591,-0.011,-0.0453,-0.0213,0.0374,0.0207,-0.0034,0.0443,0.0057,0.013,-0.0362,-0.076,-0.0056,-0.0688,-0.0283,-0.0768,-0.005,-0.0958,-0.0148,-0.0368,0.1617,-0.0456,-0.0229,-0.1046,0.1468,0.1284,-0.0074,0.0298,0.0001,0.0881,-0.0088,-0.0045,-0.0904,-0.0671,-0.0169,-0.0062,-0.0276,0.0159,-0.0298,0.0964,0.0831,-0.0,-0.0251,0.0025,0.0371,-0.1298,-0.0015,0.0262,0.0615,-0.0827,-0.0363,-0.0387,0.052,-0.0324,0.0139,0.2926,0.1576,0.0769,0.0044,0.0213,-0.0612,0.0585,0.1142,-0.1151,0.4054,0.3855,0.2852,0.1784,0.3301,0.1124,0.0872,0.0674,0.0767,0.0815,0.0121,0.0495,0.0117,-0.0663,0.0559,0.055,0.0342,0.0831,0.0061,0.0006,0.2607,0.1424,-0.0418,-0.0314,-0.0555,0.0655,-0.0332,0.0735,-0.0311,-0.0723,0.002,0.0427,0.0541,0.0598,0.1837,-0.1436,-0.0645,-0.1012,-0.0542,-0.0661,0.3935,-0.033,0.0338,0.015,-0.0074,0.0438,-0.0668,-0.1278,-0.0742,-0.0805,0.0545,-0.0192,-0.0117,0.0445,0.0218,-0.1265,-0.1172,0.06,-0.0255,-0.0323,0.0133,-0.0919,-0.0466,-0.0911,-0.0035,-0.0382,0.0019,-0.1785,-0.1019,0.2582,0.0617,0.0208,-0.0297,0.1753,-0.0079,0.0041,-0.1424,-0.1253,0.0282,-0.09,-0.1435,-0.1441,-0.0328,-0.0217,-0.0094,0.0845,0.0401,0.05,0.0305,0.0165,0.0431,0.0049,0.0757,-0.0303,0.0765,-0.0111,0.0899,0.1468,-0.0286,-0.0084,0.0805,0.0636,-0.0473,-0.0426,0.033,-0.1203,-0.0736,-0.1214,-0.0277,-0.0163,-0.0527,-0.086,0.0259,-0.0449,0.0471,-0.045,-0.056,-0.0456,-0.0465,-0.0378,0.0695,-0.0193,0.4894,0.3897,0.2936,0.4358,-0.0512,-0.0726,-0.0645,-0.0763,-0.0862,-0.0457,-0.1164,0.0792,-0.0402,-0.0517,0.0603,-0.0654,-0.0029,0.1068,0.0567,-0.0299,-0.036,0.0267,-0.0354,-0.0165,0.0053,0.164,0.0425,-0.0128,-0.1118,-0.1118,-0.092,0.0477,0.0103,0.0054,-0.0958,0.0279,-0.0284,0.0842,-0.1779,-0.1584,0.1265,-0.0172,-0.1519,-0.1459,-0.1761,-0.0236,-0.0683,-0.0427,-0.0355,-0.0374,-0.0206,0.0663,0.1576,-0.0067,0.1252,-0.0075,0.0493,0.1264,-0.0218,0.0,-0.0206,0.0165,0.0432,-0.0269,-0.0484,0.0302,0.0851,-0.0955,-0.0706,-0.0497,-0.029,-0.0132,-0.015,-0.0458,-0.0047,-0.084,-0.0736,-0.1188,-0.2285,-0.0644,-0.049,-0.1686,-0.1018,-0.0863,-0.1035,0.0196,-0.0856,0.0356,-0.1139,0.0078,-0.0839,-0.1576,-0.0112,0.0276,-0.0526,0.1215,0.0992,-0.0004,0.0869,-0.0849,-0.0308,-0.013,-0.1451,-0.1432,0.0358,-0.0572,0.0037,-0.0508,-0.0173,0.0252,0.0481,0.0355,-0.068,-0.0437,-0.0483,0.0513,-0.0489,-0.0372,-0.0157,0.0268,-0.0169,-0.0408,0.0682,-0.006,-0.0686,-0.0114,-0.1338,-0.1317,-0.0223,-0.0231,0.0147,-0.0078,0.0068,-0.1038,-0.0781,0.0228,-0.0878,-0.0077,0.0162,-0.0873,-0.1954,-0.137,0.0518,0.082,0.1076,0.0296,-0.0003,0.0015,0.247,0.0665,0.0477,0.0347,-0.1177,0.0888,-0.0081,0.0869,-0.0453,0.19,0.0212,-0.0597,-0.0336,0.0826,-0.0958,0.0005,-0.0481,0.0073,-0.0579,-0.0183,0.0719,0.0122,-0.033,-0.0585,-0.0034,0.0287,0.0399,-0.0183,0.0102,-0.1212,0.0302,0.0473,-0.0912,0.0096,-0.0986,-0.0828,-0.0354,-0.0633,-0.0568,-0.0663,-0.0118,-0.0177,0.0163,-0.0043,0.0789,0.0074,-0.0101,-0.0549,-0.0287,-0.0315,-0.009,-0.1504,0.0059,-0.1358,-0.1248,0.002,0.0775,0.1079,-0.0171,0.029,-0.0513,-0.0014,-0.0421,-0.0374,-0.1149,-0.0403,-0.1915,-0.0612,-0.0276,-0.0651,-0.0561,-0.0693,-0.034,0.1934,0.1282,0.0284,0.3174,0.0366,0.0844,-0.0335,0.3087,0.002,-0.0585,0.0848,0.1765,-0.0321,0.0047,-0.1184,-0.1552,-0.0609,-0.0272,0.0591,-0.0427,-0.0846,0.0355,0.1309,-0.0473,-0.0471,-0.0092,0.0007,0.0258,0.0849,-0.2021,-0.0904,-0.0275,-0.2117,-0.1819,0.1257,0.0436,0.0277,-0.0096,0.0182,0.0436,-0.1297,-0.0621,-0.079,-0.0633,-0.1914,-0.0199,-0.0543,0.0051,-0.0885,0.1218,0.0025,0.0165,0.023,0.0132,0.0946,0.093,-0.1012,0.0541,-0.0319,-0.0264,-0.0868,-0.0028,0.0241,-0.0205,0.0113,0.1471,-0.0074,-0.0266,-0.057,-0.0861,-0.0099,0.1969,0.1814,-0.1142,-0.0968,-0.0454,-0.0366,-0.1062,-0.0301,-0.1388,0.03,0.0082,-0.0096,0.0506,-0.0153,0.1268,-0.026,0.061,0.0854,-0.0328,0.0678,0.1645,-0.1951,-0.0514,0.2132,0.0758,0.0314,0.1032,0.1036,-0.0429,0.1191,0.1023,-0.0042,-0.0765,0.0986,0.0664,0.1661,0.1169,0.0637,0.0544,0.0357,0.0808,-0.0575,0.0027,0.1613,0.009,0.094,0.0191,0.0241,-0.1276,-0.0189,0.0893,-0.0434,0.1123,-0.0226,0.0944,0.1735,-0.0024,0.0357,0.0211,0.0648,-0.002,0.04,-0.0275,0.0363,0.0413,0.1857,0.0195,0.0148,0.3843,-0.0784,-0.0349,0.0283,0.0194,0.0133,0.1081,0.1044,-0.1135,-0.0456,0.0254,-0.0517,-0.0174,0.0055,-0.0108,-0.03,-0.0008,0.0242,0.0475,0.1017,0.2043,0.2317,-0.0706,-0.1498,-0.0414,0.0122,0.144,0.1105,0.0669,0.0596,0.1102,0.0174,0.0621,-0.1618,-0.1668,-0.0921,0.0443,0.0968,-0.0909,-0.0594,0.0064,0.0539,0.0097,0.0831,-0.0132,-0.0245,0.0191,0.0365,0.0252,-0.087,-0.0895,-0.144,0.0642,-0.0225,-0.0132,0.1172,0.058,0.0718,0.0906,0.038,0.0733,0.1408,-0.083,-0.0194,-0.0182,-0.0492,0.0673,0.055,0.1353,-0.0938,0.0351,0.1039,-0.0144,-0.0759,0.0324,-0.139,-0.0671,-0.0548,-0.099,-0.0215,0.0821,-0.094,-0.1897,-0.0509,-0.1072,-0.0878,-0.1698,-0.1635,-0.0422,-0.0131,-0.005,-0.0945,-0.0013,0.0899,-0.0079,0.0831,-0.1378,-0.0624,-0.1014,-0.014,0.0217,-0.0955,-0.0491,0.0034,-0.1072,-0.0196,0.1377,0.0404,0.1199,0.0401,0.0069,-0.0256,-0.0152,-0.0231,-0.0098,-0.0838,-0.1853,-0.0008,-0.1091,-0.0322,-0.0317,0.0006,0.055,0.2729,0.2429,0.107,0.0491,-0.043,-0.1913,-0.0832,-0.1708,-0.1222,-0.0129,-0.0387,-0.018,-0.0313,-0.1188,-0.1618,-0.0532,0.1189,0.0521,-0.0592,-0.1002,-0.0575,-0.0892,-0.1548,-0.1317,-0.0612,0.0526,0.0003,-0.0488,-0.0686,-0.0304,-0.0647,-0.09,-0.1315,0.0061,0.106,-0.0875,-0.0624,-0.0646,-0.0187,-0.0333,-0.1199,-0.1472,0.0363,0.1694,0.1579,0.0515,0.0651,0.1174,0.004,0.0418,0.0669,0.1067,-0.0796,-0.0308,0.0054,0.0799,-0.0254,-0.0801,0.004,-0.0874,-0.0279,-0.0629,-0.0551,-0.084,-0.0564,-0.031,0.0055,0.016,-0.1918,0.0336,-0.0346,-0.0629,-0.0125,-0.078,0.069,-0.0673,-0.0039,0.0735,0.1181,0.0123,0.0781,-0.1223,-0.0595,-0.0394,-0.1082,-0.0642,-0.0393,0.0518,0.0454,0.0397,-0.0816,-0.0547,0.0609,0.052,0.1139,0.1201,-0.137,-0.142,-0.0966,0.0007,-0.001,-0.0943,0.0347,-0.0005,0.0371,-0.0391,-0.0398,-0.0628,-0.0469,-0.0574,-0.0827,-0.0092,-0.0632,-0.0363,-0.0495,-0.0551,0.0228,0.032,-0.0706,-0.09,-0.0524,-0.1094,-0.0483,-0.156,-0.0435,0.2011,-0.0611,-0.0838,-0.1444,-0.0535,-0.2022,-0.093,-0.0726,-0.0975,0.0974,-0.1171,-0.0105,-0.0315,-0.1523,-0.1323,-0.1699,-0.0749,0.0766,-0.1073,-0.0248,0.0016,0.1035,0.0486,0.0749,0.0284,0.0022,0.0155,-0.0325,0.0519,0.0275,0.0714,-0.1541,-0.1375,-0.1587,-0.1003,-0.0691,0.0801,0.1666,0.2233,0.0694,0.0412,0.0523,0.1437,0.0112,0.0539,-0.0369,0.0538,0.0394,-0.1459,-0.0601,-0.1224,-0.0229,0.0245,-0.0781,-0.0913,-0.0656,-0.0289,0.0149,-0.2049,-0.1544,0.0093,-0.0622,-0.123,0.0043,-0.0934,-0.0263,0.0323,-0.0855,0.0125,-0.139,-0.0389,0.0375,-0.073,-0.0562,0.0272,-0.1206,0.0441,0.0354,0.0134,-0.0856,-0.0657,0.0992,0.0212,0.0175,0.0665,0.0239,-0.0351,0.0498,0.0093,-0.0217,-0.1635,-0.03,-0.0322,-0.0338,-0.0076,-0.0202,-0.0961,-0.0434,-0.0207,-0.0764,0.0114,-0.0565,-0.049,0.0497,0.089,0.0626,0.096,0.0764,-0.1597,0.0011,-0.0921,-0.0821,0.0621,0.125,0.1383,-0.0311,0.3938,0.257,-0.1303,-0.1144,0.4519,0.1067,0.1061,0.1174,0.1757,0.1292,-0.0843,-0.0805,-0.0924,-0.1137,0.3678,0.2409,0.2351,0.0273,0.1077,0.2404,0.4176,0.4275,0.4054,-0.0129,0.0166,-0.0743,-0.0155,-0.0569,-0.0179,-0.0792,-0.0562,-0.0671,-0.0219,-0.0302,-0.0236,0.0951,-0.0566,-0.0249,-0.1519,-0.0063,0.0845,0.1176,-0.0671,-0.0,-0.1166,-0.0565,0.0029,-0.037,-0.0214,-0.0472,-0.0314,-0.0284,-0.0695,-0.1358,-0.1265,-0.0698,-0.0705,-0.0147,0.1464,0.0651,0.1059,-0.023,0.0756,0.3074,-0.1069,-0.1337,-0.1034,-0.0984,0.1034,0.0317,0.1219,0.0793,0.0786,-0.0093,-0.1519,-0.1493,-0.1188,-0.114,-0.0906,-0.2012,-0.184,0.0461,-0.0034,0.2111,-0.1118,-0.022,0.0807,0.0003,0.0948,0.1153,0.0375,-0.0683,-0.102,-0.0611,-0.0144,-0.1429,-0.0774,-0.1151,0.0448,0.0929,0.05,0.0296,0.1212,-0.0046,-0.0013,0.0409,0.0276,0.0851,0.1223,0.021,0.0406,0.0216,-0.0027,0.0067,-0.1008,-0.0981,-0.0125,-0.0,-0.0719,0.0185,-0.025,-0.0484,-0.0062,0.0567,0.0405,0.0444,0.0658,-0.0296,0.169,0.1243,-0.0265,-0.1305,-0.0511,-0.0992,-0.107,0.0531,-0.0177,-0.0616,-0.076,0.1105,0.0035,-0.1368,-0.0942,-0.0653,0.0742,0.0316,0.0644,0.0848,0.1253,0.169,0.3091,0.0819,0.0484,-0.0263,-0.0139,-0.0128,-0.126,-0.0826,-0.0821,-0.0182,-0.1113,-0.0891,0.0099,-0.0622,0.0307,-0.0271,-0.0995,-0.0853,-0.0599,-0.0562,-0.0729,-0.0218,-0.0583,-0.0687,-0.0128,-0.0425,-0.0898,-0.0721,0.1911,0.107,0.0318,-0.113,0.1703,0.1601,-0.1493,0.1762,-0.141,-0.0669,-0.0044,-0.0979,-0.0972,-0.0576,0.0236,0.002,0.0209,-0.0992,-0.0608,0.0456,0.0389,0.0559,-0.114,0.0016,-0.0002,0.0129,0.0394,-0.0954,-0.0465,-0.0216,-0.0607,-0.082,-0.0441,-0.0426,-0.0393,0.0069,0.023,-0.03,-0.1704,-0.0807,-0.1158,-0.1359,-0.0929,-0.0646,-0.0724,-0.0724,-0.0007,-0.0425,0.0431,-0.139,-0.0085,-0.1787,-0.1697,0.0711,0.0484,-0.1423,0.2087,-0.1684,0.0717,0.1139,0.0128,0.1262,0.081,-0.117,-0.1002,-0.0424,0.0023,-0.0317,-0.0009,-0.0451,-0.0373,0.0851,0.0578,0.0739,0.022,-0.0823,-0.076,-0.0625,-0.082,-0.0156,-0.0705,-0.0593,-0.0194,-0.015,-0.0418,0.0126,-0.0355,-0.0196,0.0094,0.0939,-0.025,0.1606,0.0619,-0.0604,-0.0287,-0.0985,-0.0271,-0.0134,0.0298,-0.0057,-0.0657,-0.0653,-0.0436,-0.0026,-0.0006,-0.0172,0.1361,0.0784,0.2995,0.1256,0.0216,0.003,-0.115,0.0134,0.1129,0.1188,-0.0712,0.0403,0.0435,-0.02,0.0238,-0.2509,-0.1417,-0.2099,-0.1627,-0.1436,-0.0957,-0.2204,0.1024,-0.0201,0.0895,0.1705,-0.039,0.0234,0.0182,-0.0432,-0.1001,-0.0341,-0.0051,0.067,-0.0259,-0.001,-0.1277,-0.0013,0.1168,0.0838,0.1211,0.0372,0.0583,-0.115,0.0406,-0.0543,-0.0056,-0.0361,0.0158,0.0073,-0.0255,-0.0238,-0.0863,-0.0524,0.0688,-0.0527,0.0824,-0.0615,0.0712,0.0111,0.076,0.0526,0.0235,-0.0661,-0.0686,-0.0313,-0.0019,0.009,0.0902,-0.0275,-0.0558,0.0089,0.1335,0.0788,-0.0847,-0.0542,-0.1208,-0.0998,-0.0052,0.0109,0.0471,-0.0879,-0.0462,-0.0857,-0.0186,-0.0611,0.0161,-0.0026,-0.1686,0.0891,-0.033,-0.0687,-0.0818,0.0825,-0.0757,0.0319,0.0219,0.0189,-0.1334,0.0389,-0.0083,-0.0685,0.0403,0.0807,0.0088,0.0321,-0.1107,-0.0465,-0.1233,-0.1116,-0.125,-0.0378,-0.1056,-0.0792,-0.0693,0.0469,0.0396,0.0525,-0.0813,-0.0698,0.0972,0.2214,0.2805,0.1024,-0.0644,0.0232,-0.0331,-0.0432,0.0301,-0.0207,-0.0797,-0.0753,-0.0466,-0.0765,-0.1309,0.2983,0.0723,0.0322,0.2364,0.0783,0.1211,-0.0187,-0.0968,-0.0784,-0.0342,-0.1219,0.0115,0.036,0.0053,0.0269,-0.023,-0.0244,-0.0786,0.014,-0.0636,-0.0706,-0.0236,-0.0317,-0.0492,-0.0165,0.0347,0.0121,0.0349,-0.0411,0.0807,-0.1667,-0.0725,-0.0985,-0.1378,0.032,-0.0763,-0.0604,-0.1524,-0.0844,-0.1408,0.0662,-0.1311,-0.0151,-0.0527,-0.015,0.0928,0.0729,-0.0781,-0.0902,-0.0008,-0.0433,0.0733,0.1058,-0.054,-0.0188,0.0089,0.0588,0.0278,0.0497,0.0941,0.0015,-0.0572,0.0595,0.0129,0.0107,0.0757,0.0415,-0.0636,-0.0917,0.0027,0.178,0.0037,0.1978,0.2025,-0.1133,0.0267,0.0376,-0.095,-0.1012,-0.0475,0.0656,0.224,0.0303,0.0636,0.0575,-0.0098,0.1307,0.1716,0.0679,0.0641,-0.074,-0.0272,-0.0502,0.0353,-0.0353,0.0194,-0.0825,-0.0079,0.0539,-0.0184,0.0467,-0.0179,0.0449,0.015,-0.1484,0.1003,0.0856,0.0323,0.0233,0.0985,0.1504,0.0215,0.0847,0.0013,-0.0175,-0.0119,0.117,0.1191,0.0078,-0.0093,0.1008,-0.0462,-0.1257,-0.2518,-0.2384,0.0188,0.0375,-0.0071,-0.0199,0.0264,0.1241,0.0137,0.0309,-0.0267,0.0826,-0.0379,0.0194,-0.0143,-0.0143,0.0345,-0.0982,-0.04,-0.1176,-0.0867,-0.0663,0.0058,-0.003,-0.1488,-0.0705,0.0106,-0.0731,-0.0034,0.1009,0.009,-0.125,-0.0811,0.1386,-0.0706,0.0801,0.0341,0.0515,0.0009,0.0606,-0.201,0.0133,0.006,-0.0734,-0.0475,-0.0438,0.0308,-0.033,-0.087,-0.1347,-0.1144,-0.0556,-0.0487,0.0157,0.088,0.014,-0.0657,-0.0535,-0.1603,0.1697,0.2147,-0.0995,-0.0857,-0.0673,-0.0918,-0.1108,0.2377,0.049,-0.0615,-0.0049,0.0316,0.1186,-0.1966,-0.1915,-0.1012,-0.1619,-0.0465,-0.0952,0.0265,0.0484,0.0602,0.0723,-0.074,0.0171,0.3223,0.0912,0.194,0.3208,-0.174,-0.0705,-0.089,0.1788,0.0298,0.0479,0.0527,0.0566,0.1064,-0.1844,-0.1497,0.0051,0.2018,-0.0453,-0.1687,-0.1927,-0.0941,0.0069,0.1285,-0.0943,0.0084,-0.013,-0.0098,0.0271,0.0824,-0.0277,0.0181,0.0188,-0.0807,0.0068,-0.0262,0.0031,0.0009,-0.0853,0.0022,-0.0441,-0.005,0.0072,-0.0168,0.09,0.0584,-0.0068,0.0137,-0.0512,-0.0141,-0.1152,-0.1083,-0.0419,-0.1021,0.26,-0.0143,0.2046,0.0888,0.0408,0.0368,0.0348,0.0454,-0.0933,0.0691,0.0715,0.0424,0.0514,0.0238,0.0098,-0.0796,-0.0886,-0.1835,-0.0375,0.0604,0.1624,-0.1235,-0.039,-0.0283,0.0022,-0.0145,-0.0483,-0.0138,-0.0779,0.0344,-0.1859,0.0249,-0.0867,0.1496,0.0355,-0.0044,0.0874,-0.0612,-0.0074,-0.0917,-0.0794,0.0146,0.0468,-0.0627,-0.0687,-0.0687,0.0351,0.0071,-0.0293,-0.0072,0.1329,0.0127,-0.0267,-0.1575,-0.0637,-0.1061,-0.1255,-0.0364,-0.0653,-0.052,-0.0599,-0.0612,-0.0803,-0.0129,0.0019,-0.0063,-0.0076,0.0175,0.0213,-0.0781,0.0277,-0.2608,-0.2292,-0.2139,-0.0641,-0.0366,-0.1155,-0.1036,0.0069,0.048,0.026,-0.1132,0.1486,0.151,0.0756,-0.0257,-0.0044,-0.058,-0.0598,0.0217,-0.0268,0.1057,0.1279,0.1885,0.0029,0.0752,0.0881,0.0496,-0.1393,-0.0006,0.0178,-0.0025,-0.1024,-0.0994,-0.089,-0.1018,-0.0749,-0.1695,-0.1628,0.0187,0.0144,-0.1869,0.0044,-0.0022,0.0317,-0.0436,-0.061,-0.2476,-0.1941,-0.1077,-0.1874,0.1548,-0.0563,-0.004,0.0579,-0.0698,-0.1451,-0.2659,-0.1638,0.1837,0.1267,0.1343,0.0786,0.0369,-0.0465,-0.0104,0.0733,0.069,0.0494,0.0138,-0.0015,0.1589,0.0464,-0.1052,-0.1716,-0.0762,-0.0969,-0.1222,0.0507,-0.1439,0.0895,0.0564,0.0725,0.0344,0.0314,-0.1389,-0.0318,-0.1083,-0.0211,-0.1155,-0.1372,-0.0281,0.0821,-0.0624,-0.0545,-0.0174,-0.1643,-0.0674,-0.0949,-0.1083,-0.0675,-0.0593,0.0452,0.1094,-0.0061,-0.0566,0.0113,0.0227,-0.0008,-0.0631,-0.0372,-0.0764,-0.0071,0.1067,0.0257,-0.0249,0.1133,0.0116,0.0595,0.0562,-0.0063,0.0342,0.033,0.0459,-0.0325,0.045,0.0168,0.1421,0.1851,0.1705,0.08,0.0894,-0.0158,0.0321,-0.0567,0.0728,-0.0331,0.0507,-0.0119,-0.1181,-0.12,0.1538,0.0297,0.0024,-0.0336,0.0541,-0.0323,-0.0367,-0.0324,0.0727,-0.058,-0.0618,0.0371,0.0592,0.0592,-0.1233,-0.0508,-0.133,-0.014,-0.1325,-0.0107,0.018,0.0305,0.0122,-0.0143,-0.0775,-0.0918,-0.1052,0.077,-0.0949,-0.0944,0.0597,0.0128,-0.028,0.0274,0.1782,0.0764,0.0973,0.1678,-0.0691,0.0061,0.193,0.0502,-0.0156,0.1797,-0.0092,0.0473,0.0304,0.1977,0.0351,-0.095,-0.142,-0.1099,0.1247,0.2443,0.0011,0.0968,0.0328,0.0108,0.024,0.028,0.0357,0.1222,0.0105,-0.0819,0.0885,-0.0972,-0.0775,0.0421,-0.0042,0.0298,0.0296,-0.0397,-0.0344,-0.1314,-0.0852,0.1201,0.2144,-0.0387,-0.0712,0.0907,0.0659,-0.0407,-0.0535,-0.1138,-0.1608,0.1165,0.105,-0.0431,-0.0444,-0.0807,-0.0514,-0.11,-0.0082,-0.0532,-0.1046,-0.0018,-0.0662,-0.0171,0.0085,-0.0926,-0.1209,-0.0413,-0.0445,0.0605,-0.0857,-0.04,0.0787,-0.0253,-0.0814,-0.163,-0.0416,-0.0974,-0.0194,-0.0964,-0.1203,0.0612,0.054,0.099,-0.057,-0.0714,-0.061,0.0376,-0.0493,-0.0126,-0.1561,-0.0643,-0.1169,0.0232,0.0156,0.0925,-0.0935,-0.1519,-0.1071,-0.1717,-0.1718,-0.0292,-0.0278,0.0584,-0.0019,-0.056,-0.0696,-0.0634,-0.0805,-0.1973,-0.094,-0.0374,0.0116,-0.0294,0.0775,-0.0147,0.0997,-0.0062,0.0324,-0.0519,0.0726,0.1579,0.1069,0.0477,0.002,-0.0527,-0.0025,-0.0736,-0.0043,-0.0494,-0.0379,0.0121,0.0004,-0.1061,-0.0559,-0.0183,-0.0141,-0.0394,-0.088,0.0003,0.2624,-0.0912,0.0932,0.0518,0.0512,0.0352,0.0525,0.0243,-0.0213,-0.1072,-0.0194,0.044,0.0548,-0.0689,-0.0383,-0.071,-0.1018,-0.0629,-0.036,-0.0588,0.0842,0.0591,-0.1299,-0.1309,-0.0595,-0.113,-0.0599,-0.0643,0.1505,0.1402,-0.0314,0.0381,-0.09,-0.0207,-0.0767,-0.0805,-0.1871,-0.1435,0.0065,-0.0116,-0.076,0.029,-0.0431,-0.0545,0.1157,-0.0092,0.0353,-0.0024,0.0045,0.0072,-0.0537,-0.0042,0.127,-0.0894,0.0816,-0.0738,0.041,-0.1163,0.3647,0.0357,0.0476,-0.1014,-0.0907,0.0654,0.1055,0.0085,0.1044,0.0863,0.0174,0.0087,0.0736,0.0934,0.0778,0.098,0.1595,0.1344,0.1803,0.2609,-0.0224,0.0847,0.1488,0.3827,0.1284,0.1374,0.2,0.1314,0.1025,0.1244,0.0779,0.1503,0.1648,0.186,0.2017,0.0515,0.1861,0.3724,0.1695,0.2257,0.1549,-0.0117,0.1233,-0.1585,-0.068,-0.087,-0.1483,-0.0405,-0.1608,-0.1631,-0.0484,-0.1244,-0.0855,-0.1716,-0.1499,-0.1308,-0.0291,0.0832,-0.0699,0.1855,-0.0101,-0.061,0.0379,-0.0764,-0.0968,-0.093,-0.0416,-0.113,0.0734,-0.1537,-0.1607,0.0168,-0.0129,-0.0641,-0.0143,-0.0182,-0.1375,0.0516,0.0605,-0.0607,0.2531,0.3575,0.0395,0.1756,0.2208,-0.0689,0.1339,0.1369,-0.004,-0.0038,0.2204,0.0149,0.0377,-0.1194,0.026,0.1346,-0.0046,-0.0176,-0.0327,0.0062,-0.016,-0.0321,sentence processing
trm_4a3fd79d0b967,-0.0446,-0.07,-0.0362,0.0013,0.0135,0.0023,-0.0187,-0.0998,-0.0765,-0.0164,0.0189,0.0483,-0.0429,0.0203,-0.0134,-0.0596,-0.0131,0.1123,-0.0491,0.1511,0.0651,0.0666,0.0007,0.0633,0.0041,0.0166,0.0134,0.0549,0.0118,-0.0108,0.0178,0.0839,-0.0374,-0.0518,0.0653,0.0321,-0.0609,-0.0233,-0.0261,0.0286,-0.0013,-0.0393,-0.0733,0.0956,0.0071,0.0688,0.0797,-0.0547,-0.0326,-0.0074,-0.0142,-0.1119,-0.005,-0.0142,0.0773,-0.0042,-0.0401,0.0403,0.0335,0.0295,0.0083,0.0108,0.0501,-0.0024,-0.0089,-0.1584,0.0646,0.13,0.0423,-0.0176,-0.0158,-0.0306,0.067,0.0654,-0.0344,0.0893,-0.0876,0.061,0.0157,-0.053,0.0407,0.0731,0.0155,0.0652,0.02,-0.0405,-0.0828,-0.0493,0.0584,-0.1978,-0.0413,-0.1664,0.0251,-0.3184,-0.2143,-0.2442,-0.0778,-0.0996,-0.1816,-0.2634,-0.0068,0.0082,-0.0661,-0.2626,-0.1255,0.0244,0.0853,0.0549,-0.054,-0.0273,0.0407,0.0729,0.048,-0.0702,0.0385,0.0468,0.0514,-0.1964,0.0831,0.0115,0.1086,0.0255,0.153,0.063,0.0419,0.1038,0.1008,-0.0211,0.0181,-0.0381,0.1494,0.0099,-0.0096,0.0487,0.0848,0.0929,-0.0641,0.0663,0.0265,-0.0408,-0.0005,-0.0058,0.0573,0.0895,0.0632,-0.0512,-0.1033,0.0746,-0.0152,0.0855,0.0201,0.0819,0.0009,0.0865,0.0642,-0.0797,0.0018,-0.0292,0.0702,0.028,-0.0146,0.073,0.091,0.0173,0.0004,0.0076,0.049,0.1131,0.1146,0.0898,0.0016,0.0948,-0.034,0.1902,0.0681,0.0859,0.0805,0.1384,0.0853,-0.0691,0.0269,0.0306,0.0333,-0.0188,-0.052,0.0273,-0.0502,0.1681,0.1527,0.0239,0.0269,0.0409,-0.0015,0.105,0.1102,-0.0441,0.017,0.1087,0.0833,-0.2381,-0.1273,-0.2087,0.1033,-0.0026,0.0517,-0.0857,0.1785,-0.0108,-0.0147,0.0246,0.1456,0.0857,-0.0557,0.0466,0.0668,0.0692,0.0757,-0.0537,-0.2819,0.0251,-0.0046,0.0427,0.0646,0.0056,-0.0547,0.0127,-0.0013,-0.0464,0.0834,0.0991,-0.2595,0.0494,0.0052,-0.069,-0.0818,-0.1521,0.0929,0.094,-0.0202,-0.0087,-0.093,-0.031,-0.085,-0.0571,0.0094,0.0291,0.1181,0.019,-0.0953,0.2058,0.0564,-0.0309,0.0443,0.024,-0.0691,0.0936,-0.0548,-0.1037,0.0371,0.1059,0.0007,-0.0336,0.0274,0.0057,-0.0043,0.0127,0.0107,0.0719,0.0822,0.0394,-0.0508,-0.1081,0.0351,0.0837,-0.1907,-0.0254,-0.2164,-0.1009,-0.2042,-0.0779,-0.0516,0.1124,0.1189,0.1787,0.1633,-0.0417,0.0028,0.0475,-0.1155,-0.0259,0.0291,0.0375,-0.0215,0.0852,-0.04,-0.0473,0.1193,0.0026,0.0436,-0.0398,-0.0236,0.1916,-0.0587,0.0678,-0.2258,-0.2473,-0.032,-0.0168,-0.1397,0.0561,-0.035,0.0098,-0.0295,0.0963,0.0324,-0.0573,0.0108,-0.017,0.0638,0.0345,0.0235,0.0595,0.0267,0.0677,-0.0065,0.0148,0.0327,0.0054,-0.0408,-0.0418,0.0142,0.0021,0.1097,0.0645,0.1156,-0.116,0.0197,0.1103,0.0816,0.12,0.1074,0.1115,-0.1693,-0.1295,0.0303,-0.0306,-0.0853,-0.0843,-0.0803,-0.044,-0.0929,-0.1251,-0.1748,-0.1193,-0.0157,-0.1218,-0.0228,0.0134,-0.0652,-0.0167,0.0072,-0.0042,-0.1047,-0.0694,-0.1145,-0.065,-0.0765,-0.0392,0.0291,0.0091,0.0451,-0.0108,-0.0193,-0.0384,0.0557,-0.077,0.0097,0.0352,0.1813,0.0297,0.184,-0.1955,0.0157,0.0043,-0.0114,-0.013,0.0124,-0.0067,0.0107,-0.0273,-0.1224,-0.0112,-0.1844,0.0618,-0.1282,-0.2658,-0.2604,-0.0503,-0.1001,0.0201,0.0446,0.0234,-0.0255,0.0305,-0.0287,0.0436,0.0632,0.0335,0.0269,-0.0376,-0.0773,0.059,0.0632,0.0938,0.1178,0.1498,0.1282,0.1031,0.1136,0.0255,-0.0168,-0.1069,-0.0977,-0.0336,-0.0081,-0.1039,-0.0244,-0.1785,0.0059,-0.1826,0.0219,-0.0166,-0.0132,-0.0464,0.148,0.089,-0.14,-0.038,-0.0491,-0.0281,-0.0668,-0.0774,-0.0641,0.0062,0.0523,-0.0219,-0.0469,-0.1093,0.138,0.0862,0.0411,-0.0002,0.0163,-0.0172,-0.0671,0.1295,0.0114,0.0015,0.0497,0.0088,0.014,-0.0648,0.0541,0.0809,0.0491,-0.0101,-0.0403,0.1355,-0.0365,-0.0626,-0.0641,-0.0319,-0.1452,0.0108,0.0321,0.0052,-0.1299,-0.1025,-0.0051,-0.0086,-0.2064,-0.1301,-0.1555,-0.0386,0.0754,0.0526,-0.0534,-0.0637,0.1165,-0.0383,-0.0019,-0.1415,0.0397,0.0506,0.0101,0.0728,0.062,-0.0408,0.0449,0.0826,0.0793,0.0952,-0.0154,-0.0275,-0.0283,0.0233,0.0885,0.1223,0.0084,-0.0981,-0.0085,-0.1035,0.0629,-0.0036,0.0471,-0.0218,0.0539,0.0347,-0.1919,0.0079,-0.0291,-0.0418,0.0528,-0.0063,0.0442,0.0782,-0.0167,-0.0747,-0.0563,-0.041,-0.0449,-0.0516,-0.1175,0.017,0.1172,-0.0216,0.0509,-0.052,0.0127,0.0288,0.0697,0.0418,-0.0466,-0.0183,0.0233,-0.0573,0.0397,0.0707,0.0366,0.0502,-0.071,0.0826,-0.0333,-0.2335,-0.0605,0.0593,0.0118,-0.0059,0.0921,-0.1057,0.0808,0.0646,0.0767,-0.0638,0.0346,-0.0341,0.0763,0.2032,0.0193,0.0817,0.0274,0.1532,-0.0898,-0.0178,-0.3597,-0.3284,-0.0583,-0.0941,-0.0194,0.0033,0.01,0.0258,0.0724,-0.021,-0.0386,0.0206,-0.1846,0.0236,-0.1121,0.0641,0.022,-0.0396,-0.0168,0.0103,-0.1427,-0.1013,0.0577,0.0779,-0.065,0.0325,0.0257,0.0347,0.0289,-0.0148,-0.0572,-0.3386,0.0506,0.0135,0.0091,0.0678,-0.0093,-0.053,0.0653,0.0662,0.0237,0.0636,0.0134,0.0896,0.0539,0.0549,-0.0557,-0.0186,-0.0707,0.06,-0.0204,-0.0832,-0.0208,0.0668,-0.1516,-0.0038,-0.0422,-0.1895,0.0384,0.0436,-0.011,-0.1754,0.0018,-0.1332,0.083,-0.1147,-0.0542,-0.0864,-0.0936,-0.2917,0.0017,-0.0134,0.1619,0.1339,-0.0811,0.1019,0.0456,0.0085,-0.1172,0.0644,0.0488,-0.1473,-0.3098,-0.1081,0.0095,-0.0292,0.1197,-0.3012,-0.01,-0.267,-0.1723,-0.0679,-0.2398,0.0916,-0.2617,-0.1015,-0.0497,0.0176,-0.0443,-0.0969,0.0103,0.0076,-0.1546,0.0662,0.079,0.0363,0.0234,-0.051,0.0362,0.0014,-0.0172,0.0167,-0.0032,0.0393,-0.0163,-0.1068,-0.0237,-0.0097,-0.0889,0.0446,0.0453,0.2015,0.0216,0.0314,-0.0231,0.0406,-0.0469,0.0067,0.0225,0.0621,0.0614,-0.0473,0.0086,-0.0166,-0.0395,0.0344,0.0992,0.1825,0.1495,0.0545,0.2167,0.1026,-0.0136,0.0666,0.0756,0.0037,-0.011,0.0182,0.0909,0.0745,0.0864,0.0332,0.0064,0.0357,0.0946,-0.1356,0.0858,0.0398,-0.0914,-0.0377,-0.0419,-0.0268,-0.1478,0.0402,0.011,0.0488,0.1352,0.0584,-0.0848,-0.0104,0.1192,0.0781,0.0668,-0.0089,0.0377,0.0134,0.0344,-0.0231,0.113,0.1905,0.1583,0.1252,0.0057,0.1425,0.0536,-0.1407,0.0559,-0.1397,-0.0227,0.0235,-0.0459,-0.05,0.0998,-0.0074,-0.1162,0.0105,-0.0407,-0.0118,-0.0949,-0.0285,-0.054,0.0197,0.0132,0.0617,0.0427,0.0688,0.1048,0.0667,0.0643,-0.0131,0.0955,0.0431,0.0225,0.0046,-0.0379,0.0734,-0.0881,0.0185,0.092,-0.0004,-0.0357,-0.06,0.0422,0.0821,-0.0135,0.103,0.0846,0.0282,0.1405,0.073,0.0654,0.0736,-0.0019,-0.0519,-0.0731,-0.0717,-0.0885,-0.1469,0.0401,0.0409,-0.0183,-0.0038,-0.0233,0.0518,-0.0814,-0.034,0.0549,0.0271,0.0999,-0.1062,0.02,0.1432,0.1624,0.0527,0.0944,0.0749,0.1377,0.0551,0.0215,0.114,0.0199,-0.0382,0.0498,-0.1212,-0.058,0.0681,0.0089,0.0836,0.0107,0.0094,-0.0604,0.0263,-0.0219,0.0205,0.0254,-0.0509,-0.0172,-0.0476,0.0576,0.0349,0.0309,0.0372,0.0005,0.0768,0.1052,-0.0475,0.0167,0.0631,0.0312,0.0641,-0.1219,-0.252,0.0123,0.047,-0.1844,0.0579,0.0495,0.0486,-0.3974,0.0398,-0.0817,0.0064,0.0819,-0.0092,0.0832,0.0951,0.0561,0.0058,0.018,0.0393,0.0028,-0.0166,0.0033,0.0539,0.0663,0.0628,-0.0313,-0.055,-0.0155,-0.0609,0.0455,-0.0113,0.0346,0.0685,0.0414,0.0279,0.0408,-0.0316,0.175,0.0328,0.0376,0.2213,0.0445,0.1094,0.0211,0.093,0.0433,0.0541,0.0937,0.0072,-0.0074,-0.0145,0.0473,-0.036,0.0028,0.0028,-0.1129,-0.06,0.0077,0.0468,-0.2791,-0.0589,-0.0301,-0.0949,0.0243,0.028,-0.0448,0.0427,-0.039,-0.0598,0.0108,0.029,0.0312,0.0358,-0.0295,0.0396,0.0327,0.1824,0.0882,0.2138,0.1438,0.0967,0.0865,0.0521,0.1742,0.0872,0.1995,0.143,-0.0446,-0.0524,0.0155,0.0562,-0.0129,-0.0008,-0.0008,-0.0663,0.0581,-0.0258,0.1862,0.1988,0.1477,-0.0002,-0.1034,-0.0947,-0.0125,0.0503,0.0587,0.002,-0.0544,0.0446,0.0689,0.1133,0.0141,-0.0082,-0.1088,0.0058,-0.0285,0.0525,0.0497,0.1195,0.061,0.2369,0.2077,-0.0325,-0.0666,-0.0934,-0.0007,0.1378,0.1128,-0.0336,0.007,-0.0285,-0.095,-0.0644,-0.0049,-0.0152,-0.0211,-0.0989,0.0543,0.0679,0.0842,-0.0652,-0.0345,0.1101,0.0813,0.0937,-0.0181,-0.058,-0.0695,0.0954,0.1218,0.0638,0.0459,0.037,0.003,0.0037,-0.0272,0.0546,-0.0354,-0.2034,-0.074,0.0196,0.0386,-0.0158,0.0468,0.0658,-0.047,-0.0906,-0.2306,-0.384,0.0114,0.0513,0.0523,-0.061,0.0238,0.0947,0.0595,0.0754,-0.0285,-0.0516,-0.0846,-0.0705,-0.0296,-0.0121,-0.0162,0.015,-0.1467,0.0169,-0.0251,0.0745,0.0026,-0.0269,-0.0085,-0.0443,0.0612,-0.0326,0.0164,0.0194,0.0553,0.1086,0.109,0.0335,-0.0457,-0.0024,0.0369,0.0395,-0.032,0.104,0.12,0.0117,0.1157,0.1577,0.0489,0.0251,-0.0047,0.0087,-0.2606,-0.0237,-0.0457,-0.0775,-0.0482,-0.108,0.1225,0.0773,-0.001,0.0857,0.1861,0.1109,-0.1566,-0.1886,-0.2034,-0.086,-0.1496,0.0374,0.1121,0.3397,0.2649,0.2476,0.1689,0.3745,0.1855,0.095,0.134,0.1294,0.0826,0.0385,-0.0489,-0.0234,0.0321,-0.0981,-0.072,0.0768,-0.0436,0.0174,0.0517,0.1195,0.1321,0.0946,-0.0242,0.0565,0.0307,-0.0242,-0.0274,0.0328,0.0569,0.1566,0.1796,0.1386,0.1264,0.0767,-0.2498,-0.0585,-0.0196,0.0753,-0.0003,0.2606,-0.0276,-0.0478,-0.1517,0.0742,-0.0139,-0.2298,-0.3951,-0.3312,-0.3051,-0.0001,0.0435,-0.0034,-0.0462,-0.0359,-0.0534,0.0751,-0.0293,0.0698,-0.2069,0.0132,-0.0273,-0.0786,0.0335,0.0084,-0.0452,0.108,-0.3076,-0.2796,0.0764,0.1041,0.0086,0.0631,0.0621,-0.0635,-0.0834,0.1178,0.1034,0.0752,-0.0002,-0.158,-0.0745,0.0979,-0.0273,0.084,-0.0903,-0.0207,-0.0946,-0.2136,-0.0632,-0.0555,0.1185,0.0932,-0.1711,-0.0505,0.0085,-0.0352,-0.1005,0.0182,0.0696,-0.0153,-0.0348,0.0992,0.0322,-0.0268,0.0512,0.068,0.0314,0.0345,-0.1788,-0.0476,-0.0564,-0.1166,-0.0825,-0.0355,-0.0242,-0.0618,-0.0447,0.0686,-0.0828,0.009,-0.0455,0.3404,0.2614,0.1956,0.2931,0.0913,0.0237,0.0617,0.1194,0.0521,0.036,-0.2473,0.0191,0.1517,0.1361,0.0197,-0.0752,0.0732,0.0257,0.026,-0.0763,-0.028,-0.1954,0.1343,0.1431,0.0232,-0.0928,-0.0355,0.0831,-0.1026,-0.1026,0.0878,0.0028,-0.0601,-0.0203,-0.07,0.1119,-0.0289,-0.2239,0.0715,0.1027,0.0815,0.0045,0.0404,0.061,-0.0071,-0.0548,-0.1014,0.1115,0.0517,-0.0794,-0.2175,0.0034,0.0414,-0.0592,0.0777,-0.0818,-0.0464,-0.069,-0.0756,0.0774,0.006,0.0382,0.0555,0.0677,-0.1572,-0.0627,0.0698,-0.3933,-0.2834,-0.2925,-0.0378,-0.2507,0.1623,0.1333,0.0252,0.1157,-0.0389,0.0514,-0.0926,-0.0256,0.0726,0.0835,-0.2108,-0.053,0.0174,-0.0022,-0.1916,0.0488,-0.0918,-0.0528,-0.0065,-0.2348,0.0855,-0.0647,0.0495,0.1568,-0.1594,-0.2324,-0.1744,-0.0864,-0.0712,0.0152,-0.1022,-0.0998,0.0789,0.0376,0.0087,0.1863,-0.0135,0.0579,0.0271,0.0643,0.1247,0.1108,-0.0392,-0.024,-0.1451,-0.0534,0.1238,0.0133,0.0644,-0.0012,0.2063,0.2091,0.1184,0.0047,0.0568,0.0435,0.0451,0.046,-0.0461,-0.1014,-0.0959,0.0211,0.0348,-0.0636,0.032,0.0572,-0.0472,-0.1174,-0.2397,0.0721,0.0384,-0.0618,0.1133,-0.0339,0.0443,0.0629,0.2159,-0.0344,-0.07,-0.0771,0.0916,-0.0059,-0.0305,0.0532,-0.3422,0.2169,-0.0093,-0.219,-0.1801,-0.1532,0.0246,-0.0161,0.0968,0.0639,0.0682,0.1198,0.1152,0.0065,-0.0585,0.1,0.0938,0.0504,0.1267,-0.0296,0.1178,-0.0399,0.0151,-0.0088,-0.0794,0.0135,0.0333,-0.0483,-0.0027,0.0984,0.0517,0.025,0.0827,-0.0173,-0.0351,-0.0035,-0.0491,0.0035,0.0297,0.0425,-0.066,-0.0788,0.072,0.0511,-0.0295,-0.2421,-0.2927,0.0563,0.085,0.1049,-0.0285,-0.0199,-0.0553,0.0328,0.0642,-0.0448,0.128,-0.0305,-0.1698,-0.0418,0.0025,-0.0214,-0.0051,0.0279,0.1011,-0.1145,-0.0564,-0.0195,0.2164,-0.2551,0.1098,-0.1074,0.1741,0.0185,0.0108,0.1479,0.0706,-0.0504,-0.0203,-0.0926,-0.1484,-0.0629,0.0549,0.0429,-0.1278,-0.1745,-0.1628,-0.0647,-0.0029,0.0265,-0.0079,-0.1226,-0.0337,0.0551,-0.2296,-0.1602,-0.1514,-0.2311,-0.2303,0.0972,-0.0536,-0.0018,0.0118,-0.0958,0.0112,0.0428,0.0956,-0.0861,-0.0675,-0.1633,0.0756,0.0374,-0.0082,-0.1186,0.0269,0.0084,0.0576,0.0367,0.0103,-0.0156,-0.0312,0.0061,0.111,-0.1079,-0.0116,-0.0497,0.0737,-0.075,0.0028,0.0551,-0.0303,-0.0663,-0.0741,0.0134,-0.0215,-0.0714,-0.1035,-0.0924,0.0332,0.0206,-0.0823,-0.0222,-0.0736,0.0501,-0.0147,0.017,0.0606,0.0732,-0.0384,-0.0349,-0.1992,0.0623,-0.1323,0.0351,-0.077,-0.1337,-0.0213,-0.3488,0.0697,0.0637,-0.0887,-0.0491,0.0412,0.0337,-0.0005,0.1815,0.1508,-0.0813,-0.1226,0.0856,0.0609,0.1851,0.0911,0.1515,-0.0316,-0.011,-0.0618,0.0646,0.0448,0.1471,0.109,0.1146,0.0203,-0.0806,-0.0438,0.0287,-0.0105,-0.0329,-0.0129,0.011,0.0545,0.0285,-0.0095,0.0644,-0.0214,0.1093,-0.0033,0.1147,-0.0684,0.0179,0.1696,0.1013,-0.0278,0.0152,0.2187,0.1443,0.0654,0.0481,0.0801,-0.1044,-0.0525,-0.1302,0.0155,0.0301,0.0117,-0.0008,-0.0375,0.0094,0.0945,-0.0741,-0.0458,-0.0334,0.0671,-0.062,0.0678,0.0736,-0.0345,-0.0957,0.0137,0.0634,-0.0096,0.0133,0.1756,0.0506,0.0456,-0.0156,-0.0469,-0.3304,0.0566,0.07,0.0368,0.0135,-0.0345,-0.036,0.026,0.1671,0.1208,-0.0177,0.0416,0.0718,0.0165,0.0278,0.0352,-0.1083,-0.0755,-0.1491,0.036,0.0359,0.0726,-0.035,0.1216,0.1622,0.1698,-0.2649,-0.0783,-0.1077,0.0813,-0.0533,-0.1108,-0.0488,-0.1142,-0.1019,0.0423,-0.0097,0.0693,0.1574,-0.1011,0.0291,-0.0981,0.0483,0.0877,0.1325,0.017,0.0246,0.0566,-0.0809,-0.3181,0.0455,-0.164,-0.149,-0.2062,-0.0593,-0.01,-0.0422,-0.0318,-0.1399,-0.0613,-0.0312,-0.0902,-0.0699,0.1158,0.0795,0.1234,0.0075,0.089,0.1362,0.0292,0.0601,-0.0323,0.0579,0.0849,0.0862,-0.0665,0.026,-0.0047,-0.1806,-0.1137,0.046,-0.0678,-0.1137,-0.1189,-0.0586,0.1047,0.0406,0.075,0.0969,-0.0082,0.1771,0.2142,0.1494,0.0385,-0.1571,0.1243,0.0734,0.0566,0.0821,0.0919,-0.0436,-0.0661,0.1207,0.0969,-0.0315,-0.0187,0.0746,0.0111,-0.0916,0.0058,0.0264,0.0006,0.0105,-0.0737,0.0642,0.0073,-0.004,0.0386,0.217,0.0129,0.0348,0.1186,0.1657,-0.0519,0.2131,-0.1112,-0.0297,-0.0352,-0.0384,0.0158,0.0393,-0.0626,0.2245,0.2301,0.1767,-0.0372,0.192,0.0894,0.1391,0.1211,0.0212,-0.0561,-0.023,0.0125,-0.0161,-0.0643,0.0478,0.0825,0.0611,-0.0969,0.0746,0.0891,0.1395,0.0486,0.042,-0.0253,0.0698,0.0454,0.1222,0.0832,0.0185,0.0398,-0.0786,0.0014,0.0457,-0.0701,-0.031,0.0145,0.1183,-0.0325,0.1142,0.0237,0.033,0.1103,-0.0799,0.0873,0.0654,-0.033,-0.2216,-0.1396,0.0012,0.0261,0.0332,-0.0523,0.0014,-0.0981,0.0489,0.0731,-0.1084,-0.0666,-0.0135,-0.1141,0.0057,-0.0045,0.0676,-0.0403,0.0025,0.054,-0.0704,-0.0148,0.0869,0.0962,0.0482,-0.1274,-0.0651,-0.0683,-0.1662,-0.0567,-0.0748,0.1687,0.0639,0.0079,0.0415,0.1366,0.1199,0.0315,0.0754,0.0406,-0.4939,-0.2801,-0.4047,-0.4416,-0.3026,-0.2988,-0.1346,-0.2052,-0.1413,-0.1099,-0.4304,-0.3113,-0.4511,-0.4285,-0.1374,0.1669,-0.0612,-0.0215,0.0389,0.0335,0.1833,-0.0317,0.0164,0.0108,-0.1643,-0.1537,0.0393,0.0594,-0.3071,-0.1587,-0.174,-0.234,0.0038,0.1276,-0.017,0.0344,0.0639,0.0628,0.0627,0.0938,-0.0418,0.0854,0.0335,0.0989,0.0307,0.2208,0.0761,0.0375,0.1295,0.1653,0.0805,0.1624,0.1032,0.1463,0.0757,-0.2078,-0.2122,-0.1931,-0.0399,0.0841,-0.1466,-0.1218,-0.1117,0.0271,-0.0063,-0.1223,-0.0108,0.0674,0.1149,-0.0096,0.0787,0.0081,-0.1025,-0.1156,-0.0324,-0.076,-0.1357,0.038,0.1374,0.1004,0.2082,0.1999,0.108,0.1117,0.0187,0.0282,0.1168,-0.2232,-0.0562,-0.0345,-0.0907,-0.0098,-0.0526,0.0022,0.0354,0.0137,-0.0229,0.0283,0.0001,0.0329,-0.0287,0.0065,0.0248,0.0555,-0.0075,-0.2228,-0.0543,0.0033,0.0642,0.0126,-0.0033,0.0263,-0.0275,0.1061,0.1538,-0.0372,0.0297,0.1916,-0.2616,0.0215,-0.0542,0.0741,-0.1338,0.0769,0.0735,0.0419,-0.0401,0.3045,0.2395,0.193,0.1125,0.1234,0.1661,0.1918,0.2045,0.1341,0.0994,-0.0337,-0.0309,-0.0485,-0.0766,-0.1044,0.1556,0.0282,0.0548,0.1146,0.043,0.0357,0.0947,-0.028,-0.069,-0.1003,0.0634,-0.038,0.0136,-0.2625,-0.1663,-0.3217,0.015,0.0086,-0.0076,0.0274,0.0091,0.1001,-0.1011,0.1136,0.1728,0.1599,-0.1576,-0.21,-0.0511,0.1345,0.0229,-0.0925,-0.0254,0.1007,0.0951,0.0142,0.0876,0.1193,-0.2777,0.0131,0.063,0.023,-0.0494,-0.1122,-0.2867,-0.0674,-0.0829,-0.0447,-0.0467,-0.3017,-0.2858,-0.2699,0.0091,0.0957,0.1163,-0.1026,0.0473,-0.0061,-0.036,0.2027,0.1271,0.1502,0.0429,-0.0115,-0.0741,0.0458,-0.0497,-0.059,-0.0895,0.0332,-0.2214,-0.1551,-0.0465,-0.0704,0.0207,-0.1688,0.0154,-0.2318,-0.1797,-0.0619,0.0689,0.0101,-0.0481,-0.1363,-0.0121,-0.092,-0.0868,-0.1811,-0.1663,0.0386,-0.03,0.0334,-0.0668,-0.0187,-0.0484,0.0303,0.0138,-0.1133,-0.1727,0.0486,0.0258,0.1472,0.021,0.0556,-0.0056,0.0987,-0.0329,0.0095,0.0305,-0.008,-0.0605,-0.1522,0.0531,-0.0687,-0.0811,0.1282,0.0073,-0.0603,-0.0184,0.0066,-0.0397,0.1264,-0.1948,-0.0597,-0.0407,-0.0743,-0.1731,0.0032,-0.0419,-0.0928,0.0391,-0.0793,-0.1291,-0.0904,0.001,0.0986,0.1141,0.1409,0.1269,0.0286,-0.0074,0.021,0.109,-0.0205,-0.1405,-0.0185,-0.0807,-0.155,-0.0995,-0.0589,0.1498,-0.1243,-0.0059,0.1808,0.2423,-0.1897,0.0831,0.009,-0.0371,-0.2346,-0.1921,-0.1921,-0.0582,0.024,-0.0031,-0.0349,-0.0696,-0.0434,0.0488,-0.0069,0.0603,0.0579,-0.021,0.0142,-0.0502,0.0809,0.1137,0.1085,0.001,0.0939,0.0364,0.0346,0.0721,0.0493,-0.1236,-0.064,-0.1042,0.1673,0.0417,-0.0377,0.1574,0.1103,0.0558,0.0397,0.0397,0.0605,-0.049,-0.0863,0.0157,0.0099,-0.1931,-0.1371,-0.0478,0.0794,0.1013,-0.0552,-0.1829,0.0307,0.0283,-0.154,-0.1283,-0.0099,0.1015,-0.031,0.0161,0.0285,0.0164,-0.1176,-0.1342,-0.2693,-0.233,-0.1289,0.0186,0.0024,-0.3495,-0.223,-0.0135,0.0023,0.0488,0.016,0.0508,0.0213,0.0102,0.0372,-0.0836,0.0015,0.0207,-0.1168,0.0891,0.1054,0.0326,0.0342,0.1715,0.0242,0.1739,0.0734,-0.036,-0.0595,0.0748,-0.4997,-0.4893,-0.2852,-0.2568,-0.163,-0.0655,0.1084,0.0773,0.1442,0.0648,-0.0266,-0.0749,-0.096,-0.0697,0.0601,-0.0001,-0.1291,0.089,0.0484,0.0351,-0.003,-0.3972,-0.1133,-0.4115,-0.2798,-0.2698,-0.1739,-0.3396,0.1443,-0.1151,0.0959,0.1654,-0.0455,-0.0184,0.0744,0.0519,0.0835,0.0116,-0.0278,0.0558,0.056,0.0829,-0.0173,0.0239,0.0971,0.1095,0.0589,0.0396,-0.0196,-0.0779,-0.128,-0.1004,-0.0647,-0.2352,0.0068,0.0087,0.0279,0.0277,-0.0655,-0.0755,-0.035,-0.0382,-0.0861,-0.176,-0.0201,0.0313,0.0537,-0.0677,-0.0427,0.0017,-0.0249,-0.0464,-0.0263,-0.064,0.0183,-0.0155,0.0376,0.0445,-0.0825,-0.1107,0.1563,0.128,0.0403,0.057,-0.0022,-0.0032,0.0183,0.0906,0.0443,0.0845,-0.0552,0.0512,-0.0504,0.0068,-0.2469,0.0491,0.0544,0.036,-0.0051,0.0782,-0.0343,0.1044,-0.0577,-0.1353,-0.0773,0.0514,-0.0125,-0.0338,-0.0162,0.0373,-0.099,0.0238,-0.0494,0.063,-0.0977,0.0251,0.0069,-0.0672,0.0451,-0.091,-0.1737,-0.0268,-0.0099,-0.0302,-0.0087,0.1049,0.0993,0.1056,0.1146,0.0017,-0.1122,0.0921,0.004,0.0389,0.1423,0.0575,0.0801,0.0237,0.0053,0.0205,0.0693,0.2886,0.165,0.0835,0.1711,0.0799,0.0756,0.1514,-0.0382,-0.1077,-0.0771,-0.0975,-0.0734,-0.1151,-0.0952,-0.0322,0.0035,0.0348,0.0373,0.0824,0.0164,0.1051,0.0089,-0.0188,0.0095,0.1109,-0.0006,-0.0083,0.0256,0.0497,0.0131,0.0279,-0.015,0.0778,0.0465,-0.0831,0.0568,0.0511,0.0869,0.0272,-0.2248,-0.1794,0.0426,0.1153,-0.0509,0.0119,0.1044,0.1225,0.043,0.0536,0.0729,0.0603,0.0774,0.0603,-0.1042,-0.0303,-0.0442,-0.0047,0.0029,-0.0214,-0.0035,0.0626,-0.0111,-0.0046,-0.0191,0.0787,0.1835,0.1642,-0.0089,-0.2023,0.0307,0.0278,-0.0351,-0.0055,-0.0202,-0.2078,0.0447,0.0623,0.0721,-0.0616,0.0246,-0.1583,-0.0567,-0.008,0.0435,0.0773,-0.0602,-0.0321,0.0453,-0.0087,0.0386,0.1333,0.0391,-0.0265,0.0199,0.119,-0.0329,-0.1542,-0.1864,0.0028,-0.0354,0.032,0.0277,0.0287,-0.025,-0.0119,-0.039,0.0369,-0.009,0.1282,-0.0442,0.0686,0.0544,-0.0628,0.0183,-0.1054,-0.1647,0.0527,0.0367,0.0645,-0.0544,0.0819,-0.0008,-0.0797,0.0288,0.0531,-0.0826,-0.018,-0.1692,0.0207,0.0225,0.1983,0.1308,0.13,0.1132,0.0305,-0.0095,-0.0682,0.0782,-0.0426,-0.036,0.1308,0.0455,0.035,0.1075,-0.2049,0.1192,0.0066,0.1571,0.0924,0.0105,-0.0699,0.0411,0.0563,-0.0036,-0.1441,0.0689,0.0137,0.0373,-0.0703,0.041,-0.0016,-0.03,0.0394,-0.346,-0.1462,-0.1605,0.1193,0.1151,0.0201,0.1,0.1827,-0.0065,-0.1869,0.0498,0.0462,0.0303,0.1884,0.0003,0.0493,-0.0509,-0.0635,-0.0106,0.1693,0.181,0.144,0.0392,-0.115,0.043,0.0893,0.2007,-0.0085,-0.019,-0.0469,0.0836,-0.0056,-0.3738,-0.3778,0.0167,-0.033,0.015,0.0057,-0.0526,-0.0685,-0.0279,0.0794,-0.0237,-0.0535,0.2027,0.0063,0.0305,0.1428,0.0326,0.109,0.0779,0.1799,0.0737,0.0525,0.1218,0.0857,0.0158,-0.2469,-0.1728,-0.032,0.1511,0.0526,-0.4103,-0.3182,-0.2903,-0.0168,0.0767,-0.2772,0.0423,0.0192,0.0002,-0.0355,-0.0747,-0.0857,0.0161,0.0285,-0.2816,-0.179,-0.3162,-0.0793,0.0171,0.0837,-0.0216,-0.1124,-0.0615,-0.0239,-0.033,-0.0016,0.0609,-0.0282,-0.0283,0.0282,0.0512,0.0385,-0.0198,0.059,-0.0621,0.1622,0.0585,0.1058,-0.0597,-0.0641,0.0177,0.0408,0.0011,-0.1904,0.0204,-0.0969,-0.1009,-0.1013,-0.0385,-0.0449,-0.0227,-0.0077,-0.3148,-0.1516,0.0835,-0.0162,-0.1404,-0.0421,-0.0526,-0.0493,0.0455,-0.0396,-0.0291,0.0012,-0.0807,-0.3687,-0.0845,0.0995,0.0394,0.0164,-0.1777,-0.0324,0.0137,-0.0713,-0.179,-0.0543,-0.0798,-0.0868,-0.1458,-0.0481,-0.1425,-0.0964,0.0144,0.0544,-0.069,0.1033,-0.1104,-0.1506,-0.1572,0.0062,0.0166,-0.0451,-0.0361,-0.4411,-0.002,0.0446,0.0367,0.0648,0.2075,0.0857,0.0936,0.0582,0.0745,0.0983,0.003,0.0723,-0.4308,-0.3636,-0.3417,0.0635,-0.1735,-0.1565,-0.0203,0.0435,0.0488,0.0131,-0.2226,-0.051,-0.0689,0.0037,-0.0737,-0.0754,0.0072,-0.0473,-0.0523,-0.0168,0.0886,0.0014,0.0903,0.0537,0.0854,0.0307,-0.0433,-0.0787,0.1082,0.0867,0.0704,-0.1557,-0.1224,-0.2062,-0.0857,-0.0732,-0.0659,-0.189,-0.1733,-0.0351,0.0344,0.0646,0.0397,-0.0676,0.0043,-0.0126,0.04,0.0609,0.024,-0.0304,-0.0347,0.0682,0.0961,0.0295,-0.1383,-0.2823,-0.34,-0.139,0.1043,-0.0453,-0.0782,-0.0309,-0.0398,-0.0687,-0.0792,-0.0337,0.0758,0.143,0.0444,0.0521,-0.0325,-0.0489,-0.0526,0.0455,0.0867,-0.0272,0.0553,0.0716,-0.2344,0.0259,0.0474,-0.0199,0.0176,0.0359,0.0829,0.0496,0.0961,0.0354,0.0139,-0.0597,-0.0455,-0.0388,-0.0477,0.0724,-0.0711,-0.2118,-0.068,0.0668,-0.1683,0.0724,-0.0594,0.101,0.154,0.0109,-0.0011,0.0459,0.0028,-0.0813,0.0733,0.0654,-0.0555,-0.1027,0.0441,-0.036,-0.0562,-0.0304,0.0931,0.139,0.0755,-0.0936,0.0292,0.115,0.0861,-0.0574,-0.0074,0.0836,0.0102,-0.1426,-0.021,-0.1293,-0.0344,-0.0125,-0.2204,-0.0568,-0.1332,-0.1759,-0.2166,-0.1146,-0.4651,-0.4631,0.03,-0.0095,-0.0717,-0.0265,-0.0359,-0.3378,-0.3352,-0.0424,-0.0214,-0.0007,0.0495,-0.0325,-0.0361,-0.0195,0.0507,0.0321,0.1109,-0.0357,-0.0264,-0.0345,0.0939,-0.0082,-0.0358,-0.0042,0.0458,0.066,-0.3225,0.088,0.0479,-0.367,-0.0961,-0.0969,0.0217,-0.0481,-0.0421,-0.1161,-0.0092,-0.0113,-0.037,-0.0258,0.031,-0.011,0.0043,0.0072,0.0169,-0.0275,0.0392,-0.1458,-0.0371,0.0256,-0.0583,-0.075,0.0941,0.136,0.0442,0.0483,-0.0836,-0.0143,-0.069,0.1846,0.1436,0.1238,0.0604,0.1115,-0.0344,-0.1921,-0.0808,-0.0358,-0.0347,-0.0356,-0.0092,-0.0116,0.0802,0.0986,0.0888,0.07,0.1107,-0.0082,-0.073,0.135,0.073,-0.0295,0.0549,-0.0796,-0.1633,0.1256,0.0543,0.0828,0.0938,0.0175,-0.0001,0.0929,0.1373,-0.0709,-0.009,0.0617,0.0317,0.0812,0.0829,-0.093,-0.1045,-0.1215,-0.1072,-0.0656,-0.0382,-0.074,-0.0133,-0.1915,0.0446,-0.2022,0.07,0.0511,0.0061,-0.1552,-0.152,0.0814,-0.0696,-0.0045,-0.032,0.0165,-0.2492,-0.0015,0.0095,-0.1237,-0.0541,0.0366,0.0391,-0.0035,0.0279,-0.0917,-0.2682,0.1114,0.1293,-0.1831,-0.2111,0.014,-0.1572,0.0868,0.0356,0.0831,0.117,-0.0006,0.0428,0.0653,0.0262,0.0032,-0.068,-0.0415,-0.0184,-0.0792,-0.1102,0.056,-0.012,0.0062,0.0217,0.0418,0.0781,0.0209,0.0335,-0.0479,-0.0173,0.0797,-0.0062,0.0345,0.0321,0.0954,0.0466,0.0269,-0.0476,0.0135,0.0189,0.0497,0.0232,-0.0763,0.1046,-0.0987,0.0177,0.0217,0.0514,0.0731,0.0733,0.0361,0.0841,-0.0134,0.0662,-0.0548,0.0015,-0.2255,-0.0058,-0.1274,0.0044,0.0968,-0.0378,-0.0058,-0.0812,-0.0582,0.0213,0.0741,-0.1239,0.0643,-0.0352,0.0037,0.2442,0.0184,0.1713,0.0167,0.0956,0.0024,-0.1033,0.1675,0.0868,-0.0658,-0.0255,0.0483,-0.0817,0.0112,0.0925,0.0048,0.0542,-0.0324,0.013,-0.015,-0.0072,0.0231,0.1046,0.0569,0.0886,0.0361,0.0565,0.0787,-0.3974,0.1136,0.2692,0.022,0.0698,0.1851,0.1568,-0.0296,0.0278,-0.0419,-0.0507,-0.073,-0.1157,0.0064,0.1271,-0.0759,-0.1025,-0.0572,0.0277,0.1375,0.219,0.1736,-0.0303,0.0255,0.1112,0.1595,0.0574,0.0048,0.2148,0.1605,0.1551,0.1304,-0.0569,0.0078,0.058,0.0414,0.1543,-0.0207,0.0914,0.1438,-0.1183,0.114,-0.0355,-0.184,0.0173,0.0335,-0.017,0.1339,-0.2185,-0.0245,0.0865,0.0532,0.0485,-0.3605,-0.2283,0.1337,0.1341,-0.0025,-0.0745,0.0548,0.1542,-0.0343,0.0104,-0.0061,-0.0128,-0.024,-0.0285,-0.025,0.1021,0.0494,0.0143,0.1229,0.107,-0.0561,-0.051,-0.0439,0.0457,0.0391,0.0348,0.0006,-0.022,0.048,0.1386,0.1671,0.1384,0.0689,0.1197,-0.0092,-0.0197,-0.0233,0.0979,0.1104,0.0771,0.1505,0.089,0.0302,-0.0105,-0.0266,0.0773,0.0508,0.0059,0.0534,0.0472,-0.1316,recognition
trm_557b4a913f8cc,0.0225,0.0251,0.0276,0.0112,-0.0118,0.0042,0.0055,0.0212,0.0061,0.031,-0.0052,0.0027,-0.0022,0.0054,0.0276,0.023,0.0086,-0.0016,-0.0212,-0.0027,0.015,-0.0054,-0.0139,-0.0213,0.0049,0.0012,0.0012,0.0147,0.0222,0.014,0.0077,0.0014,0.0087,0.0116,0.005,-0.0086,-0.0197,-0.0121,0.0318,0.0088,0.0007,0.0191,0.0069,-0.0185,0.0101,0.0276,-0.0113,0.022,-0.0161,0.0021,0.0209,0.0115,0.0062,0.0078,-0.0035,-0.0119,-0.0032,0.0185,-0.0096,0.0209,0.0043,-0.0002,0.007,0.0082,0.0074,0.0141,0.0303,0.0241,0.0169,-0.0105,-0.0222,-0.0257,-0.0191,-0.013,0.0277,-0.0078,0.0242,-0.0229,0.0207,-0.0007,-0.0247,-0.0062,-0.0031,0.0066,0.0042,0.0057,-0.002,-0.0019,-0.0138,0.0112,0.016,0.0239,-0.0587,0.0123,0.0074,0.0148,-0.0096,0.0185,-0.0002,0.0002,0.0132,-0.0125,-0.0107,-0.0002,0.0062,-0.0024,0.0235,-0.016,0.0203,0.0282,-0.0128,0.0162,-0.0113,0.0022,0.0115,-0.0119,0.0078,0.0013,0.013,0.0049,0.0012,0.0108,0.0046,-0.0064,0.0001,0.0068,-0.0014,-0.0145,-0.0123,-0.0211,0.0006,0.004,0.0032,-0.017,0.005,0.0218,0.0086,0.0031,-0.001,0.0213,0.0187,0.0019,-0.0236,0.0018,0.0009,0.0016,0.0204,0.0053,0.0116,-0.029,0.0139,-0.0005,-0.017,0.0052,-0.0073,-0.0149,-0.0115,0.0105,-0.0188,-0.0114,0.024,0.0118,0.0131,0.027,-0.0012,-0.0003,-0.0083,0.0209,0.0201,0.0063,-0.0323,0.0033,-0.0131,-0.0014,0.0153,0.0017,0.0023,0.0016,-0.0007,-0.0077,0.0114,-0.0308,0.006,-0.0168,0.0287,0.0033,0.0158,-0.0026,0.0194,0.0119,0.0151,0.0066,0.0015,0.0236,0.0208,0.029,0.026,0.009,0.0104,0.0169,0.0041,0.0128,-0.0007,0.023,-0.0028,-0.0065,-0.0076,0.02,-0.0035,-0.0179,0.0021,-0.007,-0.0079,-0.016,-0.0041,0.0007,-0.0373,0.0141,0.0254,0.0026,-0.0096,0.0148,-0.0065,0.0084,0.0093,-0.0231,0.021,-0.0039,-0.0096,-0.0301,-0.003,-0.0043,-0.0194,-0.0038,-0.0069,0.0022,-0.0108,-0.0127,0.0026,0.0161,-0.0229,0.0143,-0.0017,0.0021,-0.002,0.0108,-0.0123,0.0072,0.0167,-0.0046,0.0126,-0.0006,-0.0018,-0.0124,-0.0008,0.0148,0.0075,0.0088,0.0019,-0.0079,0.0025,-0.0068,0.0141,-0.0059,0.0119,-0.0234,-0.0096,0.0125,-0.0344,0.0138,0.0037,0.0287,0.0074,0.0005,0.0136,-0.0127,0.0004,0.0074,0.0135,-0.0239,-0.0198,-0.0032,-0.0144,0.0065,0.0073,0.0173,-0.0256,0.0092,0.0277,-0.002,0.0016,0.0246,0.0056,0.002,-0.0061,0.0009,0.011,0.0051,0.0031,0.0098,0.0079,-0.0105,-0.0141,-0.0112,0.008,0.0083,0.0075,0.0066,0.0234,0.0156,-0.0148,-0.0021,0.019,-0.0128,-0.0183,0.0114,0.0025,-0.0061,0.0083,0.0188,-0.0117,0.0087,-0.0073,-0.0135,-0.001,0.0267,-0.0095,0.0001,0.001,-0.005,-0.0045,-0.0004,-0.0003,-0.0234,-0.0029,-0.0103,-0.009,-0.0107,0.0028,-0.0015,-0.0038,0.0013,0.0125,0.0018,0.0165,0.0119,0.012,0.0051,0.0098,0.0024,0.0204,0.002,0.0116,-0.0029,0.0085,0.0134,0.0053,0.0069,0.0224,0.0004,-0.0111,0.0182,0.0104,0.0054,-0.0122,-0.0081,0.0183,0.0119,0.0131,0.0205,0.0008,-0.0034,0.0027,-0.0056,0.0116,0.0017,0.0204,0.0054,-0.0468,-0.0192,-0.0443,0.012,0.0196,-0.0013,0.0175,0.0013,0.0171,-0.001,0.013,0.0006,0.0041,0.0176,0.006,0.0093,0.0061,0.0029,0.0121,0.0013,0.0259,0.0002,0.0131,-0.006,0.0239,0.0173,0.0027,0.0027,0.007,0.0247,-0.0134,-0.014,0.0192,-0.0023,0.0187,0.009,0.0009,0.0105,-0.0109,0.0057,0.0202,0.0218,-0.0068,0.0207,0.015,0.0331,0.0271,0.0198,0.0256,0.0006,0.0194,-0.005,0.0186,-0.0153,0.0159,0.0017,-0.0445,-0.0043,0.0021,-0.0123,0.0228,0.0172,-0.0082,-0.0119,0.0128,-0.009,0.021,0.0134,-0.0214,-0.0093,0.0145,0.012,0.0125,0.0121,0.0099,0.0162,-0.011,0.007,0.0045,0.0122,0.0146,-0.0222,-0.0037,0.0102,0.0152,-0.0312,0.0104,0.0041,-0.0165,-0.0287,0.0213,-0.0035,0.0137,-0.0009,0.0235,-0.0137,-0.0141,0.0041,-0.0001,-0.01,-0.0134,0.0217,0.006,0.0122,0.0185,0.0069,-0.0185,-0.0294,0.0084,-0.0065,0.0068,0.0017,-0.0368,-0.0364,0.0087,0.001,-0.0204,0.0092,0.0094,0.0088,-0.0223,0.0204,0.0181,0.0125,0.0106,0.0228,0.018,0.0053,0.0147,-0.0105,-0.0052,-0.0,0.0165,-0.0263,-0.0002,-0.0038,-0.0145,-0.0072,0.0121,0.0092,-0.0049,0.018,-0.0033,0.007,0.0106,0.0083,0.0039,-0.0154,-0.0114,-0.0308,-0.0259,0.0005,-0.0051,0.0269,0.0023,0.0169,-0.0006,0.0098,0.0118,0.0107,-0.0013,0.001,-0.006,-0.0103,0.0063,0.0129,-0.0217,-0.0089,0.0035,-0.0056,-0.0083,-0.02,-0.0298,-0.0094,0.0051,0.0018,0.0211,0.0084,-0.0169,0.0015,-0.0317,0.029,0.0066,0.0081,0.0225,0.0111,-0.0014,-0.01,-0.025,-0.0107,-0.0031,0.0078,0.0002,0.0017,-0.0251,0.0024,-0.0145,-0.0083,-0.0087,0.0126,-0.0003,-0.0183,-0.0083,0.0249,0.0035,0.0193,0.0066,-0.0031,0.0199,-0.0066,-0.0158,0.0062,-0.0049,0.0136,-0.002,0.0137,0.0109,0.0182,0.0212,-0.0105,0.0126,0.0042,-0.0017,-0.0167,-0.0051,-0.0191,0.0108,-0.0179,0.0166,0.0177,0.0205,0.0119,0.0206,0.0181,-0.0085,0.015,0.0315,0.0145,0.0224,-0.0043,0.0036,0.0384,0.0123,0.0225,-0.0361,0.0091,0.0128,-0.0199,0.0192,0.0118,0.0109,0.0054,-0.002,0.0036,0.0058,0.0112,0.0284,0.004,0.014,-0.0078,0.0088,0.019,0.0134,-0.0013,0.007,0.0045,-0.0116,0.0152,0.0116,0.0077,-0.0121,0.0111,-0.0224,-0.0045,0.0132,0.017,-0.0054,-0.0003,0.0158,-0.0182,-0.0029,0.0109,-0.0132,-0.0008,-0.0243,0.0058,0.01,0.004,0.0162,0.0097,0.0015,0.0026,-0.0155,-0.0075,-0.0056,0.0027,0.0129,0.0077,-0.0364,0.0231,-0.0053,-0.0072,-0.0054,-0.0094,0.0131,0.0136,-0.0204,0.0158,0.0135,0.011,-0.001,0.0181,0.0102,0.0073,0.0144,0.0151,-0.0377,0.0135,0.0004,0.0271,0.0052,0.017,-0.0024,-0.0045,0.0075,-0.0314,0.0215,0.0045,0.0239,0.0108,0.0094,-0.0163,0.0077,-0.0046,0.0002,-0.0366,-0.0219,0.0064,-0.0141,-0.0113,-0.0221,0.002,-0.0249,0.0103,0.0115,0.0105,0.0049,0.0158,0.0175,0.0102,0.0087,0.0155,-0.0293,0.012,-0.0166,-0.0012,-0.0014,0.0174,0.0201,-0.0169,0.0133,-0.0058,0.0116,0.0006,0.0149,-0.0016,-0.0082,0.012,0.0124,0.0029,0.0094,-0.0056,-0.0189,-0.018,0.0091,0.0212,0.0038,-0.0013,0.0079,-0.0122,-0.0227,0.0138,-0.0058,0.0057,-0.0012,-0.0091,-0.0183,-0.0002,-0.0151,0.0321,0.0076,-0.0046,0.002,-0.0159,0.0008,0.0117,0.0067,0.0187,-0.0142,0.0031,0.0257,0.0171,0.019,0.0187,-0.0183,0.0004,-0.0142,-0.0067,-0.0101,-0.0018,-0.0081,0.0186,0.008,0.002,-0.0183,-0.0066,-0.0006,0.0053,0.0017,0.0217,0.0071,0.0186,0.0163,-0.0192,-0.019,-0.0236,0.0001,-0.0046,0.0153,0.0141,0.0235,-0.0149,-0.0104,-0.0118,-0.0371,-0.036,0.001,-0.0367,-0.0146,-0.012,-0.0012,-0.006,0.0018,0.013,0.022,-0.0157,0.011,-0.038,0.0109,0.0101,-0.0079,0.008,0.0045,0.0016,-0.0036,-0.0009,-0.0065,0.0075,0.0018,-0.0033,0.012,-0.0218,-0.0107,0.01,0.0098,0.0206,-0.0017,0.02,0.0073,-0.0218,0.0011,-0.0028,-0.0077,0.0222,-0.023,0.0044,0.0107,0.006,0.0298,0.0119,0.0189,0.0043,-0.0143,-0.0295,0.0004,-0.0136,0.0031,-0.0075,0.0067,0.015,0.0037,0.0096,-0.011,0.0166,0.0125,0.0131,-0.011,0.0148,-0.0093,0.014,0.0148,0.0134,0.0102,-0.0174,-0.0027,0.0166,0.0185,0.0028,0.0017,0.0202,-0.0092,0.005,0.0056,0.0032,0.0019,0.0091,-0.0047,-0.0168,0.0257,0.0106,-0.009,0.0039,-0.006,-0.0098,-0.0478,-0.011,-0.0197,-0.0732,-0.0095,0.0032,-0.0078,0.0124,0.0222,-0.0282,0.0147,0.0153,-0.0012,-0.0482,-0.0272,-0.0177,-0.0132,-0.0021,-0.0016,-0.0001,0.0115,0.005,0.019,0.0021,0.0215,-0.0019,-0.0242,0.0053,-0.02,-0.0279,0.0123,-0.0012,0.0141,-0.0389,0.0115,-0.0269,0.0077,0.0194,0.0197,0.003,0.0055,-0.0064,-0.0122,-0.0041,-0.0134,-0.0099,-0.0177,0.0085,-0.0099,-0.0125,0.0052,0.0116,-0.0187,0.025,-0.0072,-0.0008,0.0123,-0.0109,-0.0309,0.0091,-0.0227,-0.0154,-0.0326,-0.0029,0.0207,0.0068,-0.0026,-0.0166,-0.0038,0.0142,0.0094,-0.0119,-0.0173,0.0067,0.0146,0.0082,0.0152,-0.0017,-0.0011,0.0017,0.0248,0.0244,-0.023,0.0125,0.0094,-0.0181,-0.0002,-0.0052,-0.0066,-0.0649,-0.0238,0.0243,0.0063,0.0119,0.0204,0.0022,-0.0056,-0.0055,0.0174,0.0136,-0.01,-0.0342,-0.0292,0.0213,0.0034,0.0061,-0.0087,-0.0031,-0.0049,0.0072,-0.0059,-0.0492,0.0156,0.0107,-0.0109,-0.0015,0.032,0.0019,-0.0033,-0.0285,-0.0128,0.0014,0.0014,-0.0009,0.003,-0.0011,0.0156,-0.0119,0.0045,-0.0068,0.0011,-0.0005,-0.0041,-0.0064,-0.0147,0.0044,0.02,-0.019,0.008,0.0194,0.0212,-0.0252,-0.0021,0.0032,0.0106,-0.0101,-0.0062,-0.0085,0.0033,0.0006,0.0078,0.0009,0.0032,-0.0351,-0.0048,-0.0391,0.005,-0.0236,-0.0077,-0.0011,0.0118,0.0135,-0.031,-0.0034,-0.02,0.0009,0.0147,-0.0478,0.0127,0.0161,0.006,0.0089,0.0143,-0.0227,-0.0156,0.0249,0.0079,-0.0079,0.0071,0.0004,-0.0049,0.0112,0.0144,-0.0053,-0.0052,-0.0149,-0.0017,0.0071,-0.0414,-0.0295,-0.0275,0.0041,-0.0198,-0.0138,-0.0249,0.0011,0.019,-0.0342,-0.0056,-0.0037,-0.0268,-0.03,-0.0104,0.0029,-0.0254,0.0177,-0.0076,-0.018,-0.0017,-0.0146,0.0146,0.0131,0.0162,0.0057,0.0035,0.0184,-0.011,0.0023,-0.0087,0.0131,-0.0002,0.0128,-0.004,-0.0161,0.0087,0.0139,0.0138,-0.0042,0.0053,-0.0057,-0.0331,-0.0077,-0.0013,-0.0001,0.0094,-0.0099,-0.0166,-0.0004,0.0187,-0.0227,-0.0147,-0.0127,0.0189,-0.0128,0.0007,0.0011,0.0048,-0.0123,-0.0247,-0.0012,0.0009,0.0021,0.0038,0.0125,0.0009,0.0133,-0.0232,-0.0157,0.018,0.02,0.0319,0.013,-0.0082,0.0005,0.0204,0.0016,-0.005,-0.0046,0.003,0.0028,0.0028,0.0155,0.0012,0.0202,0.0232,0.0008,0.0223,-0.0134,0.0017,-0.0136,0.0187,0.0012,0.0167,0.0065,0.0108,-0.0056,-0.0044,0.007,0.0274,-0.0011,-0.0098,0.0122,0.0185,0.0054,-0.0127,-0.0031,0.0237,-0.0068,-0.0087,0.004,0.0167,-0.0011,-0.0064,0.006,0.0126,-0.0052,-0.0092,0.0089,0.0101,0.0121,0.0091,-0.0047,0.0071,-0.011,-0.008,0.0083,0.0127,-0.0348,0.0032,-0.0337,-0.0249,-0.0114,-0.0267,0.0273,-0.0003,0.0102,0.0028,0.0303,-0.0308,0.0086,-0.0084,-0.0003,0.0062,-0.0059,0.0025,0.0057,-0.03,-0.0051,-0.0291,-0.0148,-0.0092,0.0112,-0.0048,0.0063,0.0083,0.0081,-0.008,-0.0108,-0.0108,0.0048,0.0214,0.0176,0.0031,-0.0138,-0.0426,0.013,-0.0232,0.0223,0.0201,0.0111,-0.0041,0.0244,0.0244,0.0152,0.0016,0.0072,-0.0031,-0.0036,-0.0076,0.0138,-0.0136,-0.0054,0.0253,-0.0084,0.0058,0.0012,-0.0036,0.0009,0.0026,0.0127,0.0216,-0.0013,-0.0102,-0.0128,-0.0051,-0.0076,0.0009,0.0115,-0.0097,0.0151,-0.0158,-0.0144,-0.0141,-0.0236,0.0023,-0.0069,0.0052,0.0045,0.0132,-0.016,0.014,0.003,-0.023,0.018,-0.0036,-0.0036,-0.0225,0.0139,0.0137,0.0147,0.0231,-0.0054,0.002,-0.001,-0.0089,0.0016,0.0181,0.0125,-0.0023,0.0031,-0.003,0.0005,-0.001,-0.009,-0.0257,0.0208,0.0107,-0.0198,0.0116,-0.0092,0.0091,0.0209,-0.0013,0.0007,-0.0074,0.0185,-0.0127,-0.0056,0.0097,-0.0188,0.008,0.0003,0.0027,0.0023,-0.007,0.0124,0.0091,0.0021,0.0008,-0.0001,0.0239,-0.0045,0.0117,0.0098,-0.0137,-0.0004,-0.0158,-0.0021,0.0205,-0.0048,-0.0005,-0.0017,-0.0297,0.0029,-0.0034,0.0062,0.0286,-0.005,-0.002,-0.0088,0.0127,0.008,-0.0004,-0.003,-0.0062,-0.0104,-0.0143,0.0122,0.0127,0.0168,0.0082,0.0075,0.0138,-0.0087,-0.0103,0.0136,0.0113,-0.0057,0.0116,0.0009,0.0164,0.0034,-0.0079,-0.0153,0.013,-0.0031,-0.0066,-0.0231,0.0073,-0.0091,0.0023,-0.0019,0.0136,-0.0238,0.0035,0.0033,-0.0108,0.005,-0.0166,0.0052,-0.0035,-0.0043,0.0021,0.0214,-0.0074,-0.0166,-0.0086,-0.0039,0.0023,-0.0415,0.0147,0.0128,0.012,-0.0234,0.0112,0.0057,-0.0117,0.0079,-0.0115,0.0165,0.0122,0.0177,-0.0062,-0.0031,-0.025,-0.0309,-0.0019,0.0134,0.0094,0.0189,0.0099,0.0125,0.0028,-0.0304,0.0071,-0.0112,-0.0049,-0.0189,0.0008,0.0188,0.0115,-0.0192,0.0217,0.0184,-0.0004,0.0146,0.0208,-0.0072,-0.0062,0.0315,0.0082,0.0022,-0.0034,0.0262,-0.0,0.0113,-0.0094,0.0058,0.0002,0.0176,0.0191,-0.0061,0.0179,0.0077,0.0049,0.0083,-0.0178,0.0128,-0.0251,-0.0094,0.0167,0.0176,-0.0017,0.0089,0.0335,0.01,-0.0049,0.0042,0.0076,-0.0213,0.0172,0.015,-0.0103,0.0007,-0.0204,0.0128,0.014,-0.0507,0.0068,0.0059,-0.0021,-0.0053,-0.007,0.0058,-0.0359,0.0036,0.0073,-0.0145,-0.0044,-0.0028,0.0035,0.0014,0.0065,0.0065,0.0057,-0.0066,0.009,0.0058,-0.0028,0.0214,0.005,0.0189,0.0199,0.0212,0.0133,-0.0127,0.0057,-0.0107,0.0155,-0.0161,0.0061,-0.0065,0.0063,0.0155,0.0032,0.0085,-0.0163,0.0158,0.0082,0.0087,-0.0131,-0.0121,0.0024,-0.005,-0.0196,-0.0077,-0.0178,0.0052,0.0004,0.0081,-0.0217,-0.0575,0.0181,0.0064,-0.0276,-0.0102,0.0027,0.0058,0.0042,0.0002,0.0002,-0.0184,0.0108,0.0015,0.0115,0.0133,0.0121,0.0251,-0.0016,0.0193,0.0053,-0.019,-0.0269,0.0024,-0.0232,-0.0301,-0.0015,0.0187,0.0042,-0.0282,0.0027,0.0172,-0.0117,0.0209,0.006,0.0216,0.0032,0.0141,-0.0046,0.0097,0.0168,0.0014,0.0215,0.0205,0.0026,0.0154,-0.0126,-0.0073,-0.0099,-0.0056,0.0012,-0.007,-0.0,0.0342,-0.0088,0.0025,-0.0052,-0.0069,0.0058,-0.0041,0.0079,0.0034,0.0081,0.0278,0.0074,0.0271,0.0114,0.0091,-0.0097,0.0176,-0.0621,-0.0676,0.0069,0.0104,0.0175,-0.016,0.004,-0.0175,0.0095,0.0143,0.0108,-0.0234,-0.0021,-0.0101,0.0047,0.0186,0.0089,0.0052,0.002,0.0079,-0.0066,0.0036,0.0133,0.0124,0.0054,0.0114,0.0029,0.0032,0.0023,-0.0097,-0.0153,0.0195,0.0142,-0.0063,0.0111,0.0071,-0.015,0.0017,-0.0299,-0.0167,-0.0023,0.0063,-0.0041,0.0044,0.0029,0.014,-0.02,0.0158,0.0151,0.0107,0.0075,-0.0011,-0.0041,-0.0009,-0.0256,0.0045,0.0204,-0.0001,0.0003,0.0059,0.0053,0.0226,-0.0001,-0.0064,0.0111,-0.0272,-0.0025,0.002,-0.0031,0.0054,0.0131,0.0147,0.0008,0.0035,0.0217,0.0353,0.0068,0.0057,0.001,0.0015,-0.0257,-0.0163,-0.0443,-0.0202,-0.0123,-0.0214,0.0133,0.0222,0.0014,0.0156,0.0158,0.0047,0.0027,0.0014,0.0131,-0.0048,-0.0042,-0.0121,0.0106,-0.0107,0.0046,0.0186,-0.0555,-0.0033,0.024,0.0031,0.0159,0.0073,0.0026,-0.0185,0.0243,0.0284,-0.0032,-0.0005,0.0258,-0.0073,0.0019,0.0074,0.0153,-0.006,0.0102,0.0182,0.0045,-0.0219,0.0024,-0.003,-0.0034,0.0089,-0.023,-0.0149,0.0152,-0.0109,-0.0031,-0.0018,-0.0087,-0.0175,0.0154,-0.0113,0.0025,0.0123,-0.0098,0.0117,0.0159,0.0236,-0.0059,-0.0161,-0.0025,0.0247,-0.0202,-0.0142,0.0052,-0.0097,0.0151,0.0143,0.001,0.0131,0.01,0.0097,0.0045,0.0083,-0.0065,0.0026,0.0111,0.0201,0.0232,0.0111,0.0093,0.0169,0.0115,-0.0211,0.0127,0.0119,-0.0058,0.0238,-0.003,-0.014,-0.0461,-0.0287,0.0103,0.0175,0.0276,0.0074,0.0126,-0.0001,-0.0141,0.0145,-0.0027,0.012,0.0216,0.0191,0.0035,0.0183,0.0112,0.0112,0.0207,-0.0062,0.0223,0.012,0.0108,0.0073,0.0121,-0.005,-0.012,0.0059,0.0143,0.008,0.0022,-0.0347,0.0189,0.0141,0.0071,0.0069,0.0081,0.0168,0.0173,0.0067,0.0211,0.0002,0.0097,-0.0169,0.0208,0.0103,0.0111,0.0034,-0.0245,0.0072,0.0119,-0.0291,-0.0216,0.0163,0.0066,0.0144,-0.0111,-0.0026,0.0224,0.0042,-0.0347,-0.0352,0.0209,0.0033,0.0071,0.0003,0.0022,-0.0217,-0.0081,-0.0212,-0.0055,-0.0091,-0.0011,0.0075,-0.0071,-0.0246,-0.0072,0.0194,0.0153,0.0126,0.0152,0.0194,0.0198,0.0053,0.0161,0.0033,-0.0051,-0.0439,0.0064,0.0208,0.0255,0.0181,0.0163,0.0132,-0.0074,0.0168,0.0077,-0.0104,0.0122,0.017,0.0084,-0.0051,-0.0182,0.0103,-0.0039,0.0145,0.0063,0.0142,-0.0083,-0.0019,-0.0029,0.0141,0.0046,-0.0012,-0.0054,-0.0254,-0.0016,0.004,-0.0065,-0.0024,-0.0042,0.0098,0.0155,0.0052,-0.0252,-0.0104,0.0073,0.0211,0.0179,0.0126,0.0185,-0.0449,0.015,0.009,0.0114,-0.0016,0.0121,-0.0032,0.001,0.022,0.0038,0.016,0.0064,0.0066,-0.0265,-0.0044,0.0231,-0.0478,-0.0369,0.026,0.0158,-0.0361,0.0107,0.0091,0.0027,0.0083,0.0006,0.0198,0.0194,0.0153,0.0029,-0.0506,-0.0636,-0.0189,-0.0618,-0.0045,-0.0253,-0.0561,-0.0548,-0.0334,0.0145,0.0051,-0.0174,0.012,0.0196,0.0108,0.0038,0.0125,0.0169,-0.0004,-0.0108,-0.016,-0.0083,0.0021,0.0081,-0.0246,-0.0441,-0.0243,-0.0193,0.0261,0.0009,0.0118,0.0,0.0139,0.0126,0.0009,0.0038,-0.0076,-0.0055,0.009,0.0173,0.0154,0.0034,0.0184,0.0111,-0.0028,0.0072,-0.0126,-0.0117,-0.0059,-0.0235,-0.0091,0.0187,-0.0115,0.0121,-0.0036,0.0162,0.0143,0.0016,0.0134,-0.0107,0.0071,0.0095,0.0027,-0.0005,0.0084,0.0218,0.0074,-0.0191,-0.011,-0.0078,-0.0108,-0.0014,-0.0222,0.0206,0.0005,0.0046,0.0148,-0.0132,0.0196,-0.0074,0.017,-0.0075,0.0046,0.0034,-0.0063,0.0037,0.0147,0.0066,-0.0068,-0.0124,0.0164,-0.0091,-0.0,-0.022,0.0002,-0.0127,-0.0027,0.014,-0.0148,-0.0189,-0.0149,-0.0166,0.0039,0.0009,0.0224,0.001,-0.0034,0.0163,-0.0128,0.0038,0.006,-0.0187,-0.0031,-0.0158,-0.0184,-0.0079,0.0116,0.0051,-0.005,0.0234,0.0208,-0.0073,-0.0041,-0.0102,0.0093,-0.0055,-0.0087,0.0165,-0.0183,-0.0316,0.0228,0.001,0.0102,-0.0185,0.0069,-0.0251,-0.0354,0.0091,-0.0011,0.0152,0.0013,0.0004,0.0007,0.0127,0.0087,0.0,0.0053,0.0157,0.0107,0.0108,0.0174,0.0251,0.0104,-0.0033,0.0012,0.0148,0.016,-0.0137,0.0187,-0.0147,-0.0188,0.0174,0.0147,-0.0078,-0.0079,-0.0078,0.0079,0.0146,-0.0446,-0.0287,0.0067,-0.0037,0.0075,0.022,-0.0017,0.0034,0.0057,-0.0133,-0.0019,-0.0323,0.0167,0.0208,0.0003,0.0142,-0.0048,0.0076,-0.0204,0.0208,0.0144,0.0061,-0.0019,0.0152,0.0107,0.0001,0.0022,-0.006,0.006,0.0119,-0.0047,-0.0111,-0.003,-0.0012,0.0213,0.0201,0.0155,-0.0015,0.0252,0.0162,0.0184,0.0184,-0.0042,0.0187,0.0054,0.0264,-0.0074,0.0127,0.0031,0.0158,-0.004,0.0203,-0.0018,0.013,0.012,-0.0233,0.0038,0.0046,0.0145,-0.0129,0.0197,0.0126,-0.036,0.0073,0.0139,0.012,0.0161,0.0151,0.0187,-0.0062,-0.032,0.0116,0.0142,-0.0127,0.0114,0.015,0.0033,0.0143,-0.0029,0.0016,0.0099,0.0001,0.0008,0.004,0.0206,0.0119,0.0227,-0.0025,0.0044,0.0084,0.0129,0.0088,-0.0079,0.0096,0.0004,0.0075,0.0102,0.0152,0.0019,-0.0024,-0.0082,0.0044,-0.0192,-0.0021,-0.0116,0.0004,-0.0373,-0.0022,0.0263,0.0028,-0.0199,0.0136,-0.014,-0.0082,0.0016,-0.0109,-0.0176,0.0065,0.0066,0.0119,0.0128,-0.017,0.017,0.0048,-0.0146,0.0214,-0.0079,-0.0202,-0.0243,0.0135,-0.0225,0.0204,0.0305,0.016,-0.0318,0.0058,0.009,0.0098,-0.0012,-0.0263,-0.0095,0.0068,0.0088,-0.0237,0.0076,-0.0072,-0.0042,0.015,0.0005,-0.0015,0.0135,0.0121,0.0298,0.0272,0.0243,0.0037,0.002,0.0004,-0.0237,0.0189,-0.0038,-0.0054,0.0043,-0.0105,0.0223,0.0259,-0.0144,0.0301,0.0299,0.0033,-0.0013,-0.0092,-0.0163,-0.0033,0.0115,-0.0038,0.0182,0.0127,-0.0021,0.0053,0.0022,0.0071,-0.0077,0.0075,0.0114,0.0102,0.0073,0.0052,0.0228,-0.0054,0.0125,0.011,0.0152,0.0056,-0.005,-0.01,0.0189,-0.017,0.0148,0.0074,0.0212,0.0047,-0.0032,0.0131,-0.0141,0.0006,0.0099,-0.0224,0.01,0.0065,-0.001,0.0239,0.0067,0.0007,0.0105,0.002,0.0049,0.0176,0.0147,0.0059,0.015,0.025,0.0121,0.0041,-0.02,-0.0157,0.0073,-0.0203,-0.0037,-0.0003,0.002,0.0265,0.011,0.0168,0.0017,0.0141,0.0112,-0.0192,0.0044,0.0097,-0.0454,0.0074,-0.0038,-0.0087,-0.0208,0.0151,0.0086,0.0101,0.0,-0.0037,-0.0024,-0.0023,0.0233,0.0075,0.0092,0.0058,-0.0026,0.0131,0.0143,-0.0146,-0.0167,-0.0006,0.0175,-0.0041,0.0125,-0.0141,0.0014,0.0167,-0.0042,0.0121,0.0117,0.0058,0.0085,0.024,0.0112,0.0165,0.018,0.0038,0.0093,0.0061,0.0055,-0.0074,-0.0219,-0.005,0.0161,0.0318,0.0072,0.0064,-0.011,0.0078,0.0107,0.0155,0.0147,-0.0051,-0.0073,0.0083,0.0225,-0.0286,-0.0041,0.0043,-0.0078,-0.0089,-0.015,0.0005,0.0057,0.0171,0.0018,0.0004,0.0041,-0.0183,-0.0127,-0.0126,0.0093,-0.0071,0.0052,-0.0057,-0.0026,-0.008,-0.024,-0.0148,-0.0146,-0.0145,0.008,-0.0151,-0.0213,-0.0236,0.0027,0.0038,-0.051,0.0175,-0.0032,0.018,0.0179,0.0024,0.0158,-0.0023,-0.0301,-0.0083,0.0083,0.0002,-0.0239,0.0097,0.0061,0.0163,-0.0047,-0.0449,-0.0071,-0.0037,0.003,0.0018,-0.0014,0.0109,0.0079,0.0,-0.0054,-0.0367,-0.005,0.0104,-0.0053,0.0128,0.025,0.0224,-0.0009,-0.0084,-0.0027,0.0024,0.0036,0.0081,0.0186,0.0054,0.0098,-0.0038,-0.0037,-0.0052,-0.0106,0.0186,0.0071,0.0131,-0.0076,0.0036,0.0155,0.0133,0.0081,0.0021,0.0187,0.0115,-0.011,0.0107,0.0127,0.008,0.0242,0.0037,-0.0041,-0.0183,0.0012,0.0257,-0.0103,0.0102,-0.0172,-0.0037,0.0168,-0.011,-0.0143,-0.0255,0.0015,-0.0098,-0.0159,0.004,-0.0031,0.0169,0.0248,0.0036,0.0126,0.0058,-0.0061,0.0116,0.0083,0.0266,0.017,0.0023,-0.0005,-0.0014,-0.0082,0.0283,0.0191,0.0279,-0.0105,-0.0096,0.013,-0.0243,-0.0191,0.0082,0.0103,0.0154,0.0158,0.0177,0.0139,0.0005,0.0159,-0.0277,0.0103,-0.0316,0.0056,0.0066,-0.03,0.0082,0.0021,-0.024,0.019,0.0154,-0.0015,-0.0082,0.0003,-0.0065,0.0146,0.0026,0.0126,0.0192,0.0121,0.0136,-0.0193,-0.0047,0.0035,-0.01,-0.0066,0.0029,-0.0219,0.0255,0.0055,-0.0013,0.0041,0.0044,-0.0025,-0.0118,0.0028,0.017,-0.0071,-0.0034,0.0181,-0.0193,0.001,0.003,-0.0125,-0.0022,-0.0016,0.0124,0.0062,-0.0261,-0.0015,0.0074,-0.0135,0.0055,0.0079,0.0158,0.0138,0.0059,0.0107,-0.0273,-0.0156,-0.0254,0.0201,-0.0154,0.006,0.0042,-0.0106,0.0242,-0.0247,-0.0178,-0.0216,-0.0115,0.0214,0.0042,-0.0026,0.0143,0.0091,0.0272,-0.0198,0.0193,0.0242,0.0093,-0.0011,0.0054,0.0165,0.0099,-0.0142,0.008,0.0201,0.0147,0.0035,0.0076,-0.0104,-0.0021,0.0043,-0.0068,-0.0043,-0.0022,0.001,-0.0222,0.0049,-0.0269,0.013,0.0035,0.0265,0.022,0.0085,0.0127,-0.0083,0.0037,0.0173,0.0135,0.0273,0.0179,0.0007,0.0039,0.0229,0.0204,0.0025,-0.0074,0.0084,0.0058,0.0102,0.019,0.0057,-0.0048,0.0046,-0.0034,0.0193,0.002,0.0169,0.0112,0.018,-0.008,-0.0037,0.006,-0.0022,-0.0005,-0.0096,-0.0053,0.014,0.0111,-0.0033,-0.0006,0.0091,-0.0003,0.0096,0.01,-0.0151,-0.0031,-0.0081,-0.0211,-0.014,0.0052,0.0166,-0.0381,-0.0061,0.0121,-0.0182,-0.0038,-0.015,0.0056,-0.0021,-0.0037,0.0123,-0.0084,-0.0041,0.0194,0.0135,0.0014,0.0043,0.0083,-0.0335,-0.0279,-0.0025,0.0074,0.0218,0.027,0.0107,0.0339,0.0033,0.0087,0.019,0.0188,-0.0039,-0.0081,0.0101,0.0199,-0.0561,-0.0101,-0.026,-0.0023,0.018,0.0174,0.0168,0.0088,-0.0148,-0.0037,0.0162,0.0082,-0.0253,-0.0268,0.0101,0.0245,0.0101,0.0108,0.0093,0.0118,0.0095,-0.007,-0.0162,0.0215,0.002,0.0103,-0.0045,-0.0176,0.0151,-0.0088,0.018,0.0327,-0.0261,0.0058,-0.0049,-0.0012,0.021,0.0183,0.0279,0.0047,0.0176,0.0076,0.0003,0.012,0.0062,0.0165,0.01,-0.0413,-0.0051,-0.0089,0.008,0.0181,0.0128,0.0228,0.0011,-0.0136,0.0163,-0.0408,0.0045,0.0192,0.0095,0.004,-0.0099,-0.0132,-0.0229,-0.0099,0.0265,-0.012,-0.0071,0.0014,-0.0025,-0.0067,0.0103,-0.0126,-0.0037,-0.0198,-0.0219,0.0239,-0.0123,-0.0019,0.0102,0.0087,0.0019,-0.0015,0.0114,-0.0045,-0.0004,0.0047,0.0093,-0.0013,-0.0178,-0.0051,-0.0168,-0.0079,-0.0245,0.0177,0.0136,0.0042,0.0098,-0.0109,0.0271,0.0076,-0.0024,0.0157,-0.0212,0.0026,0.012,0.0071,-0.0005,0.006,0.0222,0.0117,-0.0168,-0.0064,-0.0087,-0.0189,-0.0073,0.004,0.0184,-0.0057,0.0016,-0.0074,0.0091,-0.024,0.0134,0.0005,0.0029,-0.0068,-0.0186,-0.0072,0.0144,0.0147,-0.0115,-0.0138,-0.0024,-0.0239,0.0065,0.0104,0.0096,-0.0028,0.0181,0.0129,0.0015,-0.016,0.0015,0.0104,0.0012,0.0057,-0.0053,-0.0018,-0.0001,0.0239,0.0176,0.0099,0.0084,0.0192,0.0037,-0.0163,-0.0269,0.003,0.0127,0.0234,-0.0054,-0.0048,-0.0029,0.0153,0.0076,0.0002,0.0043,0.0167,0.0084,-0.0003,-0.0164,0.0096,-0.0049,0.0222,-0.0019,0.0109,0.0148,0.0112,0.0189,0.0246,0.0277,-0.0032,0.0073,0.0198,0.0179,0.0171,0.0019,0.0056,0.0052,0.0122,0.0119,0.02,0.0168,0.0109,0.0091,-0.0125,-0.0029,-0.0205,-0.0053,0.0036,-0.0105,-0.0189,0.0081,0.0144,0.0185,0.0254,0.0101,-0.0162,0.0021,0.0004,0.0127,0.005,0.0006,0.0158,0.0168,-0.004,0.0041,-0.0487,0.0194,0.0097,0.0082,-0.0029,0.0012,0.0203,-0.0108,0.0163,0.0158,0.0165,0.0136,0.0138,-0.0059,-0.0113,0.0166,-0.004,0.0086,0.0104,-0.0149,-0.0016,-0.0143,0.0171,-0.0162,0.0106,-0.008,0.0133,0.0149,-0.0036,-0.0093,-0.0046,0.0015,0.0185,0.0108,0.0033,-0.0192,-0.0341,0.0065,0.0072,-0.0329,0.0055,-0.0135,-0.0002,-0.0138,0.0101,0.0068,-0.0047,0.0107,-0.0008,-0.0052,-0.0019,0.0079,0.0086,0.012,0.0181,0.0035,-0.0144,-0.0055,-0.0188,0.0178,0.0147,0.0054,0.0193,0.0026,0.0112,-0.0728,-0.0471,0.0032,-0.0041,-0.0175,0.0191,0.004,-0.0121,0.0132,0.026,-0.0026,-0.0154,-0.001,-0.0026,0.0026,0.0169,-0.0137,0.0187,0.009,0.0037,0.0268,-0.0057,0.0077,-0.0129,-0.0067,0.0014,0.0092,0.0149,0.0016,0.0148,-0.0495,-0.0115,-0.0118,-0.013,-0.017,-0.0086,0.0053,0.0033,0.0133,0.0117,-0.0039,0.0157,-0.0135,0.005,0.0075,0.0051,-0.0122,-0.0134,-0.0114,-0.045,0.0197,-0.0112,-0.0481,-0.0526,-0.0322,-0.0493,-0.0663,-0.0284,-0.0279,-0.0143,-0.0099,-0.0383,-0.0376,-0.0241,-0.0564,-0.0259,-0.0189,-0.0117,-0.0198,-0.0142,-0.0079,-0.0045,0.0038,0.0155,0.0027,-0.014,0.0181,-0.0071,0.0123,0.0178,0.0177,0.0182,-0.0069,0.0216,0.0071,0.0209,0.0196,0.0175,0.01,0.0071,0.0171,0.0059,0.0109,0.0223,0.0225,0.02,-0.0084,0.0159,-0.0302,0.002,0.0161,-0.0023,0.0203,0.0069,0.0018,0.0,0.0241,0.0006,0.0036,-0.0029,-0.0113,-0.0124,-0.0119,-0.0192,-0.004,0.0093,-0.0025,-0.0032,-0.0133,0.0154,0.0022,0.0045,-0.0108,0.0006,0.0038,-0.0156,-0.0135,-0.0133,-0.0235,-0.0075,-0.0063,0.0134,risk processing
trm_559f09a5cdca9,-0.1797,-0.1069,-0.1963,-0.1999,-0.0616,-0.0274,-0.1501,-0.0751,-0.0234,-0.1244,-0.0624,-0.0349,-0.1571,-0.0964,-0.1295,-0.054,-0.0879,-0.1752,-0.0765,-0.0534,-0.1326,-0.0138,-0.0148,0.034,-0.015,0.0167,0.0181,-0.1894,-0.1845,-0.1047,-0.1421,-0.1347,-0.0933,-0.0875,-0.1661,-0.1753,-0.0373,-0.104,-0.1575,-0.1081,-0.1398,-0.1661,-0.054,0.0534,-0.1024,-0.1101,0.2597,-0.0948,0.0387,-0.1453,-0.0337,0.0507,0.0652,-0.0202,-0.0869,-0.0605,-0.1479,-0.0425,-0.0101,-0.0781,-0.0016,0.0391,-0.2178,0.039,0.0552,0.0961,-0.2965,-0.3291,-0.181,0.0112,0.123,0.0391,0.1711,-0.1366,-0.1936,0.0156,-0.1323,0.0519,0.0645,-0.0065,0.0233,0.041,-0.0408,-0.1966,0.002,0.1009,0.0503,-0.0041,0.0049,-0.1046,-0.0842,-0.0562,0.0035,0.4458,0.4323,0.4219,0.215,0.127,0.2511,0.1578,0.0968,0.0026,0.1,0.101,0.1994,-0.1952,-0.234,0.1942,-0.0537,-0.0644,-0.0227,-0.1798,0.0867,0.2194,-0.0054,0.0495,-0.1385,0.1312,-0.1,-0.1187,-0.1633,-0.2034,-0.2133,-0.0552,-0.1324,-0.1801,-0.1599,0.06,0.065,0.0348,-0.1028,-0.0721,-0.0051,-0.2301,-0.058,-0.2902,0.003,-0.1438,-0.0801,-0.0147,-0.1253,-0.146,0.1062,-0.1063,-0.1127,0.1007,-0.0954,-0.0083,-0.0468,0.0671,-0.1134,-0.1283,-0.1354,-0.2208,0.1361,-0.012,0.1186,0.0229,0.003,-0.0885,-0.0784,-0.1155,-0.264,-0.2544,-0.014,-0.0181,-0.0485,-0.2606,-0.2515,0.0109,-0.0769,-0.1734,0.0308,-0.2403,-0.1848,-0.2087,-0.1436,-0.1585,-0.0857,-0.0362,-0.1857,0.0734,-0.1401,-0.0138,-0.1247,-0.097,-0.0954,-0.0881,-0.0204,-0.0442,-0.0359,-0.1348,-0.0677,-0.3016,-0.2702,-0.2873,-0.3258,-0.0801,0.0222,-0.0841,-0.0479,0.3833,-0.1959,-0.1816,-0.0172,0.0086,-0.113,-0.114,-0.1301,-0.0504,-0.2603,-0.0852,0.0527,-0.0385,0.0906,0.0103,0.1008,-0.1957,-0.0607,-0.0368,0.1545,-0.1166,-0.2015,-0.1007,0.0992,0.0382,-0.0874,0.1665,-0.0284,0.1732,0.0847,-0.1279,0.2062,-0.1309,-0.123,0.079,-0.0401,0.0268,0.059,-0.0024,0.0509,-0.1984,-0.0282,-0.0317,-0.1394,-0.1316,-0.0809,-0.2174,-0.0392,-0.2054,-0.046,0.0612,-0.045,0.0695,0.0334,-0.2175,0.0179,-0.0462,0.1817,0.2824,0.1418,0.3649,-0.1383,0.1488,0.1966,0.3767,0.1614,-0.05,0.019,0.0125,-0.0096,-0.0564,-0.0584,0.0084,0.0331,0.0958,-0.0246,-0.0994,-0.0625,0.0284,0.0568,-0.0578,-0.0599,-0.2734,-0.2081,-0.0778,0.0982,0.0845,-0.1336,-0.1266,-0.1143,-0.1312,-0.038,-0.0813,-0.0976,0.0736,-0.0419,0.078,-0.0653,0.1238,0.0683,-0.2663,-0.0777,-0.1242,-0.0628,-0.047,-0.1816,-0.0574,0.0644,-0.0352,0.0213,-0.0173,-0.1326,0.0266,0.0432,-0.062,0.1224,-0.0014,0.031,-0.2006,-0.0103,-0.0019,-0.0335,-0.0974,-0.0698,-0.1094,0.0406,-0.0059,-0.0689,-0.1204,-0.0052,-0.0974,-0.0125,0.0438,0.0049,0.1931,0.033,-0.0402,0.0478,-0.1866,-0.1704,-0.0494,-0.0121,-0.0278,0.0658,0.0338,-0.261,-0.182,-0.18,-0.0851,-0.0366,0.3024,-0.0476,0.0128,-0.0626,-0.0589,-0.0576,-0.1164,-0.1663,-0.0721,-0.0186,-0.0244,-0.004,0.0099,0.0136,0.0847,-0.1726,0.2117,0.051,-0.2115,0.0056,0.0925,-0.0349,0.1243,-0.1587,0.0273,-0.0525,0.075,0.1409,0.0737,0.1129,0.0484,-0.1618,-0.0098,0.1062,0.1253,-0.0598,-0.0518,0.0636,-0.0391,0.0087,-0.05,-0.0302,-0.0261,0.0638,0.0221,-0.0466,-0.1697,-0.0914,-0.0922,-0.1072,-0.0123,0.0204,-0.1049,0.0622,0.0593,0.0818,0.0452,-0.1299,-0.0632,-0.061,-0.197,-0.096,0.244,-0.1548,-0.1196,0.2068,-0.0965,-0.1791,-0.0695,-0.0125,-0.2634,-0.1707,-0.4499,-0.3952,-0.1455,-0.2522,-0.0372,-0.2227,-0.1132,-0.0032,0.0337,0.017,-0.0118,-0.0618,0.0376,0.0798,0.0305,-0.2927,-0.1551,0.2621,0.1396,0.0089,0.1006,-0.0883,-0.1239,0.1171,0.2284,-0.0915,-0.0976,-0.0894,0.0441,-0.1256,-0.0952,0.0278,-0.2099,0.0424,-0.0722,-0.0195,-0.0431,-0.0042,-0.0562,-0.064,0.1016,-0.1347,-0.154,0.0857,0.3226,-0.0504,-0.0623,0.0712,0.0651,0.1112,-0.0307,0.0473,-0.088,0.0471,0.0891,0.0045,-0.0491,0.2203,0.0328,0.0136,0.0748,0.0027,0.1033,-0.0022,0.0824,-0.1585,-0.0571,0.1958,0.1497,-0.12,-0.188,0.0777,0.0682,-0.0596,-0.0909,0.0377,-0.1414,-0.1167,-0.0206,-0.0006,-0.1599,-0.1352,-0.1066,0.0147,0.0465,-0.0384,0.2082,-0.19,0.0904,-0.0523,0.0189,0.0912,0.0802,-0.166,-0.1538,0.1716,-0.1014,-0.0992,-0.0766,0.1253,0.0133,0.123,0.0386,0.1504,0.1876,0.0656,0.1099,-0.0706,-0.0388,-0.0844,-0.2533,-0.1034,0.0584,-0.1589,-0.0984,-0.0618,-0.1402,-0.0728,0.0026,0.0896,-0.0621,-0.0765,0.038,-0.04,0.0061,0.0174,-0.057,0.1128,-0.0781,-0.0218,0.0437,0.0472,-0.147,0.0304,0.0909,0.022,0.0026,-0.0583,-0.0095,-0.0644,0.112,-0.0334,0.1198,0.0818,-0.0534,-0.0135,-0.0809,-0.0463,-0.0299,-0.0825,0.0446,0.1161,0.0579,0.0726,0.0615,0.1125,0.0881,0.0065,-0.1521,-0.0467,-0.0308,0.0665,0.0454,0.0588,0.0693,0.1516,-0.0637,-0.15,0.0096,0.0563,0.0972,-0.017,-0.0802,-0.301,-0.0885,0.1755,-0.0973,0.1086,0.0487,0.058,0.1656,0.1406,0.1035,-0.0134,-0.2249,-0.2115,-0.0295,-0.2307,-0.0612,0.0619,-0.055,-0.3187,-0.1193,-0.0801,-0.0196,0.0236,-0.2763,-0.0602,-0.2713,0.1012,-0.0124,-0.0122,0.1056,-0.1516,-0.1756,-0.0633,0.0164,0.0562,0.0903,-0.0576,-0.0593,-0.0555,0.0614,0.0334,-0.02,-0.1312,0.0074,-0.093,0.1236,0.0057,0.0347,-0.1349,-0.0687,-0.2501,-0.2009,0.1334,-0.2665,-0.0271,-0.1361,0.2692,-0.1355,0.0063,0.0215,0.106,-0.0994,-0.0987,-0.0955,-0.2271,0.178,0.2154,0.0278,0.148,0.1517,-0.0804,-0.1367,0.0349,-0.07,-0.0666,-0.0968,-0.0989,0.008,-0.0731,-0.0994,0.2684,-0.1421,0.0434,-0.087,0.035,0.1148,0.1189,-0.0058,0.1227,-0.1778,-0.1432,0.1014,0.0483,0.0562,0.0381,0.1451,0.1476,0.1308,-0.0421,-0.0984,0.0379,-0.0752,-0.07,-0.0753,0.0732,0.0212,-0.0986,-0.115,-0.0786,-0.088,-0.1554,-0.1503,-0.1103,0.004,0.0943,-0.0933,-0.1394,0.0063,-0.0711,-0.0701,-0.1125,0.0274,-0.1254,0.0192,0.1203,-0.0667,-0.3204,-0.32,-0.2098,-0.0696,-0.0596,-0.1419,0.0078,-0.0312,0.0891,-0.0273,-0.0147,0.0098,0.0816,0.0168,-0.1121,0.1071,0.1179,0.2049,-0.1972,0.0047,-0.1129,0.0484,0.0073,-0.1956,0.0863,0.0893,-0.0227,0.0513,0.0224,0.1747,-0.2142,-0.3302,-0.2734,-0.205,0.0702,0.2407,-0.0464,-0.0773,-0.0005,-0.0111,0.0835,0.0614,0.0298,0.0466,-0.1434,-0.091,-0.0171,0.131,0.1544,0.166,-0.0541,-0.0413,0.0211,-0.1117,0.0439,-0.13,-0.1276,-0.0636,-0.2102,-0.2083,-0.1234,0.0927,0.0633,0.0231,-0.0155,-0.0556,0.0685,0.1018,0.0129,-0.1315,0.0315,0.0152,0.0572,-0.0098,0.0791,-0.0805,0.1332,-0.2795,-0.2765,0.0783,0.1268,0.2369,-0.0325,-0.0553,0.127,0.0462,0.1523,0.3614,0.1411,0.1655,0.0755,0.14,0.1104,0.0271,0.207,0.1613,-0.1071,0.0662,0.0584,-0.2838,-0.2276,0.0044,-0.1565,-0.0011,-0.3284,-0.1134,-0.2124,-0.1631,-0.2722,0.0799,-0.0022,0.1028,-0.1211,-0.1008,-0.0192,0.0599,0.1059,0.0437,0.0947,0.1148,0.0405,0.036,0.0136,0.0067,0.1021,0.1058,-0.1258,0.1223,0.0541,0.0348,-0.1029,-0.1703,-0.0469,0.0926,-0.0593,-0.2888,-0.1707,0.013,0.0749,0.1047,0.051,-0.0354,0.1279,0.1522,-0.1479,-0.1702,0.1732,-0.183,0.0654,-0.1345,0.2498,-0.1232,0.2002,0.027,-0.0191,0.0292,-0.1736,-0.1446,-0.126,0.31,-0.122,-0.1718,-0.1099,0.1011,0.0218,-0.2236,-0.0963,-0.2283,0.0202,-0.0327,0.1768,0.1396,0.0495,0.0732,-0.2591,-0.0891,-0.066,0.0252,-0.163,-0.0072,0.0459,-0.0021,0.1036,0.2583,0.1271,-0.173,-0.1329,-0.1245,-0.0499,-0.1116,-0.0952,0.0827,0.2059,0.0469,-0.0498,-0.0926,0.1599,0.1655,0.0628,-0.0252,-0.0833,-0.1173,-0.1321,-0.0991,-0.0957,0.0505,0.0555,-0.1591,-0.0676,0.114,0.0553,-0.1119,-0.0577,0.0619,-0.0284,-0.01,-0.0153,-0.1943,-0.1891,-0.2411,-0.1436,-0.2584,-0.0546,-0.0845,-0.093,-0.1748,-0.1417,-0.2043,-0.108,-0.1936,-0.0126,0.0415,-0.0215,0.09,0.0836,-0.0543,0.0905,-0.0048,0.0287,0.0941,0.0682,0.0605,-0.0253,-0.0639,0.0328,0.0593,-0.0498,0.085,0.0709,0.1166,0.0015,0.0334,-0.0404,0.0985,-0.0296,-0.0958,-0.0103,0.1607,-0.0017,0.0892,-0.2155,-0.1188,-0.0919,-0.2097,-0.1754,0.0101,0.1126,0.0531,0.1626,0.0968,0.076,-0.0385,-0.0234,0.0051,-0.0057,0.0629,-0.0026,-0.0467,-0.0616,-0.094,-0.104,0.0955,0.0699,-0.101,-0.13,-0.0959,-0.2258,-0.1063,0.1257,0.089,0.1038,-0.0007,0.0307,-0.0706,0.0484,0.0841,-0.0319,-0.0576,-0.0351,-0.0285,-0.0295,0.0094,0.0462,0.0557,-0.1619,0.0033,-0.1847,0.0415,-0.1757,0.0166,0.1611,0.3107,0.015,0.0427,-0.0209,0.0145,0.0039,-0.0754,-0.0985,-0.1374,-0.0104,-0.0107,0.0335,-0.0086,-0.0791,0.016,-0.0129,-0.0512,-0.0632,-0.0646,-0.1341,-0.1316,-0.1321,0.1758,0.0028,0.1227,-0.1736,0.2895,0.1859,-0.0524,-0.0144,-0.0425,0.0417,-0.0578,0.0955,-0.0922,-0.0959,-0.026,-0.0411,-0.1376,-0.1124,-0.015,-0.0144,0.0097,-0.0935,-0.0131,-0.0627,0.0343,0.0022,-0.016,0.0781,0.0331,-0.0921,0.0472,-0.1582,0.0347,-0.0126,-0.0875,0.4131,0.2337,0.4404,0.2977,0.3397,0.1043,0.4238,0.1996,-0.2787,0.2114,0.2029,0.1126,0.0997,0.1117,-0.0207,0.0384,0.0146,-0.0334,0.086,0.0089,0.0591,0.0574,-0.1209,0.1322,0.1535,-0.035,0.058,-0.0329,-0.1084,0.1345,0.0321,-0.1396,0.0129,-0.1486,0.0629,0.0234,0.1781,-0.0357,-0.1748,-0.1508,-0.0686,-0.0363,0.1622,0.1591,0.0075,-0.0409,-0.1092,-0.1773,-0.1111,0.2072,-0.1195,0.256,0.3466,-0.0789,0.0221,0.0421,0.1498,0.2026,0.0731,0.2225,0.0524,-0.012,0.0614,0.032,-0.0259,-0.2109,-0.0519,-0.1016,0.1591,0.0106,-0.0924,-0.0672,-0.1445,-0.072,-0.0463,-0.1528,-0.038,0.0231,0.203,-0.0905,0.0591,-0.0494,0.1571,0.0862,0.0239,-0.3057,-0.2958,-0.1139,-0.1457,-0.0706,-0.1408,-0.1148,-0.0559,-0.0468,0.1675,0.0613,0.0878,0.3597,-0.0286,0.0609,-0.1183,0.0303,-0.009,0.1929,-0.098,0.1975,0.3778,-0.0331,-0.1148,0.2697,0.2608,-0.0531,-0.1357,-0.0085,-0.2316,-0.1211,-0.2875,-0.0578,0.1428,-0.078,-0.0812,0.0877,-0.0034,-0.0513,-0.1477,-0.0178,-0.0375,-0.0846,-0.0341,0.0993,0.0019,0.2552,0.2065,0.1631,0.2258,-0.1629,-0.0648,-0.1318,-0.1648,-0.106,-0.0666,-0.049,0.2968,-0.1672,-0.1349,0.0453,0.0059,-0.0354,0.0423,0.0037,0.008,-0.0128,0.0983,-0.123,-0.1592,-0.0825,0.2981,0.0654,-0.0412,-0.0682,-0.0682,-0.184,0.1495,0.068,0.098,-0.0426,-0.0009,-0.0704,0.3759,-0.3082,-0.2888,0.0408,-0.0309,-0.2519,-0.2505,-0.2222,-0.0024,-0.0578,-0.1129,-0.0366,0.0063,0.2625,-0.0538,0.0856,-0.0524,0.0836,-0.0191,0.1143,0.0706,-0.057,-0.0708,0.0038,-0.0694,-0.0577,-0.0456,0.0165,0.1093,0.0394,0.2469,0.1407,0.1731,0.0344,0.3249,-0.1278,-0.1001,0.0025,-0.1843,-0.0098,-0.232,-0.3109,-0.0348,-0.1276,-0.2636,0.065,-0.045,-0.2057,0.0039,-0.0645,-0.0535,-0.1624,0.0033,-0.123,-0.1386,-0.074,0.0726,-0.0967,0.2371,0.1978,0.1706,0.192,-0.0053,0.0054,-0.0244,-0.1142,-0.1115,0.0025,-0.1118,0.058,-0.1591,-0.0383,0.0378,0.0374,-0.0062,-0.1901,-0.1254,-0.0296,0.0435,0.0634,-0.0296,-0.0997,0.0062,-0.0307,-0.1195,-0.1919,-0.2829,-0.1963,-0.0675,-0.1867,-0.181,0.0014,0.0058,0.1659,0.0669,0.0232,-0.1439,-0.1388,0.046,-0.1909,-0.033,0.0203,-0.0184,-0.0473,-0.2048,0.0263,0.1721,0.022,0.017,0.0174,-0.0748,0.1895,0.1048,0.0231,-0.0045,-0.2675,0.2058,-0.0051,0.0479,0.1982,0.0636,0.0364,-0.0315,0.051,0.3093,-0.1239,0.0317,-0.1374,-0.0534,-0.1805,-0.1507,-0.0721,0.0865,-0.0139,-0.0974,-0.1566,-0.0321,-0.0354,0.0138,-0.0968,-0.1623,-0.0248,0.02,-0.0761,0.0566,-0.1107,-0.0525,-0.0585,-0.1381,-0.1701,-0.1582,-0.0618,-0.0637,-0.0296,0.0391,0.1555,-0.0552,-0.0396,-0.0844,-0.0101,0.0304,-0.0262,-0.2124,0.1146,-0.057,0.058,0.0051,0.0821,0.0643,0.1087,0.1023,-0.0869,-0.0104,-0.0906,-0.0609,-0.2363,-0.0001,-0.1178,-0.0002,-0.019,-0.0544,0.0016,-0.047,-0.0669,0.2262,0.1334,-0.0325,0.2556,0.1851,-0.0205,0.0494,0.177,-0.0273,-0.047,0.0177,0.2629,-0.0152,-0.0086,-0.073,-0.0794,-0.0416,-0.1051,0.0539,0.0051,-0.0228,0.1799,0.1875,-0.1141,-0.0908,0.0025,0.0754,0.0962,0.0741,-0.2443,-0.1319,-0.0037,-0.1985,-0.1687,0.0675,0.138,0.0573,0.0545,0.1266,0.0688,-0.235,-0.0521,0.0287,-0.0894,-0.2121,-0.0166,0.0246,0.0713,-0.0085,0.1968,0.0001,0.0003,0.0228,0.0589,0.2234,0.1798,-0.0729,0.0333,0.0506,0.0028,-0.1012,0.0005,0.0895,-0.0103,0.0062,0.1884,0.0247,0.0447,-0.0973,-0.1299,0.0376,0.5535,0.5357,-0.1665,-0.1445,0.0606,-0.0894,-0.0857,-0.1015,-0.16,0.0101,-0.0677,-0.1065,-0.0156,-0.0168,0.2632,-0.0799,0.1368,0.1138,-0.0077,0.1342,0.4326,0.0234,-0.1118,0.2693,0.114,0.1026,0.0651,0.0338,-0.0929,0.074,-0.0233,-0.0219,0.0268,0.0772,0.0606,0.0914,0.0929,-0.0469,0.1077,0.056,0.1961,-0.1663,0.0142,0.1021,-0.0554,-0.0084,0.0254,0.0221,-0.1546,-0.0133,0.0969,-0.0392,0.0618,-0.0502,0.0418,0.092,0.002,-0.049,0.0869,0.0067,0.0153,0.0911,0.1106,0.079,-0.0245,0.1589,0.0441,0.0233,0.4317,-0.1731,-0.1363,0.0098,-0.1496,0.0962,0.1089,0.1721,-0.0648,0.0122,0.0137,-0.1002,-0.0059,-0.0723,-0.1451,0.063,0.0661,0.0907,0.0507,0.1656,0.1976,0.2136,-0.0779,-0.1207,-0.1133,-0.045,0.0309,0.028,-0.0431,0.0804,0.1052,-0.0346,0.0206,0.0976,-0.3049,-0.1609,-0.023,0.1183,-0.0873,0.0285,0.0079,0.062,0.039,0.0662,-0.0156,-0.1459,0.0341,0.0232,0.0197,-0.076,-0.1068,-0.1101,0.0382,-0.0022,0.0162,0.1877,-0.1487,-0.1627,-0.045,0.2531,0.117,0.1682,-0.0786,0.0828,0.1112,0.0261,0.196,0.2912,0.2418,-0.0484,0.0151,-0.0029,0.0446,-0.187,0.0314,-0.2971,-0.1256,-0.1381,-0.1529,-0.0403,0.0797,-0.1148,0.0506,-0.0629,0.0417,0.0344,0.1142,-0.0264,-0.0407,-0.0562,-0.053,-0.0374,0.0477,0.202,0.1134,0.1381,-0.2551,-0.1782,-0.2213,-0.1186,0.0164,-0.1475,-0.1064,-0.0598,-0.1386,-0.0671,0.16,0.0239,0.1448,0.0768,0.069,0.1159,0.0486,0.0058,0.0515,0.0157,-0.1473,-0.0272,-0.1966,-0.1063,-0.0876,-0.027,0.0518,0.2825,0.1648,0.0679,0.1064,-0.0532,-0.3767,-0.1614,-0.2479,-0.1882,-0.0119,-0.0511,0.0146,-0.181,-0.2299,-0.2156,-0.1081,0.0333,0.0861,0.0178,-0.0856,-0.0399,-0.0618,-0.2276,-0.0505,-0.0554,0.0481,-0.0021,-0.0457,-0.3426,-0.1156,-0.1734,-0.1835,-0.3396,0.1462,-0.1575,-0.0881,-0.1035,-0.1166,-0.06,-0.0467,-0.159,-0.0041,-0.2279,-0.0336,-0.0008,0.1586,0.0064,-0.035,-0.1655,-0.0422,0.0037,0.1787,-0.1351,-0.0875,0.0221,0.1342,-0.127,-0.1306,-0.0422,-0.0797,-0.1385,-0.2146,-0.2131,-0.1446,-0.1496,-0.0622,-0.0565,-0.0214,-0.3331,-0.0277,-0.0208,-0.1443,-0.1036,-0.1789,-0.0319,-0.1315,-0.0041,0.0443,0.1406,-0.0248,-0.0304,-0.2082,-0.2022,-0.1918,-0.0556,-0.1506,-0.0626,0.0384,0.3065,0.2822,-0.0666,-0.1272,0.0136,0.138,0.1935,0.2432,-0.2992,-0.3175,-0.0668,0.1012,-0.0522,-0.0664,0.041,-0.076,0.0815,-0.0732,-0.0998,-0.1311,0.0242,-0.1196,-0.2255,-0.1068,-0.1702,0.0145,-0.031,0.0274,0.2553,0.195,-0.1399,-0.2549,-0.1232,-0.1733,-0.0863,-0.2602,-0.1447,0.5052,-0.1572,-0.137,0.1746,0.0878,0.0339,0.1758,0.0656,0.0724,0.1529,0.0184,0.0863,0.0273,0.0327,0.0831,0.1364,0.3273,0.4609,-0.2565,-0.0146,0.0562,0.4117,0.0067,-0.1662,0.0394,-0.0445,-0.0155,0.0363,0.2397,-0.0011,0.0286,-0.0593,-0.0846,-0.1098,0.0432,-0.0806,-0.0505,0.1309,0.1795,0.0194,0.0668,0.0226,0.1194,0.1708,0.0545,-0.0046,-0.016,0.0253,-0.3811,-0.1389,-0.1908,-0.1603,-0.0536,-0.1815,-0.2277,-0.1441,-0.0615,-0.1569,-0.1654,-0.0945,0.1029,-0.1137,-0.3094,0.1411,-0.1008,0.0069,0.0266,-0.1229,0.0754,-0.1746,-0.1338,-0.0808,-0.0969,-0.0901,0.0443,-0.1333,0.27,0.0497,0.1643,0.0365,-0.1388,0.0059,-0.0412,-0.1141,-0.0541,-0.0616,-0.111,0.0186,0.0038,-0.094,-0.1054,-0.0791,-0.0066,0.0297,-0.0464,-0.0604,-0.1599,-0.1065,-0.0676,-0.0927,0.0937,-0.1329,-0.0761,0.0165,0.0049,-0.0953,0.0113,0.0092,-0.1501,-0.0314,-0.173,-0.1925,0.1363,0.2216,0.2353,-0.0933,0.525,0.2696,-0.1863,-0.1582,0.4367,0.4668,0.0363,0.3097,0.2495,0.3089,-0.139,-0.1308,-0.1466,-0.1172,0.4374,0.3518,0.2522,0.0157,0.1551,0.1823,0.4244,0.4299,0.4023,-0.0046,-0.0271,-0.0474,0.0705,0.0242,-0.0284,-0.2309,-0.1169,-0.0637,-0.1354,-0.1713,-0.1317,0.0533,-0.0097,0.0441,-0.0103,0.0555,0.1679,0.2038,0.021,0.0391,-0.0353,-0.0632,-0.0478,0.0191,-0.0501,-0.1298,-0.0809,-0.0183,-0.2108,-0.2978,-0.2759,0.0587,0.0529,0.0821,0.2288,0.0919,0.2631,0.0945,0.0681,0.1948,-0.0766,-0.2202,-0.2731,0.026,0.1169,-0.0669,0.115,0.1389,0.1547,0.1389,-0.19,-0.1776,-0.0879,-0.0746,0.1062,-0.1977,-0.1014,-0.0028,-0.084,0.0382,-0.0682,-0.0607,0.0558,0.0366,-0.1696,-0.0618,-0.1791,-0.184,-0.2248,0.024,-0.0865,-0.0456,-0.0044,-0.0339,0.0827,0.4431,0.3733,0.1197,0.2832,-0.0047,0.1338,0.1015,0.2796,0.2435,0.2659,0.0588,0.0874,0.0617,0.2631,0.223,-0.005,-0.0119,0.0172,0.0391,-0.0644,0.0375,0.013,0.0102,0.0153,0.0932,-0.0013,0.0309,0.2514,0.0616,0.1759,0.1919,-0.177,-0.1864,-0.1699,-0.1376,-0.2238,0.1485,-0.0416,-0.0837,-0.0171,0.1419,-0.0029,-0.3032,-0.0313,0.0278,-0.0753,0.0265,0.0601,0.1709,0.1741,0.2973,0.4038,0.1999,0.1085,0.0143,-0.052,0.1691,-0.1175,-0.1667,-0.0637,0.0083,-0.0372,0.018,-0.0029,-0.1056,-0.016,-0.1803,-0.2386,-0.2311,-0.0549,0.0187,-0.1897,-0.0827,-0.1289,-0.0099,-0.0712,-0.0412,0.0308,-0.0472,0.1326,0.0397,0.0952,-0.177,0.0613,-0.0237,-0.0239,0.0932,-0.2411,-0.1381,0.2658,0.009,0.0071,0.0145,0.0255,0.0106,0.0374,-0.0418,-0.0205,-0.0203,-0.0069,0.0234,-0.2048,0.0925,0.0515,0.1897,-0.0189,-0.2169,-0.1407,-0.0011,-0.1263,-0.0874,-0.0707,-0.1365,-0.0272,0.1377,0.0638,0.1845,-0.3659,-0.1353,-0.1534,-0.2992,-0.2328,-0.1747,-0.1886,-0.1886,-0.0344,0.0149,0.0777,-0.2275,-0.0629,-0.02,-0.0493,0.0771,-0.0529,-0.4149,0.2096,-0.1296,-0.0123,0.0347,0.3591,0.2163,0.0451,-0.2247,-0.1172,-0.0089,0.0182,-0.0221,0.2697,0.0421,0.1114,0.2012,0.156,-0.0079,0.0185,0.1316,0.0406,-0.031,-0.0728,-0.0833,-0.0518,-0.1295,-0.0477,0.0055,-0.064,0.1167,-0.0853,-0.0617,0.0658,0.0768,-0.112,0.1099,0.0686,-0.2101,-0.0504,-0.254,-0.0562,-0.041,0.0851,-0.1129,0.3366,0.3024,0.1715,0.202,0.2183,0.0325,0.0776,0.0196,0.323,0.1349,0.0311,0.1103,-0.1332,0.1169,0.0534,0.1278,-0.0106,-0.02,0.0048,-0.0554,0.035,-0.0067,-0.0956,0.024,-0.0347,0.0377,-0.0282,0.0198,0.1855,0.1058,0.0275,0.0346,-0.0683,0.054,-0.0553,-0.1246,-0.1333,-0.0712,0.0871,0.0706,-0.0621,-0.0407,-0.092,-0.0181,0.1353,0.1079,0.0357,0.0166,0.0009,-0.0407,0.1132,-0.0679,0.0348,0.0062,0.0303,-0.0681,-0.1281,-0.1196,-0.0934,-0.0088,0.032,-0.0974,0.0933,0.0305,0.1228,-0.0054,0.0651,0.1559,0.037,-0.0478,-0.117,-0.1213,-0.0584,0.0502,0.0319,-0.0003,-0.0788,-0.0216,0.0868,0.13,-0.2193,-0.1908,-0.1631,-0.1901,-0.0145,-0.023,0.0135,-0.1795,-0.1423,-0.186,-0.072,-0.1555,0.0203,-0.0284,-0.0948,0.1899,-0.1164,-0.1116,-0.1132,0.0143,-0.0841,-0.0507,0.1434,0.0648,-0.197,0.0779,-0.0447,-0.0495,0.0383,0.0602,0.0304,0.0537,-0.1054,-0.1668,-0.0862,-0.2144,-0.2177,-0.0689,-0.1367,0.0834,0.1386,0.0828,0.0701,0.117,-0.1442,-0.1819,0.0278,0.1075,0.187,0.1007,0.0108,-0.0041,0.0112,-0.0932,0.0336,-0.1893,-0.1158,-0.0624,-0.0775,-0.1313,-0.2075,0.092,-0.0638,-0.0072,0.1886,-0.0037,0.0665,-0.1927,-0.066,-0.0118,0.0079,-0.0539,0.059,0.2009,0.0892,0.0089,-0.0767,-0.106,-0.1317,-0.098,-0.0341,-0.2414,-0.0184,-0.0218,-0.0268,-0.0298,-0.0017,0.0686,0.0206,-0.1186,0.1498,-0.2697,-0.1347,-0.1653,-0.1952,0.0225,-0.2049,-0.1592,-0.2846,-0.124,-0.0463,0.1324,-0.1818,-0.1478,-0.1011,0.0885,0.0414,0.0578,-0.1815,-0.1925,-0.1199,-0.0555,0.0364,0.1208,-0.0835,-0.0201,-0.0436,0.0848,0.043,0.0514,0.1491,-0.0433,-0.0598,0.0558,0.0078,-0.0492,-0.0563,-0.083,-0.0821,0.0134,-0.0032,0.0635,0.0531,0.1213,0.1946,0.0417,-0.0197,-0.0582,-0.2362,-0.1114,-0.0508,0.2789,0.3173,0.0553,0.0182,-0.0137,0.0404,0.2223,0.1991,0.1416,0.0935,-0.1691,-0.0139,-0.0904,0.0449,-0.1259,0.05,0.0403,0.0781,0.0532,0.0686,0.0632,-0.0479,0.0662,0.0049,-0.1512,0.1933,0.0637,0.0224,-0.0581,0.1185,0.1078,-0.0002,0.0787,-0.0111,-0.0198,0.1363,0.181,0.1694,-0.0959,0.0213,0.1182,-0.0313,-0.1901,-0.3901,-0.38,0.1056,0.0971,0.1275,-0.0855,0.0128,-0.1078,-0.154,-0.1496,-0.1808,0.0395,-0.1126,-0.01,-0.0784,0.0634,0.0098,-0.2789,-0.1066,-0.1865,-0.235,0.0041,-0.1225,0.0032,-0.3163,-0.1293,-0.0306,-0.0193,-0.0103,0.0595,0.0064,-0.0318,-0.1559,0.3109,-0.1223,0.1315,0.0612,0.0625,0.0348,0.0808,0.0176,0.291,0.2684,-0.1802,-0.1072,-0.0878,-0.0244,-0.1874,-0.124,-0.108,-0.2503,-0.1487,0.0051,-0.1335,0.0704,-0.0073,-0.0326,-0.0978,-0.2082,0.0912,0.067,-0.2285,-0.1111,-0.0536,-0.1444,-0.2975,0.1721,0.1839,-0.1284,0.04,0.0967,0.1346,-0.0659,-0.0434,-0.1778,-0.2644,-0.0954,-0.1589,0.0154,0.0996,0.0977,0.0689,-0.0342,0.1449,0.3689,0.2404,0.1891,0.3084,-0.2859,-0.2359,-0.2206,-0.0578,-0.0208,-0.0568,-0.2034,0.002,0.0711,-0.1052,-0.1041,-0.0163,0.2108,-0.1536,0.0822,0.0128,0.1362,0.1304,0.146,0.0241,-0.0455,-0.0356,-0.0254,0.0614,0.1011,0.1537,0.0695,-0.0379,0.0788,0.1487,0.147,0.0936,-0.0299,-0.1717,-0.0035,-0.0358,0.0328,-0.0529,-0.0235,0.0944,0.0234,0.0501,0.02,-0.0761,-0.0545,-0.226,-0.1612,-0.0972,-0.1094,0.3567,-0.0042,0.2757,0.1277,0.1191,-0.0433,-0.0606,0.1601,0.112,0.1872,0.3136,0.1833,0.1705,0.0587,0.1057,-0.0743,-0.0696,0.0117,0.025,0.1945,0.1855,-0.1091,-0.051,0.0262,0.0081,-0.0394,0.0684,-0.0399,-0.1499,0.0189,-0.0495,0.0369,-0.1141,0.0877,0.1141,0.1753,0.0613,0.0324,0.073,-0.0344,-0.0548,0.1776,0.1861,0.0367,0.0325,-0.0103,0.1664,0.0226,-0.0095,0.0294,0.1179,0.131,0.0471,-0.0989,-0.0986,-0.1726,-0.0694,0.0116,0.1452,-0.1039,-0.0772,-0.1309,-0.1297,-0.1205,-0.0488,-0.0906,-0.0525,-0.0197,-0.0352,-0.0967,0.0782,0.0106,-0.0136,-0.0185,-0.0839,0.0183,-0.0708,-0.1037,0.0057,0.2525,0.0495,-0.0566,0.3969,0.3898,0.209,-0.0003,0.1559,-0.0535,-0.0615,0.0204,-0.0649,0.04,0.1944,0.2474,-0.0163,0.0053,0.0511,0.0774,-0.1113,-0.1048,-0.0645,-0.0689,-0.0881,-0.0844,-0.0369,-0.0865,0.0185,-0.1593,-0.1341,0.2913,-0.0084,-0.2433,-0.0268,0.064,0.1411,-0.0776,-0.0806,-0.401,-0.3374,-0.147,-0.1918,0.2949,-0.1257,-0.0793,0.1088,-0.0262,0.061,-0.0016,0.0481,0.2027,0.1584,0.2847,0.2526,0.1316,-0.0445,-0.0067,0.0756,0.0136,0.0073,0.0184,-0.0203,0.2952,0.1971,-0.1697,-0.3024,-0.1832,-0.1599,-0.2418,-0.0127,0.0052,0.0946,0.0518,0.1395,0.0241,0.0003,-0.2447,-0.0773,-0.1752,0.0388,-0.1681,-0.2585,0.0129,0.1057,-0.0615,-0.0976,-0.0475,-0.1046,-0.1039,-0.248,-0.0398,-0.1795,-0.0177,-0.1166,-0.0816,-0.0378,-0.061,0.0244,0.035,0.047,-0.1267,-0.1621,-0.1417,0.0425,0.1644,0.0424,-0.054,0.1949,-0.0848,-0.1254,0.0675,0.0984,0.0261,-0.0223,-0.0255,0.0297,-0.0036,-0.0408,0.2261,0.5044,0.4251,0.1504,0.1254,-0.0379,0.2313,-0.0086,0.2285,0.0184,0.4525,0.0172,0.1476,0.1158,0.0839,0.0385,0.0122,0.0089,0.0607,0.1539,0.1808,0.1581,0.1054,0.0212,-0.1657,0.0355,0.1591,0.0884,-0.2229,-0.1669,-0.239,0.0058,-0.1711,-0.0263,-0.0276,0.0684,0.0376,-0.0331,-0.1688,-0.17,0.2047,-0.0036,-0.1357,0.0693,0.2921,0.0806,-0.0726,0.1889,0.2499,0.14,0.0753,0.1797,-0.1151,0.0505,0.2339,0.1173,-0.0893,0.2444,0.089,0.0895,0.0722,0.2986,0.0592,-0.2114,-0.1308,-0.0616,-0.0444,0.0983,-0.0481,0.0537,-0.0131,-0.0556,-0.0217,-0.2406,-0.1138,0.1288,-0.0419,-0.1825,0.1098,0.0071,-0.0333,0.0546,-0.0279,0.0068,0.0179,-0.1165,-0.1057,-0.2896,-0.2251,0.0913,0.1946,-0.0444,-0.097,-0.0446,-0.0212,-0.0354,-0.1239,-0.1712,-0.2168,0.0055,0.0703,-0.1059,-0.1094,-0.1211,0.0209,-0.1383,-0.1868,-0.0344,-0.0965,-0.1113,-0.1637,-0.1115,-0.0262,-0.1476,-0.0931,-0.0237,0.0036,0.1276,-0.1204,-0.0069,0.1232,0.0627,-0.1933,0.0984,-0.0655,-0.1977,-0.0878,-0.044,-0.0792,0.0453,0.1668,0.2381,-0.0519,-0.1418,0.1938,0.0439,0.002,0.226,-0.2413,-0.0898,-0.2301,0.0635,0.0579,0.1515,0.0656,-0.2728,-0.2559,0.0805,0.1133,-0.0081,0.1828,0.1071,-0.0185,-0.1582,-0.1549,-0.1016,-0.1383,-0.3195,-0.1338,-0.1182,0.0693,0.0012,0.1205,0.0175,0.2251,-0.0507,0.0457,-0.0312,0.1158,0.1578,0.0191,-0.0282,-0.0453,-0.0585,0.0521,-0.0706,0.0328,-0.1108,-0.101,-0.1122,0.0203,-0.1178,-0.0523,-0.0631,-0.0203,-0.0861,-0.0929,0.0417,0.1678,-0.0037,0.0959,-0.0625,-0.016,-0.0349,-0.0385,0.0125,-0.094,-0.1975,-0.0796,0.1828,0.0748,0.0682,-0.0096,-0.0464,-0.1284,-0.1181,-0.0029,-0.0839,0.135,0.1526,-0.2304,-0.184,0.0326,-0.1854,-0.0622,-0.098,0.3268,0.411,-0.2487,0.1504,-0.1217,0.008,0.0101,-0.2457,-0.2909,-0.1663,0.035,-0.1007,-0.1164,-0.0019,-0.155,-0.1107,0.1506,0.0023,0.0166,0.0584,-0.0168,0.0103,-0.1668,-0.0346,0.0793,-0.1689,0.09,-0.2146,0.3518,-0.2586,0.2659,0.0719,0.0406,-0.2926,-0.2732,0.0239,0.025,-0.0466,0.0706,0.0469,0.025,0.014,0.0298,0.066,0.2975,0.291,0.2705,0.0997,0.1945,0.2885,-0.0434,0.118,0.3942,0.5506,0.2726,0.189,0.3181,0.2163,0.1328,0.2767,0.213,0.4111,0.253,0.2331,0.313,0.1903,0.2046,0.2396,0.425,0.2253,0.3737,0.2505,0.339,-0.2219,-0.088,-0.2419,-0.1035,-0.0611,-0.3177,-0.2681,-0.1661,0.0814,-0.0078,-0.3281,-0.2415,-0.1806,-0.0056,0.0082,-0.2294,0.278,-0.021,-0.1011,-0.055,-0.1228,-0.0758,-0.0697,-0.1468,-0.2082,0.134,-0.2954,-0.3138,0.0146,-0.004,-0.0674,0.0073,0.0083,-0.1612,0.0781,0.1329,-0.1702,0.0938,0.2219,-0.0409,0.0918,0.0073,-0.123,0.2047,0.2047,-0.038,-0.0805,0.1245,-0.0736,-0.0027,-0.1811,-0.03,0.1676,-0.1821,-0.1589,-0.0424,-0.0324,-0.0514,0.0139,subjective food value
trm_4a3fd79d0a30c,-0.0699,0.0135,-0.0342,-0.0274,-0.0147,0.0132,-0.0627,-0.0409,-0.0461,-0.0516,0.0128,-0.0229,-0.0319,-0.0264,-0.0252,0.0346,0.0002,-0.0375,-0.0328,0.0381,-0.0079,-0.0068,0.0026,-0.0049,0.0251,0.0139,0.0074,-0.0484,-0.0549,-0.0316,-0.0463,-0.0325,-0.0457,-0.0489,-0.0622,-0.0016,-0.0022,-0.0482,-0.0329,0.0124,-0.0176,0.02,-0.0052,0.0566,-0.0167,-0.0066,0.0936,-0.0893,-0.0029,-0.082,-0.0302,-0.0461,-0.0073,-0.0258,-0.0032,-0.0555,-0.0583,-0.0261,-0.0063,-0.0095,0.04,0.0352,-0.0213,-0.0057,0.0013,-0.0116,-0.0271,-0.0932,-0.0755,-0.0217,-0.0047,0.0293,0.0241,-0.0342,-0.0689,0.0378,-0.0378,0.0227,0.0537,0.0262,-0.0044,-0.0111,-0.0252,-0.0439,-0.0039,0.0125,-0.0285,0.0194,-0.0176,-0.0706,0.0171,-0.0542,0.0458,0.1216,0.0996,0.1207,0.0307,-0.0172,0.0095,0.0264,0.0878,0.0189,0.006,0.026,0.028,-0.0424,-0.0217,0.0005,-0.0002,0.0204,-0.0022,-0.0405,0.0449,0.0375,0.0302,0.0605,-0.0453,0.0475,-0.0664,-0.0636,0.0046,-0.0224,-0.0277,-0.0354,-0.0477,-0.0167,-0.0154,0.0243,0.0055,-0.0387,-0.0274,-0.0594,-0.0293,-0.0972,0.0246,-0.0491,-0.0456,-0.036,0.0538,-0.0364,-0.0329,-0.0729,0.0205,0.0001,0.0217,0.0675,-0.0996,-0.0006,-0.003,0.0055,-0.0271,0.0445,-0.0292,-0.0609,0.0256,0.0149,0.055,0.064,0.044,0.0087,0.0053,-0.0073,-0.0547,-0.0699,0.006,0.0546,0.0014,-0.035,-0.0302,-0.0017,0.0607,0.0285,0.0516,-0.1097,-0.0983,-0.028,-0.0665,-0.074,-0.0718,0.0096,-0.0434,0.0189,0.0131,-0.032,-0.0227,-0.0488,-0.0163,-0.0324,-0.0455,0.0228,0.0258,-0.0407,0.0162,-0.0937,-0.0969,-0.0791,-0.092,0.0081,0.0501,-0.0806,-0.1029,0.1433,-0.042,0.0185,0.0189,-0.0483,-0.0597,-0.0201,-0.0236,-0.0235,-0.0721,-0.06,-0.0105,-0.0448,0.0112,-0.0035,0.0387,0.0001,-0.0282,0.0567,0.0338,-0.0545,0.015,-0.0064,0.065,0.013,0.0502,0.0391,-0.0206,0.0384,0.1264,-0.0339,0.053,0.0167,0.0161,-0.0157,-0.0303,-0.0509,-0.0065,-0.0321,0.0247,-0.07,0.0187,0.0117,-0.0381,-0.0167,-0.0185,-0.0139,-0.0149,-0.0404,-0.0144,-0.0021,-0.0046,0.0152,-0.0013,-0.0468,0.0181,-0.0377,0.0238,0.0866,0.0235,0.0812,-0.0431,0.0549,0.0554,0.0594,0.0192,-0.0454,0.0764,0.0327,0.0339,-0.032,-0.0435,-0.026,-0.0416,0.0137,-0.0541,-0.0666,-0.0503,0.0259,-0.0138,-0.0216,-0.0235,-0.0528,-0.0266,0.0073,0.0422,0.0126,-0.0507,-0.0381,-0.0238,-0.0636,-0.013,0.0196,-0.0179,0.0274,-0.0436,0.0329,0.019,0.0199,-0.031,-0.0824,0.0186,0.0394,-0.0497,-0.038,-0.048,-0.0306,-0.0334,-0.0415,-0.0319,-0.0183,0.0066,-0.0541,0.0044,-0.0184,0.0178,-0.0009,0.0054,-0.0443,-0.0194,-0.0314,-0.0117,-0.0176,-0.0106,-0.0093,0.0347,0.0067,-0.0649,0.0657,0.0132,-0.0804,-0.0678,-0.0032,-0.0148,0.0109,0.0243,-0.0163,0.0161,-0.0887,-0.0808,0.0283,-0.0033,-0.0729,0.0395,-0.024,-0.0905,-0.0265,-0.0705,-0.039,0.0035,0.0664,-0.0243,-0.0176,-0.0274,0.0138,-0.0116,-0.0556,-0.0908,-0.0511,-0.0061,-0.0091,-0.0851,-0.0056,-0.0124,0.0155,-0.0273,0.0441,0.1021,-0.0727,0.0594,0.0225,0.0653,0.0078,-0.0423,0.0158,0.0386,0.0261,0.0387,0.0553,0.058,0.0354,-0.0278,0.024,0.0285,0.0098,-0.0075,-0.0356,-0.0208,-0.0226,-0.0629,0.0691,0.0823,0.0457,-0.0611,-0.063,-0.0163,-0.0262,-0.0286,0.0044,-0.0568,0.0178,-0.0294,-0.0125,0.027,-0.0139,0.0175,-0.0096,-0.039,0.0261,0.0239,-0.0071,0.0005,0.1003,-0.0126,-0.0295,0.0522,-0.0067,-0.0331,-0.0486,-0.0284,-0.0838,-0.049,-0.0738,-0.081,-0.0398,-0.0612,-0.0299,-0.0633,-0.0198,0.0277,0.0326,-0.028,-0.0396,-0.0088,-0.0088,0.0697,0.0198,-0.0684,-0.0946,0.0979,0.0181,0.0568,0.0333,-0.0051,-0.0247,0.023,0.0395,-0.0337,-0.073,-0.0264,0.0183,0.0002,-0.0406,-0.0407,-0.065,0.0266,-0.0273,-0.0168,-0.0487,-0.0062,0.0039,-0.0165,0.1146,-0.0109,0.0163,0.0802,0.0982,0.009,-0.0126,0.0057,-0.0274,-0.0069,-0.0326,-0.0197,0.0181,0.0296,0.031,-0.0248,-0.0288,0.0958,-0.017,0.0633,-0.0106,0.0163,0.0385,-0.0086,0.0322,0.0058,-0.0313,0.0644,0.0009,0.0938,0.054,0.0954,0.0243,-0.0321,-0.0178,0.0631,-0.0513,-0.0472,0.0434,-0.0338,0.0123,-0.0755,-0.0112,0.0269,0.0273,0.0018,0.062,-0.0746,0.0119,-0.004,-0.0037,0.0178,0.0084,-0.1163,-0.1092,0.0358,-0.0653,-0.0734,-0.0049,0.0355,0.0169,-0.002,0.0155,0.0174,-0.0069,-0.0433,0.0203,-0.0474,-0.0137,0.0138,-0.0093,-0.049,0.0269,0.0092,0.0568,0.0462,-0.0362,-0.0055,0.0115,-0.0126,-0.0311,-0.0598,0.0115,0.0014,-0.0275,-0.007,0.0283,-0.0229,-0.0252,0.0316,-0.0372,0.0003,0.0109,-0.0234,-0.0234,0.0092,-0.0265,0.0212,0.0516,0.0061,0.0286,0.0016,0.0496,0.0555,0.0022,-0.0216,-0.0391,-0.0037,0.0033,-0.0236,-0.0158,0.0694,0.0383,-0.0171,0.0314,0.037,0.0107,-0.0495,-0.0119,0.0032,-0.0099,0.0056,0.0534,-0.0475,0.0158,-0.0,-0.0091,-0.0267,0.0169,0.0012,-0.0163,-0.0028,-0.0134,-0.0727,-0.0398,0.0745,0.0262,0.0816,-0.0134,-0.0104,-0.0044,0.0708,0.024,-0.0285,-0.0754,-0.0727,0.013,-0.0578,-0.0448,0.0028,-0.0491,-0.0716,-0.004,-0.0032,-0.0272,0.0164,0.0016,-0.0389,-0.0128,0.0834,0.0314,0.0279,0.0426,-0.0708,-0.0754,-0.0296,0.039,0.0507,-0.0229,0.0118,-0.0688,-0.0332,0.0262,0.0074,0.0487,-0.0751,-0.0516,-0.0348,0.0397,0.0139,0.0782,0.0186,-0.029,-0.0939,-0.0803,0.0097,0.0028,-0.0517,0.0179,0.1022,0.0601,-0.0225,-0.0326,0.0519,-0.0273,-0.0145,-0.0156,-0.0394,0.054,0.0348,0.0173,-0.009,0.0595,-0.0473,0.0241,0.0292,-0.0638,0.0026,-0.0131,0.0126,0.1145,0.0218,-0.0373,0.0336,0.0071,0.0535,-0.0305,0.0283,0.0252,0.0626,0.0427,0.0532,-0.0327,-0.0554,0.015,0.011,0.0242,-0.0794,0.0945,0.0512,0.0605,0.1282,0.0296,0.0319,-0.0425,-0.0668,-0.0737,0.0138,0.0176,-0.0201,0.0041,-0.0601,-0.0578,0.0082,0.0576,0.0693,-0.0087,0.0346,-0.01,-0.0177,0.0263,-0.0055,-0.0158,0.0164,0.01,-0.0032,0.0106,0.0185,-0.0556,0.0226,0.0331,-0.0045,0.01,-0.0108,-0.0519,-0.0596,-0.0113,0.0517,-0.0114,0.0111,0.0379,0.0491,0.0151,-0.0667,-0.0249,0.0248,0.0108,-0.0601,0.0111,-0.0118,0.0155,-0.0086,-0.0429,0.0436,0.0036,-0.0009,0.0279,-0.0279,0.0128,-0.0988,-0.0797,-0.0623,-0.051,0.0768,0.1068,0.0379,0.0004,0.0315,-0.039,0.0048,0.078,-0.005,0.0765,-0.0306,-0.0329,0.0263,-0.0256,0.0594,0.0809,-0.0222,-0.0517,-0.0063,-0.0266,0.0583,-0.02,0.0213,0.0213,-0.0664,-0.0618,-0.0301,0.0323,0.0813,0.0255,0.0096,-0.0612,0.005,0.0476,0.0272,-0.0439,0.0505,0.013,0.0446,0.0018,0.0441,-0.0099,0.0091,-0.0941,-0.0976,0.0287,0.0774,0.1206,0.0117,-0.0466,0.0371,0.0,0.0906,0.0392,0.0245,0.0432,0.0495,0.008,0.0355,0.0461,0.0253,-0.0027,0.0219,0.008,-0.003,-0.0255,-0.0162,0.0395,-0.0115,-0.0228,-0.1139,-0.0542,-0.0354,-0.0398,-0.0903,0.0286,0.0026,0.0342,-0.007,-0.0098,-0.0198,-0.034,0.0133,0.0561,0.0329,0.0768,0.0229,0.0866,0.0172,0.0377,0.0472,0.0089,0.0006,0.0769,0.0453,0.0156,-0.0438,-0.056,-0.0201,-0.0337,-0.0431,0.0057,-0.0864,-0.0226,0.0495,0.0174,0.0269,-0.0261,0.0155,0.0346,-0.0273,-0.0305,0.0848,-0.0842,0.0312,-0.0351,0.1085,-0.0306,0.05,-0.0558,-0.0146,-0.0468,-0.089,-0.0789,-0.0227,0.1376,-0.0314,-0.0658,0.0183,0.0146,0.0226,-0.0762,0.0064,-0.0666,0.0425,-0.0442,0.0328,0.0211,-0.0186,0.0964,-0.0632,-0.0262,-0.009,-0.0341,-0.087,-0.0179,0.1089,0.0153,0.0292,0.1595,0.0403,-0.0535,-0.0691,-0.0117,0.0119,-0.0054,-0.061,0.0479,0.0796,-0.0349,-0.01,-0.0256,0.0496,0.0488,-0.0305,0.0041,-0.0473,0.037,-0.0055,-0.0152,0.0004,0.0469,0.043,-0.0529,-0.0324,0.0426,0.0276,0.0149,-0.0274,0.0424,0.0358,-0.0103,-0.0268,-0.0337,-0.0313,-0.1049,-0.0861,-0.1188,-0.0401,-0.0374,-0.0157,-0.0735,-0.0498,-0.0911,-0.0623,-0.0828,-0.0188,-0.0454,0.0036,0.0153,0.0449,-0.0069,0.0305,0.0396,0.0665,0.0331,0.0504,0.0281,0.0477,-0.0355,-0.0008,-0.0393,-0.0122,0.0556,-0.0098,0.0598,-0.0066,0.0132,-0.0073,0.0369,0.02,0.0089,-0.0058,0.0691,-0.0177,0.0525,-0.0882,-0.0265,-0.022,0.0278,0.0236,-0.0446,0.0081,-0.0117,0.0297,0.0846,0.0615,-0.0081,-0.0141,-0.0134,-0.0083,-0.0052,0.037,-0.036,-0.0163,0.0193,-0.0295,0.0046,0.0071,-0.0192,-0.0187,-0.0312,-0.0853,-0.04,0.0611,0.0327,0.0261,0.0367,0.0196,-0.0006,0.0376,0.0393,-0.0162,-0.032,-0.0211,0.0003,-0.0294,-0.0176,0.0008,0.0249,0.0041,0.0083,-0.0073,0.0163,-0.0165,-0.0128,0.0605,0.0811,0.0062,0.0111,-0.0281,-0.0023,-0.0121,-0.0865,-0.0276,-0.044,0.0193,-0.0284,0.0108,0.014,-0.0059,-0.0288,-0.0279,-0.0206,-0.0144,0.0208,-0.0496,-0.0135,-0.0395,0.0353,0.0342,0.0624,-0.0387,0.0824,0.0303,-0.0405,0.0222,0.0099,0.0158,-0.0175,0.0066,-0.0363,-0.0106,0.0161,-0.0465,-0.0394,0.0329,-0.064,-0.0251,-0.0626,-0.0516,-0.0152,0.0066,0.0115,0.0625,0.0691,0.0329,0.0222,0.0068,0.0078,-0.0677,0.0371,-0.0013,-0.0167,0.1715,0.1204,0.089,0.0497,0.0575,0.046,0.0761,0.0635,-0.1031,-0.0125,0.0344,-0.0031,-0.0148,-0.0205,-0.0696,-0.0143,-0.0515,0.0221,0.0061,-0.0245,-0.0327,0.0564,-0.0376,0.0091,0.0259,0.0079,0.0295,0.0087,-0.029,0.0308,0.0268,-0.0335,0.0108,-0.0878,-0.0412,0.0126,0.0305,0.0014,0.011,-0.0794,-0.0563,-0.0152,0.0364,0.0502,-0.0129,-0.0032,-0.0332,-0.0575,-0.079,0.0234,-0.1098,0.0806,0.0782,-0.0181,0.0244,0.0304,0.0264,0.0255,-0.0088,0.1205,0.0029,-0.0102,0.035,0.0007,0.0526,0.0339,-0.0243,-0.0476,0.0593,0.0387,-0.0447,-0.0266,-0.034,0.0058,-0.0263,-0.042,0.0185,0.023,0.1262,-0.0249,0.0424,-0.0008,0.0288,0.0236,-0.0203,-0.0757,-0.0934,0.022,-0.0323,-0.0002,0.0455,0.008,-0.0564,-0.0277,-0.034,-0.0162,-0.0196,0.0465,-0.0171,-0.0644,-0.0732,0.0037,-0.0509,0.0651,-0.0349,0.0563,0.1021,0.0024,-0.0553,0.1097,0.0711,-0.0064,-0.0608,-0.0107,-0.058,-0.07,-0.0135,0.022,0.0061,0.0635,0.0387,-0.035,0.0496,0.0067,-0.0622,0.0599,0.0248,-0.0304,-0.0782,-0.0324,0.0197,0.0713,0.0137,0.0755,0.0749,-0.0714,-0.0079,-0.034,-0.0501,-0.0153,0.049,-0.0373,0.0623,-0.0663,-0.0409,0.0347,0.0751,-0.0156,0.0488,0.047,0.0324,0.0107,0.0356,-0.0422,-0.0305,-0.0291,0.1184,-0.0317,0.0173,-0.0451,-0.0451,-0.0642,0.088,0.0523,0.0393,-0.0276,-0.0061,0.0475,0.1934,-0.0923,-0.0723,0.0042,-0.0525,-0.1014,-0.1021,-0.0858,-0.0414,0.0034,-0.0354,-0.0468,-0.0052,0.0922,0.0049,-0.034,-0.0213,0.0268,-0.0062,-0.0803,0.0022,-0.0477,-0.0454,-0.0444,-0.0327,0.0161,-0.0172,-0.0592,-0.0279,-0.013,0.1209,0.0697,0.0174,0.0455,0.1117,-0.1107,-0.0715,0.0089,-0.0716,0.035,-0.0475,-0.1191,-0.0107,-0.056,-0.0401,0.0107,-0.0051,-0.0668,-0.0455,-0.0519,-0.0595,-0.1089,-0.0195,-0.0607,-0.0736,0.0065,-0.0158,-0.0335,0.1131,-0.0017,0.0033,0.0113,0.0142,0.0712,-0.0359,-0.0701,-0.0691,-0.0376,-0.0263,-0.0268,-0.0271,0.0386,0.0232,-0.0148,0.0399,-0.0659,-0.0362,-0.0027,-0.0244,0.0093,-0.053,-0.0464,0.0542,0.0234,0.0354,-0.0315,-0.0456,-0.0764,-0.0006,0.0185,0.0139,0.0555,0.0553,0.0543,-0.0103,0.0413,-0.0496,-0.0509,0.0118,-0.073,0.0233,0.0007,-0.0333,0.0399,0.0668,0.007,-0.0078,0.0098,0.1163,0.0262,0.0027,-0.0111,-0.0685,-0.056,-0.0694,-0.0487,0.0901,-0.0419,0.0029,0.066,0.0149,-0.0178,-0.0447,0.0039,0.0714,-0.0208,0.0271,-0.0722,-0.0294,-0.0729,-0.0347,-0.0009,0.0072,-0.0065,-0.0201,-0.0638,-0.0145,0.0039,0.0325,-0.0505,-0.0626,-0.0035,0.0197,-0.0219,-0.0191,-0.0312,-0.0248,0.0531,-0.0064,-0.0195,-0.0151,0.0048,-0.013,-0.0146,-0.0479,-0.0116,-0.0132,0.0057,-0.0052,0.0147,0.0024,0.0815,0.099,-0.0168,-0.0218,0.0531,-0.03,0.0147,0.0447,-0.01,0.0027,-0.0257,0.0004,-0.036,-0.0287,-0.0895,-0.0019,-0.0354,0.006,0.0212,0.0171,-0.0478,-0.0023,-0.0279,-0.0072,-0.0369,-0.008,0.098,-0.0069,0.016,0.026,0.1094,0.0067,0.0257,-0.0108,0.0565,0.0097,0.0195,-0.0197,-0.0376,-0.0302,-0.0601,0.0218,0.017,-0.0491,0.0301,0.0564,0.0123,-0.0056,0.06,-0.0232,0.0739,0.0041,-0.1165,-0.0666,-0.0202,-0.1082,-0.09,0.052,0.0742,0.0026,-0.0133,0.0428,-0.0037,-0.0804,-0.0382,0.0706,-0.0176,-0.0751,0.022,0.0182,0.0147,0.0347,0.0343,-0.024,-0.052,0.0296,-0.0261,0.0536,0.0135,0.0109,0.0136,-0.0088,0.0059,-0.0044,-0.0317,0.0295,-0.0223,0.0185,0.016,0.0022,-0.0465,-0.0359,-0.0574,0.0825,0.1626,0.1567,0.0603,0.0576,-0.0142,-0.0484,0.0092,-0.009,-0.0663,0.0244,-0.0132,-0.024,-0.0242,0.0632,0.0028,-0.0108,0.024,-0.0026,0.0456,0.0299,0.1119,0.0165,-0.0264,0.0909,0.0175,-0.004,0.0393,0.0309,0.0051,0.0885,0.0577,-0.0608,0.035,0.0153,0.0233,0.0332,0.0415,0.0139,0.017,-0.0026,0.034,-0.0782,0.0108,0.0645,0.0373,0.0511,-0.0767,-0.0501,-0.0231,0.0054,-0.0091,-0.063,-0.0274,-0.0211,0.0081,0.0303,0.0549,0.0332,0.0596,0.0066,-0.0263,0.0577,-0.0262,0.0211,0.0041,0.0845,0.0117,0.0225,0.2147,-0.0776,0.0386,-0.005,-0.052,-0.0332,-0.0226,-0.0067,-0.0075,-0.0107,-0.0353,-0.0192,0.0455,-0.026,-0.0274,-0.0193,0.0221,-0.0017,0.0313,0.0556,0.0744,0.0783,-0.0748,-0.0635,-0.0454,-0.0399,0.0353,0.0188,0.0486,-0.0339,-0.0286,0.0116,-0.0199,0.0355,-0.0695,-0.0132,0.0183,0.0541,0.0433,0.0735,0.0144,0.0658,0.0519,-0.0164,-0.0051,-0.0203,-0.0289,0.0608,-0.0127,-0.0671,-0.0779,-0.099,0.0458,-0.0237,-0.0456,-0.0204,-0.0676,-0.049,0.0015,0.0287,0.03,-0.0411,0.0391,0.0532,-0.0351,-0.0103,0.0369,0.1507,0.1087,-0.0453,0.0035,0.0046,0.0271,-0.0997,-0.007,-0.0348,-0.0294,-0.0003,0.0717,0.0091,0.0206,0.0012,0.0662,-0.0005,-0.0106,-0.0153,0.0368,-0.0007,-0.0316,-0.0232,-0.0176,-0.0261,0.0091,0.0602,0.0495,-0.0113,-0.0781,-0.0299,-0.0528,-0.0391,0.0343,-0.015,-0.0354,-0.0208,-0.0614,0.0143,0.0166,-0.0152,0.0671,0.0232,0.0559,0.0647,0.0536,0.0553,-0.0101,0.007,-0.0293,-0.0245,-0.0704,-0.0305,-0.0391,0.0019,0.0586,0.0732,0.0346,-0.0107,-0.0094,-0.0464,-0.1211,-0.0518,-0.0959,-0.0305,0.0128,0.0238,0.0021,-0.0406,-0.044,-0.0601,-0.0475,0.0343,0.079,0.0023,0.0131,0.0222,-0.0006,-0.058,-0.0073,-0.006,0.0232,-0.012,-0.0512,-0.0789,-0.0438,-0.0277,-0.0728,-0.0826,0.0732,-0.0331,0.0195,-0.0003,-0.0124,0.0098,-0.0488,-0.0724,-0.0076,-0.0143,0.0053,0.0378,-0.0084,0.0191,0.0049,0.0117,-0.0599,-0.0395,0.0096,-0.0515,-0.051,0.004,0.0483,-0.0351,-0.0565,-0.0266,-0.0241,-0.0379,-0.0426,-0.0406,-0.0167,0.0089,-0.0057,0.0242,0.0313,-0.0994,-0.0172,-0.0611,-0.0563,-0.0525,-0.0905,-0.0194,-0.0609,-0.0106,-0.0376,0.0961,-0.0143,-0.0045,0.0407,-0.0337,-0.0195,-0.0124,-0.0737,-0.0286,0.0594,0.0471,0.0429,0.0481,-0.0362,0.0074,0.0574,0.066,0.0537,0.0439,0.0143,-0.0084,0.0393,0.0165,-0.0289,0.0199,0.0089,0.0477,-0.0144,-0.0234,-0.0284,-0.0169,-0.0432,-0.0207,-0.0062,0.0127,-0.0201,-0.0038,0.0121,0.0849,0.0372,-0.0868,-0.1188,-0.0371,-0.0372,-0.0487,-0.1004,-0.0649,0.1872,-0.046,-0.0295,0.0425,-0.0045,0.0539,0.0239,0.0049,0.0078,-0.0,0.0051,0.0103,-0.0331,0.0237,0.0438,0.049,0.0664,0.1213,-0.0848,-0.0539,-0.0017,0.1831,-0.0211,-0.0433,0.0319,0.0323,-0.0205,-0.0571,0.1221,0.0428,-0.0243,-0.011,-0.1242,-0.1145,-0.0469,-0.0582,-0.0076,0.0603,0.0401,0.0422,-0.0024,0.0421,0.0802,0.1202,0.0388,0.0149,-0.0035,0.0443,-0.1023,-0.0493,-0.0286,-0.0616,-0.0425,-0.0644,-0.0593,-0.0403,-0.0629,-0.0522,-0.0547,0.0164,0.0673,0.0793,-0.0099,0.0131,0.0699,0.0344,0.0117,-0.0317,-0.0156,-0.039,-0.0341,-0.025,-0.0345,-0.0192,0.03,-0.0249,0.0404,0.0087,0.0671,0.0259,-0.0149,0.0056,0.0169,-0.0629,-0.0497,-0.0296,-0.0429,0.0556,-0.0014,-0.0762,-0.0643,0.0034,0.0548,0.0179,-0.086,-0.0155,-0.0557,-0.0361,-0.0457,0.0076,0.0427,-0.0029,-0.0328,0.0082,0.0417,-0.0186,0.0314,0.0529,-0.1142,-0.0798,-0.0533,-0.0422,0.0761,0.0495,0.0303,-0.0406,0.2092,0.136,-0.0498,-0.0269,0.157,0.0995,0.0126,0.0766,0.068,0.0334,-0.0561,-0.0537,-0.0301,-0.0303,0.2185,0.1441,0.1137,0.0378,0.1341,0.0502,0.1761,0.1744,0.1368,-0.0301,0.0016,-0.0121,0.0265,0.0079,0.0412,-0.0676,-0.0273,0.0269,0.0536,-0.0125,-0.0174,0.0325,0.0179,0.0143,-0.0109,0.0773,0.0382,0.0169,0.013,-0.0518,-0.0666,0.037,0.0676,0.0088,-0.0457,-0.065,0.0114,-0.0857,-0.1018,-0.116,-0.1119,0.0095,0.0351,0.0229,0.0605,0.018,0.0698,0.0579,0.039,0.0686,0.0564,-0.0559,-0.056,-0.042,0.0433,0.0282,0.0365,0.0776,0.069,-0.0269,-0.0735,-0.0708,-0.0409,-0.0325,0.019,-0.0787,-0.0589,0.0595,0.0089,0.0444,-0.0451,0.0785,0.0104,0.0197,-0.0323,-0.0102,-0.0211,-0.0473,-0.0469,0.113,-0.0166,-0.0251,-0.0571,-0.0653,-0.0093,0.1424,0.0945,0.0589,0.0828,-0.0424,0.0545,0.0059,0.0805,0.0115,0.0988,0.0647,0.02,0.0411,0.1363,0.1944,0.0544,0.0468,-0.0828,-0.0518,0.0222,0.0337,0.0108,0.0293,-0.0986,0.075,0.026,0.0437,0.0723,0.0147,0.0347,0.048,-0.0499,-0.0155,-0.0904,-0.0454,-0.0518,0.0344,-0.0362,-0.0346,-0.0414,0.0287,0.0445,0.0245,0.0447,0.0711,-0.0041,-0.0679,-0.0205,0.0275,0.0378,0.0258,0.1047,0.0722,0.0202,-0.0353,-0.0294,0.0391,-0.0167,-0.0742,-0.0115,0.0383,0.0224,0.0633,-0.0097,-0.0388,0.0101,-0.0643,-0.0953,-0.0982,-0.0373,-0.0123,-0.077,-0.0218,-0.0381,0.013,-0.0364,0.0191,0.0126,-0.0688,-0.0163,0.0281,-0.0047,-0.0409,0.0382,0.0183,-0.0735,0.0212,-0.0807,-0.0398,0.066,-0.0733,-0.0749,0.0272,0.0064,-0.0277,0.0401,-0.054,-0.0497,0.0335,0.005,0.0069,-0.1064,0.0424,0.0681,0.0785,-0.0028,-0.0941,-0.0242,-0.0224,-0.0718,-0.0281,-0.0268,-0.0495,0.0095,-0.0112,0.0307,0.0503,-0.1021,-0.0406,-0.0133,-0.0848,-0.0606,-0.0519,-0.033,-0.033,-0.0008,-0.0026,0.016,-0.0572,0.0009,0.0437,0.0359,0.0985,-0.013,0.0109,0.08,-0.0441,0.0561,0.0074,0.1377,-0.0072,0.0389,-0.035,0.0494,0.019,0.1167,0.0701,0.0984,0.0068,-0.0106,-0.0043,-0.0028,-0.0098,0.0048,-0.0158,-0.0531,-0.0363,0.121,0.0602,-0.0332,-0.0656,0.0112,-0.0219,-0.0315,0.0072,-0.0661,-0.0139,0.012,0.0648,-0.0388,-0.0017,0.0389,-0.0852,0.0642,-0.1005,-0.0704,0.021,-0.0362,-0.0549,0.0611,0.067,0.0067,0.0782,0.0906,-0.0014,-0.0061,-0.0158,0.0996,0.0303,0.0306,0.0144,-0.0728,-0.0101,-0.0232,0.0351,-0.0138,-0.027,-0.035,-0.0206,0.0487,0.0435,-0.0712,0.0446,-0.0239,0.0345,0.0638,0.0494,0.117,0.0351,0.017,0.0244,0.0406,0.036,0.01,-0.0168,-0.0588,-0.028,0.0165,0.0102,-0.0412,-0.0212,-0.0105,-0.0434,0.0271,-0.004,0.0493,0.0008,0.0134,-0.0066,-0.0304,0.0017,0.0181,-0.0522,-0.0496,0.0062,-0.0284,-0.0496,-0.0539,0.0168,-0.0254,-0.0359,0.021,-0.0306,0.0619,0.0178,0.0564,0.0429,0.0082,0.0022,-0.0102,0.0058,-0.0139,0.0027,-0.0051,0.0104,-0.0142,-0.0176,0.0092,-0.01,-0.0388,-0.0481,-0.0784,-0.0048,0.0096,-0.0268,-0.0384,-0.0511,-0.0165,-0.0504,-0.0081,-0.0327,-0.0285,0.0326,-0.0572,0.0943,-0.038,-0.0692,-0.0397,0.0184,-0.042,-0.0239,0.0524,-0.0,-0.0391,0.0038,0.0292,0.0299,0.0076,0.0056,0.032,0.0487,-0.0748,-0.054,-0.0312,-0.0656,-0.098,-0.0474,-0.0242,0.1113,0.1208,0.0287,0.0031,0.0486,-0.049,-0.0432,0.0049,0.0179,0.0415,0.0554,-0.0237,0.0082,0.0342,-0.0497,0.0303,-0.0557,-0.0666,-0.0217,-0.0542,-0.0359,-0.0793,0.0803,0.0419,0.0061,0.0149,0.0525,0.0156,0.0184,0.0556,0.0781,0.0262,0.0162,0.0166,0.0119,0.046,-0.0344,-0.0417,-0.0353,-0.0107,-0.0211,0.0391,-0.0104,-0.0315,0.0012,0.0031,-0.016,-0.0197,0.0227,0.0308,-0.0081,0.0252,-0.0458,-0.0268,-0.0643,0.0137,-0.0411,-0.0858,-0.0569,-0.1283,-0.0758,0.0097,-0.0739,0.0136,-0.0311,0.0419,0.0127,0.0377,0.0375,-0.0116,-0.0357,0.0056,0.0271,0.0589,0.0547,-0.0124,0.0066,-0.0499,0.0407,0.0491,-0.0151,0.0934,-0.019,-0.014,0.0636,-0.0351,0.0492,0.0534,0.0009,-0.0066,0.0241,0.023,0.0207,0.0183,0.0242,0.0525,-0.0034,-0.0088,0.0071,-0.1167,-0.0274,-0.0023,0.0705,0.1382,0.0258,0.0117,0.0501,0.0239,0.0953,0.0607,0.0667,0.0638,-0.0332,0.0517,-0.0331,0.0619,-0.0714,-0.0219,-0.0125,-0.025,0.0117,0.0074,0.0157,-0.0127,0.0619,-0.0137,-0.0399,0.0381,0.0687,-0.0156,0.0039,0.0257,0.0594,-0.0375,-0.0402,-0.0327,-0.0423,0.0001,-0.0024,0.0536,-0.0829,-0.0288,0.0477,-0.0425,0.0025,0.0022,0.012,0.0224,0.0127,0.0119,-0.0204,0.0077,0.0521,0.0364,0.024,-0.0062,-0.0013,-0.0267,-0.0068,0.0104,0.0327,0.0313,-0.0552,-0.0058,-0.0551,-0.0237,-0.0509,-0.0714,0.0028,-0.0655,0.0027,0.026,-0.017,0.0079,0.0145,-0.013,-0.0308,-0.0368,0.0813,0.0388,0.041,0.0554,0.0465,0.0195,0.0473,0.0119,0.0592,0.0543,-0.0692,0.0004,0.0428,-0.0041,-0.0547,-0.0268,-0.0433,-0.0152,-0.0198,0.0166,-0.0187,-0.0116,-0.0267,-0.052,-0.0828,-0.07,0.0279,0.0475,-0.0489,-0.0157,-0.0793,-0.064,-0.0948,0.0531,0.0492,-0.0492,0.0157,0.0081,-0.018,-0.028,-0.018,-0.0327,0.0093,-0.0437,-0.0383,0.0099,0.008,0.0373,0.0862,0.0342,0.0353,0.1174,0.0605,0.0445,0.1225,-0.0482,-0.006,-0.0888,-0.0041,0.0044,0.0104,-0.0363,-0.016,-0.0008,-0.026,-0.0235,0.027,0.0769,-0.0445,0.0619,0.0569,0.0597,0.0288,0.0315,0.0736,-0.0346,-0.0108,-0.0521,-0.0096,0.0561,0.1141,0.0364,0.0297,-0.0052,-0.0649,0.0018,-0.0506,0.0107,-0.0777,-0.0413,-0.0073,0.0014,-0.0565,-0.0119,0.0726,0.0251,-0.0016,-0.0028,-0.0406,0.0135,-0.0218,-0.0549,-0.0215,0.0115,0.178,0.0406,0.0978,0.047,0.011,-0.0689,-0.068,0.0664,-0.0137,0.1142,0.0323,0.015,-0.0045,-0.0047,0.0172,-0.0294,-0.0172,0.0188,-0.0426,0.1415,0.0521,-0.044,0.0094,-0.0483,-0.0149,-0.0015,0.0402,-0.0198,-0.0249,-0.005,-0.0135,0.0282,0.0119,0.0596,0.0753,0.0924,0.0307,0.0769,-0.0024,-0.0206,0.0121,0.0227,0.0948,0.04,0.027,-0.0327,0.0149,0.0036,-0.0145,-0.0266,0.0856,0.0511,-0.0056,-0.0642,-0.0641,-0.0261,0.0039,-0.0172,0.0179,0.0121,-0.0105,0.0384,-0.018,-0.0758,-0.0226,-0.0572,-0.0344,-0.0229,-0.0232,-0.0356,0.0042,0.0204,0.0153,0.0033,-0.0259,-0.0057,-0.0538,0.0511,0.0466,0.0712,-0.0153,0.0043,0.1109,0.0818,0.0842,-0.004,0.0661,0.0069,-0.0682,-0.0326,-0.0261,-0.0094,0.0778,0.0912,0.0098,0.0025,0.0092,0.0371,0.0155,-0.032,-0.0158,-0.0381,-0.0867,-0.0872,-0.066,-0.0362,-0.0372,0.0032,-0.0126,0.0692,-0.058,0.0066,0.0534,0.0186,0.0341,-0.0322,-0.0451,-0.0221,-0.0141,0.0426,-0.0305,0.0939,-0.0644,-0.0511,0.0124,-0.0696,0.0526,-0.0147,0.0415,0.0229,0.0149,0.0497,0.0175,0.0591,-0.0261,-0.0278,-0.0202,0.0799,0.0268,-0.041,-0.0453,0.1207,0.0181,-0.0009,-0.0738,-0.0496,-0.0361,-0.0484,0.0233,0.0288,0.01,-0.0065,0.0656,0.0006,-0.0176,-0.0929,-0.0346,-0.0631,-0.0524,-0.02,-0.0788,-0.0546,-0.0301,0.0146,0.0166,-0.0016,-0.0503,-0.0365,-0.0896,0.0074,-0.0248,-0.0311,0.024,0.0059,0.0495,-0.0371,0.0032,0.0136,0.0295,-0.0539,-0.0288,-0.0058,-0.0116,0.0244,0.0077,-0.0645,-0.0,-0.0015,0.0442,0.0374,0.0057,0.0163,0.0099,0.0145,0.0176,0.0091,-0.0123,0.0349,0.1385,0.1033,-0.0026,-0.0302,0.017,0.0023,-0.0415,0.0391,-0.0124,0.1419,-0.0492,0.03,0.0224,0.0159,-0.0239,-0.0006,0.0275,0.0149,0.0238,0.0258,0.0426,0.0389,0.0178,-0.0161,0.0378,0.066,0.0784,-0.0604,-0.0284,-0.0652,-0.0245,-0.0578,-0.0462,0.0041,0.0242,-0.0285,-0.0216,-0.0852,-0.0753,0.0748,-0.0046,-0.0529,0.0059,0.0964,0.0612,-0.0258,0.0767,0.0567,0.0495,-0.0272,0.0206,-0.0318,0.0494,0.0465,0.0244,-0.0099,0.0898,0.0027,0.0143,0.0166,0.0623,0.045,-0.0886,-0.0139,-0.0107,-0.0343,0.0474,0.0175,0.0109,-0.0203,-0.059,0.0059,-0.082,-0.0119,0.0508,-0.0156,-0.1167,-0.0158,-0.0749,-0.0018,0.0145,-0.0009,0.0255,0.009,-0.0311,-0.0173,-0.1064,-0.0648,-0.0037,0.0208,0.0072,-0.0067,0.0081,0.0046,-0.0229,-0.0701,0.0247,-0.0486,0.0106,-0.002,-0.0727,-0.0693,-0.0376,-0.0009,0.0059,-0.0626,-0.0155,-0.001,0.009,-0.0002,-0.0467,-0.0504,-0.083,0.0063,0.0547,0.1231,0.053,-0.0069,0.0078,0.0408,-0.0415,-0.0282,0.0214,-0.0278,-0.03,-0.044,-0.0429,-0.0572,0.0272,0.1316,0.1321,-0.0236,-0.0616,0.0992,0.0085,-0.0118,0.0599,-0.1223,-0.057,-0.0888,0.0529,0.0089,0.0564,-0.0168,-0.0627,-0.1007,0.0393,0.0369,0.0222,0.0204,0.0403,0.0218,-0.0665,-0.0466,-0.0376,-0.0172,-0.1072,-0.0494,-0.0014,0.0416,-0.0019,0.03,0.0693,0.0323,-0.0029,-0.0413,-0.0266,0.0338,0.0549,-0.0069,0.0338,0.0023,-0.0687,-0.0067,-0.0646,0.0332,-0.0169,-0.0025,0.0196,-0.0456,-0.0238,0.0505,-0.0397,-0.0018,-0.0419,-0.0198,-0.0033,0.023,-0.0167,0.0351,-0.0225,-0.0139,0.0241,-0.0299,-0.0058,-0.0585,-0.1001,0.0058,0.0613,0.0205,0.0362,0.0437,0.0074,0.0171,-0.0207,-0.0502,-0.0282,-0.0053,-0.0066,0.023,-0.0567,0.0153,-0.0419,-0.0581,-0.006,0.1594,0.1408,-0.0865,0.0072,-0.051,0.0079,0.0267,-0.0176,-0.0568,-0.0656,0.0166,-0.0049,0.0037,-0.0225,-0.0603,-0.0145,0.0273,-0.0136,-0.0158,0.0332,-0.0086,-0.03,-0.0777,-0.0172,0.0741,-0.0339,0.0419,0.0177,0.0634,-0.0501,0.0855,-0.0171,0.011,-0.0693,-0.0518,-0.0011,-0.1007,-0.0228,-0.0714,0.0522,-0.0539,-0.0198,0.0338,-0.0784,0.0837,0.1111,0.0811,0.0611,0.0533,0.0408,-0.0476,0.0899,0.1814,0.2209,0.1243,0.0554,0.1221,0.127,0.0857,0.1311,0.0361,0.1396,0.0974,0.0595,0.0922,0.0379,0.0885,0.1266,0.1627,0.0905,0.1248,0.1221,0.0832,-0.0604,-0.0372,-0.0352,-0.1154,-0.0683,-0.1022,-0.0456,-0.0561,0.0594,-0.0473,-0.0679,-0.0902,-0.0288,0.0366,0.0396,-0.0791,0.0798,0.0613,-0.056,0.0215,-0.0287,-0.0571,-0.0237,-0.0202,-0.0758,0.0158,-0.0949,-0.0944,0.0327,0.017,-0.0604,0.0461,0.0383,-0.012,-0.026,0.0456,-0.0826,0.0408,0.1242,0.0559,0.0413,0.024,-0.006,-0.0317,-0.029,0.0241,-0.0118,0.0247,-0.0035,0.0071,-0.0645,-0.0377,0.0708,-0.0541,-0.0449,-0.0031,0.0456,0.0401,-0.057,face recognition
trm_51a690a7492eb,-0.0096,-0.0001,-0.0551,0.0415,-0.0127,0.0269,-0.0148,-0.0386,-0.011,0.0058,-0.0171,-0.0271,0.0129,0.0294,0.0509,0.0237,0.0149,0.0653,0.0032,0.0509,0.0106,-0.0024,0.0296,0.0227,-0.0004,0.0056,0.0073,0.0184,0.0429,-0.0234,0.0395,0.0506,0.0118,-0.0161,0.0283,0.0325,-0.0383,-0.0285,0.0441,0.025,0.0092,0.0157,0.0184,0.0052,0.0056,0.0601,-0.0038,0.0078,-0.014,0.0157,0.036,-0.0344,0.0048,0.0228,0.0395,0.0226,0.0302,-0.0056,-0.0117,-0.0081,0.0122,-0.0088,0.0423,-0.055,0.0205,-0.0685,0.0751,0.1092,0.0583,-0.0161,0.0343,-0.0148,-0.0227,0.0394,0.0668,-0.0068,0.0261,0.0195,-0.001,-0.0079,-0.042,-0.0389,0.0608,0.0472,-0.0148,-0.0459,0.0038,-0.0618,-0.0221,0.03,-0.0095,-0.055,-0.0385,-0.1033,-0.0647,-0.1145,-0.0163,-0.0075,-0.1294,-0.0977,-0.0294,0.0481,-0.0637,-0.097,-0.0006,0.0456,0.0485,-0.0225,0.0337,-0.022,0.0364,0.0508,-0.0044,-0.0471,-0.0166,0.0183,0.0242,-0.0896,0.0319,-0.0109,0.0682,0.0488,0.0345,0.0149,0.0271,0.0635,0.0695,-0.0408,-0.0533,-0.0335,0.0489,0.046,-0.0251,0.0888,0.0505,0.0303,-0.0382,0.0144,0.0268,-0.0209,0.0246,0.0224,-0.0083,0.0356,-0.0152,-0.021,-0.0014,0.0296,0.0313,-0.014,0.0005,0.0539,0.019,0.0758,0.0063,-0.01,-0.047,0.0093,-0.0228,-0.0233,0.0044,0.0445,0.0606,0.0619,0.005,-0.0279,-0.0041,0.0634,0.0601,0.0287,-0.0354,0.0531,-0.059,0.0713,0.0488,0.0463,0.0377,0.0484,0.0393,-0.0427,0.0233,-0.0512,0.0388,-0.0406,0.0174,0.0186,0.0214,0.0305,0.035,0.0396,0.0383,0.0373,0.0264,0.0765,0.0737,0.088,0.0945,0.0127,0.0282,0.0441,0.0157,-0.0997,0.0334,0.0549,0.0492,-0.0026,0.0502,0.0418,0.0343,-0.0033,0.0869,0.0526,0.0006,-0.0165,0.0316,-0.0214,-0.0223,0.0314,-0.0455,0.0369,-0.0282,0.055,0.0433,-0.0019,-0.0272,0.0403,0.0269,-0.0252,0.025,0.0322,-0.0785,0.0498,-0.0082,0.0605,0.0559,-0.0163,0.0108,0.0102,-0.0191,-0.0232,0.0209,0.0294,-0.0191,-0.0354,0.0315,0.0319,0.0243,0.0387,0.0057,0.0451,-0.0281,-0.0078,0.0091,-0.0167,-0.0114,0.0261,-0.0245,0.0028,-0.0116,-0.0328,-0.021,0.0379,0.0334,-0.0017,0.0242,0.0315,0.0566,0.0317,-0.0053,0.03,0.0205,-0.0154,0.0609,0.0207,0.0144,-0.0341,-0.0038,0.0406,-0.0046,-0.0071,-0.0174,0.033,0.0182,0.0623,0.0451,0.0008,-0.0132,-0.0349,-0.0069,0.026,-0.0146,0.0198,0.0331,0.0381,0.0195,0.0482,0.0001,-0.0161,0.0153,-0.0448,-0.0248,0.0911,-0.002,0.0279,-0.0343,-0.0463,0.0243,-0.0175,-0.0369,0.0091,0.0095,-0.0047,0.0631,0.0209,0.0139,0.0212,-0.0171,-0.034,0.025,0.0298,-0.0047,-0.0053,0.0291,0.0465,0.0169,0.0264,0.0362,0.0443,-0.0021,-0.0136,-0.0223,0.0241,0.0328,0.0019,0.0177,-0.0422,-0.0372,0.0554,-0.001,0.0607,0.0492,-0.009,-0.0599,-0.0448,-0.0067,0.0115,0.0144,0.007,-0.0107,0.0188,0.0135,-0.0396,-0.058,-0.0644,-0.0268,-0.0498,-0.0019,0.0349,0.039,0.0338,0.0178,0.0064,0.0439,-0.0287,-0.0249,-0.0883,0.0117,0.0127,0.001,0.0375,0.021,-0.0243,0.0171,-0.0579,0.0562,0.0161,0.0193,-0.035,-0.0397,-0.0585,-0.0513,-0.0782,0.0606,0.0402,-0.0222,-0.0135,-0.0041,-0.0373,0.0112,0.0227,-0.0086,0.0147,-0.0578,0.0555,-0.177,-0.2002,-0.0908,0.0201,0.0007,0.0318,0.0217,-0.0146,-0.0086,-0.0301,0.0052,0.0356,-0.0015,0.0543,0.0172,0.0037,0.0133,0.0104,0.018,-0.0332,0.037,0.0295,-0.0048,0.0345,0.0567,0.0293,-0.022,0.0273,-0.0009,0.1007,0.1119,0.0216,0.0469,-0.0322,0.0298,0.0252,0.0035,-0.0704,-0.0033,-0.05,0.0399,0.0001,-0.0451,0.0238,0.0677,0.0138,0.0024,-0.0236,0.0083,-0.0328,-0.0117,0.0044,-0.0311,-0.0271,0.0863,0.0816,0.0426,0.0112,0.0544,0.057,-0.0004,0.0701,-0.0876,0.0078,0.0404,-0.0427,-0.0136,0.0447,0.0129,0.0158,0.0343,0.0652,0.0024,-0.0364,0.0017,-0.0035,0.0169,-0.0111,-0.0294,-0.0185,0.0133,0.0521,-0.0308,-0.047,-0.018,-0.0094,-0.0821,-0.0176,-0.0933,-0.0669,0.0279,-0.0162,-0.0143,-0.0004,0.0684,0.022,-0.0318,-0.0459,0.0469,0.0438,0.0088,0.0088,0.0633,0.013,0.0088,0.0702,0.0675,0.027,0.0358,0.0167,0.0244,0.0182,-0.0375,0.017,0.0324,-0.0341,0.0393,-0.0565,0.0117,0.0188,-0.0267,-0.0296,0.0445,0.0227,-0.0729,0.0174,0.0105,0.0121,0.0051,0.0407,-0.0107,-0.0193,-0.0087,-0.0355,-0.0297,0.0204,0.0375,-0.0424,-0.0271,0.0474,0.0169,0.019,0.0392,0.0248,0.0028,0.0192,0.0411,-0.0142,-0.0096,-0.006,0.0062,-0.008,0.0241,-0.0173,0.0025,0.034,-0.0694,0.0561,0.0077,-0.043,-0.0141,0.0468,-0.0582,0.0096,-0.0255,0.0009,0.0366,0.0265,0.0711,-0.0247,0.0263,-0.0046,-0.0204,0.0503,0.0259,0.0327,0.0527,0.0208,0.0138,0.0008,-0.1899,-0.1906,-0.0264,-0.039,-0.0251,0.0162,0.0368,0.0472,0.0258,0.0202,-0.0409,0.0088,-0.0003,0.0068,-0.0171,-0.0057,-0.0013,0.0227,0.0254,-0.0042,0.0061,-0.0601,0.0448,0.0016,-0.0858,0.0203,0.008,0.0003,0.0102,0.0178,-0.0017,-0.1673,0.0375,0.0423,0.0375,-0.0087,-0.046,-0.0228,0.0001,0.0149,0.0604,0.0303,0.0223,0.0081,0.0477,0.0381,0.0045,0.0271,-0.028,0.0236,0.0263,-0.0713,0.0512,0.043,0.0013,0.005,-0.0084,-0.1345,0.0044,0.0554,0.04,-0.0055,-0.0278,0.0122,-0.0136,0.0102,0.0153,-0.0225,-0.0291,-0.1691,0.0465,-0.0254,0.0724,0.0612,-0.0387,0.0191,0.0221,0.0174,-0.017,0.0159,0.0038,0.0243,-0.1436,0.0161,-0.0432,0.0512,0.0448,-0.1056,-0.0692,-0.1328,-0.0071,-0.0293,-0.0702,0.0695,-0.0777,-0.0662,-0.0344,-0.0024,-0.0054,0.0257,-0.0024,0.0378,-0.0295,0.0056,-0.0227,0.0104,0.0047,-0.0198,0.0046,-0.0085,-0.0396,0.064,0.0275,0.0491,0.0258,0.0009,-0.0881,0.0032,-0.0214,0.0276,-0.0104,0.0364,-0.0479,0.0286,0.0477,0.0558,-0.0405,-0.0111,0.0127,0.0356,0.023,-0.0259,0.0293,0.0288,0.015,0.0056,0.0319,0.0196,0.0453,-0.0338,0.0367,0.0257,-0.0702,0.0023,0.0424,-0.0252,-0.0425,-0.0083,0.0817,0.0742,0.0543,-0.0007,0.0168,0.0305,0.0396,0.0154,0.0045,-0.0147,0.0305,-0.0012,-0.0005,0.0139,0.0427,-0.0048,-0.0294,-0.0136,0.0635,-0.0266,0.0102,0.0041,0.0385,0.0256,-0.0032,-0.0231,0.0311,-0.0077,0.0361,0.0117,0.0581,0.0958,0.0783,0.0645,0.0022,-0.0366,-0.0095,0.0242,0.0099,-0.0382,-0.0151,0.0278,-0.0128,-0.0198,-0.0078,0.0399,-0.0277,0.0186,-0.0141,-0.07,-0.0158,0.0232,-0.0636,0.0036,-0.0128,0.0267,0.0612,0.0337,0.0516,0.0331,0.0485,-0.0378,-0.0135,-0.0139,-0.0059,-0.0261,0.0474,0.0003,-0.0215,0.0334,-0.0093,0.0103,-0.0237,-0.0522,0.0136,0.0266,-0.0002,0.0754,0.0714,0.0022,0.0058,-0.0222,0.0249,-0.0107,-0.0187,0.0264,0.0328,-0.0012,-0.0118,-0.0333,-0.0693,-0.0381,-0.0453,0.0185,-0.0603,-0.0557,-0.0125,-0.054,0.0096,0.0531,0.0473,-0.0154,0.0123,0.0214,0.1084,0.0264,0.0569,0.0742,0.0617,0.0411,0.0307,0.018,-0.0041,-0.0461,0.0727,-0.0715,-0.0335,0.0096,-0.0063,-0.0158,-0.0323,-0.0272,-0.006,0.0251,0.0006,-0.0274,0.0372,-0.0589,-0.0467,0.0209,0.0037,0.0088,0.0467,-0.0172,0.0497,0.0787,0.0531,0.0614,-0.0149,0.0162,0.0458,-0.0012,-0.0174,-0.1112,0.0474,0.0313,-0.043,0.0441,0.0169,0.046,-0.1803,0.0488,-0.0104,0.045,0.0377,0.0364,0.078,0.078,0.0271,-0.0128,0.0218,0.0267,-0.0026,-0.0295,-0.0014,0.0544,0.0278,0.055,-0.021,0.0135,-0.0274,-0.0394,0.0586,-0.0258,0.0551,0.0422,0.0201,-0.0279,0.0193,0.0039,0.001,-0.0079,0.0155,-0.0402,0.0178,0.0324,-0.0044,0.0415,0.0487,0.0024,0.0201,-0.037,-0.0352,-0.0116,-0.0334,0.0518,-0.0135,-0.0607,-0.0261,-0.0011,0.03,-0.02,-0.0466,-0.0119,-0.0403,-0.056,0.0422,0.0383,-0.0129,-0.0398,0.0087,0.0266,-0.0091,-0.0032,0.0151,-0.005,0.0063,0.0247,0.0289,0.0927,0.0722,0.1011,0.0344,0.0047,0.059,0.0403,0.0266,0.0476,0.0644,0.0634,0.0325,0.0448,-0.018,0.0381,0.0254,0.0208,0.0067,-0.0089,-0.0098,-0.0195,0.0338,-0.0119,-0.0181,-0.0011,0.0093,0.016,-0.0169,-0.0237,0.0058,0.0048,0.0385,-0.0083,0.0091,-0.0023,-0.0024,0.0189,0.0258,0.0291,0.0188,0.0287,0.0564,0.0611,0.0325,0.0509,0.0458,-0.0751,-0.0124,-0.0809,0.0044,-0.023,-0.019,0.0124,-0.0075,0.0109,-0.0118,0.006,-0.0316,0.0107,-0.0261,-0.001,0.0022,-0.0356,-0.0126,0.0201,-0.0088,0.0234,0.0484,0.0541,-0.0396,-0.0219,-0.0419,-0.0546,-0.0081,0.0457,0.0277,0.0064,0.07,0.0221,-0.0088,-0.0196,0.012,-0.0437,-0.0148,0.0338,0.0451,0.0247,0.0321,-0.0196,0.005,-0.0289,-0.1136,-0.1708,0.0342,0.0118,0.0366,0.0554,0.0208,-0.0056,0.0551,0.0405,-0.0669,-0.0246,-0.0266,0.0243,-0.0223,0.0304,0.0274,0.0314,-0.0749,0.0263,0.024,0.0458,0.0118,-0.0569,-0.0028,-0.039,0.0334,-0.0653,-0.0754,-0.0362,0.0076,0.0297,0.0032,0.0129,-0.0243,0.0279,0.0405,0.0413,0.0256,0.0993,0.0487,0.0137,-0.0122,0.0245,-0.0335,0.0336,-0.0167,-0.0301,-0.1515,-0.0077,0.0124,-0.0111,-0.0147,-0.0674,0.0264,0.0019,-0.0034,0.0235,-0.1067,-0.1056,-0.0141,-0.0003,0.0058,0.029,-0.0079,-0.0288,0.0727,-0.0494,-0.0674,-0.0385,-0.0068,-0.0253,0.0265,-0.0115,0.02,0.0025,-0.022,0.0123,-0.0063,0.0016,0.059,-0.0219,-0.029,0.0082,-0.0322,0.0157,0.0383,-0.0311,0.0095,0.0311,0.0077,0.0533,-0.0542,-0.0048,-0.0487,0.055,0.0473,0.0539,0.0392,-0.0007,0.0421,-0.0055,-0.0923,0.0341,0.056,0.0625,0.0378,-0.0626,0.027,-0.0667,0.0063,0.0174,-0.0317,-0.0741,-0.2666,-0.2247,-0.2254,0.0085,-0.02,0.0002,-0.0201,0.0056,0.0029,0.0594,0.0037,0.0115,-0.0704,-0.0149,0.0084,0.0004,0.0134,0.0242,-0.01,0.0072,-0.022,-0.1667,-0.0389,0.0137,0.0273,0.0125,0.0068,-0.0414,-0.0344,0.0765,0.0758,0.0542,0.051,-0.0166,-0.0023,0.0423,-0.0173,0.0279,0.0677,0.0562,-0.004,-0.0069,-0.0016,0.0445,0.0624,0.0028,0.0005,0.0081,0.0535,0.0346,-0.0278,0.0369,0.0643,0.0244,0.0289,0.0366,0.0417,-0.0023,0.0636,0.0455,0.0436,0.0126,-0.0683,-0.001,0.0143,-0.0377,0.0192,-0.0057,0.0257,0.01,0.032,0.0562,0.0053,0.0149,0.0127,-0.0761,-0.0705,-0.0856,-0.059,0.0604,0.02,0.0499,0.0191,0.0918,0.0309,-0.0464,0.0013,0.0364,0.0567,0.0151,-0.0659,0.001,-0.024,-0.0061,-0.0699,-0.0132,-0.0884,0.0818,0.0461,0.0296,-0.0363,-0.0031,0.0503,-0.0281,-0.0281,0.0854,0.0247,0.0141,-0.0265,-0.0416,0.0107,-0.0081,-0.1618,0.1152,0.1056,0.0119,0.027,0.0546,0.0577,0.0428,-0.0211,-0.0342,0.0258,0.0243,-0.0114,-0.0804,-0.0397,0.0065,0.004,0.0091,-0.0678,0.0287,-0.0147,0.0152,0.0312,0.0429,0.0439,0.029,0.0397,0.0018,0.0052,0.0104,-0.2224,-0.1522,-0.1823,0.0283,-0.136,0.0439,0.0261,0.0021,0.0324,0.0003,0.0542,0.0143,0.0144,0.0408,0.0558,-0.084,-0.0629,0.0711,-0.0174,-0.0324,0.0117,0.0558,0.0472,0.0062,0.0095,0.0351,0.0102,-0.0069,-0.0364,-0.0569,-0.1064,-0.0572,-0.0314,-0.0353,-0.0146,0.0218,0.0179,0.0117,0.0735,0.0694,0.0654,0.0017,0.0045,-0.0102,0.0242,0.0256,0.0586,-0.0233,-0.0472,-0.0089,-0.0015,0.0243,-0.0134,-0.0132,0.0126,0.042,0.0733,0.0382,0.0016,0.037,0.0309,-0.0003,-0.0019,0.0094,0.0048,-0.0363,0.0046,0.0287,-0.0587,0.0563,0.0176,-0.0588,-0.027,-0.0721,0.0437,0.0028,-0.0487,0.0675,0.01,0.0168,0.0262,0.0009,0.031,-0.0739,-0.0583,0.0612,-0.042,0.0382,-0.0774,-0.107,-0.0567,-0.0115,-0.0127,-0.0341,-0.0546,0.0197,-0.0338,0.0352,0.0031,0.0502,0.0533,0.0249,-0.016,0.0011,0.0439,0.0659,-0.0225,0.0382,0.002,0.0155,0.0363,0.0299,0.0286,0.0372,-0.0425,0.0184,0.0331,0.0334,0.0606,0.0272,0.0124,0.0218,-0.0201,-0.0134,0.0491,-0.0068,0.0139,0.021,0.0037,-0.029,-0.0317,0.0335,0.0533,0.0087,-0.1084,-0.1885,0.0134,-0.0082,0.0146,0.0084,0.0064,0.0423,0.0133,0.0388,-0.004,0.0729,-0.0315,-0.0305,0.0056,0.0311,0.0213,0.011,0.0284,0.0505,-0.0056,0.033,0.0171,-0.0472,-0.0444,0.0164,-0.0313,-0.0126,-0.0117,0.0041,0.0207,0.0058,0.0445,0.0196,0.012,0.0308,0.0186,0.041,0.0008,-0.0562,-0.0416,-0.0809,-0.0844,0.0201,-0.0022,-0.0066,-0.0106,-0.0193,0.0068,0.0515,0.0278,-0.0007,0.0479,0.0255,-0.0213,-0.0279,0.0228,-0.0203,-0.0663,0.0161,0.0474,0.0684,-0.0439,0.028,0.0127,0.0682,0.0587,0.0461,-0.014,0.009,0.0066,0.0427,-0.0341,0.0003,-0.0239,-0.0143,-0.0324,0.0009,-0.0477,-0.0055,0.0159,0.0433,-0.0395,-0.0119,-0.0016,-0.0454,-0.056,-0.0101,0.0267,0.0265,-0.0043,-0.0384,-0.0352,0.0631,0.0383,-0.0277,0.0084,0.0091,-0.0604,0.0408,-0.0213,0.0032,0.0186,-0.0072,-0.0201,-0.084,0.0669,-0.0397,-0.0105,-0.0517,-0.0077,-0.0114,-0.1672,0.0463,-0.013,-0.0038,-0.0224,-0.0648,-0.0298,0.0386,0.0186,0.0169,-0.0313,-0.0139,-0.0025,0.004,0.0342,-0.0116,0.0633,0.0531,0.0508,-0.0392,0.0383,-0.0231,-0.0044,0.0284,0.0409,0.0084,-0.0224,0.0554,0.0729,-0.0324,0.0228,0.0121,0.0374,0.0072,0.0029,0.0417,0.0625,0.0004,-0.0139,0.0056,-0.0105,-0.0572,-0.0747,0.0284,-0.0482,0.0133,-0.0564,-0.1023,0.0671,0.068,0.0241,0.0463,-0.0277,0.007,-0.0919,0.0194,-0.0233,-0.0121,0.0061,-0.0018,-0.0279,0.0098,-0.0475,0.0191,-0.0463,-0.0148,-0.0598,-0.0466,-0.0535,-0.0122,-0.0195,0.0531,0.0012,-0.0245,-0.0403,0.0048,0.009,-0.0054,0.0302,-0.1144,-0.0945,0.0798,0.0631,0.0269,0.0305,-0.0544,-0.049,-0.0238,0.0161,0.0124,0.0126,0.0403,0.0482,-0.0229,0.0242,0.0127,0.0366,0.0275,0.032,-0.024,0.0112,0.0284,-0.0059,0.0431,0.0456,0.0144,-0.1094,0.0145,-0.1082,-0.0235,0.0128,-0.0343,-0.0275,-0.0728,-0.0139,-0.0329,0.0098,0.0056,0.0291,-0.0081,0.0074,-0.0818,0.0504,0.0576,0.0561,0.0452,0.0199,-0.0017,0.0025,-0.2052,0.0068,-0.0498,-0.0391,-0.0992,0.0385,0.0116,-0.0192,0.0058,-0.0342,-0.0193,-0.0131,-0.0162,0.0099,0.0787,0.0656,0.0647,-0.0075,0.0441,0.0508,0.0408,0.0208,0.0302,0.0252,0.029,0.0096,-0.048,0.004,0.0412,-0.0734,-0.0196,-0.0019,-0.0378,0.0141,0.0598,-0.0127,0.054,0.0265,0.0355,0.0111,-0.0377,-0.01,0.0041,0.0498,0.0218,0.0091,0.1181,0.0778,0.0728,0.0629,0.0249,-0.053,-0.0503,0.0576,0.0677,0.0017,0.0005,0.0073,0.0293,-0.0126,0.0346,-0.0185,-0.0404,-0.0028,0.0513,0.0437,-0.0044,-0.0074,0.0271,0.0901,0.0509,0.0178,0.0484,0.0915,0.0422,0.0234,-0.0554,0.0555,-0.0175,0.0125,-0.0148,0.0339,0.0418,0.0353,0.0622,0.0214,0.0065,0.0362,-0.0325,0.0579,0.0504,0.0279,-0.0011,0.0395,0.0189,0.0293,-0.0288,0.0655,0.0532,0.0573,-0.0052,0.0494,0.0565,0.0284,0.0075,-0.0101,0.0453,-0.0007,-0.0037,0.0694,0.0067,0.043,0.0096,0.0168,0.0365,0.0636,0.0516,0.06,0.0222,-0.0007,0.0072,0.0387,0.07,0.0093,0.0807,-0.007,0.0583,0.061,-0.0063,-0.0894,-0.0175,-0.0007,-0.0147,0.0376,-0.0242,-0.0274,-0.0075,0.0653,0.073,-0.0039,-0.0404,-0.0247,-0.0297,0.0329,0.0267,0.0527,0.0142,0.0247,0.0136,0.0055,0.0291,0.0245,-0.0134,0.0552,-0.0269,0.0101,0.0183,-0.0477,-0.0387,-0.0372,0.0359,0.0511,0.04,0.0247,0.096,0.0553,-0.0085,0.006,0.0437,-0.2029,-0.1332,-0.2066,-0.1353,-0.1197,-0.1493,-0.0432,-0.1375,-0.069,-0.0545,-0.0962,-0.1713,-0.1772,-0.1901,-0.0194,0.074,-0.0801,-0.0112,-0.0125,0.0166,0.0446,-0.0763,-0.0006,-0.0011,-0.0498,-0.0516,-0.0401,-0.0041,-0.0618,-0.0035,-0.0413,-0.1049,0.0082,-0.0026,-0.06,-0.0172,0.0191,-0.0027,-0.022,0.0191,-0.025,-0.0108,0.0387,0.0159,-0.0148,0.1087,0.0488,0.0219,0.0615,0.0543,0.0471,0.0616,0.0253,0.0198,0.0281,-0.0215,-0.0895,0.0058,0.0093,0.078,-0.028,0.0002,0.0014,-0.0073,0.0372,-0.0254,0.0494,0.0261,0.0187,0.0116,0.0415,0.0059,-0.0295,-0.0025,-0.0951,-0.0379,0.0055,0.0036,0.0145,-0.0232,0.0726,0.0145,0.0694,0.0411,-0.0479,-0.0007,0.0312,0.0166,0.02,-0.0071,-0.0199,-0.0375,0.0045,-0.0104,0.0239,-0.0446,-0.0732,-0.0034,0.0531,0.0219,-0.0638,-0.0128,-0.019,0.0077,-0.017,0.03,-0.0314,0.0351,0.0465,-0.0132,0.0011,0.0195,0.0251,-0.089,-0.0687,0.0623,0.0057,-0.0863,-0.0747,-0.0462,-0.0052,-0.0246,-0.0544,0.0704,0.0687,-0.0108,-0.0416,-0.0772,-0.0507,-0.0392,-0.0106,0.0046,-0.0451,-0.0811,-0.083,-0.1095,-0.006,-0.0128,-0.0017,0.0268,-0.005,-0.0213,0.0737,0.0265,-0.0008,-0.0035,0.0298,0.033,-0.0308,0.0008,-0.0248,0.0229,0.0028,-0.0229,0.0222,-0.0338,0.0239,-0.0258,0.0006,0.0209,0.0084,0.0121,0.0156,0.013,-0.0317,0.0445,0.0811,0.0809,-0.0406,-0.0065,0.0238,-0.0119,-0.0017,0.019,-0.0912,-0.0089,-0.0526,0.0028,0.0535,0.0697,-0.1128,0.0177,0.0202,-0.0243,-0.0093,-0.0601,-0.063,-0.0146,-0.0107,0.021,0.0156,-0.1437,0.0236,0.0174,0.0164,-0.0079,-0.0267,-0.0281,-0.0087,-0.0061,0.0465,0.0111,0.0057,0.0251,0.0557,0.0417,-0.0512,-0.0106,-0.0445,-0.0318,0.0,-0.0141,-0.0433,-0.0517,0.0002,-0.0212,0.055,-0.0096,-0.0265,-0.0526,-0.082,-0.0045,-0.0013,0.0014,-0.0124,-0.0062,0.0086,-0.0282,-0.0214,0.0173,0.0239,-0.0173,0.02,-0.0048,-0.0213,-0.0061,-0.0041,-0.0031,-0.0301,-0.0733,-0.0543,-0.0211,-0.0152,0.0468,0.0243,0.0133,0.0055,0.0761,-0.0026,0.0272,-0.0017,0.0039,-0.0409,-0.0896,0.0474,-0.0124,-0.0381,0.0339,-0.0055,-0.0234,-0.0715,-0.0135,-0.0611,-0.0671,-0.1155,-0.0467,0.006,-0.0389,-0.0837,0.0347,0.0271,0.0127,-0.0053,0.0292,-0.053,0.0235,0.0025,0.0707,0.0567,0.0935,0.0542,0.0408,0.0519,0.0183,0.056,0.0206,-0.003,-0.0248,0.0191,0.0078,0.0291,-0.0514,0.0335,-0.0769,-0.0089,-0.0035,0.043,0.0112,-0.0446,0.0468,-0.0035,-0.0299,0.007,0.0091,-0.0284,0.0221,0.0037,0.0028,0.0476,0.018,0.0174,0.0001,-0.0002,0.0247,-0.0372,0.0125,0.0118,-0.025,0.0327,0.069,0.0057,0.05,0.0149,0.0099,0.0191,0.0173,-0.0487,0.0396,0.0228,0.1026,0.0263,0.0295,0.0861,0.0683,0.048,0.0224,0.0224,0.0278,-0.0115,-0.0012,0.0341,-0.0003,-0.083,-0.0624,0.0292,0.0083,0.1001,-0.0249,0.036,0.01,0.0158,-0.0519,0.0134,0.0039,0.0267,0.0224,-0.0629,-0.0752,0.0131,-0.0177,-0.0798,-0.046,-0.0703,-0.022,0.0111,-0.0042,-0.0623,-0.0289,-0.0586,0.0662,0.073,0.0083,0.0651,0.0255,0.0044,0.0066,-0.0194,0.0409,0.0623,-0.0599,0.0061,0.0413,-0.0282,0.0148,0.1005,0.0263,0.1078,0.0307,0.0168,-0.0115,0.0244,-0.181,-0.1747,-0.0979,-0.0935,-0.0059,0.0052,-0.003,0.0215,-0.037,-0.0465,-0.0166,-0.0809,0.0117,-0.026,0.0335,-0.0237,0.0093,0.037,0.0166,-0.034,0.0245,-0.18,0.0196,-0.2007,-0.0469,-0.1943,-0.0356,-0.1132,-0.0344,0.0006,-0.0269,-0.006,-0.0239,-0.0445,-0.0203,0.056,0.0855,0.0242,-0.0405,0.0312,0.0421,0.0236,0.0212,-0.0051,0.0495,0.037,0.0244,0.0165,-0.0544,0.0028,-0.0463,0.0024,-0.0102,-0.0741,0.0234,0.0654,0.0062,0.0143,-0.001,-0.005,-0.0815,0.0459,-0.0466,-0.0471,-0.086,0.0198,0.0185,-0.023,-0.0179,0.0037,0.0344,0.0636,0.0376,-0.0278,-0.017,-0.0097,0.028,-0.0346,-0.0369,0.0157,0.0379,0.0324,0.0608,0.0607,-0.0117,0.0042,0.0126,0.0531,0.0115,0.0794,0.0064,0.0357,0.0237,0.007,-0.066,0.0078,-0.0008,0.0361,0.0182,-0.0049,0.0223,0.0179,-0.0263,-0.0458,0.0345,0.014,-0.0422,-0.003,0.0252,-0.0141,-0.0314,0.0095,-0.0053,0.0664,-0.0152,0.0406,0.0707,-0.0774,0.0479,-0.0386,-0.0589,-0.0282,-0.0283,-0.0365,0.0249,0.0638,-0.0129,-0.0151,-0.0636,-0.0217,-0.013,0.0147,0.0294,0.0351,0.0442,0.0559,0.0307,0.0288,-0.0185,0.0103,0.0669,-0.0207,0.0358,0.0035,0.0186,0.0114,-0.008,0.0576,-0.0379,-0.0136,-0.0,-0.081,-0.0043,0.028,-0.0603,0.0049,0.0234,-0.0291,0.0321,-0.006,-0.0013,0.0504,-0.0025,0.0009,0.0029,0.0215,0.0088,-0.0187,0.0196,0.0171,-0.0376,0.0398,-0.0048,0.0572,0.0336,-0.0166,0.0521,0.0574,0.108,0.0702,-0.054,-0.0908,0.032,0.004,0.0281,0.0064,0.0457,0.0122,0.0239,0.0629,0.0692,0.0117,0.0041,-0.033,-0.0164,0.0142,0.0072,0.0011,-0.0282,0.0086,-0.0274,-0.0076,-0.0066,0.0229,-0.0159,0.0341,-0.0073,0.0388,-0.0282,-0.1327,0.0004,-0.0529,0.0182,-0.0831,-0.0456,-0.1266,-0.0084,0.0203,0.0604,0.0239,-0.0279,-0.131,-0.1109,-0.0681,-0.0181,-0.0142,-0.0017,-0.0332,-0.0754,-0.0273,-0.0309,0.0993,0.0094,0.0535,-0.0267,0.0091,-0.0104,-0.0418,-0.0347,-0.0133,-0.0299,-0.041,0.0125,-0.0452,-0.0209,0.0142,0.0048,-0.0338,0.0372,-0.0174,-0.0257,-0.0172,-0.0032,-0.0378,0.0157,0.0327,-0.0453,0.0034,-0.0303,0.0194,0.0009,0.0308,-0.0049,-0.0156,0.0717,0.0791,-0.1033,-0.0265,-0.0481,-0.0015,0.0146,0.0362,0.062,0.0475,0.0634,-0.0123,-0.0095,0.0053,0.0547,-0.0479,-0.0526,0.0545,0.0,0.0474,0.0342,-0.107,0.0333,0.0004,0.1023,0.0349,0.0148,-0.0465,-0.0019,0.0015,0.0623,-0.0266,0.0552,0.0023,0.026,-0.0205,0.0177,0.0088,-0.0016,0.0092,-0.1175,-0.0154,0.0088,0.052,0.0685,0.0334,0.0297,0.0395,0.0348,-0.0275,0.0756,0.0361,0.0038,0.0096,-0.0129,0.05,-0.0125,0.0265,0.0157,0.0385,0.0303,0.098,0.0612,-0.0354,0.0119,0.0751,-0.0112,-0.0719,0.013,0.0063,0.0042,-0.0297,-0.0858,-0.0523,0.064,0.0546,0.046,0.0143,-0.0626,-0.0038,0.031,-0.0086,0.0244,-0.0399,-0.0442,0.0049,0.0029,-0.0827,0.0591,0.0481,0.0362,0.01,-0.001,0.012,0.0415,0.0151,0.0016,0.0322,0.022,0.0067,-0.0113,0.0754,-0.1933,-0.1965,-0.0951,-0.0446,-0.0196,-0.1356,0.0667,0.06,0.0489,0.0091,-0.0399,-0.0727,-0.0247,-0.0605,-0.111,-0.0231,-0.1742,-0.0337,-0.0116,0.0212,-0.0107,-0.0457,-0.0086,-0.029,-0.0301,0.0267,0.0142,0.0391,-0.0272,-0.0023,0.0234,0.0579,0.0516,0.0677,0.0071,-0.0602,0.0086,-0.0417,-0.0301,0.0088,-0.001,-0.0046,-0.0019,0.0339,0.0197,0.0068,-0.0253,-0.03,-0.0741,-0.0007,0.0073,-0.0106,-0.1189,-0.055,-0.022,-0.0438,-0.0506,-0.1001,-0.0557,0.0224,0.0161,-0.0038,-0.0027,-0.004,-0.0322,-0.0573,-0.0443,0.0289,-0.04,0.0057,-0.1018,-0.0113,0.0014,-0.0223,-0.0268,-0.0169,-0.0618,-0.0494,-0.0634,-0.0226,-0.0396,-0.0854,0.0427,0.0763,-0.0069,-0.0239,-0.1149,-0.0773,-0.0112,0.0163,0.0497,0.0347,0.0061,-0.1459,-0.0514,0.0054,0.0197,0.0584,0.0983,0.0693,0.0661,0.0552,0.053,-0.002,0.018,0.0304,-0.1295,-0.1124,-0.0616,0.0543,0.0099,0.0284,0.033,0.0016,0.0309,0.0289,-0.0566,-0.0185,-0.0056,-0.0212,0.0193,-0.0384,-0.0239,0.0085,-0.005,0.0212,0.0287,-0.063,-0.0557,0.0428,0.0348,-0.0121,-0.0488,0.0146,0.0226,0.0098,0.0213,0.0008,-0.0004,-0.0351,0.0363,-0.0626,0.0658,-0.053,-0.0557,-0.0146,0.033,0.004,-0.017,-0.0142,0.015,0.0369,0.0953,0.0767,0.0016,0.0623,-0.0096,0.0425,0.0414,0.0259,0.0133,-0.0627,-0.0546,-0.0657,-0.0203,-0.0794,-0.0302,0.0311,-0.0398,0.0455,0.0313,-0.0298,0.0186,0.0149,0.0327,0.0436,-0.0315,-0.0246,-0.0208,0.0561,0.0766,0.0194,0.038,0.0369,-0.0903,0.0376,0.0048,0.013,0.0162,0.0267,0.0423,0.0304,0.0705,0.0475,0.0814,0.0632,0.0178,0.0102,0.009,-0.0214,-0.0268,-0.0676,0.0096,0.0409,-0.059,0.045,0.0217,0.0387,0.017,0.0426,0.0376,-0.0024,-0.0159,-0.0088,0.054,0.0216,0.0445,-0.0221,-0.0356,-0.0416,0.0068,-0.0318,0.039,0.0431,0.0193,-0.0062,0.0087,-0.0027,0.0286,-0.0193,0.0121,0.012,0.0102,-0.016,-0.01,0.0059,0.0136,-0.0321,-0.0052,0.0485,-0.1047,0.0038,-0.0912,0.0341,-0.1462,-0.1563,-0.0065,0.0265,0.0196,-0.0188,-0.0335,-0.0481,-0.045,-0.0621,0.0056,-0.022,-0.0014,-0.0471,-0.0074,0.0287,0.074,0.0551,0.0632,-0.0139,0.0255,0.0712,0.0181,-0.0083,-0.0026,0.0099,0.0152,0.0275,-0.1217,-0.0262,0.0329,-0.218,-0.0365,-0.0241,-0.0052,-0.0395,-0.1004,-0.0795,0.0046,-0.008,-0.0096,0.0052,0.0114,-0.0564,0.0309,-0.0211,0.024,0.0256,0.0022,-0.0901,-0.0483,0.0495,-0.0003,0.0154,0.0416,0.0005,0.043,0.0088,-0.0098,0.0216,0.0026,0.0641,0.0367,-0.0172,0.0647,0.0353,0.0392,0.0091,0.048,0.0427,0.0488,0.0493,0.0395,0.008,0.0445,0.0736,0.0547,0.0106,-0.0207,0.0069,-0.0222,0.0262,-0.0427,-0.0079,-0.0098,0.0239,0.0048,0.016,0.0281,0.0733,0.0693,0.0157,-0.0072,0.0685,0.0609,-0.0051,0.0075,0.0383,0.0449,0.0559,0.0609,-0.0109,-0.0184,-0.0423,0.0205,-0.047,-0.0117,-0.0256,-0.0354,-0.0924,0.0389,-0.0763,0.0622,0.0324,-0.0059,0.0116,0.0085,0.018,-0.0739,-0.0544,-0.0191,0.0238,-0.0876,0.06,0.0568,-0.0194,0.014,0.0665,0.0713,-0.0141,-0.0113,-0.0681,-0.0625,0.0856,0.0762,-0.0839,-0.0986,-0.0259,-0.0592,0.0089,0.0243,0.0312,0.0786,0.0317,0.0424,0.0554,0.0395,0.0181,0.0348,0.0251,0.0275,0.0139,-0.0791,0.0431,-0.0155,0.0053,0.01,0.0221,-0.0102,0.0076,0.007,-0.0031,0.0231,0.0131,0.0174,0.0206,0.0187,-0.022,0.0541,0.0351,-0.021,0.0454,-0.0074,0.0396,0.0022,0.0053,-0.0104,-0.0814,-0.054,0.0015,-0.0126,-0.0348,-0.025,-0.0097,0.057,0.0299,0.0311,-0.0478,-0.0142,-0.0888,0.0339,-0.0136,0.0322,0.0313,-0.0584,-0.0083,-0.0453,-0.0457,0.0219,0.0812,-0.043,0.0326,0.0156,0.0302,-0.0222,-0.0356,0.0719,0.0283,0.02,0.0388,-0.007,0.0572,0.0176,0.0305,-0.069,-0.0404,0.0123,0.0299,0.0742,0.033,-0.0478,-0.0414,-0.0353,0.0123,-0.0042,-0.0026,0.0636,0.0165,-0.0434,0.0517,0.0051,0.0429,-0.1675,0.0564,-0.0411,0.0263,0.0353,0.06,0.0534,-0.0308,0.0093,0.0329,-0.0414,-0.031,-0.1023,0.0374,0.0163,-0.1033,-0.005,-0.0124,0.0012,-0.0158,0.0199,-0.0111,0.0327,0.036,-0.0326,-0.0993,-0.0124,-0.0497,-0.0714,0.0177,-0.005,-0.0634,-0.0611,-0.0405,-0.0359,-0.0205,-0.0141,-0.0093,-0.0447,-0.0534,-0.1569,-0.0874,-0.0666,-0.1113,0.0034,0.054,0.06,0.0628,-0.0142,0.0087,0.0564,0.0697,0.0305,-0.0819,-0.0728,0.0819,0.0935,0.0333,-0.0281,0.0302,0.05,-0.0086,0.0163,0.039,-0.0311,0.0136,0.0197,-0.0135,-0.019,0.0142,-0.0658,0.096,0.1,-0.0744,0.0139,0.0023,-0.0008,-0.0053,0.0356,0.0339,0.0102,0.0775,-0.0273,-0.0529,0.0113,-0.0326,-0.0174,0.0186,0.0142,0.0139,0.005,0.05,-0.0434,0.0299,0.0124,0.0095,-0.0249,-0.0628,-0.0098,0.0291,-0.0369,-0.0006,0.0191,-0.0055,emotion regulation
trm_4a3fd79d0aab0,-0.0743,-0.0966,-0.0608,-0.1284,0.0005,-0.0372,-0.0517,0.0053,0.0045,-0.0687,-0.0022,0.018,-0.0909,-0.0983,-0.1587,-0.0644,-0.0957,-0.1517,-0.0552,-0.0917,-0.0782,0.0083,-0.0716,0.021,-0.0471,-0.0166,-0.016,-0.141,-0.1553,-0.0621,-0.1138,-0.1016,-0.1143,-0.0837,-0.1296,-0.1328,-0.0213,-0.0362,-0.1346,-0.0229,-0.1025,-0.1194,-0.0274,0.0661,-0.1102,-0.1368,0.1495,-0.0408,0.0629,-0.0812,-0.0662,0.0671,0.045,0.0224,-0.0795,-0.0684,-0.0859,-0.0174,0.0335,-0.0274,0.0098,0.0347,-0.1853,0.0963,-0.0053,0.1371,-0.2159,-0.2649,-0.1344,0.005,0.0502,0.0576,0.1217,-0.0849,-0.1491,0.0254,-0.1068,0.0426,0.0297,-0.0084,0.0532,0.0859,-0.0738,-0.1289,0.0289,0.0651,-0.0141,0.0236,0.0284,-0.1063,-0.0636,0.0427,0.0345,0.1946,0.1892,0.1575,0.1471,0.022,0.268,0.1475,0.0207,0.0326,0.1383,0.1481,0.101,-0.1039,-0.2326,0.1772,-0.0264,-0.0416,0.0082,-0.1103,0.0944,0.1928,0.0427,-0.0257,-0.1275,0.1147,0.0026,-0.0288,-0.157,-0.1911,-0.1557,0.0074,-0.0946,-0.1767,-0.1438,0.0639,0.1257,0.0723,-0.0845,-0.0839,0.0163,-0.2368,-0.0216,-0.2234,0.0201,-0.1338,-0.0683,-0.0025,-0.0885,-0.1186,0.0288,-0.0567,-0.0898,0.0762,-0.0364,0.0132,-0.0941,0.0635,-0.0525,-0.0974,-0.1377,-0.1658,0.1214,0.0258,0.0758,0.0041,0.0364,-0.0279,-0.066,-0.1023,-0.2517,-0.2228,-0.0054,0.0288,0.0021,-0.2475,-0.2407,-0.0393,0.0325,-0.137,0.1056,-0.2079,-0.153,-0.1809,-0.1311,-0.1357,-0.0734,-0.0462,-0.1576,0.1479,-0.063,0.0212,-0.0313,-0.0555,-0.0405,-0.0907,-0.0417,-0.2134,-0.2,-0.0466,-0.0462,-0.1755,-0.1587,-0.2577,-0.2231,-0.0817,-0.0405,-0.0712,0.0001,0.2362,-0.2174,-0.1927,-0.0193,-0.051,-0.1709,-0.0306,-0.0514,0.0218,-0.1692,-0.0518,0.0367,0.0488,0.0524,0.015,0.102,-0.1207,-0.047,0.0219,0.1469,-0.1579,-0.1451,-0.0463,0.0923,0.0366,-0.0941,0.1366,-0.0257,0.1477,0.0309,-0.1463,0.171,-0.1323,-0.1231,0.1578,-0.0788,0.006,0.0117,-0.1218,0.0161,-0.1962,-0.0494,0.0125,-0.0932,-0.1148,-0.0814,-0.1231,-0.0549,-0.1261,0.0304,0.0685,-0.0195,0.0649,0.0343,-0.1962,0.0178,-0.076,0.1387,0.1945,0.0313,0.1929,-0.1401,0.0432,0.1712,0.283,0.0858,-0.0455,0.0243,-0.0827,-0.0656,-0.0001,-0.2009,-0.0657,-0.0328,0.0992,0.006,-0.0672,-0.0325,0.0645,0.104,-0.1168,-0.0972,-0.3192,-0.2545,-0.0822,0.036,0.0923,-0.1071,-0.1488,-0.0431,-0.1042,-0.0348,-0.0855,-0.0952,-0.0207,0.0033,0.0927,-0.0521,0.1461,0.0617,-0.1993,-0.1046,-0.0804,0.0498,0.0666,-0.0986,-0.056,0.045,-0.0064,0.0132,0.0131,-0.1697,0.0506,0.0663,-0.0335,0.155,0.0386,0.0504,-0.166,-0.0283,0.0233,-0.1958,-0.2502,-0.0778,-0.0882,-0.0141,-0.0595,-0.0548,-0.0749,0.0372,-0.0842,-0.0227,0.0044,0.0322,0.1714,0.0821,-0.014,-0.0344,-0.1757,-0.1504,0.0448,0.1095,0.0614,0.1008,0.0725,-0.1594,-0.1182,-0.0869,-0.0769,-0.0936,0.1427,0.025,0.0403,-0.0073,-0.007,-0.0259,-0.141,-0.0789,-0.0977,-0.0368,-0.042,-0.0211,0.0005,0.0147,0.1207,-0.1281,0.1836,0.0455,-0.1177,-0.0522,0.0317,-0.0085,0.1466,-0.1488,-0.0092,-0.0976,0.0892,0.1444,0.1803,0.1954,0.1076,-0.0821,0.036,0.0417,0.0955,-0.1453,-0.0004,0.043,-0.037,0.0201,-0.0535,0.0029,-0.0921,0.1883,0.1765,0.0362,-0.1239,-0.0508,-0.0568,-0.0512,0.0473,-0.0122,0.006,0.036,0.0541,0.0254,-0.0128,-0.1173,-0.0047,-0.0375,-0.1728,-0.0871,0.1841,-0.1335,-0.0522,0.2368,-0.0238,-0.1285,-0.0696,0.0154,-0.1889,-0.1029,-0.3843,-0.3451,-0.1088,-0.2024,-0.0394,-0.1337,-0.1031,-0.0763,0.0892,-0.0608,-0.0145,0.016,0.0682,0.0531,0.0295,-0.2496,-0.133,0.0171,0.0788,0.0016,0.0418,-0.0073,-0.0814,0.0377,0.1529,-0.2211,-0.1723,-0.0408,0.0857,-0.1535,-0.0891,0.0159,-0.2191,0.0339,-0.0977,-0.0986,-0.0211,0.0199,-0.1064,-0.0808,-0.0149,-0.1376,-0.1374,0.0287,0.3428,-0.0723,0.014,0.0316,0.0523,0.059,-0.0399,-0.0831,-0.0683,0.0556,0.0637,-0.0067,-0.0491,0.1418,0.047,0.0439,0.0694,0.0616,0.1212,-0.0012,0.0234,-0.0944,-0.0241,0.0944,0.1775,-0.1819,-0.2111,0.0701,0.0145,-0.1833,-0.0224,0.0061,-0.1247,-0.1159,0.0036,-0.0717,-0.1358,-0.0864,-0.1252,-0.0248,-0.0765,-0.0535,0.1503,-0.1741,0.0851,-0.0933,0.0282,0.1216,0.0525,-0.1084,-0.0764,0.1721,-0.0785,-0.0931,-0.066,0.0837,0.0421,0.1486,0.0555,0.1522,0.1709,0.102,0.0747,-0.0893,0.0022,-0.0365,-0.2857,-0.084,-0.0035,-0.2186,-0.1663,-0.05,-0.135,-0.0473,0.0016,0.021,-0.0206,-0.1137,-0.03,-0.0113,0.0486,0.0296,-0.0689,0.1136,-0.0698,-0.1035,0.0437,-0.0187,-0.1618,0.1775,0.037,0.0888,-0.0403,-0.1152,0.0087,-0.168,0.0387,-0.1063,0.0532,0.0984,-0.1234,-0.0451,-0.0723,-0.1542,-0.0831,-0.1071,-0.012,0.1781,0.1335,0.0809,0.0364,0.0689,0.0417,0.0067,-0.1214,-0.0401,-0.0546,0.1152,-0.0239,0.0684,0.0225,0.0854,-0.0205,-0.0983,-0.0499,0.068,0.0819,-0.0479,0.0278,-0.2171,-0.0819,0.164,-0.0326,0.0319,0.0688,0.0774,0.0403,0.0563,0.1495,-0.0609,-0.1271,-0.1177,0.0189,-0.1248,-0.0179,0.0125,-0.0404,-0.26,-0.0868,-0.0939,-0.0299,-0.0006,-0.2335,-0.0666,-0.2293,0.1062,0.0024,-0.0548,0.0908,-0.1143,-0.123,-0.0512,0.0277,0.1159,0.1407,-0.0933,-0.0322,-0.0321,0.0705,0.0523,-0.0364,-0.0533,-0.0684,-0.0589,0.1102,0.024,0.0987,-0.1424,-0.0518,-0.3142,-0.1638,0.1467,-0.2806,-0.0109,-0.221,0.1687,-0.2081,-0.0496,-0.0944,0.132,-0.0235,-0.0309,-0.1466,-0.2137,0.1539,0.1977,0.089,0.0617,0.0844,0.0015,-0.1412,0.0396,0.0452,-0.0246,-0.0645,-0.0593,-0.0417,-0.0739,-0.0901,0.3017,-0.1198,0.0383,-0.055,0.0068,0.0875,0.031,0.0266,0.1671,-0.2051,-0.0637,0.0216,0.0305,0.0429,0.1014,0.1681,0.1485,0.064,0.0781,-0.0617,0.0606,-0.0565,-0.0665,-0.0435,0.0315,-0.003,-0.0071,-0.1215,-0.0677,-0.0193,-0.1837,-0.1618,-0.1277,0.0426,0.0978,-0.0042,-0.0683,0.0604,-0.0451,-0.0702,-0.0187,0.0659,-0.1399,0.0019,0.1588,-0.0735,-0.4159,-0.4031,-0.3003,-0.0154,-0.0654,-0.1403,-0.0378,-0.0416,0.0797,-0.0428,-0.027,0.1095,0.0951,0.0159,-0.0941,0.0406,0.0828,0.1903,-0.1933,-0.0222,-0.0977,0.0413,-0.0122,-0.1365,0.0691,0.0583,-0.0666,0.004,-0.0222,0.0682,-0.1869,-0.2773,-0.2314,-0.1676,0.057,0.1997,0.0015,-0.0787,-0.0415,0.1088,0.0788,0.0704,0.072,0.0498,-0.1431,-0.0997,0.0059,0.1037,0.1031,0.133,-0.0226,-0.0119,0.0356,-0.047,0.0976,-0.1039,-0.1642,-0.0136,-0.1697,-0.1343,-0.0855,0.0929,0.1058,0.0582,-0.0058,0.0046,0.0005,0.11,-0.0053,-0.1388,0.0578,-0.0407,0.0179,0.0252,0.0985,-0.1222,0.0656,-0.1754,-0.1807,0.101,0.1025,0.1774,-0.0531,0.0004,0.0503,0.0138,-0.0473,0.2413,0.0308,0.0544,0.152,0.1755,0.0572,0.0206,0.2143,0.2029,-0.0673,0.0395,0.0548,-0.216,-0.2217,0.0262,-0.0878,0.0172,-0.2725,-0.1191,-0.172,-0.1285,-0.222,0.0267,-0.0309,0.077,-0.0929,-0.0,-0.0467,0.1299,0.1122,-0.0042,0.0486,0.1155,0.0362,0.0161,0.0409,-0.0195,0.0824,0.1045,-0.1343,0.1247,0.0449,-0.0048,-0.0478,-0.127,-0.0799,0.0942,-0.0386,-0.4092,-0.2351,-0.0399,0.0723,0.0968,-0.0146,0.0027,0.0898,0.103,-0.0391,-0.0871,0.1003,-0.084,-0.0244,-0.2363,0.1996,-0.0849,0.0923,0.0183,-0.044,0.0333,-0.3187,-0.2924,-0.0783,0.2055,-0.0807,-0.0733,-0.1065,0.0594,0.0144,-0.1353,-0.0578,-0.1424,0.0637,-0.03,0.0751,0.1231,-0.0435,0.1078,-0.2258,-0.1161,-0.0191,0.1116,-0.1146,0.037,0.1144,0.0867,0.1043,0.3121,0.1408,-0.0689,-0.0663,-0.1114,-0.0897,-0.0201,-0.0311,0.0702,0.1917,0.0862,0.0358,-0.0868,0.0924,0.2349,0.0876,0.0022,-0.0298,-0.1054,-0.0393,-0.0213,-0.0196,0.0592,0.0046,-0.1159,0.0085,0.1199,0.0144,-0.1061,-0.0187,0.0605,-0.074,-0.0535,-0.0654,-0.1197,-0.1225,-0.28,-0.2109,-0.2883,0.0042,-0.0651,-0.1083,-0.1823,-0.1269,-0.1765,-0.1157,-0.2139,-0.1282,-0.1538,0.0561,0.0202,0.0963,-0.0226,0.0486,0.0511,0.0249,0.1056,0.0858,0.1033,0.0662,-0.0272,-0.011,0.0333,-0.0436,0.0433,0.0563,0.078,-0.0362,0.0965,-0.012,0.0914,-0.0412,-0.0202,-0.0135,0.0449,-0.0277,0.0664,-0.1943,-0.105,-0.1032,-0.2057,-0.1422,0.1152,0.0944,0.1125,0.0829,0.1547,0.1111,0.0265,0.0325,0.0104,-0.0265,0.0668,-0.0086,-0.0036,-0.0677,-0.0875,-0.0778,0.0964,0.0656,-0.1064,-0.0826,-0.1146,-0.234,-0.1702,0.1259,0.1033,0.1205,0.1274,0.0489,-0.1752,-0.0833,0.0247,-0.0207,-0.0288,0.0013,0.014,-0.0297,0.0536,0.0234,0.0163,-0.1503,-0.0139,-0.1068,0.0239,-0.1152,0.0561,0.1833,0.3128,0.0138,0.0139,-0.0399,-0.0127,-0.023,-0.083,-0.0663,-0.1002,0.0125,0.0407,0.1074,-0.0076,-0.0239,0.0183,0.0301,-0.0406,0.0489,-0.1349,-0.1358,-0.2116,-0.1303,0.2325,0.0304,0.1083,-0.1732,0.2482,0.1105,-0.0237,-0.0227,-0.0084,0.0105,-0.0422,0.1224,-0.1234,-0.1263,-0.0387,-0.0295,-0.1573,-0.0777,-0.0708,0.006,-0.0132,-0.0619,-0.0658,-0.0636,0.0308,0.076,-0.02,0.0521,0.0029,-0.105,0.045,-0.0771,0.0135,-0.0396,-0.0884,0.3887,0.2742,0.3181,0.2011,0.218,0.097,0.2983,0.1944,-0.1639,0.2387,0.235,0.1496,0.1446,0.1644,-0.0017,0.0542,-0.009,-0.0205,0.0333,-0.0175,0.08,0.0049,-0.1514,0.0699,0.0698,0.0272,0.1051,-0.0531,-0.1583,0.0566,-0.0265,-0.1109,-0.0378,-0.0742,0.1088,0.0901,0.1797,-0.041,-0.2342,-0.1125,-0.0538,0.0079,0.1145,0.1177,0.0464,-0.0864,-0.2133,-0.1227,-0.0672,0.2367,-0.0697,0.2554,0.219,-0.0937,0.0328,0.0025,0.2446,0.2434,0.2168,0.175,0.1481,-0.002,0.0403,0.0733,-0.0515,-0.2189,0.0344,-0.0857,0.1614,-0.012,-0.1063,0.004,-0.1302,-0.0628,0.0517,-0.0373,-0.0601,0.1349,0.1404,-0.0502,-0.0049,-0.0519,0.119,0.0901,0.0722,-0.1729,-0.1731,-0.1068,-0.0943,-0.0109,-0.0881,-0.0871,-0.014,-0.0437,0.0724,0.0342,0.0684,0.2407,-0.022,-0.0377,-0.0972,0.1024,0.0492,0.1326,-0.0945,0.1281,0.2675,0.0437,-0.1582,0.1934,0.162,-0.0934,-0.1635,0.0254,-0.1955,-0.0757,-0.3106,-0.0539,0.1823,-0.0902,-0.0982,0.0791,-0.0817,0.0162,-0.0597,-0.0684,-0.0573,-0.119,-0.0356,0.0543,-0.0285,0.3351,0.2264,0.2588,0.2932,-0.1883,0.0054,-0.0858,-0.0934,-0.1274,-0.0493,0.0645,0.1672,-0.1529,-0.0905,0.0726,0.0821,-0.0129,0.1207,0.035,0.0399,0.0073,0.188,-0.0906,-0.0781,-0.036,0.109,0.0336,-0.0428,0.0171,0.0171,-0.2039,0.0099,-0.0362,0.0038,0.0118,0.0466,-0.0569,0.2481,-0.2857,-0.2734,0.0444,-0.0325,-0.1944,-0.2077,-0.1618,-0.0424,-0.0235,-0.0774,-0.0304,-0.0135,0.1946,0.0043,0.064,-0.089,0.1015,0.0187,0.0141,0.0708,-0.0285,-0.1031,-0.0271,-0.1154,-0.1042,-0.1246,0.0421,0.0781,-0.0361,0.2291,0.1371,0.2497,0.031,0.2264,-0.0906,-0.0462,-0.0121,-0.1645,0.0388,-0.1817,-0.2151,0.0158,-0.0806,-0.2244,0.0482,-0.0171,-0.2018,0.004,-0.0083,0.0337,-0.1674,-0.0307,-0.0762,-0.1038,-0.032,0.0309,-0.0572,0.234,0.1667,0.1812,0.1366,0.0213,0.0769,-0.0395,-0.0778,-0.0751,-0.0026,-0.12,-0.0473,-0.1359,-0.0064,0.0083,0.0203,-0.0294,-0.1335,-0.1535,-0.0031,0.0156,0.0367,0.0027,-0.0194,0.0503,-0.0382,-0.1399,-0.1263,-0.211,-0.1169,-0.0323,-0.1236,-0.1417,0.0036,0.0096,0.0143,0.0488,0.0144,-0.1247,-0.1361,0.0628,-0.1554,0.028,0.0431,-0.0021,-0.0005,-0.2143,-0.0208,0.164,-0.0439,0.0045,0.0455,-0.0527,0.1643,0.0057,0.0474,0.0114,-0.2217,0.1109,-0.0211,0.1003,0.2218,0.102,0.0231,-0.054,-0.0033,0.1539,-0.0906,0.0088,-0.1346,-0.0641,-0.1831,-0.136,-0.0523,0.0619,-0.0348,-0.0989,-0.1984,0.0207,-0.0136,-0.0169,-0.0018,-0.1214,0.0123,-0.0092,-0.0753,0.0862,-0.0206,-0.0535,-0.0477,-0.1047,-0.0607,-0.0427,-0.114,-0.037,0.0429,-0.0241,0.1161,-0.0675,-0.0386,-0.033,0.0624,0.0243,-0.1157,-0.256,0.0723,0.0076,0.1395,-0.0023,0.0479,0.0277,0.069,0.0467,-0.0674,-0.0451,-0.084,-0.0102,-0.2505,0.0454,-0.0627,0.0275,-0.0198,-0.0381,-0.1011,-0.1641,-0.1903,0.1124,0.0245,-0.004,0.3057,0.0772,0.043,0.0838,0.1354,-0.0091,-0.0504,0.0484,0.1566,-0.0379,0.0222,-0.0226,-0.0423,-0.0778,-0.0912,0.0338,0.0585,0.034,0.1683,0.1703,-0.0886,-0.0829,-0.0578,0.053,0.0885,0.0307,-0.1565,-0.0506,-0.0016,-0.1243,-0.0637,0.06,0.0961,0.0512,-0.0018,0.0948,-0.0097,-0.1807,-0.0938,-0.0074,-0.0529,-0.1485,-0.1715,-0.0695,-0.1926,-0.086,0.1076,-0.0329,-0.0595,-0.0247,0.0199,0.1305,0.2016,-0.0156,0.0583,-0.0018,-0.0559,-0.0672,-0.0886,0.0651,0.0285,0.0453,0.1803,0.1185,0.0769,-0.0358,-0.0585,-0.0233,0.378,0.3756,-0.2091,-0.2029,0.0884,-0.054,-0.0269,-0.0231,-0.1697,0.0865,-0.0702,-0.0473,-0.0195,0.0089,0.2734,-0.0838,0.1877,0.0535,0.0323,0.0719,0.3153,0.1027,-0.057,0.2083,0.0292,0.0891,0.0849,0.0254,-0.0811,0.0894,0.0153,0.0048,-0.0002,-0.0344,-0.0477,0.0023,0.0302,-0.1738,-0.1798,-0.1375,0.1248,-0.1458,0.0211,0.0925,-0.1029,-0.1229,-0.0123,0.0458,-0.1297,-0.0381,0.0615,-0.0604,0.0323,-0.1323,0.0633,0.1217,-0.1003,-0.1171,-0.0125,0.0132,0.0155,0.1422,0.1744,0.1404,-0.0019,0.1177,0.005,0.0096,0.3868,-0.1402,-0.2431,-0.0184,-0.1902,0.1106,0.0996,0.1481,-0.0783,0.0608,0.0233,-0.0083,0.0415,0.0954,-0.0316,0.0195,0.0405,0.0783,0.0758,0.1538,0.268,0.2663,-0.0111,-0.0627,-0.1034,-0.0341,0.0753,0.0429,-0.0773,0.0506,0.0404,0.0105,0.149,0.0386,-0.2494,-0.1332,-0.0261,0.0797,0.0269,0.1066,0.0173,0.2059,0.1677,-0.0103,-0.0433,-0.1007,0.028,0.0145,0.091,-0.1121,-0.1362,-0.1172,0.0426,-0.0732,-0.0434,0.1896,-0.1329,-0.1004,0.0187,0.2016,0.0617,0.1984,0.025,0.0061,0.0512,0.0432,0.1833,0.1696,0.1683,-0.0086,0.0478,0.0411,0.0509,-0.0809,0.1547,-0.1685,-0.1014,-0.0868,-0.1322,0.0049,0.0738,-0.0411,0.1222,-0.0476,0.096,0.0911,0.0872,-0.0618,-0.0316,-0.0343,-0.0058,0.0096,0.0767,0.1822,0.1073,0.1864,-0.2379,-0.1523,-0.1895,-0.0138,0.0079,-0.123,-0.1133,-0.0654,-0.1329,-0.0814,0.123,-0.0062,0.1455,0.1228,-0.0097,0.1187,-0.0102,0.0096,0.0381,0.0281,-0.1906,-0.0148,-0.128,-0.0704,-0.0979,0.0249,0.109,0.253,0.126,0.0278,0.0601,-0.0688,-0.3034,-0.1829,-0.2156,-0.1582,-0.0078,-0.0008,0.0702,-0.1543,-0.191,-0.1176,-0.0741,-0.0295,0.0061,-0.0078,-0.0585,0.0411,-0.0134,-0.161,-0.1284,-0.1123,0.1053,0.0324,-0.0153,-0.3835,-0.1386,-0.1736,-0.1358,-0.4618,-0.0022,-0.0729,0.0096,-0.0804,-0.0397,-0.0541,-0.0251,-0.1474,-0.0515,-0.2374,-0.0108,0.0326,0.0701,-0.0132,0.0771,-0.1967,-0.0043,0.0429,0.1862,-0.0669,-0.0375,-0.1472,0.1677,-0.2945,-0.3359,-0.2818,-0.0766,-0.069,-0.1541,-0.1282,-0.0901,-0.0296,-0.0466,0.005,0.0134,-0.2221,-0.001,-0.0515,-0.086,-0.0415,-0.0487,-0.0933,-0.1518,0.0148,-0.0548,0.1497,-0.0296,-0.1377,-0.2973,-0.1368,-0.2043,-0.0637,-0.3541,-0.2848,0.0336,0.1024,0.0429,0.0067,-0.0525,-0.0517,0.1736,0.2136,0.1695,-0.3848,-0.4075,0.0147,0.116,-0.0035,-0.0294,0.0389,-0.1159,-0.0297,-0.029,-0.0706,-0.0713,0.0071,-0.0662,-0.0676,0.0313,-0.1175,0.0627,-0.0475,0.0149,0.144,0.1158,-0.0228,-0.1561,-0.2737,-0.1492,-0.0898,-0.2481,-0.1272,0.2404,-0.0641,-0.1036,0.2478,0.161,0.1447,0.1976,0.0982,0.1323,0.1784,0.1057,0.1012,0.0942,0.094,0.1537,0.1852,0.282,0.2305,-0.3001,0.0661,0.0627,0.2573,-0.0749,-0.0876,0.093,-0.0534,0.0019,0.0683,0.1356,-0.0166,0.026,-0.003,-0.035,-0.0609,0.0928,-0.0714,0.0437,0.2124,0.216,-0.0056,-0.0181,0.0674,0.105,0.0654,0.0667,0.0155,-0.0077,0.0699,-0.363,-0.1573,-0.181,-0.1875,-0.127,-0.1654,-0.207,-0.1244,0.0016,-0.0987,-0.1036,-0.0544,-0.0625,-0.1701,-0.4167,0.07,-0.1763,-0.0368,0.0531,-0.1308,0.0551,-0.1514,-0.1196,-0.0309,-0.0633,-0.0909,0.017,-0.0681,0.0416,0.1582,0.1551,0.0295,-0.1321,0.015,-0.0311,-0.1511,0.0088,-0.1078,-0.088,0.1036,-0.0085,-0.0351,-0.0642,-0.1564,-0.0504,0.0109,0.0068,-0.0452,-0.0807,-0.1049,0.0126,-0.0173,0.0967,-0.1743,-0.0722,0.0747,0.0274,-0.0266,0.0174,0.0158,-0.1415,0.0219,-0.0577,-0.1265,0.1674,0.2657,0.2229,-0.0748,0.3691,0.2091,-0.1779,-0.0895,0.3338,0.2151,0.0833,0.1107,0.079,0.1161,-0.1271,-0.1214,-0.0707,-0.0799,0.4479,0.391,0.26,0.0904,0.1403,0.2174,0.4125,0.4025,0.3659,-0.0142,-0.0003,-0.0135,0.0173,-0.024,0.0329,-0.1924,-0.0623,-0.0013,-0.0877,-0.1628,-0.1573,0.1313,-0.0102,0.0094,-0.0115,0.0588,0.1569,0.1913,0.0527,-0.0266,0.0137,0.0018,-0.0349,-0.053,-0.0574,-0.0499,-0.0665,0.0762,-0.1754,-0.2472,-0.2152,0.0858,-0.0237,-0.0221,0.1606,0.0066,0.1538,0.1103,0.0935,0.2934,-0.0322,-0.1777,-0.242,0.1164,0.0611,-0.079,0.1164,0.0487,0.1498,0.1521,-0.0904,-0.0852,-0.0801,-0.0701,0.2165,-0.156,-0.0761,0.0243,-0.025,0.1124,0.0171,0.0086,0.1156,0.0135,-0.1022,-0.0051,-0.1392,-0.1672,-0.1802,0.0199,0.0131,-0.0117,0.0525,-0.026,0.0599,0.2396,0.2112,0.0718,0.1963,-0.1949,0.0169,0.0771,0.1761,0.25,0.2088,0.0335,0.0156,-0.0344,0.1445,0.1249,0.0454,0.0373,-0.0399,-0.0266,-0.1067,0.0327,-0.033,0.0252,0.0525,0.0129,0.078,0.0115,0.1829,0.0072,0.1045,0.0784,-0.2364,-0.1483,-0.0994,-0.1166,-0.1784,0.1521,-0.0138,-0.0341,-0.0434,0.2072,0.0586,-0.3258,0.0109,0.0565,-0.1857,0.0443,0.0428,0.059,0.1578,0.2197,0.3611,0.2573,0.1381,-0.0566,-0.0018,0.1537,-0.1137,-0.0954,-0.0046,0.0109,-0.0514,0.0419,-0.066,-0.0607,-0.2316,-0.288,-0.2852,-0.2341,-0.1297,-0.1586,-0.104,-0.1136,-0.0763,0.0509,0.0132,-0.0359,-0.0309,-0.0388,0.2286,-0.0131,0.0399,-0.06,0.0569,-0.0445,-0.0043,0.0422,-0.1396,-0.0831,0.1753,-0.0191,-0.0277,0.0069,0.0126,0.0712,0.0205,-0.0698,-0.0255,-0.0234,-0.002,0.0395,-0.1239,0.0652,-0.0058,0.0652,0.0508,-0.2378,-0.1172,-0.0017,-0.1051,-0.0574,-0.0465,-0.1016,-0.0461,0.087,-0.0139,0.0851,-0.3699,-0.1429,-0.1475,-0.3025,-0.2206,-0.1492,-0.1113,-0.1113,-0.0678,-0.0366,0.0838,-0.2019,-0.0275,-0.0259,-0.0414,-0.1253,-0.033,-0.4569,0.1103,-0.0815,-0.0135,-0.0297,0.2145,0.0201,-0.0347,-0.1503,-0.1093,0.0636,0.0643,-0.0477,0.1679,0.1211,0.1365,0.2631,0.1989,-0.022,0.0369,0.1048,0.0617,0.0121,-0.2662,-0.2438,-0.0424,-0.1199,-0.0402,-0.0291,0.0013,0.0749,-0.0084,-0.0579,0.057,0.0541,-0.095,0.118,-0.0629,-0.2746,-0.0886,-0.315,-0.0584,-0.0813,0.0541,-0.0984,0.2879,0.2731,0.0773,0.2335,0.1873,-0.0452,0.1461,-0.0124,0.234,0.1416,-0.0055,0.1554,-0.0663,0.0696,0.0505,0.0572,-0.0061,-0.0658,0.017,-0.0443,0.0117,0.1153,-0.0798,0.1303,0.0468,0.1314,0.0304,0.0034,0.2524,0.0242,0.0772,0.0484,0.0291,0.0027,0.03,-0.0949,-0.1342,-0.0577,0.1474,0.1034,-0.0054,0.0041,-0.0898,0.0267,0.0394,0.0491,0.0273,0.0266,0.032,-0.0389,0.1585,-0.0799,0.003,0.1505,-0.0414,-0.0738,-0.0955,-0.0906,-0.0335,0.017,0.0575,-0.0926,0.0763,0.0976,0.0896,0.0078,0.0383,0.1266,-0.0021,-0.0807,-0.0474,-0.1071,-0.0832,0.0315,0.0466,-0.0221,-0.0415,-0.0087,0.1296,-0.0685,-0.1778,-0.1214,-0.184,-0.1621,0.0467,0.0105,0.0633,-0.1856,-0.1469,-0.1491,-0.0421,-0.1006,0.0377,0.0408,0.0512,0.1175,-0.1347,-0.1049,0.0116,-0.0112,-0.0937,-0.0933,0.0626,0.0706,-0.1175,0.0575,0.0222,-0.072,0.0661,0.0657,0.0519,0.0622,-0.0051,-0.1992,-0.049,-0.1844,-0.2017,0.0234,-0.1043,0.0666,0.0743,0.1187,0.1108,0.131,-0.1255,-0.1717,-0.0135,0.1586,0.2651,0.0006,-0.0177,-0.0478,-0.0286,-0.1623,-0.0718,-0.1708,-0.1357,-0.0309,0.0153,-0.09,-0.1425,0.055,-0.0783,-0.0236,0.1254,-0.0272,0.0348,-0.211,0.0419,-0.0273,0.0194,-0.0158,0.0125,0.0384,0.0739,-0.0611,-0.0559,-0.0534,-0.0951,-0.0185,-0.0762,-0.3465,-0.0527,-0.0487,-0.036,-0.0354,0.0057,-0.0096,0.0187,-0.0904,0.0555,-0.1733,-0.0589,-0.1563,-0.1383,0.0451,-0.2179,-0.1558,-0.3081,-0.1519,0.0185,0.2036,-0.1432,-0.0126,-0.0468,0.0527,0.0289,0.0258,-0.1464,-0.2141,-0.093,-0.079,-0.0022,0.0865,-0.0294,-0.0464,-0.0923,0.1013,0.0725,0.0197,0.0909,-0.013,-0.0189,0.0364,-0.0065,-0.0407,-0.0516,-0.1199,-0.0647,0.0778,0.0381,0.1556,-0.0271,0.163,0.1396,0.1003,0.0343,-0.0399,-0.2076,-0.0844,-0.0219,0.2403,0.2325,0.12,-0.0254,0.0065,-0.0005,0.2303,0.1523,0.1326,0.1305,-0.2729,-0.0292,-0.0715,0.0622,-0.079,0.0374,0.094,0.0193,0.0818,0.066,0.0901,-0.0489,0.1126,0.0595,-0.1369,0.1593,0.0847,0.0061,-0.0243,0.0658,0.0374,-0.0042,-0.0145,0.0569,-0.014,0.1232,0.1615,0.2103,-0.003,0.0562,0.0155,-0.0462,-0.1736,-0.4186,-0.4124,0.0699,0.1097,0.0992,-0.0207,0.0271,-0.1127,-0.1644,-0.1765,-0.2017,0.0601,-0.0567,0.0194,-0.0369,0.0611,-0.0199,-0.1458,-0.0197,-0.1393,-0.1163,0.0881,-0.1432,0.0274,-0.2751,-0.1114,-0.0601,0.0107,0.0158,0.0909,-0.0499,-0.0676,-0.138,0.2271,-0.1494,0.1068,0.1218,0.1055,0.0178,0.0334,0.0346,0.2178,0.2148,-0.1088,-0.1345,-0.0808,-0.0309,-0.1322,-0.1198,-0.1005,-0.2947,-0.0957,0.0092,-0.0845,0.0853,-0.0799,-0.0255,-0.113,-0.1572,0.0205,-0.0113,-0.2246,-0.1033,0.0172,-0.0851,-0.2195,0.1373,0.157,-0.071,0.0592,0.09,0.0966,0.0088,-0.0345,-0.2051,-0.2608,-0.1282,-0.0758,0.0761,0.069,0.0014,0.0464,-0.0365,0.1451,0.3167,0.2005,0.0827,0.222,-0.3693,-0.3431,-0.1377,-0.0733,-0.0828,-0.0907,-0.1881,-0.0537,0.0257,-0.0762,-0.0813,-0.0519,0.1734,-0.107,0.1344,0.114,0.1252,0.0932,0.1326,0.0525,-0.1614,-0.0948,-0.1335,0.0283,0.1436,0.1539,0.0393,0.0903,0.1473,0.1696,0.2032,0.1481,0.0148,-0.13,0.0168,0.0041,-0.0146,0.0467,0.0615,0.0998,0.0241,0.0254,0.0462,-0.0639,-0.0066,-0.1985,-0.1378,-0.1044,-0.1166,0.3596,0.0099,0.1963,0.1208,0.0921,-0.0154,-0.0112,0.1522,-0.0281,0.1896,0.21,0.0771,0.1431,0.0736,0.0294,-0.1282,-0.0186,0.0446,0.0597,0.1496,0.125,-0.013,0.0328,0.071,-0.0093,0.0089,0.0396,-0.0989,-0.0887,0.0465,-0.0084,0.1046,-0.0907,0.0915,0.0351,0.1733,0.0719,-0.008,-0.0163,0.0735,0.0013,0.1441,0.2575,0.0492,0.1001,0.0272,0.1298,-0.1146,-0.1598,0.0152,0.0723,0.1422,0.0476,-0.0875,-0.0753,-0.1045,-0.0904,0.0399,0.2436,-0.0339,-0.0148,-0.1316,-0.1792,-0.3287,-0.2308,-0.2053,-0.1965,-0.1681,-0.0868,-0.0976,0.05,0.0133,-0.0023,-0.0227,-0.1073,0.0398,-0.0851,-0.0965,0.0836,0.1101,0.0587,-0.0157,0.2304,0.2712,0.1015,-0.0668,0.0851,-0.0409,-0.1064,0.05,-0.0008,0.0108,0.2076,0.1772,0.0006,-0.0071,0.0501,0.1343,-0.1357,-0.1332,-0.0877,-0.0895,-0.0409,-0.0349,0.0629,-0.0928,0.0876,-0.149,-0.0316,0.1893,0.004,-0.2508,-0.0303,0.1337,0.1574,-0.0659,-0.135,-0.469,-0.3594,-0.1834,-0.3654,0.1632,-0.0806,-0.1048,0.0341,-0.0065,0.0742,0.0407,0.026,0.221,0.1352,0.2812,0.1267,0.167,-0.0323,-0.0102,0.1504,0.0104,0.0146,-0.0017,-0.0302,0.2406,0.1446,-0.1497,-0.2221,-0.144,-0.0389,-0.1125,-0.0975,0.028,0.0093,0.044,-0.0527,0.0746,0.0375,-0.1497,-0.0266,-0.1499,-0.0125,-0.175,-0.1955,0.0273,0.0063,-0.0232,-0.082,-0.0246,-0.0109,-0.0629,-0.1694,0.0232,-0.1571,-0.0889,-0.0572,-0.0581,-0.0676,-0.1319,0.0019,0.0214,0.0386,-0.0903,-0.0749,-0.1362,0.0049,0.1125,0.1174,-0.0849,0.239,-0.0994,-0.1308,0.0467,0.1353,0.0317,0.0082,-0.092,0.019,-0.0717,-0.0465,0.1154,0.2679,0.317,-0.0404,0.0168,0.0203,0.0961,-0.0601,0.2189,-0.0656,0.3016,-0.0633,0.2312,0.2259,0.0917,-0.0434,-0.0398,0.0306,0.0472,-0.0083,0.0019,0.1405,0.0247,-0.0294,-0.0801,0.1056,0.1539,0.1124,-0.1986,-0.1644,-0.1878,0.0202,-0.1188,-0.1382,-0.0357,0.0251,0.0263,-0.029,-0.1087,-0.138,0.1216,0.002,-0.1734,0.1918,0.271,0.0537,-0.094,0.159,0.3189,0.1541,0.0356,0.1135,-0.0895,0.0128,0.2,0.1584,-0.142,0.2283,0.0556,0.0391,0.0957,0.3195,0.0803,-0.1039,-0.0781,-0.0233,-0.1055,0.048,-0.1398,0.0117,-0.084,-0.0843,-0.0698,-0.1973,-0.0808,0.1177,-0.1565,-0.2048,-0.0546,-0.0277,-0.097,-0.1376,-0.1953,-0.2343,-0.2252,-0.0959,-0.1053,-0.1971,-0.1377,0.1227,0.2158,-0.044,-0.0137,0.0082,0.0393,-0.0744,-0.0937,-0.0769,-0.0768,-0.0042,0.0574,-0.297,-0.3546,-0.0549,0.0116,-0.1282,-0.2627,0.0166,-0.073,-0.1296,-0.2418,-0.1132,-0.0661,-0.0439,0.0011,0.024,-0.0558,0.1415,-0.0793,0.074,0.1888,0.1514,-0.1448,0.0533,-0.2868,-0.1418,-0.0802,-0.0148,-0.0065,-0.0075,0.1253,0.1206,-0.0261,-0.1011,0.1007,-0.1813,-0.0161,0.1454,-0.1156,-0.0748,-0.1438,0.0667,0.0321,0.1515,0.0668,-0.3036,-0.2685,0.0639,0.083,0.0087,0.1507,0.1198,-0.0455,-0.1086,-0.1311,-0.0481,-0.1488,-0.262,-0.1197,-0.1192,0.0996,0.0011,0.1038,0.004,0.1905,-0.0297,0.0215,0.0263,0.0593,0.0692,0.0502,-0.0114,0.0153,-0.0985,0.0391,-0.0716,-0.0357,-0.0868,-0.0611,-0.0275,-0.0135,-0.0805,-0.0321,-0.1157,-0.063,-0.1793,-0.0197,0.0171,0.0606,0.0432,0.1418,0.028,0.0414,-0.0392,0.0143,0.007,-0.071,-0.1426,-0.1087,0.2391,0.1186,0.0901,-0.0691,-0.0239,-0.1293,-0.0794,-0.0263,-0.0288,0.0883,0.1395,-0.2072,-0.1537,0.0403,-0.152,-0.0336,-0.0178,0.3489,0.2708,-0.2439,-0.0105,-0.0609,-0.04,-0.0737,-0.1708,-0.1899,-0.1525,0.0844,0.0378,-0.0947,-0.0131,-0.123,0.0132,0.1571,0.0142,0.0634,-0.0153,-0.0245,0.048,-0.1499,-0.0322,0.0948,-0.1616,0.039,-0.2455,0.2595,-0.1715,0.2833,0.0162,0.0095,-0.2682,-0.24,0.057,0.1582,0.0186,0.159,0.0238,0.1041,0.0437,-0.0143,0.113,0.0555,0.047,0.0576,0.057,0.049,0.1379,-0.1295,0.0717,0.2668,0.5115,0.1694,0.2374,0.3721,0.18,0.2062,0.2879,0.2071,0.2536,0.1479,0.1824,0.2595,0.1574,0.2137,0.2556,0.3785,0.2864,0.2742,0.2347,0.1539,-0.1698,-0.1416,-0.2431,-0.0447,-0.0389,-0.2242,-0.2128,-0.1006,0.0883,0.0282,-0.2724,-0.2358,-0.1436,-0.0058,-0.0178,-0.1943,0.0724,-0.0441,-0.1281,-0.0358,-0.1345,-0.0268,-0.0233,-0.0421,-0.1197,0.1196,-0.1973,-0.2231,0.0981,-0.0123,-0.0328,0.0035,0.0109,-0.14,0.1154,0.1214,-0.1188,0.1584,0.2537,0.0098,0.0759,0.1072,-0.099,0.2166,0.2218,-0.0975,-0.1268,0.0997,-0.0785,-0.0113,-0.1018,-0.0224,0.1671,-0.0899,-0.1232,0.0358,-0.0239,-0.0765,-0.024,object recognition
trm_5519b80525e89,-0.0242,-0.0617,-0.0436,-0.1349,0.028,-0.0213,-0.0153,-0.0273,-0.0012,-0.054,0.0105,0.0374,-0.0458,-0.048,-0.071,-0.0534,-0.0546,-0.1302,-0.045,-0.035,-0.0336,0.0207,0.0398,0.0017,0.0268,0.0566,0.0548,-0.1071,-0.0963,-0.0112,-0.0685,-0.0766,-0.0959,-0.0124,-0.1265,-0.1044,0.047,-0.0333,-0.1019,-0.0504,-0.0595,-0.0958,-0.0336,0.0352,-0.0744,-0.0923,0.2105,-0.0369,0.0483,-0.0574,-0.0255,0.0185,0.0168,-0.01,-0.1015,-0.0368,-0.0669,0.0117,0.0329,-0.0083,0.0547,0.061,-0.1422,0.0599,-0.0352,0.0934,-0.1686,-0.1687,-0.0955,0.0331,0.0599,0.0524,0.0613,-0.0272,-0.0915,-0.0264,-0.0701,0.0777,-0.0088,0.0197,0.0219,0.0771,-0.0827,-0.0776,-0.0063,0.0584,-0.0236,0.0252,-0.0153,-0.1312,-0.0781,-0.0062,-0.0292,0.1686,0.1875,0.1679,0.1379,0.0522,0.2022,0.0753,0.065,-0.023,0.066,0.0733,0.0917,-0.1055,-0.1432,0.1254,-0.0292,-0.05,-0.0059,-0.0693,0.0601,0.1291,-0.007,-0.0211,-0.0466,0.0526,-0.0186,-0.0331,-0.0773,-0.1373,-0.0952,-0.0518,-0.1227,-0.0981,-0.1111,0.0595,0.0706,0.0473,-0.0507,-0.0302,-0.0061,-0.1277,-0.0573,-0.1747,-0.0032,-0.0753,-0.0668,0.0099,-0.0744,-0.0735,0.0051,-0.0431,-0.0914,0.0078,-0.0181,0.0176,-0.0825,0.0188,-0.0664,-0.0857,-0.1079,-0.1242,0.122,0.011,0.0708,0.0273,0.0088,-0.0259,-0.0659,-0.0461,-0.1408,-0.1038,0.0017,-0.0312,0.0094,-0.1374,-0.1306,-0.05,0.0009,-0.1127,0.0907,-0.0802,-0.0511,-0.1001,-0.0716,-0.0628,-0.0503,-0.0094,-0.1225,0.0749,-0.0452,-0.0089,-0.0241,-0.0107,-0.0228,-0.022,-0.0139,-0.0958,-0.102,0.0003,0.0097,-0.1011,-0.0878,-0.1628,-0.1434,-0.017,-0.0562,-0.0496,0.0123,0.2142,-0.1299,-0.1046,-0.0778,-0.0619,-0.102,-0.0551,-0.0344,-0.0066,-0.1061,-0.0129,-0.0416,0.0373,0.0259,-0.004,0.1173,-0.0903,-0.0255,0.0232,0.1231,-0.0592,-0.1021,-0.0871,0.0369,0.0552,-0.1439,0.0959,-0.0056,0.0522,0.0157,-0.0411,0.1843,-0.0774,-0.0736,0.0356,-0.0066,-0.0082,0.0285,-0.0636,0.0424,-0.1175,-0.0624,0.0002,-0.0657,-0.0859,-0.07,-0.1461,-0.0531,-0.1122,0.0184,0.0266,-0.0705,0.018,0.0087,-0.1218,-0.0281,-0.1117,0.116,0.2245,0.0882,0.2508,-0.0521,0.1174,0.1499,0.2414,0.0675,-0.0119,0.0498,-0.0148,-0.0489,0.0071,-0.0901,0.0449,-0.0306,0.0904,-0.0537,-0.0737,-0.0438,0.0063,0.0505,-0.0218,-0.0028,-0.1892,-0.1742,-0.0782,0.0212,0.0526,-0.0275,-0.0664,-0.0587,0.0048,0.0045,-0.0518,-0.0284,0.0447,-0.02,-0.0187,-0.046,0.0496,0.0132,-0.116,-0.0661,-0.0345,0.0294,0.0392,-0.0527,-0.0231,0.0308,-0.0261,-0.0287,-0.003,-0.1141,0.0219,0.0236,-0.0607,0.0529,0.0465,0.0357,-0.131,0.0094,0.0345,-0.1108,-0.1548,-0.0288,-0.0816,-0.0361,-0.0549,-0.035,-0.0737,-0.0007,-0.033,0.039,0.0026,0.0066,0.1259,-0.0564,-0.0608,0.0344,-0.114,-0.0969,0.06,0.0674,0.0386,0.064,0.034,-0.0942,-0.0769,-0.0488,-0.0475,-0.0075,0.179,0.0169,0.0174,-0.0083,-0.0007,-0.0353,-0.1047,-0.0587,-0.0879,0.0387,-0.0333,-0.0857,0.0081,-0.0052,0.083,-0.0829,0.0843,0.0056,-0.0686,-0.0164,0.0629,-0.0266,0.1231,-0.1251,-0.0561,-0.1217,0.0735,0.1069,0.0773,0.1345,0.0641,-0.107,-0.0357,-0.0257,0.0039,-0.0775,-0.0136,0.027,-0.0433,0.0295,-0.0581,0.0111,-0.0495,0.1392,0.1234,0.023,-0.058,-0.0515,-0.0987,-0.0789,0.0083,0.0233,-0.001,0.0743,0.0149,0.0286,0.0434,-0.0282,0.0175,0.0202,-0.1176,-0.0408,0.0948,-0.0779,-0.0841,0.0792,-0.0651,-0.1038,-0.029,0.0242,-0.1379,-0.0818,-0.2362,-0.2144,-0.0678,-0.089,0.016,-0.0806,-0.0671,-0.0255,0.0034,-0.0028,-0.0107,-0.0159,0.0639,-0.0004,0.0114,-0.1683,-0.1077,0.0764,0.0581,0.0325,0.0074,0.0493,-0.0089,0.0252,0.1449,-0.1174,-0.1424,-0.0838,0.0321,-0.0767,-0.077,0.0176,-0.1288,-0.0113,-0.08,-0.0932,0.0098,0.0485,-0.0284,-0.0224,0.0271,-0.0659,-0.1251,-0.0172,0.2252,-0.0626,-0.0205,0.0205,0.0854,0.0393,-0.0383,-0.0496,-0.0494,0.0238,0.0489,-0.0112,-0.0167,0.0674,0.0231,-0.0288,0.0241,0.0028,0.0534,-0.0253,0.0007,-0.0964,-0.0098,0.1094,0.0115,-0.1308,-0.1648,0.062,0.0431,-0.2183,-0.0159,0.0178,-0.1129,-0.1022,-0.0022,-0.0351,-0.0927,-0.0715,-0.108,-0.0755,-0.0575,-0.0492,0.1095,-0.1232,0.0196,-0.0789,0.0008,0.1178,0.0018,-0.0337,-0.0011,0.1219,-0.011,-0.0622,-0.0205,0.0772,0.026,0.0705,0.0376,0.0694,0.1606,0.0646,0.0378,-0.0948,-0.0401,-0.0491,-0.1736,-0.0077,0.0008,-0.1013,-0.1032,-0.0582,-0.088,-0.0226,0.0332,0.0134,-0.028,-0.064,0.0177,-0.0506,0.0258,-0.0176,0.0042,0.0838,-0.0804,-0.0698,0.026,-0.0049,-0.1038,0.0968,0.0191,0.0351,-0.0152,-0.0686,-0.0632,-0.1113,0.0891,-0.078,0.0358,0.0836,-0.0954,-0.0008,-0.083,-0.0751,-0.0718,-0.0652,0.0422,0.134,0.1165,0.0607,-0.004,0.0626,0.0023,0.0032,-0.067,-0.0322,-0.0163,0.0557,0.0165,0.0085,-0.0179,0.0521,-0.0241,-0.0724,-0.0323,0.019,0.0244,-0.0369,-0.0101,-0.136,-0.0244,0.0936,-0.0781,-0.0048,0.0645,0.0778,0.0775,0.0684,0.1299,-0.0508,-0.0696,-0.0686,-0.0211,-0.1081,-0.039,0.0294,-0.0666,-0.1521,-0.0381,-0.0272,-0.0052,0.0106,-0.1799,-0.0513,-0.1316,0.0511,0.008,0.0007,0.069,-0.0606,-0.0732,-0.0497,0.0076,0.048,0.0805,-0.0881,-0.0145,-0.0883,0.0495,0.0166,-0.0136,-0.0225,-0.0414,-0.0316,0.1094,0.0458,0.0285,-0.1018,-0.0148,-0.1542,-0.0835,0.0981,-0.1295,-0.0744,-0.1422,0.1483,-0.1049,-0.0272,-0.018,0.111,-0.036,-0.0091,-0.0998,-0.1047,0.0978,0.1741,0.0039,0.0998,0.0657,-0.0155,-0.0868,0.0298,-0.0201,-0.0311,-0.0458,-0.0328,-0.0339,-0.0463,-0.0942,0.158,-0.0513,0.0267,-0.0323,-0.0081,0.0577,0.023,0.0425,0.1737,-0.144,-0.0492,0.0057,-0.0107,0.0093,0.0796,0.0938,0.0885,0.0778,0.1154,-0.1231,0.0254,-0.0177,-0.0285,-0.0234,-0.0145,-0.031,-0.0441,-0.0768,-0.0563,-0.0427,-0.0915,-0.0766,-0.0544,0.0022,0.0596,-0.0727,-0.0581,-0.0274,-0.0755,-0.0334,-0.0097,-0.0238,-0.0609,0.0303,0.0864,-0.0352,-0.2335,-0.2256,-0.1708,-0.0391,-0.0268,-0.0534,-0.0109,-0.0189,0.075,-0.0021,0.0142,0.063,0.0513,0.0154,-0.0252,0.0598,0.0636,0.0486,-0.0969,-0.0052,-0.0643,-0.0085,-0.0224,-0.0434,0.0195,0.0491,-0.0139,-0.0154,0.0058,0.1185,-0.1368,-0.1898,-0.1626,-0.1168,0.0554,0.1408,0.0079,-0.074,-0.0545,0.0911,0.0419,0.0566,0.0427,0.0196,-0.0539,-0.0527,0.006,0.0626,0.1104,0.1376,0.0329,0.0232,0.0599,-0.0581,0.0342,-0.0454,-0.0618,-0.1026,-0.1179,-0.0856,-0.0772,0.1056,0.0419,-0.0039,-0.0376,0.0068,0.0091,0.0737,0.0392,-0.1039,0.0691,-0.0137,0.0234,0.0333,0.0296,-0.1034,0.0385,-0.0941,-0.0914,0.0838,0.078,0.1767,-0.0147,0.0243,0.0315,0.0017,0.0352,0.2749,0.0813,0.0735,0.0908,0.1053,0.0751,-0.0036,0.204,0.176,-0.0679,-0.0137,-0.0095,-0.1481,-0.1276,-0.0392,-0.0368,0.0746,-0.1849,-0.0364,-0.1191,-0.0609,-0.1099,0.0624,0.048,0.1155,-0.0541,-0.0189,-0.0408,0.0431,0.04,0.0045,0.0104,0.0948,0.0614,-0.0091,0.024,-0.0344,0.0974,0.1569,-0.0796,0.1027,0.0346,-0.0017,-0.0387,-0.063,-0.0588,0.0524,-0.0896,-0.2149,-0.1469,-0.0093,0.0729,0.0218,-0.0857,-0.0301,-0.0183,0.0501,-0.064,-0.0667,0.0688,-0.0869,0.0498,-0.1041,0.1279,-0.0624,0.0892,-0.0547,-0.0617,-0.0353,-0.1884,-0.175,-0.0687,0.2251,-0.0655,-0.0649,-0.0724,0.0771,0.013,-0.0844,-0.0726,-0.0772,-0.0391,-0.0207,0.0632,0.0109,0.0072,0.1229,-0.1367,-0.0766,-0.0134,-0.0118,-0.0638,0.0571,0.1398,0.0796,0.0707,0.2758,0.1181,-0.0489,-0.0391,-0.0993,-0.0884,-0.0195,-0.0504,-0.0088,0.0823,0.0835,0.005,-0.0476,0.0573,0.1172,0.0439,-0.0036,-0.0488,-0.0266,-0.0236,-0.0162,-0.0085,0.1012,-0.0188,-0.0545,0.0052,0.1148,0.0224,-0.074,-0.0056,0.0084,-0.0486,-0.0022,-0.017,-0.0491,-0.0479,-0.1362,-0.1373,-0.1163,0.0315,0.0189,-0.0326,-0.0986,-0.0064,-0.1037,-0.0313,-0.1268,-0.0425,-0.028,-0.024,0.0532,0.0647,-0.0405,0.032,-0.0179,0.0279,0.0892,0.0343,0.0891,0.0148,-0.0514,0.0008,0.022,-0.0408,0.0105,0.0361,0.075,-0.0039,-0.0503,0.0245,0.1277,-0.0257,-0.0589,0.0073,0.0687,-0.04,0.0834,-0.1207,-0.0732,-0.0907,-0.1497,-0.1228,0.0753,0.052,0.0377,0.037,0.1196,0.1438,-0.0275,-0.0053,0.0025,-0.0079,0.042,-0.0137,0.0062,-0.0383,-0.0818,-0.0064,0.0363,0.0194,-0.0887,-0.0825,-0.0692,-0.1551,-0.0979,0.112,0.0921,0.0859,0.0682,0.0513,-0.066,-0.0476,0.0559,-0.03,-0.0056,-0.0244,0.0094,-0.0023,0.0666,-0.0007,0.0139,-0.095,0.0167,-0.1034,0.006,-0.0755,0.0656,0.1484,0.1897,-0.0876,-0.0433,-0.0353,-0.0673,-0.008,-0.0213,-0.0816,-0.0705,0.0184,0.0016,0.0475,-0.0404,-0.0169,0.0118,0.0235,-0.0218,0.0335,-0.0904,-0.0991,-0.1253,-0.0933,0.0946,0.024,0.0889,-0.1212,0.1941,0.0987,-0.0122,-0.0122,-0.0125,-0.0098,-0.0582,0.1146,-0.0672,-0.112,-0.0484,-0.0478,-0.1276,-0.0451,-0.0531,0.0661,0.0451,-0.0216,-0.0405,-0.0393,0.0254,0.0598,-0.0009,0.0247,0.0273,-0.0425,0.0174,-0.0274,0.0721,0.0239,-0.0298,0.3936,0.2958,0.2894,0.1737,0.1845,0.0973,0.2769,0.1738,-0.0882,0.1904,0.1619,0.1451,0.1227,0.1517,0.0476,0.0927,0.034,-0.0464,-0.0089,-0.0304,0.0399,0.0207,-0.0588,0.0987,0.1122,-0.0092,0.0912,-0.0597,-0.1141,0.0787,-0.0035,-0.0927,-0.0223,-0.0028,0.0799,0.056,0.1778,-0.0453,-0.1165,-0.0381,0.0075,0.0224,0.0922,0.0789,0.0497,-0.0528,-0.1365,-0.0873,-0.037,0.1657,-0.0061,0.293,0.2242,-0.057,0.0493,0.0346,0.1666,0.1583,0.134,0.1659,0.091,-0.0319,0.0277,0.0224,0.0109,-0.0983,-0.0188,-0.0556,0.0945,0.0207,-0.0603,0.0021,-0.0898,-0.0223,0.0174,0.0114,-0.0477,0.0996,0.0594,-0.0055,-0.0021,-0.0445,0.0646,0.0843,0.0563,-0.1,-0.0997,-0.0952,-0.1067,0.019,-0.0634,-0.0177,-0.047,-0.0704,-0.0225,0.0283,0.0655,0.1928,-0.0591,-0.1128,-0.0876,0.0333,-0.0233,0.0572,-0.1331,0.0532,0.1828,0.0024,-0.1942,0.1097,0.102,-0.0791,-0.1068,0.0131,-0.1349,-0.0553,-0.1824,-0.0183,0.1189,-0.0858,-0.0574,0.0424,-0.0534,-0.0025,-0.0309,-0.0443,-0.068,-0.0801,-0.0321,0.0963,-0.0035,0.2168,0.1727,0.1817,0.1785,-0.0705,-0.0077,-0.0728,-0.0709,-0.1024,-0.0048,0.0362,0.1835,-0.1,-0.0696,0.0483,0.0782,-0.0315,0.0692,0.0249,0.0191,0.0184,0.0642,-0.0897,-0.0815,-0.1192,0.1203,0.0213,-0.0283,-0.0028,-0.0028,-0.1148,0.0178,0.0057,0.0182,-0.03,0.0494,-0.0672,0.2483,-0.1911,-0.1879,-0.0041,-0.0504,-0.1207,-0.1312,-0.1224,0.009,-0.0053,-0.0593,0.0259,-0.0209,0.1832,-0.0217,-0.0147,-0.0522,0.0028,0.0054,-0.0053,0.0206,-0.0275,-0.0755,-0.0592,-0.1156,-0.0573,-0.0496,-0.0128,0.044,0.0279,0.1657,0.1078,0.1235,-0.0032,0.2046,-0.0255,0.0269,0.0004,-0.0854,0.0389,-0.1476,-0.1367,-0.0342,-0.0483,-0.1458,0.0298,-0.0134,-0.1275,0.0263,0.0172,0.0487,-0.1597,-0.039,-0.0349,-0.0683,-0.0121,0.0289,-0.0076,0.2502,0.1042,0.1116,0.0591,0.0202,0.0481,-0.0284,-0.0809,-0.0769,0.02,-0.0745,-0.0347,-0.0497,0.0086,0.0449,0.0378,-0.0127,-0.0728,-0.0897,-0.0011,-0.011,0.0157,-0.0216,-0.0249,0.0633,-0.0139,-0.0932,-0.0826,-0.1239,-0.0907,-0.012,-0.1196,-0.1324,0.0109,0.0205,0.1571,0.1219,-0.0184,-0.045,-0.0506,0.0387,-0.0774,-0.0124,0.0169,0.0286,-0.0019,-0.1691,-0.0128,0.1328,0.01,-0.0311,0.0179,-0.0406,0.1281,-0.0198,0.053,0.0522,-0.1544,0.1189,-0.0037,0.1227,0.1146,0.1647,0.009,-0.0297,0.0059,0.1687,-0.0216,0.0406,-0.0389,-0.0387,-0.1306,-0.0843,-0.057,0.0633,-0.0362,0.0058,-0.0845,-0.0159,-0.0425,-0.0238,-0.0341,-0.0746,-0.0007,-0.0132,-0.0169,0.0548,-0.0297,-0.0249,-0.0788,-0.074,-0.0482,-0.0464,-0.0575,-0.0377,0.0405,-0.0079,0.0769,-0.0426,-0.0529,-0.0159,0.0198,0.0273,-0.0997,-0.1974,0.076,0.0362,0.1222,-0.0074,0.0366,0.0452,0.0755,0.0606,-0.0622,-0.0742,-0.0713,0.0047,-0.1684,0.0092,-0.0169,-0.0233,0.0468,-0.0193,-0.038,-0.1285,-0.109,0.0155,-0.0516,-0.0583,0.1676,0.0513,-0.0372,0.0274,0.091,0.0031,-0.0324,0.0459,0.1437,-0.0241,-0.0147,-0.0561,-0.0524,-0.0494,-0.0517,-0.0097,0.025,-0.0048,0.156,0.1783,-0.0356,-0.0688,-0.0301,0.0185,0.0216,0.034,-0.1004,-0.0354,0.0071,-0.0823,-0.0742,0.0268,0.1357,0.0358,-0.0278,0.0468,0.014,-0.1187,-0.0485,-0.0677,-0.0446,-0.074,-0.0607,-0.0725,-0.0764,-0.0849,0.118,-0.0048,-0.012,-0.0119,0.0239,0.126,0.1263,-0.0216,0.0058,0.0329,-0.0262,-0.0293,-0.0364,0.0701,-0.0024,-0.0461,0.1301,0.1124,0.0713,-0.0397,-0.0564,-0.0292,0.3038,0.2944,-0.1493,-0.1132,0.0604,-0.0637,-0.0148,-0.0268,-0.1285,0.0075,-0.0461,-0.0354,0.0431,-0.0395,0.149,-0.0878,0.0748,0.0595,-0.0432,0.0599,0.2694,0.0858,-0.0776,0.2022,0.0633,0.0219,0.0406,0.0056,-0.079,0.0155,-0.0288,-0.0033,0.0175,-0.0362,0.0391,-0.0387,0.0052,-0.1091,-0.043,-0.053,0.1028,-0.0934,0.0391,0.0652,-0.0748,-0.0997,0.0501,0.0035,-0.0661,-0.0331,0.0585,-0.0019,-0.1138,-0.1757,-0.0732,-0.0272,-0.0282,-0.0431,0.031,0.0365,0.0273,0.1094,0.1091,0.1463,-0.0035,0.0989,-0.0083,-0.0142,0.3467,-0.0749,-0.1489,-0.053,-0.1194,0.0264,0.0168,0.0425,-0.0104,0.0255,0.0443,-0.0303,-0.0035,0.0317,-0.0279,0.0452,-0.0395,0.0236,0.054,0.1034,0.1016,0.1455,-0.0099,-0.0391,-0.051,-0.0392,-0.0727,-0.0121,-0.0338,0.0779,0.0283,-0.0058,0.0973,0.0517,-0.1311,-0.0984,0.0594,0.0389,0.0346,0.0799,0.0557,0.1568,0.1297,-0.1066,-0.0195,-0.0989,-0.0221,0.0109,0.0138,-0.1075,-0.1213,-0.161,0.035,0.0164,0.0223,0.0958,-0.0706,-0.0599,0.0063,0.1106,0.0345,0.1665,0.0095,0.0394,0.0705,0.067,0.158,0.1681,0.1765,-0.0108,0.0146,-0.033,0.0298,-0.0496,0.0138,-0.1472,-0.0734,-0.0409,-0.0986,0.0046,0.0526,-0.0523,0.0589,-0.0482,0.0709,0.0716,0.0259,0.0204,-0.0035,0.0024,0.009,-0.0336,-0.0171,0.1339,0.0126,0.0618,-0.1618,-0.1035,-0.1302,0.0121,-0.032,-0.078,-0.0668,-0.0441,-0.0851,-0.0766,0.0378,-0.0417,0.0992,0.0135,-0.0104,0.0841,0.0176,0.0205,0.0466,-0.0394,-0.1406,0.0336,-0.0867,-0.0347,-0.0528,0.0148,0.022,0.1812,0.0795,0.0122,-0.003,-0.0235,-0.1963,-0.111,-0.1389,-0.1142,0.0317,0.0197,0.0877,-0.0984,-0.1297,-0.0923,-0.0535,-0.1199,0.0033,0.0013,-0.0168,-0.0101,0.0282,-0.0959,-0.0834,-0.0438,0.0568,-0.0109,0.0305,-0.2173,-0.0838,-0.1112,-0.089,-0.2633,0.0385,-0.0393,0.0117,-0.0514,-0.0305,-0.0141,0.0269,-0.1375,-0.0069,-0.1315,-0.0517,0.0251,0.0492,-0.0112,0.0431,-0.1772,-0.0501,-0.0168,0.0865,-0.0346,-0.0316,-0.0638,0.1134,-0.1459,-0.1595,-0.1178,0.0011,-0.0339,-0.103,-0.0664,-0.0566,-0.0689,-0.069,-0.0238,-0.0278,-0.1714,0.0043,-0.081,-0.063,-0.0724,-0.0368,-0.1381,-0.0822,-0.1041,-0.0277,0.1271,-0.0639,-0.1311,-0.1791,-0.0855,-0.1206,-0.0114,-0.1935,-0.1478,-0.0234,0.1503,0.1369,-0.048,-0.042,0.0268,0.1765,0.1658,0.1251,-0.2086,-0.2101,-0.0492,0.0401,-0.0317,-0.052,0.0129,0.0103,0.039,-0.0485,-0.0659,-0.0592,0.0321,-0.0539,-0.0658,0.0153,-0.0873,-0.0268,0.024,-0.0238,0.17,0.183,-0.0495,-0.0995,-0.136,-0.1225,-0.0912,-0.1451,-0.0939,0.3278,-0.0598,-0.0634,0.1352,0.0926,0.0611,0.078,0.0703,0.0945,0.0986,0.0032,0.0913,0.029,0.0084,0.0986,0.1292,0.2109,0.3028,-0.1519,0.0593,0.1157,0.3412,-0.0693,-0.0504,0.0453,-0.0156,0.0001,0.0837,0.1635,-0.0203,0.0189,-0.0047,-0.0753,-0.0989,0.0269,-0.0304,0.0183,0.0663,0.0531,0.024,0.0289,-0.0098,0.0818,0.094,0.0511,-0.0134,-0.0023,0.0336,-0.2022,-0.0942,-0.138,-0.092,-0.0165,-0.1316,-0.0877,-0.0566,0.0201,-0.0615,-0.0906,0.0057,-0.0338,-0.1068,-0.2109,0.0743,-0.1177,-0.0169,0.0271,-0.0969,0.0463,-0.1147,-0.0682,-0.0605,-0.0315,-0.063,0.0241,-0.0735,0.1245,0.1161,0.1133,0.0297,-0.0836,-0.0253,-0.0804,-0.0057,0.0351,0.0054,-0.0384,0.0427,-0.0156,-0.0272,-0.0481,-0.082,-0.0158,0.0319,0.0256,-0.0026,-0.0863,-0.1003,0.0059,-0.059,0.0662,-0.1419,-0.0327,0.0192,-0.106,-0.0818,-0.0175,0.0502,-0.0804,0.0315,-0.0625,-0.0771,0.1055,0.1651,0.164,-0.0123,0.3187,0.1904,-0.0967,-0.081,0.3061,0.2119,0.0343,0.1394,0.1156,0.1475,-0.1186,-0.1146,-0.0551,-0.0679,0.3863,0.356,0.2031,0.0499,0.1108,0.1691,0.3342,0.3265,0.2555,0.0279,0.0069,-0.0304,0.0559,-0.0084,0.0226,-0.0989,-0.0829,-0.0061,-0.0821,-0.1242,-0.0947,0.0574,-0.0194,-0.0055,-0.022,0.051,0.0818,0.1078,0.0118,-0.0156,-0.0065,0.0124,0.0052,0.0067,-0.0316,-0.0639,-0.0634,0.0087,-0.0836,-0.1279,-0.1151,0.0255,-0.0423,-0.0101,0.2025,0.0368,0.1367,0.0941,0.0129,0.0974,0.0152,-0.1356,-0.1632,0.0281,0.0184,-0.0464,0.1008,0.0896,0.1116,0.0445,-0.0511,-0.0482,-0.0515,-0.042,0.1172,-0.0847,-0.0483,-0.0079,-0.047,-0.0022,-0.0028,-0.019,0.0191,0.0027,-0.0302,0.0114,-0.0589,-0.0687,-0.1064,0.0266,0.0432,-0.0097,0.0006,-0.0332,0.0573,0.1955,0.1736,0.0432,0.173,-0.0678,0.0499,0.0489,0.088,0.1902,0.101,0.0602,0.062,-0.0156,0.127,0.1037,-0.0223,-0.0317,-0.0505,-0.0156,-0.069,0.0299,-0.0087,-0.02,0.048,0.0089,0.0619,0.0118,0.1723,-0.0119,0.1181,0.1315,-0.1746,-0.1169,-0.0666,-0.1008,-0.1413,0.1364,0.0401,-0.0515,-0.0449,0.1406,0.0045,-0.1571,-0.0446,0.0458,-0.0687,0.0487,0.0446,0.073,0.0948,0.2423,0.3262,0.1476,0.0411,-0.0363,-0.0255,0.0763,-0.0578,-0.0736,-0.0188,0.0195,-0.0239,0.0942,-0.0641,-0.0465,-0.0642,-0.1682,-0.1381,-0.0934,-0.0968,-0.0199,-0.0576,-0.1364,-0.0619,0.0274,0.0286,-0.0437,-0.0299,-0.0506,0.0161,0.0534,0.054,0.0206,0.0692,0.0352,-0.0317,0.0406,-0.0996,-0.0527,0.0919,-0.0232,-0.0281,0.0096,-0.0105,0.0315,0.0003,-0.0345,-0.0282,-0.028,0.0077,0.0128,-0.0677,0.1003,0.0236,0.079,-0.0129,-0.162,-0.0969,-0.0434,-0.0806,-0.0442,-0.0284,-0.0766,-0.0067,0.0593,-0.0033,0.0685,-0.1976,-0.0903,-0.114,-0.1636,-0.127,-0.1027,-0.0416,-0.0416,-0.0627,-0.0075,0.0666,-0.1542,-0.0078,-0.0225,-0.0491,-0.039,-0.0461,-0.2755,0.0565,-0.061,-0.0157,-0.089,0.1852,0.0238,-0.0762,-0.1111,-0.0889,0.0198,0.0658,-0.0288,0.1448,0.0352,0.0516,0.1263,0.0871,0.0059,0.0343,0.0445,-0.0056,0.0051,-0.1422,-0.1191,-0.0143,-0.0742,-0.0241,-0.001,-0.0188,0.0512,-0.005,-0.0122,0.0623,0.0877,-0.0372,0.075,0.0365,-0.2107,-0.0683,-0.2342,-0.0391,-0.074,0.0069,-0.0709,0.1777,0.1768,0.0451,0.1395,0.108,0.0313,0.0905,0.0359,0.2166,0.0864,0.002,0.1069,-0.0512,0.0667,-0.0088,0.0476,0.0219,-0.0703,0.0315,-0.0465,-0.0192,0.0603,-0.0743,0.0404,0.0117,0.0755,0.0084,0.0023,0.2829,0.0543,0.0157,-0.002,0.0032,0.0336,-0.0436,-0.0146,-0.1244,-0.0611,0.0927,0.0515,-0.0634,-0.0336,-0.0352,0.0277,0.004,0.0948,-0.029,-0.005,0.0183,-0.0226,0.0817,-0.0571,-0.0291,-0.0195,-0.0089,-0.0317,-0.0189,-0.054,-0.0175,0.0039,0.0403,-0.0762,0.1112,0.0071,0.0921,0.034,0.0071,0.1034,0.0256,-0.0533,-0.0074,-0.0626,-0.0555,0.018,0.0507,-0.0138,-0.06,-0.0037,0.0035,-0.0199,-0.0985,-0.0901,-0.1358,-0.1294,0.0838,0.0055,0.0062,-0.1164,-0.0633,-0.079,-0.0237,-0.0605,0.0103,0.0109,0.023,0.1335,-0.0851,-0.0552,-0.0187,-0.031,-0.0926,-0.0504,0.1393,0.0842,-0.1385,0.034,0.0616,-0.0537,0.126,0.0817,0.0388,0.0273,0.0101,-0.1006,-0.0219,-0.1111,-0.0986,0.024,-0.1038,0.0593,0.1031,0.1205,0.1098,0.1123,-0.0745,-0.0645,-0.0922,0.0053,0.0329,0.0042,0.0241,-0.0388,-0.0443,-0.1324,-0.0798,-0.1443,-0.0688,-0.0161,-0.0242,-0.0565,-0.1088,0.0454,-0.0458,-0.0361,0.1234,0.0061,-0.0268,-0.1678,0.0015,0.021,0.0789,-0.0726,-0.0404,0.0037,-0.0022,-0.0734,-0.0434,-0.0553,-0.0827,-0.0248,-0.0735,-0.1736,-0.0135,-0.0194,-0.0451,-0.0673,0.0129,0.0051,0.0018,-0.0911,0.0777,-0.1015,-0.0178,-0.1018,-0.1327,0.0138,-0.1106,-0.0796,-0.2047,-0.0972,-0.0134,0.0883,-0.1344,-0.0128,-0.0815,0.0924,0.0133,0.0396,-0.0953,-0.1387,-0.0803,0.0066,-0.0095,0.0465,-0.049,-0.0226,-0.0367,0.0368,0.0467,0.0269,0.0898,0.005,-0.058,0.0144,-0.0141,-0.0491,0.0005,-0.0653,-0.0413,0.0283,-0.0236,0.0819,0.0068,0.0493,0.0683,0.037,-0.0313,-0.0264,-0.1676,-0.0219,0.0211,0.1371,0.1382,0.0678,0.0119,0.0043,-0.0081,0.1039,0.1377,0.0725,0.0664,-0.1823,-0.0394,-0.0305,0.1257,-0.0403,0.0218,0.0758,0.0363,0.0122,0.0496,0.0313,-0.0359,0.0763,0.018,-0.0636,0.1007,0.0672,0.0461,-0.0024,0.0696,0.1069,0.0149,0.0569,0.0943,-0.0132,0.1135,0.1174,0.1191,0.02,0.0129,0.0985,-0.0234,-0.0595,-0.2557,-0.2603,0.0592,0.0884,0.0847,-0.0018,0.0051,-0.1387,-0.129,-0.0852,-0.1092,0.0216,-0.0294,-0.0205,-0.037,0.0682,-0.0256,-0.101,-0.0114,-0.0778,-0.0872,0.0631,-0.0891,0.0375,-0.1837,-0.0696,-0.0045,0.008,-0.0497,0.0654,-0.0174,0.004,-0.0529,0.1946,-0.1137,0.0856,-0.0056,-0.0066,0.0343,0.1199,0.0185,0.1837,0.178,-0.1057,-0.0722,-0.0791,0.0319,-0.0925,-0.0978,-0.0937,-0.1479,-0.0594,0.009,-0.0726,0.0654,-0.0422,0.0039,-0.1039,-0.1155,0.0904,0.0756,-0.1834,-0.088,0.0412,-0.0669,-0.1438,0.1096,0.1392,-0.0606,0.044,0.0771,0.0272,0.0195,0.0041,-0.144,-0.1682,-0.0474,-0.0535,0.0747,0.0576,0.0467,0.0008,-0.0371,0.0606,0.2638,0.195,0.0619,0.2213,-0.1873,-0.1689,-0.1123,-0.157,-0.0725,-0.0739,-0.1476,-0.0819,-0.0413,-0.0365,-0.0538,-0.0177,0.1571,-0.0928,0.069,0.0702,0.1387,0.1125,0.1168,0.0285,-0.2223,-0.1532,-0.1976,0.0612,0.1018,0.1133,0.0633,0.0017,0.0958,0.0984,0.1299,0.0285,-0.0257,-0.0558,0.0174,0.0334,0.0302,0.0074,0.0273,-0.005,-0.019,0.0515,0.0414,-0.0117,-0.02,-0.1232,-0.104,-0.0342,-0.099,0.2732,0.01,0.1998,0.0617,0.0524,0.0332,0.0521,0.0732,0.0153,0.0958,0.1768,0.0266,0.0651,0.0625,0.0123,-0.0294,-0.0289,0.0094,0.0586,0.1914,0.1005,-0.0091,0.003,0.0252,-0.0336,0.0365,0.072,-0.0643,-0.0652,0.008,-0.0006,0.0033,-0.074,0.0372,0.0403,0.1488,0.0116,-0.0283,-0.0401,0.0496,0.0115,0.12,0.1226,0.0206,0.0615,-0.0342,0.1248,-0.1217,-0.1033,-0.004,0.1313,0.0612,0.0094,-0.0276,-0.009,-0.0756,-0.0762,0.0375,0.1089,-0.0193,0.008,-0.0577,-0.0785,-0.1359,-0.0848,-0.1076,-0.0728,-0.0673,-0.0266,-0.0446,-0.0154,0.0138,0.0069,0.0031,-0.0529,-0.0101,-0.0885,-0.0655,0.0369,0.1224,-0.0033,-0.0461,0.2675,0.2844,0.13,-0.0037,0.0698,0.0394,-0.1252,-0.0376,-0.0648,-0.029,0.1323,0.1746,-0.0097,-0.031,0.0588,0.0555,-0.083,-0.0417,-0.0106,0.0013,-0.1321,-0.0935,-0.0548,-0.1124,0.0276,-0.0994,-0.0379,0.1411,-0.0884,-0.1653,-0.0471,0.0739,0.1093,-0.044,-0.0491,-0.2838,-0.2339,-0.1136,-0.1779,0.2518,-0.0205,-0.0768,0.0646,-0.0518,0.0324,0.0453,0.0181,0.2451,0.1242,0.285,0.1355,0.0925,-0.065,-0.0437,0.0208,-0.0544,-0.036,0.005,-0.0534,0.2067,0.1428,-0.0822,-0.1663,-0.0711,-0.0569,-0.0834,-0.0437,-0.0098,0.0426,0.024,0.0282,0.0269,0.0214,-0.0977,0.0246,-0.0595,-0.0227,-0.1464,-0.1034,-0.0069,0.0236,-0.0316,-0.0443,-0.0427,-0.041,-0.045,-0.0812,-0.0403,-0.0639,0.0004,-0.0506,-0.0488,-0.0548,-0.0538,0.0312,-0.0052,0.0257,-0.073,-0.049,-0.0811,0.0819,0.0463,0.0117,-0.0405,0.1117,-0.0949,-0.1126,0.0662,0.0618,0.0512,-0.0131,-0.0542,0.0095,-0.0612,-0.0034,0.1313,0.2194,0.2651,0.0008,0.0433,0.0348,0.0311,-0.0485,0.166,-0.0414,0.2015,-0.0591,0.1129,0.0913,0.0372,-0.0525,-0.02,-0.0116,0.0138,0.02,0.0288,0.0998,0.0192,-0.0117,-0.076,0.0939,0.0529,0.0417,-0.1259,-0.0986,-0.1377,0.0085,-0.0641,-0.1856,-0.0057,-0.02,0.0055,-0.0294,-0.0596,-0.0596,0.1616,0.0166,-0.1029,0.103,0.2093,0.0396,-0.069,0.1378,0.1346,0.0985,0.0332,0.0882,-0.0599,-0.0067,0.1913,0.0815,-0.0466,0.158,0.0388,0.0274,0.0181,0.1555,0.0654,-0.0723,-0.0964,-0.0433,-0.0717,0.0253,-0.0888,-0.0122,-0.0511,-0.1173,-0.0288,-0.1383,-0.0497,0.1387,-0.08,-0.1361,-0.0377,-0.0281,-0.0764,-0.0332,-0.082,-0.0983,-0.0967,-0.0575,-0.0662,-0.1021,-0.0619,0.0317,0.0789,-0.0527,0.0087,-0.0707,0.0351,-0.0133,-0.0757,-0.0599,-0.0581,-0.0314,-0.0155,-0.1892,-0.186,-0.0454,-0.0338,-0.0816,-0.1568,0.0424,-0.107,-0.0998,-0.1678,-0.037,-0.0277,-0.0038,0.0368,0.0415,-0.0463,0.0986,-0.0441,0.0782,0.1152,0.134,-0.1136,0.0361,-0.1453,-0.0577,-0.0381,-0.0175,-0.0168,0.0301,0.086,0.1235,-0.0021,-0.0343,0.1382,-0.0604,-0.0422,0.127,-0.0582,-0.0407,-0.0672,0.0338,0.0245,0.1145,0.0377,-0.1798,-0.1271,0.0019,0.0246,0.0208,0.1507,0.1092,0.0249,-0.0534,-0.0734,-0.0315,-0.1126,-0.1775,-0.0755,-0.095,0.0433,-0.0024,0.0681,-0.0077,0.1388,-0.0397,0.0475,-0.0021,0.0612,0.0562,0.0341,-0.0293,0.016,-0.0654,0.0113,-0.0593,-0.0668,-0.0218,-0.0149,-0.0656,-0.0269,-0.0643,-0.0377,-0.0555,-0.0192,-0.089,0.003,-0.0035,0.0762,0.0416,0.0782,0.0161,0.0209,-0.0283,0.0387,-0.0271,-0.0236,-0.0731,-0.0908,0.1481,0.0195,0.0735,-0.0829,-0.0249,-0.1221,-0.0703,0.0529,-0.0216,0.0775,0.1198,-0.1591,-0.097,0.0259,-0.0893,-0.042,-0.0262,0.3451,0.3491,-0.1119,0.057,-0.0442,-0.0142,-0.0378,-0.1123,-0.1223,-0.0887,0.0562,-0.0294,-0.0673,-0.0033,-0.1173,-0.0685,0.0947,0.0468,0.0305,0.0068,-0.0044,-0.0172,-0.1107,0.008,0.0885,-0.1286,0.0132,-0.1435,0.2007,-0.1092,0.238,-0.0155,0.0021,-0.1597,-0.1441,-0.0806,-0.0085,-0.0641,0.0693,-0.0965,0.1054,-0.0424,0.0282,0.0993,0.131,0.1025,0.109,0.0779,0.1732,0.2087,-0.0584,0.05,0.2728,0.4684,0.2012,0.1323,0.3653,0.2111,0.1816,0.313,0.2045,0.287,0.2133,0.1576,0.2524,0.174,0.2335,0.0946,0.2872,0.1252,0.2592,0.2125,0.2088,-0.1293,-0.1248,-0.1185,-0.0696,-0.1068,-0.1417,-0.162,-0.0659,0.0783,0.049,-0.1811,-0.1421,-0.1204,0.02,-0.0371,-0.1059,0.1295,-0.0546,-0.0955,-0.0436,-0.0706,-0.0408,-0.0308,0.0028,-0.052,0.0667,-0.1125,-0.1196,0.0668,-0.0096,-0.0254,0.0143,0.0195,-0.1206,0.0461,0.0207,-0.0581,-0.0479,0.0887,-0.1205,-0.0064,-0.094,-0.0996,0.0903,0.0929,-0.0648,-0.0827,0.0032,-0.049,-0.0258,-0.0952,-0.0331,0.1103,-0.0591,-0.0661,0.0153,-0.0559,-0.0605,0.0078,stimulus detection
trm_558c7b5228ed4,0.0036,0.0243,-0.0235,-0.0449,-0.0787,-0.0494,-0.0132,-0.0289,-0.0077,0.0323,-0.0142,-0.0505,0.0057,0.0483,-0.0215,-0.0062,0.0053,0.0013,-0.007,0.0389,-0.0153,-0.0456,-0.0285,0.026,-0.0339,-0.0453,-0.0437,0.0722,0.0518,0.0389,0.0345,-0.0085,0.0596,0.0201,0.0876,-0.01,-0.0187,-0.0398,0.0267,-0.0377,0.012,0.0377,0.0277,-0.0036,0.0271,0.0671,-0.1252,0.0232,-0.0224,0.0532,0.044,0.0509,0.0177,0.0012,0.0534,0.0407,0.0555,-0.0044,0.0043,-0.0097,-0.0281,-0.098,0.0303,-0.016,0.045,-0.0175,-0.0097,0.0249,0.0264,-0.0273,-0.0164,-0.0722,0.0424,0.0255,0.005,0.0847,0.0387,-0.0892,-0.0207,0.004,0.0224,-0.0156,0.0696,0.0456,0.0068,-0.0242,0.0657,-0.0705,-0.0092,0.1122,-0.0145,-0.0317,-0.0182,-0.1019,-0.0647,-0.0871,-0.0147,0.0119,-0.1103,-0.0769,-0.0059,-0.0252,-0.0583,-0.1073,-0.0139,-0.0039,0.0792,0.0733,0.0002,0.0252,-0.0325,-0.0006,-0.02,-0.0474,-0.0352,0.0972,0.0075,-0.1019,0.0349,0.0121,0.0167,0.0457,0.0138,0.0724,0.0608,0.0749,0.0338,-0.065,-0.0489,-0.0339,0.0975,0.0045,0.0287,0.1198,0.0227,0.0671,-0.0127,0.0579,0.0063,-0.0142,0.0322,0.022,0.0466,0.0163,0.0242,-0.0777,-0.0195,-0.0174,0.0034,0.0404,0.0226,-0.0319,0.0093,0.076,0.009,-0.0495,-0.0369,-0.0683,-0.0944,-0.0609,0.0038,-0.0201,0.0209,-0.0025,-0.0079,0.0081,-0.0475,0.0838,0.0816,0.0924,-0.1299,-0.027,-0.1458,0.1473,0.0714,0.0877,0.0796,0.0778,0.0684,-0.0182,0.0953,-0.0641,-0.0593,-0.0031,-0.0116,-0.0028,-0.0248,0.0843,0.1052,0.1012,0.126,0.0256,0.0305,0.0504,0.0531,0.0824,0.026,0.042,0.0966,0.0783,-0.0392,-0.1856,0.0913,0.0509,-0.0388,0.0721,0.189,-0.07,-0.0504,-0.0441,0.0409,0.0135,0.0769,-0.0346,0.0423,0.006,-0.0729,0.0098,-0.0865,-0.0558,-0.0483,0.0431,0.0,-0.0215,-0.0494,-0.012,0.0407,-0.0282,0.0302,-0.0017,-0.1555,0.0132,-0.0774,-0.0339,-0.0402,0.005,0.0515,0.077,-0.0175,0.1006,-0.072,0.0793,-0.0312,-0.0029,0.0381,0.0468,0.0382,0.0378,0.0425,0.0563,0.0042,0.0099,0.0277,0.0111,-0.0229,0.0891,-0.0035,0.0187,0.055,-0.095,-0.041,-0.133,0.0238,-0.0613,-0.1422,-0.1092,-0.0238,0.0505,-0.0524,0.0826,0.0309,-0.0108,0.1781,0.0439,0.0454,0.0255,0.0338,0.0301,0.0117,-0.0204,0.0394,0.0689,0.0286,0.1568,0.1547,-0.004,0.0302,0.0506,-0.0225,0.0376,-0.0209,0.0268,-0.0813,0.0126,0.0172,-0.0763,0.026,0.0136,-0.0339,0.0007,0.0404,0.032,0.0085,-0.0506,-0.0526,-0.0663,-0.0054,0.0251,-0.0159,0.0399,0.0243,0.0059,-0.0116,0.0453,0.0082,0.0299,-0.0333,-0.0231,-0.035,0.0736,0.0604,-0.028,0.1163,0.1411,-0.0096,-0.0375,0.0044,0.0519,-0.0453,-0.0624,0.009,0.0308,-0.0361,-0.0152,-0.0222,-0.0466,0.0516,0.0407,0.101,0.0877,0.0762,-0.1064,-0.0535,-0.0127,0.0071,0.0163,-0.0338,-0.0425,-0.0327,-0.022,0.0243,-0.0403,-0.1047,-0.0026,0.0112,-0.1213,-0.0557,0.063,0.0209,0.073,0.0011,0.0285,0.0933,-0.0889,-0.0347,-0.0914,-0.0256,-0.043,-0.0293,0.0135,0.0378,-0.0231,-0.0266,-0.073,0.0388,0.0316,0.0428,-0.0063,0.0812,-0.0605,0.0093,-0.1078,0.0184,-0.0425,-0.0146,0.0131,0.0302,0.0173,-0.0277,0.0093,-0.0571,-0.0237,-0.1344,0.015,-0.0477,-0.0507,-0.0818,-0.0383,-0.0221,0.005,0.0331,0.0147,0.0181,-0.0436,-0.0679,0.0068,0.0819,-0.0032,-0.0035,-0.0144,-0.0246,0.0623,-0.0152,0.058,0.0406,0.0557,0.0283,-0.0364,0.0066,-0.0095,-0.0225,0.0082,-0.0167,0.0602,0.0615,0.0094,0.0353,-0.0365,0.0108,-0.0064,-0.0127,0.0262,0.0659,0.036,0.0287,-0.0188,0.0329,0.0307,-0.009,0.0391,0.0412,-0.0523,-0.1126,0.0079,-0.0635,-0.0382,0.0547,-0.0504,0.14,0.0924,0.0018,-0.0188,0.0456,0.0625,-0.0069,0.0824,0.0417,0.0433,0.0741,0.0051,-0.0517,0.0077,0.0116,-0.0018,0.0543,0.0279,-0.0524,-0.0811,-0.0078,-0.0106,-0.0139,-0.0396,-0.0201,0.0658,0.1797,0.0107,-0.0145,0.0134,0.0053,-0.0216,-0.1381,-0.0804,-0.0692,-0.0074,-0.0567,-0.0137,0.0056,-0.0781,0.0203,-0.0014,0.0003,-0.0495,0.0082,-0.0094,-0.0966,0.015,0.2141,-0.1035,-0.0282,0.0297,0.0411,0.0108,-0.0379,-0.0234,0.0556,0.0437,0.1256,0.1624,0.0082,-0.1153,0.0441,-0.0119,0.0995,-0.0873,-0.0751,0.0108,0.0469,0.0066,-0.0966,-0.0025,0.073,-0.0066,-0.0662,-0.075,0.0063,-0.0434,-0.0375,-0.0195,0.0112,-0.0143,0.0527,0.0042,-0.0532,0.072,0.077,0.0661,0.0485,0.0134,-0.0135,0.0488,0.0272,-0.0092,0.0431,-0.0015,0.0233,0.023,0.0189,0.019,0.0012,-0.071,-0.0257,0.056,0.0798,-0.007,0.0247,0.0609,-0.0209,0.0378,-0.0307,0.0477,0.0413,-0.0214,0.1055,-0.0483,0.0724,-0.0051,-0.0608,0.116,0.0665,0.0808,0.0466,0.0637,-0.0754,-0.0504,-0.2147,-0.1674,-0.0207,0.0281,0.0124,0.0474,0.0722,0.0048,0.0447,-0.0332,-0.0228,-0.014,-0.0714,0.0114,-0.0848,-0.0205,-0.0011,0.0107,-0.0246,0.0585,-0.0155,-0.0494,0.028,0.0334,-0.063,-0.0306,0.0015,-0.0159,-0.0649,0.0076,-0.08,-0.159,0.0638,0.0161,0.0135,-0.0365,-0.0063,-0.0056,-0.0107,0.0398,0.0291,0.0217,0.028,0.0054,0.0038,0.004,-0.0073,-0.0094,-0.1048,-0.0159,-0.0509,-0.1063,0.0092,0.0794,0.0404,-0.0195,-0.0936,-0.0768,0.065,0.0356,-0.0358,-0.0911,-0.038,-0.0297,0.0146,0.0834,0.0089,-0.1145,-0.0766,-0.174,0.0546,0.0103,0.1006,0.0702,-0.067,0.0273,-0.011,0.0773,-0.202,0.0604,0.0433,-0.0246,-0.1356,-0.006,-0.04,0.0439,0.0531,-0.1708,-0.082,-0.0926,-0.0341,-0.0556,0.0179,-0.0288,-0.0777,-0.0056,-0.0655,0.027,-0.0052,-0.0443,0.0515,0.0133,-0.1024,0.0031,-0.0298,0.018,0.0202,-0.0589,0.0012,-0.0391,-0.0911,0.0754,-0.002,0.0524,0.0098,-0.0289,0.0309,-0.1066,-0.0715,-0.0185,-0.2301,0.0558,-0.0013,-0.022,0.0439,0.0351,0.0339,0.0218,0.0557,0.0407,0.058,0.0221,0.0475,-0.0011,-0.0691,0.0261,-0.0023,-0.0231,-0.072,0.0653,0.0334,0.0513,-0.0234,0.0335,-0.0138,0.0123,-0.0002,0.06,0.0914,0.0675,0.1161,0.0121,0.0495,0.0198,0.0739,0.0223,-0.0895,0.0284,-0.0643,-0.1396,-0.078,0.0232,-0.0131,-0.0578,-0.0158,0.0346,0.1106,0.0059,0.0128,0.005,0.026,0.0137,-0.0161,0.015,-0.0078,-0.0421,-0.0017,-0.0127,0.0743,0.0753,0.0766,0.0385,-0.0336,-0.1082,-0.0261,-0.014,0.0641,-0.0741,-0.0379,-0.0937,-0.0068,-0.0647,0.0694,0.0278,-0.1102,0.011,-0.0584,-0.0759,-0.0405,-0.0315,-0.019,0.0255,-0.0835,-0.0169,0.0276,0.026,0.0358,0.0529,0.0105,0.0115,0.0103,0.0309,0.0044,-0.0035,-0.0163,-0.0482,-0.0204,0.0892,-0.0298,0.0301,0.0158,-0.0461,0.0199,0.0881,0.0295,0.0591,0.0551,-0.1085,-0.0336,-0.1849,0.0264,0.0009,0.0358,0.0271,-0.0803,-0.1887,-0.0792,-0.0335,-0.0688,-0.0503,-0.0024,-0.0459,-0.0804,-0.0688,-0.0271,-0.0183,0.0501,0.0207,0.0675,-0.0387,-0.0113,0.0523,0.0854,0.0079,0.032,-0.0012,0.0475,-0.0218,-0.0336,-0.0263,0.0387,-0.0157,0.0656,-0.0051,0.0232,0.0028,0.0397,-0.0789,-0.0012,0.0199,-0.0403,0.0626,-0.0406,-0.0563,0.0786,-0.041,0.0074,-0.0357,0.0324,0.0391,0.0802,-0.0205,-0.0313,0.0902,0.0888,0.0262,-0.0267,0.024,0.0379,0.0593,0.0401,-0.0708,-0.0289,0.0012,-0.1702,0.0236,-0.0526,0.0705,-0.2527,0.0444,-0.0239,-0.0264,0.0282,-0.0424,0.1517,0.1649,0.0429,-0.1911,0.0335,0.0286,0.0292,-0.0498,-0.0534,0.0083,-0.01,0.0487,0.0389,0.0095,0.0478,-0.0307,0.0949,-0.1372,0.014,0.0752,0.0172,0.0374,0.0535,-0.0404,-0.1683,-0.0698,-0.0443,-0.2163,-0.166,0.0129,0.0237,0.0387,0.0205,-0.1063,0.0605,0.0075,-0.0298,-0.0696,-0.0061,0.028,-0.0331,-0.042,-0.0565,0.0181,0.0471,0.0049,-0.0775,-0.0835,-0.0638,-0.0952,-0.0025,0.0309,-0.0266,-0.0036,0.0012,0.0232,-0.0085,0.0217,-0.0184,0.0115,0.0119,0.0135,0.0077,0.1703,0.1311,0.1654,-0.0047,0.0473,0.058,0.0556,0.0316,0.1329,0.0771,0.1178,0.1154,0.1776,-0.0023,0.0014,-0.0607,0.0031,-0.0215,-0.0842,-0.037,-0.0733,-0.0443,-0.0161,-0.0139,0.0279,-0.0609,-0.0308,0.0867,0.0673,0.0586,-0.034,0.0618,0.0876,0.0229,-0.0132,0.0238,0.0461,-0.0045,0.0126,0.0547,-0.0316,0.0714,0.0601,0.022,0.1059,0.0836,-0.003,-0.0135,-0.0443,0.0182,-0.1045,-0.0925,-0.066,-0.0143,-0.0197,0.0563,-0.0121,0.0059,-0.0432,-0.0622,-0.0256,-0.0285,0.025,0.0388,-0.0137,0.0076,0.0672,0.0878,0.0688,-0.0323,-0.0598,0.0104,-0.0676,-0.0438,0.1086,0.0962,0.0019,0.0629,0.0397,0.0605,0.0339,0.0459,-0.0642,-0.0388,0.0432,-0.0368,0.0162,-0.0156,-0.0117,-0.024,-0.0736,-0.188,-0.2062,-0.012,0.0335,-0.0057,-0.0124,-0.0012,0.0391,0.0679,0.061,0.0169,-0.0041,-0.0421,-0.0142,-0.0686,0.0058,-0.07,0.0522,-0.0832,0.0977,0.0635,0.1094,0.0806,-0.0088,-0.103,-0.118,0.0367,-0.0805,-0.0404,0.0386,0.024,-0.0158,0.0423,0.0395,-0.1139,0.0097,0.0286,0.011,0.0512,0.1112,0.0211,0.0905,0.0719,0.1463,0.0645,0.0519,0.0768,0.0309,-0.1784,-0.0221,-0.0399,0.047,-0.0032,-0.0511,0.0178,-0.0239,-0.0302,0.0495,-0.18,-0.194,-0.2308,-0.176,-0.1781,-0.1389,-0.2352,-0.0942,0.0453,0.1229,0.0699,0.0642,0.0152,0.1034,0.1541,0.0393,0.1393,0.0936,0.0428,0.0198,0.0322,0.0075,0.0375,-0.039,-0.0463,0.0264,-0.0319,0.0377,0.1255,0.0835,0.0558,0.0224,0.0115,0.0426,-0.0224,-0.0742,-0.106,-0.0226,0.0481,0.1007,0.0701,0.0179,-0.0392,0.0164,-0.1036,0.0341,0.1136,0.0792,0.0314,0.0772,0.0636,-0.2544,-0.2066,0.0737,0.0172,-0.0365,-0.2232,-0.2092,-0.1328,-0.197,-0.1097,0.0047,-0.0025,0.0175,-0.1123,-0.0496,0.042,0.0677,-0.1243,-0.0119,0.0009,-0.0105,0.0417,0.0114,-0.053,0.0045,-0.0629,-0.1092,0.0933,0.0621,0.0208,0.0122,0.0311,-0.0699,-0.0308,0.0201,0.0519,0.0891,-0.0098,-0.1016,-0.0748,-0.0239,0.0312,0.0642,0.0427,-0.0117,-0.0018,-0.1809,0.071,0.1721,0.0758,-0.0227,0.044,-0.1072,0.1148,-0.0327,-0.1302,-0.0468,0.1903,-0.0971,-0.1006,-0.0173,0.1318,0.0254,0.0163,0.0061,0.0789,-0.0258,-0.115,0.0127,-0.007,0.0245,-0.0071,0.0329,0.0372,-0.0169,0.0096,0.0368,-0.0099,-0.0245,-0.0111,0.0498,0.0753,-0.0381,0.0523,0.0343,-0.0739,0.0155,0.0006,0.0123,-0.0541,-0.0642,-0.0857,0.0854,0.0271,-0.0194,-0.1631,0.0001,-0.016,-0.0205,-0.0383,-0.0403,-0.0735,0.0262,0.0474,0.0879,0.0738,0.0477,-0.0043,-0.0638,-0.0638,0.1048,-0.0608,-0.0333,-0.0613,-0.0322,-0.0766,-0.0136,-0.2167,0.1044,0.0913,0.0722,0.0316,0.0565,0.0598,0.0203,0.028,-0.0243,0.0006,-0.0271,0.0152,-0.1988,0.0671,0.1452,0.0711,0.0659,0.0049,0.1168,0.0668,0.0444,0.0594,0.0317,0.1031,0.0724,0.0237,0.0555,-0.0246,0.0847,-0.2212,-0.1318,-0.1527,-0.0546,-0.1545,0.1002,-0.0039,-0.0121,0.0436,-0.121,0.0356,0.0203,-0.0428,0.0152,0.0311,-0.0789,-0.0138,0.0737,0.0463,-0.0216,0.0026,0.1275,0.0689,0.0027,0.0093,0.02,0.0007,-0.0363,-0.1841,0.0361,-0.0499,0.0048,-0.0658,-0.1024,0.0765,0.0436,0.0423,0.0034,0.0605,0.0386,0.0186,-0.068,-0.0619,0.0161,0.0177,0.0387,0.0663,-0.0471,0.06,-0.0257,-0.0117,0.0051,-0.0791,0.0108,0.0297,0.0922,0.1145,0.0247,-0.0046,-0.0275,-0.0034,-0.0533,-0.0577,-0.0361,-0.0768,0.0272,0.0083,0.017,0.013,0.0657,-0.0717,-0.0089,-0.1114,-0.1035,-0.0119,0.0595,-0.0605,0.0861,-0.0206,-0.037,0.0417,0.04,0.1254,0.0333,0.0447,0.0784,-0.0224,0.003,-0.057,-0.1846,-0.0065,0.0244,0.0238,-0.0411,-0.1012,-0.0428,-0.0274,0.0204,0.0549,0.0788,0.0744,0.0621,-0.0862,0.0098,-0.0228,0.1283,0.0266,0.0402,-0.0266,0.0629,0.0283,0.016,0.0483,-0.0461,-0.045,-0.0419,-0.0297,-0.0251,-0.0161,0.0008,-0.008,0.0266,0.0217,0.0023,0.0511,0.0077,0.0382,-0.0151,-0.0511,-0.0813,-0.0578,0.018,-0.0027,-0.0584,-0.1031,-0.1938,-0.0308,0.0241,-0.0162,-0.0297,-0.0254,0.0401,0.1105,0.0389,-0.0097,0.1036,-0.0751,-0.0633,-0.0491,-0.0387,-0.0325,0.0483,0.0758,0.1174,0.1511,0.1791,0.0688,-0.004,0.0018,0.0354,-0.0728,0.0718,0.0138,0.0079,-0.0108,-0.0162,-0.0092,-0.0111,-0.0289,-0.0154,0.0238,0.048,0.0272,-0.0619,-0.0284,-0.0454,-0.0145,-0.0097,-0.0066,-0.0034,-0.0175,-0.0635,0.003,0.0557,0.0115,0.0189,0.0095,0.0131,0.0786,-0.0901,-0.0012,0.0147,0.0384,0.0199,0.0535,0.0082,-0.0313,-0.0081,0.0091,0.0683,0.0154,0.1615,-0.0161,-0.0245,0.0359,0.0633,0.0342,0.0255,-0.0482,-0.0777,-0.0819,0.0238,-0.034,0.0019,-0.023,0.0747,-0.0192,-0.011,0.0402,0.0001,-0.11,-0.0807,-0.0059,-0.0072,-0.0122,-0.187,-0.1927,0.0414,0.0156,-0.0689,0.0292,-0.0596,-0.0211,0.0536,-0.0309,0.0707,0.0209,0.0148,-0.0028,-0.0362,0.0151,-0.0638,0.0487,-0.0069,-0.0084,-0.1614,-0.1495,0.0528,-0.0437,0.0371,-0.0158,0.0361,0.0695,0.0242,-0.0267,0.0049,0.0374,-0.0722,0.1254,0.0069,0.087,0.0586,0.1214,0.186,0.1409,-0.0326,0.0381,-0.0802,0.01,0.055,0.1398,0.0166,0.0453,-0.0127,0.0378,0.0559,0.0426,0.1787,0.1458,0.1136,0.0917,0.023,0.0451,-0.0272,-0.0032,-0.0074,-0.133,-0.1101,-0.1374,-0.0034,-0.0124,0.0128,-0.0341,-0.1068,0.0296,0.0799,-0.0113,0.1868,0.0188,0.0582,0.0407,-0.0816,-0.0415,0.0193,-0.0146,-0.018,-0.0731,0.0064,-0.027,-0.0018,0.0162,-0.0104,-0.0177,-0.0571,-0.0444,0.0071,-0.0438,0.0424,0.0128,0.1128,0.0745,0.0425,0.006,0.089,-0.0035,-0.038,-0.1449,0.0639,-0.0452,0.014,-0.0152,-0.1679,-0.1684,-0.0789,-0.2083,-0.1856,0.193,0.0068,0.0694,0.0368,-0.0153,-0.0427,0.0759,0.1189,0.1193,0.0069,-0.0038,-0.0031,-0.0547,0.1245,0.076,0.0306,-0.0763,0.0116,-0.0237,-0.1058,-0.0546,-0.0152,-0.1047,-0.0758,-0.1782,-0.1267,-0.0563,-0.0233,0.0587,-0.0374,0.0524,-0.0381,0.0483,0.0094,-0.0289,-0.049,-0.0279,0.0059,-0.0385,-0.2125,0.0209,-0.1259,-0.1081,-0.1649,-0.0962,0.007,0.0081,-0.0166,-0.0154,-0.0195,-0.1018,-0.099,-0.0577,0.0408,0.0387,0.0497,-0.0001,-0.0104,-0.0464,0.0709,0.0723,0.0492,0.0729,0.049,0.0599,-0.0561,-0.0038,-0.0038,-0.0955,-0.0317,-0.0577,-0.0191,-0.0697,0.0155,0.0429,0.0195,0.0067,0.046,-0.0271,-0.04,-0.0474,0.0304,0.0265,0.0294,0.0692,0.1043,0.0972,0.0559,0.0121,-0.061,-0.0232,-0.1013,0.0781,0.0327,0.0019,0.0317,0.1379,0.0397,-0.0264,-0.1056,-0.0558,-0.1108,0.0115,0.0422,0.0021,-0.0523,0.0081,-0.04,0.135,0.0232,0.0409,0.0399,0.1848,-0.009,0.083,-0.0665,0.0111,-0.0108,0.0232,-0.0056,0.0103,-0.0494,0.1369,0.0454,0.0031,-0.028,0.0162,-0.0479,0.0995,0.0362,0.0422,-0.0822,-0.0002,0.0014,0.0741,-0.0841,0.1824,0.1851,0.1815,-0.0497,0.0285,0.0663,-0.0055,-0.0313,-0.0211,0.0167,-0.0194,0.0105,0.0195,0.018,0.0423,0.0257,0.0723,0.005,0.1969,0.0825,0.037,0.1243,-0.1053,0.0603,0.2559,0.0803,0.0414,0.074,-0.0594,0.2395,0.194,0.0057,-0.0535,-0.0315,-0.039,-0.0082,0.0255,-0.1281,-0.0741,-0.007,0.0574,0.0722,-0.0571,-0.0598,-0.021,-0.0048,-0.0255,0.0451,0.0287,0.0121,0.0434,0.0276,-0.0291,0.0111,-0.0154,-0.0438,0.0073,0.0105,-0.0381,-0.0428,-0.1357,-0.0776,0.0317,0.059,0.1604,0.0503,0.0654,0.0803,0.1119,-0.0905,0.0013,0.001,-0.2081,-0.1088,-0.1923,-0.1446,-0.0743,-0.1342,-0.0244,-0.0863,-0.0475,-0.0346,-0.1026,-0.1599,-0.2191,-0.2347,-0.1575,0.0921,-0.0384,-0.0702,-0.2256,0.2027,0.0607,-0.029,0.0608,-0.0284,-0.0446,-0.071,0.0322,0.0852,-0.0433,0.0592,0.0361,-0.0482,-0.0101,0.0027,-0.01,0.0644,0.054,0.0477,-0.0147,-0.0391,-0.1402,-0.0336,-0.0116,-0.0124,-0.0222,0.1165,0.061,0.0146,0.1058,0.0797,0.0971,0.0406,0.0158,-0.0436,0.07,-0.0197,-0.1032,0.0476,0.0146,0.0956,-0.031,-0.0024,-0.0149,-0.0176,0.0409,0.0262,0.0275,0.0694,0.0867,0.0181,0.0033,0.0246,-0.0229,-0.0278,-0.1288,-0.119,-0.1011,0.0478,0.0677,0.0465,0.103,0.0386,0.0704,0.0096,-0.065,-0.0127,-0.0242,-0.0209,0.0891,-0.0447,-0.0383,0.0243,0.0375,-0.0003,0.0418,-0.0048,-0.0315,-0.0686,0.1055,0.013,0.0237,0.1117,0.0987,0.0426,-0.0242,0.0281,0.0077,0.0199,0.0464,-0.107,-0.1001,-0.0556,0.022,-0.0866,-0.0582,0.0318,-0.0167,-0.0419,-0.0976,0.0354,0.0037,0.0629,0.036,0.0466,0.0449,-0.0364,-0.0189,-0.1787,-0.2124,-0.104,-0.0566,-0.109,0.015,-0.0629,-0.0545,0.0046,0.0211,-0.0035,-0.0244,-0.0454,0.0025,-0.0556,0.0774,0.0469,-0.0784,-0.0256,0.064,0.0501,-0.0468,-0.0132,-0.0155,-0.0622,-0.1042,-0.0188,-0.0769,-0.0291,0.0774,-0.0079,-0.094,-0.0426,-0.0407,0.0367,0.0507,0.0174,-0.0006,0.0881,0.0848,0.0758,-0.0704,0.0104,-0.0429,-0.0818,-0.012,-0.0744,-0.1324,0.0024,0.0195,-0.1401,0.0542,0.0643,-0.0545,-0.0052,0.0375,-0.0448,-0.0189,-0.067,-0.0504,-0.0395,-0.0325,-0.022,-0.024,-0.1325,0.0213,-0.0282,-0.0234,-0.0033,0.082,-0.0638,-0.0441,0.0099,-0.0071,0.0562,0.035,0.0701,0.0291,0.0457,-0.1158,-0.0748,-0.089,-0.0451,-0.0472,-0.034,-0.1717,-0.1791,-0.0573,-0.0762,0.1602,-0.0463,-0.0488,-0.0908,-0.0973,-0.0954,-0.0724,-0.0252,0.0351,-0.1488,-0.1677,-0.0827,-0.0713,0.1081,0.0774,-0.0374,-0.0272,-0.0239,-0.0365,0.003,0.0148,-0.0274,0.0191,-0.1037,0.0492,0.0455,0.0112,0.106,0.0132,0.052,0.0507,0.0388,-0.0431,0.0073,0.0172,0.0245,-0.0623,-0.0282,0.0208,-0.0484,-0.1002,0.1573,0.0297,0.0686,0.0545,0.0111,0.0317,-0.0936,-0.1289,-0.0767,0.0108,0.0115,-0.0484,-0.0277,0.0742,-0.0405,-0.0467,-0.0615,-0.1611,0.1293,0.0239,0.1342,0.1533,0.0829,0.0641,0.0691,-0.0095,0.0443,0.0386,0.0188,-0.0627,-0.0187,0.005,-0.017,0.0534,0.0788,0.0203,0.0411,-0.0693,0.0658,0.105,0.0011,0.0424,0.0291,0.0292,-0.15,0.0657,0.0763,-0.0567,0.0237,-0.0019,0.003,0.0055,-0.0097,0.0574,0.0276,0.0047,0.0396,-0.036,-0.0035,-0.0956,-0.0056,0.1358,0.0424,-0.0064,0.0294,-0.0044,0.0078,0.0583,-0.0522,-0.0035,0.0302,-0.0763,0.1056,0.0358,0.0214,0.0856,0.0853,0.0604,0.0081,0.0081,0.044,-0.0147,-0.0455,0.0518,-0.004,-0.1044,-0.0848,0.1211,0.082,0.1147,0.0826,0.0002,0.0052,0.1934,-0.2199,0.2516,0.1712,0.0017,-0.0124,-0.0753,-0.1479,0.0215,-0.1979,-0.0988,-0.0596,-0.0484,-0.0332,0.0515,-0.0262,-0.0582,-0.0192,-0.0217,0.0191,0.0917,-0.0171,0.043,-0.0114,-0.0285,-0.0399,-0.0129,0.0015,0.0196,-0.0593,-0.0358,0.0301,0.0095,0.0322,0.0988,0.0165,0.098,0.0212,0.0181,-0.0017,0.0836,-0.1985,-0.1858,-0.0434,-0.1802,-0.1477,-0.0206,0.0033,0.0263,-0.0098,-0.0029,0.0055,-0.1108,0.021,-0.0317,0.0854,0.0106,-0.0908,0.1062,-0.0041,0.0343,0.0371,-0.2022,0.0283,-0.185,-0.0813,-0.1765,-0.0856,-0.1196,-0.2371,-0.0411,-0.0145,0.0705,-0.0572,0.0189,0.005,-0.0185,0.0834,0.0359,-0.1035,-0.0278,0.0358,0.0287,-0.0884,-0.0329,0.0349,0.0079,0.0364,0.021,0.0403,-0.0892,-0.031,0.0111,0.0307,0.0263,0.0756,0.0681,0.0067,0.07,0.005,-0.0401,0.0626,0.0302,-0.0287,-0.0462,0.0127,-0.0492,-0.0075,-0.0785,-0.0236,0.0168,-0.0147,0.0364,0.0665,0.002,-0.0192,0.0204,0.0014,0.0004,0.079,0.2471,0.0163,0.0229,0.0312,0.0359,-0.0207,0.0157,0.0457,0.0515,0.0509,0.0091,0.0238,0.0073,0.0301,-0.0498,-0.0614,-0.0257,0.0754,0.0486,0.0078,0.0953,0.0476,0.0918,-0.1235,-0.049,0.0435,-0.0071,-0.0614,-0.0219,-0.0502,0.0119,-0.0253,-0.0583,-0.0622,0.0948,-0.0478,0.0338,0.0836,-0.0404,0.0012,-0.1756,-0.1964,-0.0811,-0.0756,-0.1104,0.0357,0.0467,0.1136,0.0774,0.0826,0.0587,-0.0257,0.059,0.0022,0.0956,0.0341,0.1044,0.0865,-0.0144,0.0366,0.011,0.0352,0.0838,0.0317,0.0145,0.0677,0.0434,0.0717,0.0711,-0.0971,-0.0769,-0.0788,-0.037,0.0412,0.013,-0.0292,0.1096,0.0362,0.0093,-0.0122,0.0134,-0.0038,0.125,0.0214,-0.0114,-0.0274,0.0386,0.0403,0.0096,0.0087,0.0334,0.0115,-0.0362,-0.0239,0.0459,-0.0199,0.0337,0.0902,0.0739,0.1465,0.0896,-0.0796,-0.0078,-0.0022,0.0076,0.0002,-0.1034,0.009,-0.0013,-0.0188,0.0501,0.09,-0.0337,0.037,-0.0247,-0.0123,0.0228,0.077,0.0003,-0.0592,-0.01,-0.0458,-0.0106,0.0009,-0.0184,0.0294,-0.0236,-0.0101,0.046,-0.003,-0.0633,-0.0248,-0.0082,0.0055,0.0529,0.0376,-0.098,0.0312,0.0511,0.0707,-0.0368,-0.0638,-0.0693,-0.0149,-0.0887,0.0533,0.0018,0.0388,-0.093,-0.0145,-0.0477,-0.088,0.1528,-0.0105,0.0111,-0.1054,0.025,-0.0056,-0.1058,0.0041,0.042,-0.0851,0.0027,0.0394,-0.0888,0.0053,-0.0108,-0.0584,-0.0385,-0.0164,-0.0211,0.0496,0.0389,0.0302,0.0718,-0.0324,0.0116,-0.0902,-0.0311,-0.0714,0.0803,-0.0145,0.0443,0.0232,-0.0628,0.0083,0.0129,-0.0515,-0.0424,-0.0784,-0.031,0.0089,0.1048,0.1107,0.0789,0.0804,0.0144,0.0143,0.0285,-0.0008,-0.1054,0.0653,0.027,-0.0382,0.0186,-0.0026,-0.0831,0.1045,-0.0503,0.0479,0.0188,0.0326,-0.0416,-0.0022,0.0284,0.0685,-0.0875,-0.0021,-0.0755,0.0233,-0.0192,-0.0746,-0.0361,-0.0206,-0.0329,-0.1469,-0.1883,-0.1886,0.0728,0.0309,0.0063,0.0076,0.0423,0.0393,0.0554,0.0657,0.03,-0.0668,0.0938,0.0384,0.0439,-0.0099,0.0656,0.0123,0.0126,0.0527,0.0928,-0.0077,-0.0335,0.0203,0.0728,0.0732,-0.1141,0.0387,-0.0303,-0.0379,0.0553,-0.0801,-0.0722,0.0754,-0.0038,0.0078,-0.0206,-0.0304,-0.0487,-0.006,-0.0254,-0.059,-0.1376,-0.0349,-0.138,0.0671,0.0092,0.1056,0.1212,0.0376,0.2161,0.0764,0.0599,0.1631,0.0881,0.1035,-0.0329,-0.0197,0.053,-0.0019,0.1001,-0.163,-0.1871,-0.1501,-0.0646,-0.0095,-0.0871,0.2362,0.1164,0.2147,-0.0098,-0.0501,-0.165,-0.0426,-0.0355,-0.1691,-0.0613,-0.138,-0.014,0.0108,0.0135,-0.0278,-0.0325,0.0066,-0.0015,-0.0658,0.0329,0.0315,-0.0618,-0.0488,-0.0016,0.0043,0.0384,0.0663,0.0317,0.0135,-0.1811,-0.0699,-0.0609,-0.031,-0.0285,0.0419,0.0316,-0.0691,-0.0425,-0.1046,-0.075,0.0164,-0.0282,-0.0518,0.0427,0.0128,-0.0091,-0.1191,-0.0409,-0.1818,0.0436,-0.064,-0.0614,-0.0136,0.0635,-0.0344,-0.0604,0.0654,0.0012,0.0431,-0.0659,-0.007,-0.057,0.0227,-0.0575,-0.1672,0.0274,-0.0809,0.0268,-0.08,-0.0773,-0.0992,-0.1282,-0.0768,-0.145,0.0087,-0.0525,0.0966,0.0796,0.0084,-0.0213,-0.0614,0.0034,-0.0219,-0.0041,-0.0183,-0.003,-0.0294,-0.1264,-0.0332,-0.0246,-0.0151,0.028,0.2318,0.1684,0.1709,0.1612,0.1404,0.1093,0.004,-0.0281,-0.1466,-0.1164,-0.0844,0.0166,0.01,0.0818,-0.0467,-0.0809,-0.1027,-0.0111,-0.043,-0.1816,-0.1611,-0.0818,-0.0336,-0.0829,-0.0574,0.1279,0.0578,0.0628,0.0722,-0.0765,-0.0517,0.0184,0.0521,0.0167,-0.0503,0.015,0.0314,0.0229,0.0065,0.1314,0.0869,0.0494,0.0679,-0.0799,-0.0299,-0.0501,-0.1447,0.1039,-0.0017,-0.0122,-0.0832,-0.0887,0.055,0.0251,0.0784,0.0526,0.0041,0.081,-0.0152,0.0101,0.0435,-0.0186,0.0927,-0.1201,-0.1681,-0.1494,-0.0204,0.0094,-0.1462,-0.0466,-0.1139,0.0555,0.0525,-0.0088,0.0339,-0.0086,0.0171,0.0329,-0.105,-0.0788,0.0142,0.0241,0.0097,-0.0273,0.0099,0.0528,-0.0806,0.0376,0.0302,0.0657,-0.0398,-0.0192,0.0315,-0.0355,0.0176,0.0085,0.0484,0.0513,0.0171,0.2011,-0.0371,0.0138,0.0128,0.003,0.0303,0.053,-0.0425,0.0364,-0.0049,0.0391,0.083,-0.0168,0.0246,-0.0179,-0.002,-0.0507,0.0282,0.0211,0.0552,-0.014,0.0439,-0.0289,0.0885,-0.034,0.052,0.1032,-0.0403,-0.0421,-0.0071,0.0352,0.0307,-0.0312,0.0937,0.047,0.0096,0.0046,-0.14,0.2228,0.1912,-0.0577,0.0828,-0.0155,-0.0757,0.0613,-0.2163,0.1988,-0.1754,-0.1585,0.0276,0.0852,0.0718,-0.0415,0.0043,0.0302,0.0202,-0.1317,0.0452,-0.0186,0.0292,-0.0608,-0.0725,-0.0697,0.0633,0.0865,0.044,-0.0073,0.0286,0.1971,0.0072,0.014,-0.0121,0.0238,0.0717,0.0581,-0.161,0.0512,0.0312,-0.1316,-0.1983,-0.0156,0.0162,-0.1257,-0.0986,-0.0886,0.0311,0.0205,0.0139,0.0224,-0.0143,-0.0848,0.046,-0.0334,-0.0341,-0.0029,0.0161,-0.0775,-0.0807,0.0266,-0.0596,-0.0087,0.2655,0.1982,0.1164,0.0749,0.1586,0.1933,0.0757,0.1707,0.0792,-0.0153,0.1383,0.1476,0.2914,0.0763,-0.0062,0.1705,0.1658,0.2119,0.2118,0.0253,0.0576,0.0613,0.0433,0.0154,0.0088,0.0222,-0.0466,0.0165,0.0005,0.0189,0.0817,-0.032,-0.0045,0.0548,0.049,0.2157,0.2632,-0.0221,-0.0306,-0.0085,0.1678,-0.0748,0.0001,0.0719,0.0919,0.0382,0.0859,-0.0166,-0.1133,-0.0553,-0.0274,-0.0729,-0.0058,-0.0943,-0.0995,-0.0824,0.0731,-0.1365,0.1897,0.0004,0.0702,-0.0011,-0.0402,-0.015,-0.0694,-0.0689,-0.0338,0.0034,-0.1433,0.1759,-0.0259,-0.1459,0.0354,0.0553,0.0462,-0.0371,-0.0389,-0.0745,-0.067,0.088,0.0781,-0.158,-0.1607,-0.0541,-0.1543,-0.0309,-0.0156,0.0315,0.0245,0.0066,0.0355,0.0573,0.0085,0.0303,-0.0823,-0.0541,-0.0585,0.0118,-0.0554,-0.0007,0.0191,-0.0295,-0.0286,0.0328,0.0589,0.0151,-0.0435,0.062,-0.0394,-0.0017,0.0478,-0.0172,-0.0344,0.0186,0.0667,-0.0033,-0.0349,0.0626,0.0184,0.0764,-0.0652,0.0461,0.0926,-0.067,0.0022,0.0112,-0.0045,0.033,0.0229,0.0747,0.0361,0.0517,0.0699,-0.1357,-0.0316,-0.1076,0.0329,-0.0116,0.0287,0.0126,-0.035,0.0039,0.0072,-0.0102,0.016,0.0359,-0.0815,0.0181,0.0151,-0.0232,-0.2591,-0.1712,0.1526,0.0234,-0.0155,0.0052,-0.0187,0.0482,-0.0446,0.0177,-0.0768,-0.0202,-0.0193,0.0223,0.0747,-0.0304,-0.0286,-0.0429,0.0086,-0.0466,0.0276,-0.0184,0.1256,0.0054,-0.0201,0.0293,0.0036,0.0693,-0.1059,0.0357,-0.0309,-0.0057,-0.0202,0.1025,0.0839,0.0773,0.0431,0.0345,0.0118,0.1587,-0.0362,0.0161,-0.0061,0.0082,-0.0078,0.0224,0.0577,-0.0093,0.0258,0.0818,0.0924,-0.0331,-0.1772,-0.2299,-0.1262,-0.0677,-0.2318,-0.1419,-0.1235,-0.2361,-0.136,-0.1095,-0.0395,-0.0551,-0.1147,-0.1178,-0.1194,0.0652,-0.1844,-0.0468,-0.1494,-0.224,-0.1049,0.0086,0.0754,0.0637,0.0642,0.1114,0.065,0.0418,0.0312,-0.1389,-0.0442,0.0769,0.0762,-0.0007,-0.0339,0.0584,0.0792,0.0329,0.0077,0.0229,0.0416,0.0148,-0.0128,-0.0286,-0.0261,0.0249,-0.0035,0.0581,0.0556,-0.1016,-0.0068,0.0257,-0.039,-0.0467,-0.0032,-0.0598,-0.0266,0.0609,0.1158,0.0484,0.0415,0.0895,0.1332,0.051,-0.0522,-0.0527,0.0619,0.059,0.0753,0.0575,0.0256,0.006,0.046,-0.0351,0.0197,0.0351,-0.0576,-0.0153,0.0112,0.0204,visual sentence recognition
trm_557b4891e9265,0.1411,0.1353,0.1506,0.16,-0.0015,0.048,0.0946,0.1006,0.0613,0.1127,0.0002,-0.0064,0.1322,0.0751,0.1525,0.0894,0.1106,0.1022,0.1002,-0.0028,0.0804,-0.0119,0.0508,-0.072,0.0443,0.012,0.0145,0.1161,0.1699,0.0951,0.1034,0.0866,0.1287,0.1449,0.0959,0.1247,0.094,0.091,0.1615,0.0337,0.1166,0.1287,0.0512,-0.1129,0.105,0.0738,-0.1802,0.1048,-0.0246,0.1264,0.0789,-0.0341,-0.066,0.0022,0.0215,0.0796,0.1286,0.0282,-0.0185,0.0437,-0.0023,-0.0055,0.1474,-0.0696,-0.0107,-0.0257,0.2165,0.2382,0.1272,0.0047,-0.0733,-0.0095,-0.1644,0.0599,0.1697,-0.1337,0.1449,-0.0437,-0.058,0.0268,-0.0586,-0.0985,0.0429,0.1196,-0.0464,-0.0466,0.0244,0.0127,-0.0293,0.1945,0.0859,0.0778,-0.0157,-0.0855,-0.1299,-0.1027,-0.1265,0.0164,-0.1537,0.0008,-0.0612,-0.0307,-0.071,0.0225,-0.0717,0.1409,0.1528,-0.2207,0.0474,0.0486,-0.0098,0.109,-0.1169,-0.1556,-0.0486,-0.0398,0.101,-0.023,0.0076,0.0863,0.0898,0.1652,0.0987,-0.0146,0.0982,0.1063,0.0568,-0.0374,-0.0821,-0.0449,-0.0028,0.1056,0.0062,0.2047,-0.0329,0.189,0.0471,0.104,0.0127,0.0625,0.1146,0.1485,-0.0883,-0.0075,0.0477,-0.0435,0.1355,-0.0267,0.0994,-0.0983,0.0715,0.0751,0.1358,0.1232,-0.1591,0.0347,-0.0653,-0.0035,-0.0352,0.0444,0.0736,0.074,0.2133,0.233,0.0148,-0.0279,0.0061,0.1443,0.1356,-0.0472,0.0336,0.1099,-0.0398,0.1067,0.1096,0.1202,0.0893,0.0798,0.0307,0.0661,0.1297,-0.1127,0.0558,0.0134,0.1028,0.0706,0.0858,-0.0035,-0.0358,0.0779,0.0654,0.0562,0.0164,0.1549,0.1333,0.2676,0.2345,-0.01,-0.046,0.1775,0.1039,-0.1279,0.1364,0.1685,-0.008,0.0615,0.0054,0.0652,0.0971,0.0081,0.1185,0.0178,-0.046,-0.0181,-0.1004,-0.0476,-0.1272,0.1643,0.2468,-0.0279,-0.1135,0.1084,0.1224,0.051,-0.0528,-0.0295,0.0613,-0.1547,-0.024,-0.1923,0.1239,0.1263,-0.1573,0.1714,0.1682,-0.0572,-0.002,-0.0883,-0.0118,0.0794,0.0348,0.2061,0.1016,0.0135,0.0983,0.084,0.0194,0.125,0.091,0.0521,-0.0539,-0.051,-0.0165,-0.0715,0.0,0.1457,0.0196,0.1141,-0.1768,-0.2752,-0.0552,-0.2154,0.1196,-0.0778,-0.1643,-0.2939,-0.1095,0.0097,-0.0724,-0.0001,0.0748,0.0629,0.0916,-0.024,0.0778,-0.0987,0.1073,0.1345,0.1517,-0.0045,-0.0824,0.013,0.0005,0.1493,0.1022,0.0991,-0.0754,-0.1189,0.1794,0.1265,0.0655,0.085,0.0461,0.0432,0.115,0.0377,-0.0393,-0.1023,0.0542,-0.1115,-0.1026,0.1306,0.1372,0.0545,0.145,0.1394,0.1398,0.0674,0.0469,-0.0272,-0.0023,0.0021,0.1753,-0.1019,-0.0659,0.0736,-0.142,-0.0288,-0.0858,0.1501,-0.001,-0.0417,0.1054,0.1174,0.1098,0.0843,-0.0162,0.024,0.1,0.116,-0.0259,0.1191,-0.0121,-0.0294,-0.067,-0.0672,-0.1186,-0.0354,-0.0656,0.1081,0.0959,-0.0614,0.0398,0.0709,-0.1005,-0.0356,0.2709,0.2048,0.1849,0.116,0.1204,-0.0728,0.1327,0.0647,0.0455,0.1205,0.0731,0.1053,0.1651,0.1086,0.0157,0.0399,0.0123,0.0477,0.0422,-0.0424,0.1732,-0.1635,-0.0724,0.1492,-0.0287,-0.059,0.0145,-0.1041,0.1268,0.0427,0.0692,-0.1197,-0.2751,-0.1835,-0.3036,0.0553,0.115,-0.0041,-0.0398,-0.0869,0.0901,0.0295,-0.0312,0.0575,0.0805,0.0358,0.1506,0.0266,0.0165,0.0989,0.1705,0.185,0.1223,0.0564,0.0501,-0.0492,0.0017,0.0383,-0.0402,-0.0735,-0.1082,-0.0105,0.1246,0.0429,0.0657,0.1526,0.0396,-0.3032,0.0737,-0.0307,-0.3254,0.0069,0.0919,0.0596,0.0154,0.2861,0.2009,0.3856,0.3301,0.1786,0.2065,0.1597,0.1717,0.2012,0.0442,-0.0925,0.0142,0.041,-0.0653,-0.1026,0.0086,-0.0432,0.2979,0.1794,-0.0675,-0.0452,0.046,-0.0861,0.0262,0.1081,-0.0301,-0.0963,0.0835,0.0808,0.012,-0.0689,0.1274,0.0887,0.0459,0.117,-0.0541,0.1074,0.0454,0.044,-0.0113,0.0969,0.0455,-0.0876,0.1005,0.1158,-0.0301,-0.3965,0.1112,0.0384,0.0055,-0.0168,-0.0041,0.0103,0.0084,0.0676,0.011,-0.0037,0.0246,0.0823,-0.015,0.0217,0.0441,-0.0369,-0.1108,-0.144,0.027,0.0411,0.0492,0.0557,-0.1113,-0.0899,0.1197,0.1627,-0.0952,-0.0879,0.0247,0.0705,-0.0446,0.1023,0.0876,-0.0448,0.077,0.1566,0.1203,0.1077,-0.0803,-0.0922,0.0419,-0.0933,0.1927,0.0132,0.0079,-0.0137,-0.1029,-0.0482,0.1243,0.1252,-0.0616,0.1003,0.0886,0.0873,-0.1178,-0.0628,-0.1826,-0.0634,-0.1553,-0.1345,-0.0752,-0.0637,0.0959,0.0385,0.1294,0.269,0.0333,-0.0057,0.1568,0.1566,0.0538,0.1211,0.0027,-0.0295,0.0138,0.0501,0.0915,0.0599,-0.0002,-0.0699,-0.0376,0.0362,-0.0665,0.0016,0.0537,0.0719,0.0319,0.1182,-0.1246,-0.0493,-0.1119,0.0715,0.0324,-0.048,0.0545,-0.0153,0.0375,-0.0826,-0.1187,-0.0684,-0.0016,0.0158,0.0797,-0.0418,0.175,-0.0027,0.1025,0.1184,-0.0575,-0.0022,-0.0816,-0.0846,-0.0333,0.1169,0.0076,0.0638,-0.0645,-0.017,0.074,-0.0414,-0.0215,0.0242,0.0842,0.0435,-0.0775,-0.0855,0.1126,0.093,0.2233,0.0424,-0.1318,0.0326,-0.0742,-0.0777,-0.0621,-0.0741,-0.0222,0.0872,-0.0106,0.1553,0.1492,-0.0565,0.1898,0.076,-0.0723,0.0414,0.2748,0.0399,0.0862,-0.0281,-0.0416,0.2102,0.1071,0.2334,-0.06,-0.0215,0.0461,-0.0034,0.129,0.1008,0.1341,-0.0195,-0.0548,0.0458,0.0462,0.0146,0.0542,0.0227,-0.0378,0.0862,0.0568,0.0662,0.1119,-0.0472,0.0363,0.1179,0.1193,0.0308,0.1891,0.1081,-0.0704,0.1885,-0.0061,0.156,-0.0993,0.1047,0.0187,0.1139,0.0614,0.1132,0.0528,0.1087,0.1455,0.0663,-0.1558,0.1035,0.0114,-0.0629,0.1923,0.0971,0.122,0.0895,0.0856,0.0471,0.0838,0.0504,0.0774,0.0997,-0.1879,0.0865,-0.0621,0.0465,-0.0457,-0.0604,-0.0849,-0.0215,-0.1408,0.1729,0.1006,-0.0679,-0.0174,0.027,0.0023,-0.1566,-0.1034,-0.1139,-0.092,-0.0239,-0.0497,0.0534,0.0983,0.0242,-0.0147,-0.0168,0.0144,0.0787,0.0598,0.0736,0.1581,0.156,0.1347,-0.0557,-0.1534,-0.0608,0.0443,-0.1217,-0.0714,-0.0391,0.0423,-0.0861,0.1021,-0.023,-0.1232,0.0784,0.2923,0.2978,0.1819,0.0065,0.0193,0.118,-0.0464,0.1078,-0.0807,0.0199,0.0961,-0.0459,-0.0644,0.0029,0.1934,-0.0801,-0.0985,-0.2291,0.0973,0.0149,0.1316,-0.0126,-0.055,0.1103,-0.1203,-0.0598,0.0375,-0.0194,0.0127,-0.0756,0.1531,0.1964,0.1733,0.1246,-0.0766,-0.2632,-0.0391,0.1604,-0.0168,0.0298,-0.0599,-0.0992,-0.0271,-0.0055,0.0489,0.1027,0.0761,-0.1169,-0.0933,-0.1395,0.0763,0.0436,-0.002,0.0771,-0.0729,0.0608,0.11,-0.0099,0.1211,0.1157,0.0487,-0.0865,-0.1369,-0.0624,-0.0002,0.0471,0.0127,-0.143,0.0496,0.11,-0.1097,0.0054,-0.0274,0.0225,-0.106,0.054,-0.0989,0.1513,0.166,-0.0879,-0.1848,-0.1842,-0.0053,-0.0188,-0.0728,0.0028,0.03,-0.1722,0.0332,-0.0138,-0.1245,-0.1746,-0.0624,-0.0069,-0.1814,-0.1868,0.1393,-0.0262,-0.107,0.2163,0.1362,0.0727,0.1152,-0.0828,0.2154,0.0874,0.1361,0.0929,0.1659,-0.0591,0.0132,-0.1242,0.0937,0.084,0.0009,-0.033,-0.0884,-0.0726,-0.0868,-0.1476,-0.032,-0.0384,-0.0024,-0.0144,-0.1041,-0.1279,0.0968,-0.1091,-0.0547,0.0329,0.0326,0.1037,0.0424,-0.0969,0.0552,0.2863,0.1453,0.0433,-0.1066,-0.1695,-0.0582,-0.0318,-0.0418,0.0461,0.0853,0.099,-0.0004,0.0698,-0.0212,0.1524,0.0453,0.0831,-0.0796,-0.0146,-0.0251,-0.0106,0.1786,0.1384,0.0738,-0.189,0.0936,0.095,0.1022,-0.0579,0.0041,0.1586,0.0376,0.1221,-0.0392,0.085,-0.0674,-0.0838,-0.0415,-0.0999,0.2105,0.0753,0.0214,-0.1064,0.122,0.0024,-0.1632,-0.0532,-0.0912,-0.3925,-0.1123,0.0492,0.0767,0.0659,0.063,0.0469,0.0046,-0.0716,-0.1584,-0.0416,-0.0379,0.1125,-0.1098,-0.2074,-0.0026,0.0254,0.0333,0.0541,0.2386,0.0899,0.0748,0.0114,-0.0461,0.1037,0.0491,-0.1564,-0.027,0.1261,0.0262,-0.1096,0.0269,0.0175,0.0696,0.14,0.1428,0.1542,0.1171,0.1517,-0.0511,-0.0051,0.049,0.1338,0.0437,0.1214,-0.0038,0.1197,0.0943,0.0822,-0.0273,-0.0986,-0.1024,0.0249,-0.0558,0.0325,-0.0794,-0.0848,-0.1815,-0.208,-0.1373,0.0441,0.0469,0.0282,0.0065,-0.15,-0.1057,-0.1097,0.0359,-0.1557,-0.0338,-0.1529,0.0155,0.0257,0.0584,-0.1088,0.0348,-0.0937,0.1685,0.0435,0.058,0.0017,-0.0228,-0.0358,-0.0808,-0.025,-0.104,-0.2015,-0.1479,0.0299,-0.0053,0.0041,0.047,-0.0106,0.0185,0.0435,0.1062,0.1417,0.0643,-0.1144,-0.1,0.1416,0.1211,0.0532,0.1837,0.0766,-0.1588,-0.0654,-0.1146,-0.1396,-0.1124,0.069,-0.0143,-0.0711,0.0054,0.0311,0.0062,-0.0393,0.0476,0.1109,0.0175,-0.0435,0.1334,0.0006,0.0953,-0.0618,0.1594,0.0067,-0.0109,-0.0495,-0.0036,-0.0504,-0.0009,0.0332,0.0091,0.0199,0.0192,0.0634,0.0085,0.009,-0.0384,0.0448,0.0672,-0.0071,0.0,0.0222,0.0806,0.0789,0.1603,0.1218,0.0971,-0.1851,0.0121,-0.0612,0.1423,-0.2071,-0.1325,0.0327,-0.0044,-0.0359,-0.1135,0.0079,-0.0693,0.1219,0.0954,-0.0103,0.0379,0.0772,-0.0048,0.0457,-0.0627,-0.099,0.0722,0.0409,0.0635,-0.0358,0.112,-0.0081,-0.0371,-0.0187,0.1368,0.0503,0.0473,-0.0714,0.0414,0.0581,-0.4507,-0.2999,-0.2214,-0.0935,-0.1082,-0.0278,-0.1924,-0.1929,0.1373,-0.4341,-0.3941,-0.2832,-0.2413,-0.3578,-0.1071,-0.1107,-0.0801,-0.0477,-0.0984,-0.027,-0.0506,-0.0235,0.113,-0.0341,-0.048,-0.0717,-0.0811,0.0161,0.0578,-0.1915,-0.1101,0.0584,0.0263,0.0645,-0.0797,-0.0343,-0.1464,0.0254,0.1671,0.0496,-0.037,-0.0603,-0.1756,-0.1786,0.1235,0.0904,0.1718,0.1006,0.0892,-0.3962,0.1218,-0.1498,-0.1275,0.0395,-0.0293,0.0965,0.0575,0.0135,0.0398,-0.1805,-0.1033,0.0254,-0.0323,-0.041,0.1123,0.1619,-0.0408,0.0643,-0.0111,-0.0031,0.1119,0.0585,0.1271,0.0529,0.0241,0.0215,0.2625,0.0925,-0.2574,-0.0003,-0.0171,0.0179,-0.1807,-0.0342,-0.0075,0.1499,0.1528,0.013,0.1033,0.1272,0.138,0.051,0.0301,0.0164,-0.1056,-0.0485,-0.0376,-0.1297,0.0102,-0.0429,0.0232,-0.1268,0.0245,-0.0983,0.0449,-0.1161,-0.2223,-0.0087,0.052,-0.1753,-0.1489,0.0411,0.1089,-0.0195,0.1777,0.0766,0.2825,0.0224,-0.0349,0.1006,0.1088,-0.0208,0.0874,-0.0016,0.1033,0.0619,0.0617,0.0695,0.0959,-0.0596,0.04,-0.532,-0.3755,-0.3454,-0.4706,0.1341,0.0539,0.0904,0.093,0.1109,0.0229,0.1408,-0.1945,0.0783,0.0443,-0.1164,-0.0135,-0.0006,-0.1111,-0.0583,0.0255,-0.0002,-0.0694,0.0417,0.0434,0.0019,-0.1514,-0.0008,-0.016,0.0903,0.0903,0.153,-0.0466,0.0326,-0.0127,0.0813,-0.1049,0.0683,-0.1675,0.2633,0.2338,-0.1287,0.0422,0.2216,0.2172,0.2021,0.0989,0.0778,0.02,0.0134,0.0318,-0.0449,-0.0455,-0.1855,0.0694,-0.1638,0.0549,-0.0704,-0.0703,0.0502,0.0333,0.006,0.0262,0.0091,0.0292,0.0289,-0.0612,-0.0432,0.0338,0.0436,-0.0336,-0.0216,-0.067,0.0332,0.0201,-0.0129,0.1161,0.0021,0.1635,0.3255,0.0185,0.0389,0.1961,0.0657,0.1013,0.1714,0.0184,0.1449,-0.0196,0.1918,0.0321,0.1217,0.254,0.009,-0.0055,0.068,-0.2761,-0.0996,0.0129,-0.0673,0.035,-0.0388,0.0376,0.1555,0.1507,-0.0352,0.0853,-0.0017,0.0567,0.0123,-0.0566,-0.0354,-0.0311,0.0929,0.0744,0.0443,-0.0328,0.0455,0.0581,-0.0137,-0.0487,0.0331,0.1044,0.0008,0.0794,0.0862,0.0231,0.1367,0.1544,-0.0143,-0.0162,0.0092,0.0236,0.0299,0.1233,0.1122,-0.0264,0.1574,-0.0252,-0.02,0.0893,0.1787,0.1547,-0.04,-0.1219,-0.0839,-0.0132,-0.0424,0.0033,-0.2916,-0.0798,0.0339,0.0633,0.1578,-0.1021,0.0309,-0.095,0.0056,-0.1849,-0.014,0.1494,0.085,-0.1012,0.0873,-0.0203,0.0857,0.0091,0.1032,0.0504,-0.0348,-0.0549,0.0522,0.0604,0.0869,-0.0246,-0.0587,0.0114,-0.0295,0.1741,-0.0056,-0.0036,0.1247,-0.0593,0.0462,0.0836,0.0276,0.0661,0.0834,0.0798,0.0421,0.067,-0.0237,-0.0013,-0.115,0.0497,0.0275,0.0465,0.0172,0.0445,0.0439,0.1812,-0.0583,0.163,0.07,-0.0223,-0.1031,-0.0865,-0.0332,-0.061,0.0864,0.0027,0.0511,0.0551,0.1734,0.0182,0.2152,0.0119,0.0207,0.0802,0.051,0.0866,0.0529,-0.1621,-0.1245,-0.0019,-0.4155,0.0199,-0.1118,-0.0001,-0.2772,-0.0014,0.0562,-0.1009,-0.2502,0.037,-0.016,0.0805,0.141,0.0878,0.0592,-0.0664,0.0537,0.1142,-0.0457,-0.1286,0.0804,0.0879,0.0302,-0.0057,-0.0763,-0.093,0.2965,0.1469,0.0605,0.285,0.232,-0.1308,-0.0776,-0.0428,-0.0225,-0.0518,-0.049,0.1951,0.0501,0.0311,0.09,0.2692,0.0496,0.0152,0.0623,0.1425,-0.1614,0.0182,0.0205,-0.0086,-0.0259,-0.1291,-0.1636,0.0514,-0.122,0.0572,0.0626,0.1192,0.0064,-0.0397,0.0001,-0.0474,-0.1626,-0.0314,-0.0072,0.04,0.0947,0.0222,-0.3244,-0.322,0.1582,0.1656,-0.0264,0.0671,0.0803,0.0253,0.1857,-0.0704,0.0423,0.0312,0.0548,0.0096,-0.1455,0.0434,-0.0678,-0.0907,0.0354,-0.0305,-0.2988,0.1726,0.0399,-0.2877,-0.0289,-0.0438,-0.1089,-0.0789,0.0627,-0.1926,-0.1292,0.1069,0.0759,-0.0588,-0.0381,-0.1857,-0.1283,-0.0124,0.0179,0.0101,-0.1371,0.1193,-0.0236,-0.1986,0.0049,-0.0411,0.0051,0.0004,0.1522,0.0114,-0.0823,0.0826,-0.1198,0.043,-0.1316,-0.1787,0.0523,0.0201,-0.0207,-0.0766,-0.0289,-0.1547,-0.0807,-0.1264,-0.0816,-0.1844,-0.0091,-0.0452,-0.4999,0.0978,0.1269,-0.0216,0.0803,-0.0305,-0.0741,-0.1031,0.0797,-0.01,-0.0048,0.0361,-0.0155,-0.0056,0.0124,0.0202,-0.0225,-0.0579,-0.0981,-0.1195,-0.2976,-0.2704,0.0874,0.1654,0.0804,0.0269,-0.1382,-0.0932,-0.0541,-0.0617,-0.112,-0.0021,-0.0558,0.1917,0.2362,0.111,0.0001,-0.1153,0.0477,-0.0465,-0.021,-0.2572,-0.1857,-0.0656,0.0172,0.0691,-0.0232,-0.0424,-0.1002,0.1188,0.135,0.1745,-0.0651,0.0393,0.0011,-0.1374,0.0461,-0.0071,-0.1071,-0.0188,-0.0348,-0.0598,-0.0195,-0.008,0.0018,0.0003,-0.0829,-0.1251,-0.1858,0.063,-0.0765,-0.1293,0.0015,0.0974,-0.0342,0.1948,0.08,0.037,0.1188,0.0112,-0.1078,0.1267,0.1174,0.0322,0.0681,0.0623,0.0517,0.1087,0.0684,0.038,0.0202,0.1109,-0.0226,-0.1551,-0.0298,-0.1129,0.1841,0.1198,0.1413,0.0302,-0.0573,0.079,0.1001,0.0217,0.1556,0.0149,-0.1822,-0.0573,-0.1148,-0.1227,-0.0397,-0.0151,0.0644,-0.0162,0.0306,0.0392,0.2301,0.0534,0.0931,0.0635,0.0569,-0.045,-0.0816,-0.3728,-0.2972,-0.1315,-0.1107,0.1548,0.2766,0.1389,0.2174,0.1281,-0.028,0.0473,0.0053,0.0698,0.1537,0.1889,0.0956,-0.1,-0.0645,0.0652,0.0773,-0.0057,0.0531,0.2078,0.1243,0.0735,-0.0832,-0.0022,0.0274,0.2169,0.0926,0.1172,0.1198,0.2973,-0.0099,-0.0473,0.0919,0.0873,0.0865,0.0642,0.0376,0.1471,0.0775,0.0494,-0.149,-0.1607,-0.0551,-0.0969,-0.1056,0.059,-0.0393,-0.058,-0.1244,0.0906,0.0332,0.0637,-0.1048,0.1365,0.1545,0.1001,0.1352,0.0564,0.117,0.0689,0.1019,0.0522,0.0342,-0.0229,-0.0213,0.2221,-0.0448,0.0238,0.1019,0.0956,0.0984,-0.0233,0.1742,-0.0186,-0.0219,-0.2196,0.0188,-0.0328,0.2395,0.1294,0.1069,0.1267,0.1763,0.1082,-0.0243,-0.0399,-0.0426,0.0224,0.0777,-0.0175,-0.1232,-0.1958,-0.151,0.2934,0.3052,0.0857,-0.0573,-0.0023,0.1359,-0.0476,0.0878,-0.0405,0.0655,0.0854,0.086,0.0373,0.092,0.0907,-0.0232,0.1047,0.016,0.0672,0.0179,-0.0773,-0.0753,0.1222,0.1083,0.1554,0.1493,0.067,0.2061,0.0849,-0.299,0.0704,0.1035,0.0944,0.0591,0.1486,0.08,0.1143,0.1006,-0.1031,0.0761,0.0134,0.0161,0.1693,0.0747,0.1351,0.0151,-0.1676,0.1835,0.0564,-0.0256,-0.2684,-0.0192,-0.0256,-0.0422,0.0013,0.0095,0.0513,-0.0702,-0.005,-0.0547,0.2203,0.1543,0.1823,0.0714,0.0853,-0.1144,-0.2124,-0.2801,-0.0797,-0.0611,-0.1221,-0.1577,-0.0797,-0.0977,-0.0311,-0.0299,-0.0648,0.2304,0.1049,0.164,0.0979,0.0107,0.1043,0.1202,0.0828,-0.0326,0.0477,0.2616,0.2002,0.0815,0.1553,0.2935,-0.0065,0.1949,0.0662,-0.0486,0.1065,0.0065,0.1701,0.0791,-0.0152,0.0895,0.0522,-0.03,0.162,-0.0478,-0.0539,-0.0929,0.0185,0.1116,-0.0837,-0.0199,0.0293,-0.0811,0.0263,0.0376,-0.0928,-0.0109,0.0145,0.2516,0.1361,0.0482,0.0188,0.0355,0.0576,0.1218,0.0865,0.0402,0.0816,-0.1102,0.1352,0.0503,-0.0575,-0.0724,-0.0222,-0.0845,-0.0539,0.2889,0.0763,0.1263,0.1177,-0.1366,-0.2165,-0.2129,0.0759,-0.4756,-0.3065,0.2029,0.1093,-0.482,-0.1203,-0.0752,-0.1287,-0.1856,-0.0995,0.1052,0.0999,0.0701,0.1371,-0.5788,-0.4613,-0.3685,-0.1146,-0.191,-0.2976,-0.5106,-0.5075,-0.449,-0.0473,0.0183,0.0635,0.014,0.07,-0.0015,0.1187,0.0577,0.0051,0.0106,0.1043,0.0992,-0.1495,0.0306,0.035,0.1003,-0.0874,-0.1244,-0.1857,0.0909,0.0535,0.1618,0.0158,0.0039,0.0417,0.0675,0.0822,0.0232,0.0301,0.1264,0.1933,0.1727,0.0417,0.1157,0.0346,-0.2178,-0.0477,-0.1547,-0.055,-0.1419,-0.3481,0.0521,0.1627,0.1838,0.0865,-0.0955,0.0144,-0.1485,-0.0523,-0.1012,0.0076,0.1836,0.1856,0.1203,0.1085,0.0229,0.3431,0.255,-0.0467,0.0021,-0.2137,0.0903,-0.0215,-0.1149,-0.0068,-0.0371,-0.0693,0.0143,0.1412,0.1782,0.0034,-0.006,0.0854,0.0481,0.1002,-0.0742,-0.1571,-0.1319,-0.0543,-0.1683,0.0557,0.0443,-0.0743,-0.063,-0.13,-0.187,-0.0665,-0.0442,0.0272,-0.0631,-0.1201,0.0628,0.0646,0.0602,0.0535,0.0904,-0.0129,0.0064,0.0433,0.0201,-0.0409,-0.0549,-0.0406,-0.0878,0.0606,-0.1715,-0.1485,0.0994,0.1704,0.1148,0.1425,0.1567,-0.1112,0.046,0.0439,0.0473,-0.1541,0.0394,0.2408,0.0721,0.0019,0.0354,-0.029,-0.0077,-0.0932,-0.1533,-0.196,-0.4271,-0.1271,-0.077,0.0585,0.0485,-0.0504,0.1443,0.1411,0.0932,-0.0122,0.0931,0.0599,0.0483,0.0889,0.0609,0.1403,0.174,0.1418,0.0683,0.0925,0.1252,0.0307,0.1109,0.0595,0.0331,0.0653,0.099,0.0778,-0.2044,-0.0863,0.0071,0.1267,-0.1954,-0.128,0.1258,-0.1272,0.1764,0.1241,-0.0544,0.1072,0.1125,0.0424,-0.0379,-0.0318,-0.0239,0.1114,0.0584,-0.0114,-0.0046,-0.0632,0.1355,-0.0375,-0.0205,-0.0595,-0.0501,0.1427,0.0731,0.0072,0.0594,0.0625,0.0439,0.078,0.0205,-0.0461,0.0157,-0.0215,0.2686,0.1267,0.1537,0.2043,0.175,0.1371,0.1321,0.1321,0.0207,0.0678,-0.0318,0.2097,0.018,0.1327,0.1155,0.0208,-0.0148,0.3149,-0.1439,0.2214,-0.0455,-0.0687,-0.1343,-0.0692,-0.0425,0.1113,0.113,-0.0195,-0.0516,0.0275,-0.1016,0.0022,0.028,-0.105,-0.1118,0.0113,-0.0408,0.0754,0.0695,0.0168,0.1506,0.1066,0.0505,0.0932,0.03,0.034,0.0256,-0.0264,0.0238,0.0165,-0.0074,-0.1298,0.0372,-0.1537,-0.0268,0.1375,0.0474,0.182,0.0411,0.0836,-0.0211,0.0626,0.014,0.0123,0.0745,-0.0635,-0.0988,0.0475,-0.1867,-0.0525,-0.3675,-0.1561,0.0018,-0.0718,0.1612,-0.0469,-0.096,-0.0908,0.0649,0.0015,-0.0382,0.0225,-0.0205,0.1889,0.1473,0.1648,0.163,0.0972,0.0831,0.209,-0.2694,0.0379,-0.1096,-0.1689,0.0357,-0.0087,-0.0385,0.0605,0.1199,0.0358,-0.0838,-0.1388,0.002,-0.0242,0.0981,0.0105,-0.1159,-0.131,-0.114,-0.0668,-0.008,0.0892,-0.0481,0.1333,0.0021,0.0071,0.0349,0.0426,0.0929,0.0777,0.0866,0.0421,-0.0239,0.1035,-0.0512,0.0203,-0.1149,-0.0337,-0.0614,-0.0861,0.003,0.0793,0.0877,0.1099,0.0723,0.008,-0.0469,0.0312,0.0348,-0.0093,-0.1169,0.0059,0.1067,0.084,0.1905,0.1238,-0.0211,0.0269,-0.03,0.102,0.0919,0.1127,0.0635,0.1011,-0.0044,-0.0378,0.1806,-0.1429,0.0846,0.0921,0.0528,-0.0379,0.119,-0.0041,-0.0435,-0.0056,0.1903,-0.0833,0.0057,0.0907,-0.0519,-0.1028,0.0205,-0.0781,0.1142,0.1199,0.1179,0.1754,0.2038,0.0772,0.0987,0.0148,0.0206,-0.0962,-0.0914,-0.1063,0.153,0.122,-0.1165,-0.2385,-0.3571,-0.072,0.0633,-0.0282,0.0253,0.0973,-0.0412,0.09,0.0886,0.0554,0.023,0.0994,0.1445,-0.2877,-0.062,-0.054,-0.243,-0.0437,-0.1102,0.0594,0.0331,0.0772,0.0359,0.0984,-0.0103,-0.0396,-0.036,0.0284,0.0659,0.0469,0.1016,0.0044,0.0257,0.2073,0.0297,0.0325,0.023,-0.0111,-0.007,-0.0053,-0.0542,0.0494,-0.0819,0.2103,0.1025,0.1253,0.155,0.0112,0.1586,0.1145,0.2401,0.1177,0.1502,-0.0412,0.1543,0.007,0.0895,-0.0524,-0.119,-0.0909,0.1301,0.1498,0.0409,0.0415,-0.0885,-0.13,0.0979,0.0161,0.0834,-0.0921,-0.0592,-0.0533,-0.1353,0.0034,0.0436,-0.064,0.0059,-0.0292,-0.0624,-0.0202,0.0684,0.0635,-0.0301,-0.1502,0.0284,-0.184,-0.1623,0.0553,-0.0426,-0.0105,0.1727,0.1157,0.0166,-0.1221,-0.2582,-0.1001,-0.0249,-0.0467,0.0092,-0.2201,-0.182,-0.1262,-0.1198,0.1416,0.0084,0.0731,-0.0552,0.035,-0.0254,0.0591,0.0666,-0.0628,-0.0271,-0.0898,0.0569,-0.0954,-0.0282,0.1521,-0.142,-0.1135,-0.0161,-0.0343,-0.0647,-0.1104,-0.0286,0.0073,-0.0288,0.0347,-0.0215,-0.195,-0.2009,0.0053,-0.0304,-0.1024,0.0707,0.2088,0.3876,0.3634,-0.0182,-0.0795,-0.0049,0.029,-0.0318,-0.0817,0.0317,0.0431,0.0847,-0.0816,0.0526,0.0147,0.0164,-0.0347,0.0267,0.1366,0.0286,0.1431,0.1104,0.0714,0.0463,-0.0174,0.2035,0.0861,0.026,0.0673,-0.0178,-0.1047,0.0152,0.17,0.1109,-0.2201,0.1219,-0.0874,-0.0952,-0.0789,0.0011,-0.066,0.1912,-0.1087,-0.1087,0.0826,0.0702,0.0645,-0.0399,0.0459,0.1355,0.1999,0.2279,0.0887,-0.0061,-0.0164,-0.0817,0.0164,0.0832,0.1411,0.207,-0.1508,-0.1551,0.1097,0.0525,0.0836,0.1123,0.1861,-0.2616,-0.1359,0.0952,-0.0235,-0.1286,-0.1087,0.2543,0.2648,0.1729,0.2661,0.0955,0.1114,-0.0231,-0.0153,-0.0172,-0.0989,0.0667,-0.1001,-0.4435,-0.2002,-0.1554,-0.3565,0.2858,0.2031,0.123,-0.129,-0.0177,-0.001,0.0609,-0.058,-0.0793,0.2265,0.2065,0.0214,-0.2779,0.0764,0.1513,0.123,0.0594,-0.0729,-0.1702,0.0949,0.018,0.0101,0.0245,-0.0333,-0.0981,-0.0729,-0.073,-0.059,0.0565,-0.0363,0.0228,-0.0326,0.0059,0.0965,-0.0039,0.0673,0.029,0.0037,-0.0027,-0.1373,-0.0838,-0.0046,-0.018,0.0467,0.0004,0.2074,0.1526,0.0771,0.1489,-0.4148,-0.0204,-0.2634,-0.1156,-0.0577,0.0207,0.0073,-0.1406,0.0717,-0.1924,-0.1601,-0.0763,-0.0862,-0.0389,-0.0353,0.1307,0.0688,0.1872,0.0237,-0.1986,-0.1696,0.1473,0.0289,-0.0057,0.0042,-0.0085,-0.0115,0.09,0.111,0.0116,0.2468,-0.0703,0.0589,-0.1408,-0.0869,-0.0496,-0.0603,0.0041,0.0048,0.0789,0.0658,-0.0636,-0.1624,0.055,-0.0113,0.0792,-0.0485,0.0271,0.074,0.0487,-0.1334,-0.0631,0.0505,0.2146,0.098,0.1181,0.124,-0.0101,0.053,0.0538,0.0199,0.1135,0.1367,0.1096,0.0881,0.0818,0.0885,0.0653,0.0067,0.1097,-0.0714,0.2638,0.2381,0.2352,0.0551,0.0329,0.1456,0.0934,-0.0787,-0.1447,-0.0668,0.1406,-0.22,-0.2556,-0.1137,0.0645,-0.0557,0.0316,0.0877,-0.0525,0.0072,-0.0832,-0.1944,-0.2364,-0.0078,-0.0625,-0.0759,-0.0711,0.1617,0.0528,0.0178,0.0328,0.1086,0.0931,0.0577,0.1094,0.0078,0.1881,0.1848,-0.0781,-0.0248,0.2235,-0.0357,-0.1061,-0.0972,0.0459,0.1256,0.3963,0.3194,0.164,0.2844,-0.1585,0.0723,0.0409,-0.0576,0.0574,0.1179,0.2221,0.0675,-0.2603,-0.1386,-0.2352,-0.1511,-0.1257,0.0496,0.024,-0.1007,-0.0765,-0.0977,-0.031,-0.0074,-0.2446,-0.1196,0.1829,0.2302,0.1058,0.1149,0.1487,0.0082,0.1365,-0.0753,-0.059,-0.0412,-0.0875,-0.0596,0.1627,0.0151,0.1347,-0.0026,0.1617,0.2465,0.0056,-0.0566,0.0457,0.0359,0.075,0.198,0.1105,0.1834,0.0976,0.1224,0.1092,-0.012,-0.0486,0.032,0.1081,-0.0549,-0.0282,0.0075,0.0706,0.0551,0.1233,0.0435,-0.1446,-0.0644,0.1008,-0.1791,0.0117,-0.0019,-0.0999,-0.0441,-0.0394,-0.0416,-0.0187,0.0029,0.0354,-0.0066,-0.1686,-0.2709,-0.3012,-0.0015,-0.0661,0.0122,-0.0426,0.0877,-0.1296,0.0915,-0.1755,0.0459,0.0834,0.0882,-0.1154,0.0042,0.024,0.0078,-0.027,0.0912,0.082,-0.0703,-0.0499,0.0327,0.0942,-0.0642,-0.1374,-0.1112,0.1948,0.1513,0.1639,0.0106,0.1664,0.0416,-0.0094,-0.0473,-0.0002,0.0266,0.1204,0.1294,0.0622,-0.0452,0.1342,0.0842,-0.2163,-0.0277,0.0597,-0.1171,-0.2634,-0.0732,-0.0691,-0.145,0.1269,-0.0207,-0.2499,-0.0922,0.1123,-0.246,-0.0707,-0.0428,-0.1004,-0.2384,-0.0527,0.1296,0.1242,0.0909,-0.05,-0.1965,0.0588,-0.0983,0.0628,0.0222,0.0517,0.0595,-0.0244,-0.1792,0.0481,0.1117,-0.0451,0.1125,0.0945,0.0206,0.0777,0.0858,0.0779,0.0806,0.0485,0.1751,0.1083,-0.1616,-0.2882,0.0398,0.0733,-0.0762,-0.0535,0.0818,0.0769,0.1368,0.214,-0.0969,-0.0933,0.1236,0.1531,0.0761,0.012,0.0983,0.0978,0.0512,0.1023,0.0488,0.1373,0.0561,-0.005,0.1215,0.0961,0.0523,0.0563,-0.1024,0.1315,0.01,-0.1534,0.0211,0.1325,0.0728,0.1087,0.1507,0.0839,0.1042,0.1023,-0.0658,-0.0924,-0.163,0.0641,0.1249,0.0215,0.0284,0.0067,-0.0607,0.1917,0.0719,0.1416,-0.0613,-0.0337,-0.1015,0.0939,0.2239,0.1725,0.0655,0.0568,0.0046,-0.0314,-0.1452,0.0144,0.0794,0.0843,0.0828,0.1232,0.2607,0.114,0.1001,-0.0403,0.0137,-0.1035,0.0152,-0.1244,-0.012,-0.0326,-0.0196,-0.0847,-0.1849,-0.0918,-0.011,-0.0286,0.142,-0.0047,0.0541,0.0125,0.0669,0.0452,0.0034,-0.0198,0.0978,0.0745,0.0669,0.0377,0.1125,0.0306,0.0025,-0.1859,0.0829,-0.1346,-0.0405,-0.0688,-0.0056,-0.0463,-0.0293,0.0497,0.1792,0.0363,-0.1599,-0.0829,0.0659,0.0514,0.1065,0.1185,0.0462,0.0408,0.0563,-0.0592,-0.0824,0.2027,0.1416,0.0355,0.1267,0.0675,0.0565,-0.4222,-0.2508,0.1395,-0.0682,0.0485,0.0195,0.1126,0.1055,0.2019,0.2029,-0.05,0.0007,0.1232,-0.0093,0.0955,0.0404,-0.1733,0.0096,-0.033,0.003,0.0067,-0.0509,0.1112,0.0114,-0.1433,0.1295,-0.0897,0.1752,-0.0574,0.1492,-0.4238,-0.0679,-0.0816,0.1739,0.1546,-0.0705,-0.1399,0.003,-0.0833,-0.0558,0.0509,-0.0273,-0.0747,0.0266,-0.0729,-0.1004,-0.159,-0.1629,-0.2165,-0.282,0.0761,-0.0951,-0.3228,-0.5849,-0.2155,-0.2201,-0.426,-0.2551,-0.2563,-0.2902,-0.1615,-0.2524,-0.2004,-0.2157,-0.3284,-0.1456,-0.2624,-0.3896,-0.2972,-0.3379,-0.2432,-0.078,-0.1782,0.1837,0.1001,0.1564,0.1587,0.0284,0.2318,0.2073,0.1085,0.1307,0.1398,0.2307,0.1937,0.1651,0.0505,-0.0465,0.1191,-0.1352,0.016,0.1146,-0.0014,0.1311,0.0847,0.0757,0.0528,0.1372,-0.0872,0.1771,0.2005,-0.0339,0.024,0.0829,-0.0153,-0.0122,0.1389,-0.0683,-0.088,0.1121,-0.297,-0.382,-0.0933,-0.1682,-0.226,0.1023,-0.1715,-0.1723,0.0006,0.0406,-0.1951,-0.0038,-0.0438,0.1177,0.0306,-0.1694,0.0704,0.0917,0.0304,-0.0208,0.03,0.0884,feature comparison
trm_4ee8facd77dfc,-0.0096,-0.0001,-0.0551,0.0415,-0.0127,0.0269,-0.0148,-0.0386,-0.011,0.0058,-0.0171,-0.0271,0.0129,0.0294,0.0509,0.0237,0.0149,0.0653,0.0032,0.0509,0.0106,-0.0024,0.0296,0.0227,-0.0004,0.0056,0.0073,0.0184,0.0429,-0.0234,0.0395,0.0506,0.0118,-0.0161,0.0283,0.0325,-0.0383,-0.0285,0.0441,0.025,0.0092,0.0157,0.0184,0.0052,0.0056,0.0601,-0.0038,0.0078,-0.014,0.0157,0.036,-0.0344,0.0048,0.0228,0.0394,0.0226,0.0302,-0.0056,-0.0117,-0.0081,0.0122,-0.0088,0.0423,-0.055,0.0205,-0.0685,0.0751,0.1092,0.0583,-0.0161,0.0343,-0.0148,-0.0227,0.0394,0.0668,-0.0068,0.0261,0.0195,-0.001,-0.0079,-0.042,-0.0389,0.0608,0.0472,-0.0148,-0.0459,0.0038,-0.0618,-0.0221,0.03,-0.0095,-0.055,-0.0385,-0.1033,-0.0647,-0.1145,-0.0162,-0.0075,-0.1294,-0.0977,-0.0295,0.0481,-0.0637,-0.097,-0.0006,0.0456,0.0484,-0.0225,0.0337,-0.022,0.0364,0.0508,-0.0044,-0.0471,-0.0166,0.0183,0.0241,-0.0896,0.0319,-0.0109,0.0682,0.0488,0.0345,0.0149,0.0271,0.0635,0.0695,-0.0408,-0.0533,-0.0335,0.0488,0.046,-0.0251,0.0888,0.0505,0.0303,-0.0382,0.0144,0.0268,-0.0209,0.0246,0.0224,-0.0083,0.0356,-0.0152,-0.021,-0.0014,0.0296,0.0313,-0.014,0.0005,0.0539,0.019,0.0758,0.0063,-0.01,-0.047,0.0093,-0.0228,-0.0233,0.0044,0.0445,0.0606,0.0619,0.005,-0.0279,-0.0041,0.0634,0.0601,0.0287,-0.0354,0.0531,-0.059,0.0712,0.0488,0.0463,0.0377,0.0484,0.0393,-0.0427,0.0233,-0.0512,0.0388,-0.0406,0.0174,0.0186,0.0214,0.0305,0.035,0.0396,0.0383,0.0373,0.0264,0.0765,0.0737,0.088,0.0945,0.0127,0.0282,0.0441,0.0157,-0.0997,0.0334,0.0549,0.0492,-0.0026,0.0502,0.0418,0.0343,-0.0033,0.0869,0.0526,0.0006,-0.0165,0.0316,-0.0214,-0.0223,0.0314,-0.0455,0.0369,-0.0282,0.055,0.0433,-0.0019,-0.0272,0.0403,0.0269,-0.0252,0.025,0.0322,-0.0785,0.0498,-0.0082,0.0605,0.0559,-0.0163,0.0108,0.0102,-0.0191,-0.0232,0.0209,0.0294,-0.0191,-0.0354,0.0315,0.0319,0.0243,0.0387,0.0057,0.0451,-0.0281,-0.0078,0.0091,-0.0167,-0.0114,0.0261,-0.0245,0.0028,-0.0116,-0.0328,-0.021,0.0379,0.0334,-0.0017,0.0242,0.0315,0.0566,0.0317,-0.0053,0.03,0.0205,-0.0154,0.0608,0.0207,0.0144,-0.0341,-0.0038,0.0406,-0.0046,-0.007,-0.0174,0.033,0.0182,0.0623,0.0451,0.0008,-0.0132,-0.0349,-0.0069,0.026,-0.0146,0.0198,0.0331,0.0381,0.0195,0.0482,0.0001,-0.0161,0.0153,-0.0448,-0.0248,0.0911,-0.002,0.0279,-0.0343,-0.0463,0.0243,-0.0175,-0.0369,0.0091,0.0095,-0.0047,0.0631,0.0209,0.0139,0.0212,-0.0171,-0.034,0.025,0.0298,-0.0047,-0.0053,0.0291,0.0465,0.0169,0.0264,0.0362,0.0443,-0.0021,-0.0136,-0.0223,0.0241,0.0328,0.0019,0.0177,-0.0422,-0.0372,0.0553,-0.001,0.0607,0.0492,-0.009,-0.0599,-0.0448,-0.0067,0.0115,0.0144,0.007,-0.0107,0.0188,0.0135,-0.0396,-0.058,-0.0644,-0.0268,-0.0498,-0.0019,0.0349,0.039,0.0338,0.0178,0.0064,0.0439,-0.0287,-0.0249,-0.0883,0.0117,0.0127,0.001,0.0375,0.021,-0.0243,0.0171,-0.0579,0.0562,0.0161,0.0193,-0.035,-0.0397,-0.0585,-0.0513,-0.0782,0.0606,0.0402,-0.0222,-0.0135,-0.0041,-0.0373,0.0112,0.0227,-0.0086,0.0147,-0.0578,0.0555,-0.177,-0.2002,-0.0908,0.0201,0.0007,0.0318,0.0217,-0.0146,-0.0086,-0.0301,0.0052,0.0356,-0.0015,0.0543,0.0172,0.0037,0.0133,0.0104,0.018,-0.0332,0.037,0.0295,-0.0048,0.0345,0.0567,0.0293,-0.022,0.0273,-0.0009,0.1007,0.1119,0.0215,0.0469,-0.0322,0.0298,0.0252,0.0035,-0.0703,-0.0033,-0.05,0.0399,0.0001,-0.0451,0.0238,0.0677,0.0138,0.0024,-0.0236,0.0083,-0.0328,-0.0117,0.0044,-0.0311,-0.0271,0.0863,0.0816,0.0426,0.0112,0.0544,0.057,-0.0004,0.07,-0.0876,0.0078,0.0404,-0.0427,-0.0136,0.0447,0.0129,0.0158,0.0343,0.0652,0.0024,-0.0364,0.0017,-0.0035,0.0169,-0.0111,-0.0294,-0.0185,0.0133,0.0521,-0.0308,-0.047,-0.018,-0.0094,-0.0821,-0.0176,-0.0933,-0.0669,0.0279,-0.0162,-0.0143,-0.0004,0.0684,0.022,-0.0318,-0.0459,0.0469,0.0438,0.0088,0.0088,0.0633,0.013,0.0088,0.0702,0.0675,0.027,0.0358,0.0167,0.0244,0.0182,-0.0375,0.017,0.0324,-0.0341,0.0393,-0.0565,0.0117,0.0188,-0.0267,-0.0296,0.0445,0.0227,-0.0729,0.0173,0.0105,0.0121,0.0051,0.0407,-0.0107,-0.0193,-0.0087,-0.0355,-0.0297,0.0204,0.0375,-0.0424,-0.0271,0.0474,0.0169,0.019,0.0392,0.0248,0.0028,0.0192,0.0411,-0.0142,-0.0096,-0.006,0.0062,-0.0079,0.0241,-0.0173,0.0025,0.034,-0.0694,0.0561,0.0077,-0.043,-0.0141,0.0468,-0.0582,0.0096,-0.0255,0.0009,0.0366,0.0265,0.0711,-0.0246,0.0262,-0.0046,-0.0204,0.0503,0.0259,0.0327,0.0527,0.0208,0.0138,0.0008,-0.1899,-0.1905,-0.0264,-0.039,-0.0251,0.0162,0.0368,0.0472,0.0258,0.0202,-0.0409,0.0088,-0.0003,0.0068,-0.0171,-0.0058,-0.0013,0.0227,0.0254,-0.0042,0.0061,-0.0601,0.0448,0.0016,-0.0858,0.0203,0.008,0.0003,0.0102,0.0178,-0.0017,-0.1673,0.0375,0.0423,0.0375,-0.0087,-0.0459,-0.0228,0.0001,0.0149,0.0604,0.0303,0.0223,0.0081,0.0477,0.0381,0.0045,0.027,-0.028,0.0236,0.0263,-0.0713,0.0512,0.043,0.0013,0.005,-0.0084,-0.1345,0.0044,0.0554,0.04,-0.0055,-0.0278,0.0122,-0.0136,0.0102,0.0153,-0.0225,-0.0291,-0.1691,0.0465,-0.0254,0.0724,0.0612,-0.0387,0.0191,0.0221,0.0174,-0.017,0.0159,0.0038,0.0243,-0.1436,0.0161,-0.0432,0.0512,0.0448,-0.1056,-0.0691,-0.1328,-0.007,-0.0293,-0.0702,0.0695,-0.0777,-0.0662,-0.0344,-0.0024,-0.0054,0.0257,-0.0024,0.0378,-0.0295,0.0056,-0.0227,0.0104,0.0047,-0.0198,0.0046,-0.0085,-0.0396,0.064,0.0275,0.0491,0.0258,0.0009,-0.0881,0.0032,-0.0214,0.0276,-0.0104,0.0364,-0.0479,0.0286,0.0477,0.0558,-0.0405,-0.0111,0.0127,0.0356,0.023,-0.0259,0.0293,0.0288,0.015,0.0056,0.0319,0.0196,0.0453,-0.0338,0.0367,0.0257,-0.0702,0.0023,0.0424,-0.0252,-0.0424,-0.0083,0.0817,0.0742,0.0543,-0.0007,0.0168,0.0305,0.0396,0.0154,0.0045,-0.0147,0.0305,-0.0012,-0.0005,0.0139,0.0427,-0.0048,-0.0294,-0.0136,0.0635,-0.0266,0.0102,0.0041,0.0385,0.0256,-0.0032,-0.0231,0.0311,-0.0077,0.0361,0.0117,0.0581,0.0958,0.0783,0.0645,0.0022,-0.0366,-0.0095,0.0242,0.0099,-0.0382,-0.0151,0.0278,-0.0128,-0.0198,-0.0078,0.0399,-0.0277,0.0186,-0.0141,-0.07,-0.0158,0.0232,-0.0636,0.0036,-0.0128,0.0267,0.0612,0.0337,0.0515,0.0331,0.0485,-0.0378,-0.0135,-0.0139,-0.0059,-0.0261,0.0473,0.0003,-0.0215,0.0334,-0.0093,0.0103,-0.0237,-0.0522,0.0137,0.0266,-0.0002,0.0754,0.0714,0.0022,0.0058,-0.0222,0.0249,-0.0107,-0.0187,0.0264,0.0328,-0.0012,-0.0118,-0.0333,-0.0693,-0.0381,-0.0453,0.0185,-0.0602,-0.0557,-0.0125,-0.054,0.0096,0.0531,0.0473,-0.0154,0.0123,0.0214,0.1084,0.0264,0.0569,0.0742,0.0617,0.0411,0.0307,0.018,-0.0041,-0.0461,0.0727,-0.0715,-0.0335,0.0096,-0.0063,-0.0158,-0.0323,-0.0272,-0.006,0.0251,0.0006,-0.0274,0.0372,-0.0589,-0.0466,0.0209,0.0037,0.0088,0.0467,-0.0172,0.0497,0.0787,0.0531,0.0614,-0.0148,0.0162,0.0458,-0.0012,-0.0174,-0.1112,0.0474,0.0313,-0.043,0.0441,0.0169,0.046,-0.1803,0.0488,-0.0104,0.045,0.0377,0.0364,0.078,0.078,0.0271,-0.0128,0.0218,0.0267,-0.0026,-0.0295,-0.0014,0.0544,0.0278,0.055,-0.021,0.0135,-0.0274,-0.0394,0.0586,-0.0258,0.0551,0.0422,0.0201,-0.0279,0.0193,0.0039,0.001,-0.0079,0.0155,-0.0402,0.0178,0.0324,-0.0044,0.0415,0.0487,0.0024,0.0201,-0.037,-0.0352,-0.0116,-0.0334,0.0518,-0.0135,-0.0607,-0.0261,-0.0011,0.03,-0.02,-0.0466,-0.012,-0.0403,-0.056,0.0422,0.0383,-0.0129,-0.0398,0.0087,0.0266,-0.0091,-0.0032,0.0151,-0.005,0.0063,0.0247,0.0289,0.0927,0.0722,0.1011,0.0344,0.0047,0.059,0.0403,0.0266,0.0475,0.0644,0.0634,0.0325,0.0448,-0.018,0.0381,0.0254,0.0208,0.0067,-0.0089,-0.0098,-0.0195,0.0338,-0.0119,-0.0181,-0.0011,0.0093,0.016,-0.0169,-0.0237,0.0058,0.0048,0.0385,-0.0083,0.0091,-0.0023,-0.0024,0.0189,0.0258,0.0291,0.0188,0.0287,0.0564,0.0611,0.0325,0.0509,0.0458,-0.0751,-0.0124,-0.0809,0.0044,-0.023,-0.019,0.0124,-0.0075,0.0109,-0.0118,0.006,-0.0316,0.0107,-0.0261,-0.001,0.0022,-0.0356,-0.0126,0.0201,-0.0088,0.0234,0.0484,0.0541,-0.0396,-0.0219,-0.0419,-0.0546,-0.0081,0.0457,0.0277,0.0064,0.07,0.0221,-0.0088,-0.0196,0.012,-0.0436,-0.0148,0.0338,0.0451,0.0247,0.0321,-0.0196,0.005,-0.0289,-0.1136,-0.1707,0.0342,0.0118,0.0366,0.0554,0.0208,-0.0056,0.0551,0.0405,-0.0669,-0.0246,-0.0266,0.0243,-0.0223,0.0304,0.0274,0.0314,-0.0749,0.0263,0.024,0.0458,0.0118,-0.0569,-0.0028,-0.039,0.0334,-0.0653,-0.0754,-0.0362,0.0076,0.0297,0.0032,0.0129,-0.0243,0.0279,0.0405,0.0413,0.0256,0.0992,0.0487,0.0137,-0.0123,0.0245,-0.0335,0.0336,-0.0167,-0.0301,-0.1515,-0.0077,0.0124,-0.0111,-0.0147,-0.0674,0.0264,0.0018,-0.0034,0.0235,-0.1067,-0.1056,-0.0141,-0.0003,0.0058,0.029,-0.0079,-0.0288,0.0727,-0.0494,-0.0674,-0.0385,-0.0068,-0.0253,0.0265,-0.0116,0.02,0.0025,-0.022,0.0123,-0.0063,0.0016,0.059,-0.0219,-0.029,0.0082,-0.0322,0.0157,0.0383,-0.0311,0.0095,0.0311,0.0077,0.0533,-0.0542,-0.0048,-0.0487,0.055,0.0473,0.0538,0.0392,-0.0007,0.0421,-0.0055,-0.0923,0.0341,0.056,0.0625,0.0378,-0.0626,0.0271,-0.0667,0.0064,0.0174,-0.0317,-0.0741,-0.2666,-0.2247,-0.2254,0.0085,-0.02,0.0002,-0.0201,0.0056,0.0029,0.0594,0.0037,0.0115,-0.0704,-0.0149,0.0084,0.0004,0.0134,0.0242,-0.01,0.0072,-0.022,-0.1667,-0.0389,0.0137,0.0273,0.0125,0.0068,-0.0414,-0.0344,0.0765,0.0758,0.0542,0.051,-0.0166,-0.0023,0.0423,-0.0173,0.0279,0.0677,0.0562,-0.004,-0.0069,-0.0016,0.0445,0.0624,0.0028,0.0005,0.0081,0.0535,0.0346,-0.0278,0.0369,0.0643,0.0244,0.0289,0.0366,0.0417,-0.0023,0.0636,0.0455,0.0436,0.0126,-0.0683,-0.001,0.0144,-0.0377,0.0192,-0.0057,0.0257,0.01,0.032,0.0562,0.0053,0.0149,0.0126,-0.0762,-0.0705,-0.0855,-0.059,0.0604,0.02,0.0499,0.0191,0.0918,0.0309,-0.0464,0.0013,0.0364,0.0567,0.0151,-0.0659,0.001,-0.024,-0.0061,-0.0699,-0.0132,-0.0884,0.0818,0.0461,0.0296,-0.0363,-0.0031,0.0503,-0.0281,-0.0281,0.0854,0.0247,0.0141,-0.0265,-0.0416,0.0107,-0.0081,-0.1618,0.1152,0.1056,0.0119,0.027,0.0546,0.0577,0.0427,-0.0211,-0.0342,0.0258,0.0243,-0.0114,-0.0803,-0.0397,0.0065,0.004,0.0091,-0.0678,0.0287,-0.0147,0.0152,0.0312,0.0429,0.0439,0.029,0.0397,0.0018,0.0052,0.0104,-0.2224,-0.1522,-0.1823,0.0283,-0.136,0.0439,0.0261,0.0021,0.0324,0.0003,0.0542,0.0143,0.0144,0.0408,0.0558,-0.084,-0.0629,0.0711,-0.0174,-0.0324,0.0117,0.0558,0.0472,0.0062,0.0095,0.0351,0.0102,-0.0069,-0.0364,-0.0569,-0.1064,-0.0572,-0.0314,-0.0353,-0.0146,0.0218,0.0179,0.0117,0.0735,0.0694,0.0654,0.0017,0.0045,-0.0102,0.0241,0.0256,0.0586,-0.0233,-0.0472,-0.0089,-0.0015,0.0243,-0.0134,-0.0132,0.0126,0.0419,0.0733,0.0382,0.0016,0.0369,0.0309,-0.0003,-0.0019,0.0094,0.0048,-0.0363,0.0046,0.0287,-0.0587,0.0563,0.0176,-0.0588,-0.027,-0.0721,0.0437,0.0028,-0.0487,0.0675,0.01,0.0168,0.0262,0.0009,0.031,-0.0739,-0.0583,0.0612,-0.042,0.0382,-0.0774,-0.107,-0.0567,-0.0115,-0.0127,-0.0341,-0.0546,0.0197,-0.0338,0.0352,0.0031,0.0502,0.0533,0.0249,-0.016,0.0011,0.0438,0.0659,-0.0225,0.0382,0.002,0.0155,0.0363,0.0299,0.0286,0.0372,-0.0425,0.0184,0.0331,0.0334,0.0606,0.0272,0.0124,0.0218,-0.0201,-0.0134,0.0491,-0.0068,0.0139,0.021,0.0037,-0.029,-0.0317,0.0335,0.0533,0.0087,-0.1084,-0.1885,0.0133,-0.0082,0.0146,0.0084,0.0064,0.0423,0.0133,0.0388,-0.004,0.0729,-0.0315,-0.0305,0.0056,0.0311,0.0213,0.011,0.0284,0.0505,-0.0056,0.033,0.0171,-0.0472,-0.0444,0.0164,-0.0313,-0.0126,-0.0117,0.0041,0.0207,0.0058,0.0445,0.0196,0.012,0.0308,0.0186,0.041,0.0008,-0.0562,-0.0416,-0.0808,-0.0844,0.0201,-0.0022,-0.0066,-0.0106,-0.0193,0.0068,0.0515,0.0278,-0.0007,0.0479,0.0255,-0.0213,-0.0279,0.0228,-0.0203,-0.0663,0.0161,0.0474,0.0684,-0.0439,0.028,0.0127,0.0682,0.0587,0.0461,-0.014,0.009,0.0066,0.0427,-0.0341,0.0003,-0.0239,-0.0143,-0.0324,0.0009,-0.0477,-0.0055,0.0159,0.0433,-0.0395,-0.0119,-0.0016,-0.0454,-0.056,-0.0101,0.0267,0.0265,-0.0043,-0.0384,-0.0352,0.0631,0.0383,-0.0277,0.0084,0.0091,-0.0604,0.0408,-0.0213,0.0032,0.0186,-0.0072,-0.0201,-0.084,0.0669,-0.0396,-0.0105,-0.0517,-0.0077,-0.0114,-0.1672,0.0463,-0.013,-0.0038,-0.0224,-0.0648,-0.0298,0.0386,0.0186,0.0169,-0.0313,-0.0139,-0.0025,0.0039,0.0342,-0.0116,0.0633,0.0531,0.0508,-0.0392,0.0383,-0.0231,-0.0044,0.0284,0.0409,0.0084,-0.0224,0.0554,0.0729,-0.0324,0.0228,0.0121,0.0374,0.0072,0.0029,0.0417,0.0625,0.0004,-0.0139,0.0056,-0.0105,-0.0572,-0.0747,0.0284,-0.0482,0.0133,-0.0564,-0.1023,0.067,0.068,0.0241,0.0463,-0.0277,0.007,-0.0919,0.0194,-0.0233,-0.0121,0.0061,-0.0018,-0.0279,0.0098,-0.0475,0.0191,-0.0463,-0.0148,-0.0598,-0.0465,-0.0535,-0.0122,-0.0195,0.053,0.0012,-0.0245,-0.0403,0.0048,0.009,-0.0054,0.0302,-0.1144,-0.0945,0.0798,0.0631,0.0269,0.0305,-0.0544,-0.049,-0.0238,0.0161,0.0124,0.0126,0.0403,0.0482,-0.0229,0.0242,0.0127,0.0366,0.0275,0.032,-0.024,0.0112,0.0284,-0.0059,0.0431,0.0456,0.0144,-0.1094,0.0145,-0.1082,-0.0235,0.0128,-0.0343,-0.0275,-0.0728,-0.0139,-0.0329,0.0098,0.0056,0.0291,-0.0081,0.0074,-0.0818,0.0504,0.0576,0.0561,0.0452,0.0199,-0.0017,0.0025,-0.2052,0.0068,-0.0498,-0.0391,-0.0992,0.0385,0.0116,-0.0192,0.0058,-0.0342,-0.0193,-0.0131,-0.0162,0.0099,0.0787,0.0656,0.0647,-0.0075,0.0441,0.0508,0.0408,0.0208,0.0302,0.0252,0.029,0.0096,-0.048,0.004,0.0412,-0.0734,-0.0196,-0.0019,-0.0377,0.0141,0.0598,-0.0127,0.054,0.0265,0.0355,0.0111,-0.0377,-0.01,0.0041,0.0498,0.0218,0.0091,0.118,0.0778,0.0728,0.0628,0.0249,-0.053,-0.0503,0.0575,0.0677,0.0017,0.0005,0.0073,0.0293,-0.0126,0.0346,-0.0185,-0.0404,-0.0028,0.0513,0.0437,-0.0044,-0.0074,0.0271,0.0901,0.0509,0.0177,0.0484,0.0914,0.0422,0.0234,-0.0554,0.0555,-0.0175,0.0125,-0.0147,0.0339,0.0418,0.0353,0.0622,0.0214,0.0065,0.0362,-0.0324,0.0579,0.0504,0.0279,-0.0011,0.0395,0.0189,0.0293,-0.0288,0.0655,0.0532,0.0573,-0.0052,0.0494,0.0565,0.0284,0.0075,-0.0101,0.0453,-0.0007,-0.0037,0.0694,0.0067,0.043,0.0096,0.0168,0.0365,0.0636,0.0516,0.06,0.0222,-0.0007,0.0072,0.0387,0.07,0.0093,0.0807,-0.007,0.0583,0.061,-0.0063,-0.0894,-0.0175,-0.0007,-0.0147,0.0376,-0.0242,-0.0274,-0.0075,0.0653,0.073,-0.0039,-0.0404,-0.0247,-0.0297,0.0329,0.0267,0.0527,0.0142,0.0247,0.0136,0.0055,0.0291,0.0245,-0.0134,0.0552,-0.0269,0.0101,0.0183,-0.0476,-0.0387,-0.0372,0.0359,0.051,0.04,0.0247,0.096,0.0553,-0.0085,0.006,0.0437,-0.2029,-0.1331,-0.2065,-0.1352,-0.1197,-0.1492,-0.0432,-0.1374,-0.069,-0.0545,-0.0962,-0.1713,-0.1772,-0.1901,-0.0194,0.074,-0.08,-0.0112,-0.0125,0.0166,0.0446,-0.0763,-0.0006,-0.0011,-0.0498,-0.0516,-0.0401,-0.0041,-0.0617,-0.0035,-0.0413,-0.1049,0.0082,-0.0026,-0.06,-0.0172,0.0191,-0.0027,-0.022,0.0191,-0.025,-0.0108,0.0387,0.0159,-0.0148,0.1087,0.0487,0.0219,0.0615,0.0543,0.0471,0.0616,0.0253,0.0198,0.0281,-0.0215,-0.0895,0.0058,0.0093,0.078,-0.028,0.0002,0.0014,-0.0073,0.0372,-0.0254,0.0494,0.0261,0.0187,0.0116,0.0414,0.0059,-0.0295,-0.0025,-0.0951,-0.0379,0.0055,0.0036,0.0145,-0.0232,0.0726,0.0145,0.0694,0.0411,-0.0479,-0.0007,0.0312,0.0166,0.02,-0.0071,-0.02,-0.0375,0.0045,-0.0104,0.0239,-0.0446,-0.0732,-0.0034,0.0531,0.0219,-0.0638,-0.0128,-0.019,0.0076,-0.017,0.03,-0.0314,0.0351,0.0465,-0.0132,0.0011,0.0195,0.0251,-0.089,-0.0687,0.0623,0.0057,-0.0863,-0.0747,-0.0462,-0.0052,-0.0246,-0.0544,0.0704,0.0687,-0.0108,-0.0416,-0.0772,-0.0507,-0.0392,-0.0106,0.0046,-0.0451,-0.0811,-0.083,-0.1095,-0.006,-0.0128,-0.0017,0.0268,-0.005,-0.0212,0.0737,0.0264,-0.0008,-0.0035,0.0298,0.033,-0.0307,0.0008,-0.0248,0.0229,0.0028,-0.0229,0.0222,-0.0338,0.0239,-0.0258,0.0006,0.0209,0.0084,0.0121,0.0156,0.013,-0.0316,0.0445,0.0811,0.0809,-0.0406,-0.0065,0.0238,-0.0119,-0.0016,0.019,-0.0912,-0.0089,-0.0526,0.0028,0.0535,0.0697,-0.1128,0.0177,0.0202,-0.0243,-0.0093,-0.0601,-0.063,-0.0146,-0.0107,0.021,0.0156,-0.1437,0.0236,0.0174,0.0164,-0.0079,-0.0266,-0.0281,-0.0087,-0.0061,0.0465,0.0111,0.0057,0.0251,0.0557,0.0417,-0.0512,-0.0106,-0.0445,-0.0318,0.0,-0.0141,-0.0433,-0.0517,0.0002,-0.0212,0.055,-0.0096,-0.0265,-0.0526,-0.082,-0.0045,-0.0013,0.0014,-0.0124,-0.0062,0.0086,-0.0282,-0.0214,0.0173,0.0239,-0.0173,0.02,-0.0048,-0.0213,-0.0061,-0.0041,-0.0031,-0.0301,-0.0733,-0.0543,-0.0211,-0.0152,0.0468,0.0243,0.0133,0.0055,0.0761,-0.0026,0.0272,-0.0017,0.0039,-0.0409,-0.0896,0.0474,-0.0124,-0.0381,0.0339,-0.0055,-0.0234,-0.0715,-0.0135,-0.0611,-0.0671,-0.1155,-0.0467,0.006,-0.0389,-0.0837,0.0347,0.0271,0.0127,-0.0053,0.0292,-0.053,0.0235,0.0025,0.0707,0.0567,0.0935,0.0542,0.0408,0.0519,0.0183,0.056,0.0206,-0.003,-0.0248,0.0191,0.0078,0.0291,-0.0513,0.0335,-0.0769,-0.0089,-0.0035,0.043,0.0112,-0.0446,0.0468,-0.0035,-0.0299,0.007,0.0091,-0.0284,0.0221,0.0037,0.0028,0.0476,0.018,0.0174,0.0001,-0.0002,0.0247,-0.0372,0.0125,0.0118,-0.025,0.0327,0.069,0.0057,0.05,0.0149,0.0099,0.0191,0.0173,-0.0487,0.0396,0.0228,0.1025,0.0263,0.0295,0.0861,0.0683,0.048,0.0224,0.0224,0.0278,-0.0115,-0.0012,0.0341,-0.0003,-0.083,-0.0624,0.0292,0.0083,0.1001,-0.0249,0.036,0.01,0.0158,-0.0519,0.0134,0.0039,0.0267,0.0224,-0.0629,-0.0752,0.0131,-0.0177,-0.0798,-0.046,-0.0703,-0.022,0.0111,-0.0042,-0.0622,-0.0289,-0.0586,0.0661,0.073,0.0083,0.0651,0.0255,0.0044,0.0066,-0.0194,0.0409,0.0623,-0.0599,0.0061,0.0413,-0.0282,0.0148,0.1005,0.0263,0.1078,0.0307,0.0168,-0.0114,0.0244,-0.181,-0.1747,-0.0979,-0.0935,-0.0059,0.0052,-0.003,0.0215,-0.037,-0.0465,-0.0166,-0.0809,0.0117,-0.026,0.0335,-0.0237,0.0093,0.037,0.0166,-0.034,0.0245,-0.18,0.0196,-0.2007,-0.0469,-0.1943,-0.0356,-0.1132,-0.0344,0.0006,-0.0269,-0.006,-0.0239,-0.0445,-0.0203,0.056,0.0855,0.0242,-0.0405,0.0312,0.0421,0.0236,0.0212,-0.0051,0.0495,0.037,0.0244,0.0165,-0.0544,0.0028,-0.0463,0.0024,-0.0102,-0.0741,0.0234,0.0654,0.0062,0.0143,-0.001,-0.005,-0.0815,0.0459,-0.0466,-0.0471,-0.086,0.0198,0.0185,-0.023,-0.0179,0.0037,0.0344,0.0636,0.0376,-0.0278,-0.017,-0.0097,0.028,-0.0346,-0.0369,0.0157,0.0379,0.0324,0.0608,0.0607,-0.0117,0.0042,0.0126,0.0531,0.0115,0.0794,0.0064,0.0357,0.0237,0.007,-0.066,0.0078,-0.0008,0.0361,0.0182,-0.0049,0.0223,0.0179,-0.0263,-0.0458,0.0345,0.014,-0.0422,-0.003,0.0252,-0.0141,-0.0314,0.0095,-0.0053,0.0664,-0.0152,0.0406,0.0707,-0.0773,0.0479,-0.0386,-0.0589,-0.0282,-0.0283,-0.0365,0.0249,0.0638,-0.0129,-0.0151,-0.0636,-0.0217,-0.013,0.0147,0.0294,0.0351,0.0442,0.0559,0.0307,0.0288,-0.0185,0.0103,0.0669,-0.0207,0.0358,0.0035,0.0186,0.0114,-0.008,0.0576,-0.0379,-0.0136,-0.0,-0.081,-0.0043,0.028,-0.0603,0.0049,0.0234,-0.0291,0.0321,-0.006,-0.0013,0.0504,-0.0025,0.0009,0.0029,0.0215,0.0088,-0.0187,0.0196,0.0171,-0.0376,0.0398,-0.0048,0.0572,0.0336,-0.0166,0.0521,0.0574,0.108,0.0702,-0.054,-0.0908,0.032,0.004,0.0281,0.0064,0.0457,0.0122,0.0239,0.0629,0.0692,0.0117,0.0041,-0.033,-0.0164,0.0142,0.0072,0.0011,-0.0282,0.0086,-0.0274,-0.0076,-0.0066,0.0229,-0.0159,0.0341,-0.0073,0.0388,-0.0282,-0.1327,0.0004,-0.0529,0.0182,-0.0831,-0.0456,-0.1266,-0.0084,0.0203,0.0604,0.0239,-0.0279,-0.131,-0.1109,-0.0681,-0.0181,-0.0142,-0.0017,-0.0332,-0.0754,-0.0273,-0.0309,0.0993,0.0094,0.0535,-0.0267,0.0091,-0.0104,-0.0418,-0.0347,-0.0133,-0.0299,-0.041,0.0125,-0.0452,-0.0209,0.0142,0.0048,-0.0338,0.0372,-0.0174,-0.0257,-0.0172,-0.0032,-0.0378,0.0157,0.0327,-0.0453,0.0034,-0.0303,0.0194,0.0009,0.0308,-0.0049,-0.0156,0.0717,0.0791,-0.1033,-0.0265,-0.0481,-0.0015,0.0146,0.0362,0.062,0.0475,0.0634,-0.0123,-0.0095,0.0053,0.0547,-0.0479,-0.0526,0.0545,0.0,0.0474,0.0342,-0.107,0.0333,0.0004,0.1023,0.0349,0.0148,-0.0465,-0.0019,0.0015,0.0623,-0.0266,0.0552,0.0023,0.026,-0.0205,0.0177,0.0088,-0.0016,0.0092,-0.1175,-0.0154,0.0088,0.052,0.0685,0.0334,0.0297,0.0395,0.0348,-0.0275,0.0756,0.0361,0.0038,0.0096,-0.0129,0.05,-0.0125,0.0265,0.0157,0.0385,0.0303,0.098,0.0612,-0.0354,0.0119,0.0751,-0.0112,-0.0719,0.013,0.0063,0.0042,-0.0297,-0.0858,-0.0523,0.064,0.0545,0.046,0.0143,-0.0626,-0.0038,0.031,-0.0086,0.0244,-0.0398,-0.0442,0.0049,0.0029,-0.0827,0.0591,0.0481,0.0361,0.01,-0.001,0.012,0.0415,0.0151,0.0016,0.0322,0.022,0.0067,-0.0113,0.0754,-0.1933,-0.1965,-0.0951,-0.0446,-0.0196,-0.1356,0.0667,0.06,0.0489,0.0091,-0.0399,-0.0727,-0.0247,-0.0605,-0.111,-0.0231,-0.1742,-0.0336,-0.0116,0.0212,-0.0107,-0.0457,-0.0086,-0.029,-0.0301,0.0267,0.0142,0.0391,-0.0272,-0.0023,0.0234,0.0579,0.0516,0.0677,0.0071,-0.0602,0.0086,-0.0417,-0.0301,0.0088,-0.001,-0.0045,-0.0019,0.0339,0.0197,0.0068,-0.0253,-0.03,-0.0741,-0.0007,0.0073,-0.0106,-0.1189,-0.055,-0.022,-0.0438,-0.0506,-0.1001,-0.0557,0.0224,0.0161,-0.0038,-0.0027,-0.004,-0.0322,-0.0573,-0.0443,0.0288,-0.04,0.0057,-0.1018,-0.0113,0.0014,-0.0223,-0.0268,-0.0169,-0.0618,-0.0494,-0.0634,-0.0226,-0.0396,-0.0854,0.0427,0.0763,-0.0069,-0.0239,-0.1148,-0.0773,-0.0112,0.0163,0.0497,0.0347,0.0062,-0.1459,-0.0514,0.0054,0.0196,0.0584,0.0983,0.0693,0.0661,0.0552,0.053,-0.002,0.018,0.0304,-0.1295,-0.1124,-0.0616,0.0543,0.0099,0.0284,0.033,0.0016,0.0309,0.0289,-0.0566,-0.0185,-0.0055,-0.0212,0.0193,-0.0384,-0.0239,0.0085,-0.005,0.0212,0.0287,-0.063,-0.0557,0.0428,0.0348,-0.0121,-0.0488,0.0146,0.0226,0.0098,0.0213,0.0008,-0.0004,-0.0351,0.0363,-0.0626,0.0658,-0.053,-0.0557,-0.0146,0.033,0.004,-0.017,-0.0142,0.015,0.0369,0.0952,0.0767,0.0016,0.0623,-0.0096,0.0425,0.0414,0.0259,0.0133,-0.0626,-0.0546,-0.0657,-0.0203,-0.0794,-0.0302,0.0311,-0.0398,0.0455,0.0313,-0.0298,0.0186,0.0149,0.0327,0.0436,-0.0315,-0.0245,-0.0208,0.0561,0.0766,0.0194,0.038,0.0369,-0.0903,0.0376,0.0048,0.013,0.0162,0.0267,0.0423,0.0304,0.0705,0.0475,0.0814,0.0632,0.0178,0.0102,0.009,-0.0214,-0.0268,-0.0676,0.0096,0.0409,-0.059,0.0449,0.0217,0.0387,0.017,0.0426,0.0376,-0.0024,-0.0159,-0.0088,0.054,0.0216,0.0445,-0.0221,-0.0356,-0.0416,0.0068,-0.0318,0.039,0.043,0.0193,-0.0062,0.0087,-0.0027,0.0286,-0.0193,0.0121,0.012,0.0102,-0.016,-0.01,0.0059,0.0136,-0.0321,-0.0052,0.0485,-0.1047,0.0038,-0.0912,0.0341,-0.1462,-0.1563,-0.0065,0.0265,0.0196,-0.0188,-0.0335,-0.0481,-0.045,-0.0621,0.0056,-0.022,-0.0014,-0.0471,-0.0074,0.0287,0.074,0.0551,0.0632,-0.0139,0.0255,0.0712,0.0181,-0.0083,-0.0026,0.0099,0.0152,0.0275,-0.1216,-0.0262,0.0329,-0.218,-0.0365,-0.0241,-0.0052,-0.0395,-0.1004,-0.0795,0.0046,-0.008,-0.0096,0.0052,0.0114,-0.0563,0.0309,-0.0211,0.024,0.0256,0.0022,-0.09,-0.0483,0.0495,-0.0003,0.0154,0.0416,0.0005,0.043,0.0088,-0.0098,0.0216,0.0026,0.0641,0.0367,-0.0172,0.0647,0.0353,0.0392,0.0091,0.048,0.0427,0.0488,0.0493,0.0395,0.008,0.0445,0.0736,0.0547,0.0106,-0.0207,0.0069,-0.0222,0.0262,-0.0427,-0.0079,-0.0098,0.0239,0.0048,0.016,0.0281,0.0733,0.0692,0.0157,-0.0072,0.0684,0.0609,-0.0051,0.0075,0.0382,0.0449,0.0559,0.0609,-0.0109,-0.0184,-0.0423,0.0205,-0.047,-0.0117,-0.0256,-0.0354,-0.0923,0.0389,-0.0763,0.0622,0.0324,-0.0059,0.0116,0.0085,0.018,-0.0739,-0.0544,-0.0191,0.0238,-0.0876,0.06,0.0567,-0.0194,0.014,0.0665,0.0713,-0.0141,-0.0113,-0.068,-0.0625,0.0856,0.0762,-0.0839,-0.0986,-0.0259,-0.0592,0.0089,0.0243,0.0312,0.0786,0.0317,0.0424,0.0553,0.0394,0.0181,0.0348,0.0251,0.0275,0.0139,-0.0791,0.0431,-0.0155,0.0053,0.01,0.0221,-0.0102,0.0076,0.007,-0.0031,0.0231,0.0131,0.0174,0.0206,0.0187,-0.022,0.0541,0.0351,-0.021,0.0454,-0.0074,0.0396,0.0022,0.0053,-0.0104,-0.0814,-0.054,0.0015,-0.0126,-0.0348,-0.025,-0.0097,0.057,0.0299,0.0311,-0.0478,-0.0142,-0.0888,0.0339,-0.0136,0.0322,0.0313,-0.0584,-0.0083,-0.0453,-0.0457,0.0219,0.0812,-0.043,0.0326,0.0156,0.0302,-0.0222,-0.0356,0.0719,0.0283,0.02,0.0388,-0.007,0.0572,0.0176,0.0305,-0.0689,-0.0404,0.0123,0.0299,0.0742,0.033,-0.0478,-0.0414,-0.0353,0.0123,-0.0042,-0.0026,0.0636,0.0165,-0.0434,0.0517,0.0051,0.0429,-0.1675,0.0563,-0.0411,0.0263,0.0353,0.06,0.0534,-0.0308,0.0093,0.0329,-0.0414,-0.031,-0.1023,0.0374,0.0163,-0.1033,-0.005,-0.0124,0.0012,-0.0158,0.0199,-0.0111,0.0327,0.036,-0.0326,-0.0993,-0.0124,-0.0497,-0.0714,0.0176,-0.005,-0.0634,-0.0611,-0.0405,-0.0359,-0.0205,-0.0141,-0.0093,-0.0447,-0.0534,-0.1569,-0.0874,-0.0666,-0.1113,0.0034,0.0539,0.06,0.0628,-0.0142,0.0087,0.0564,0.0697,0.0305,-0.0819,-0.0728,0.0819,0.0935,0.0333,-0.0281,0.0302,0.05,-0.0086,0.0163,0.039,-0.0311,0.0136,0.0197,-0.0135,-0.019,0.0142,-0.0657,0.096,0.1,-0.0744,0.0139,0.0023,-0.0008,-0.0053,0.0356,0.0339,0.0102,0.0775,-0.0273,-0.0529,0.0113,-0.0326,-0.0174,0.0186,0.0142,0.014,0.005,0.05,-0.0434,0.0299,0.0124,0.0095,-0.0249,-0.0628,-0.0098,0.0291,-0.0369,-0.0006,0.0191,-0.0055,self control
trm_557b4b56de455,0.0758,-0.0016,0.0516,-0.0336,0.0282,-0.0019,0.0327,0.0132,0.0421,0.0376,0.0666,0.067,0.0267,-0.0117,-0.0193,-0.0073,-0.0426,-0.0703,-0.004,-0.0607,0.0104,0.0337,0.0192,-0.0142,0.0059,0.0299,0.025,-0.0195,-0.0002,0.0501,-0.0321,-0.0158,-0.0365,0.0423,-0.0735,-0.0757,0.071,0.0045,-0.0284,-0.0597,-0.0378,-0.0363,-0.0186,-0.0042,-0.0417,-0.083,0.09,0.0092,0.0428,0.0036,-0.0204,0.0073,0.0127,0.0238,-0.0744,-0.0079,-0.0461,0.0309,0.0361,0.0029,0.0238,0.0311,-0.0762,0.0163,-0.034,0.0692,-0.07,-0.0573,-0.0327,0.0052,0.0134,0.0239,0.0074,-0.0032,0.0024,-0.0386,-0.0147,0.055,0.0087,-0.0184,0.0066,0.048,-0.0982,0.0008,0.0036,0.0484,-0.0212,0.0414,0.0018,-0.1103,-0.0599,0.0425,-0.0571,0.1421,0.11,0.1111,0.0681,0.0537,0.1145,0.0529,0.0113,-0.0831,0.0705,0.0832,0.0355,-0.0606,-0.0755,0.0565,-0.0187,0.0008,-0.0054,-0.0055,0.0139,0.0788,-0.0211,-0.0323,0.0177,0.0306,0.0198,0.0106,-0.0579,-0.0575,-0.0536,-0.0417,-0.0681,-0.0617,-0.0676,0.0308,0.062,0.0076,-0.0399,-0.0256,-0.0104,-0.0788,-0.0763,-0.0716,0.0326,-0.0257,-0.0518,-0.0164,-0.0063,-0.0173,-0.0314,-0.017,-0.0354,0.0008,0.0615,0.0293,-0.0499,-0.0091,-0.0173,-0.0658,-0.0308,-0.0492,0.0357,-0.003,0.0776,0.0011,0.04,-0.0118,-0.0182,-0.0524,-0.0456,-0.0176,0.0054,-0.0448,0.0202,-0.071,-0.0649,-0.0454,-0.0218,-0.0626,0.0576,-0.0403,-0.0076,-0.0586,-0.0365,0.0123,-0.0146,0.0513,-0.0918,0.0021,-0.0471,0.0139,0.0348,0.0237,-0.0217,-0.0314,-0.0096,-0.0536,-0.053,0.0056,-0.0158,0.0237,0.0254,-0.0491,-0.0241,-0.0418,-0.0753,-0.0114,0.0257,0.1657,-0.0879,-0.0587,-0.028,-0.0564,-0.1162,-0.0198,0.0193,0.0051,-0.046,0.005,-0.0594,0.0222,-0.0213,-0.0229,0.0074,-0.0193,0.0428,-0.0158,0.0634,-0.0366,-0.0857,-0.0594,0.0339,0.0281,-0.1002,-0.0067,-0.0268,0.016,0.0516,-0.0189,0.0674,-0.0326,-0.0302,0.0047,0.002,0.0168,0.0093,-0.0227,0.037,-0.0246,-0.0295,-0.0102,0.0104,-0.0434,-0.0555,-0.0619,-0.0301,-0.0723,0.0443,-0.0163,-0.0469,0.002,0.0128,-0.0213,0.0064,-0.0497,0.0391,0.0425,0.0446,0.0742,0.0109,0.0208,0.0584,0.0704,0.0171,-0.0102,0.0016,-0.0112,-0.0277,-0.0017,-0.0581,0.0187,-0.033,0.0038,-0.0613,-0.0808,-0.0489,-0.0492,-0.0093,-0.0237,-0.0044,-0.1425,-0.1392,-0.0392,0.0013,0.0231,0.0335,-0.0028,-0.0175,0.0511,0.0042,-0.02,0.0038,0.0273,-0.0227,-0.0306,-0.0447,0.0498,-0.0149,-0.0355,-0.0319,-0.0408,0.1313,0.1375,-0.0144,-0.0134,0.0138,-0.0134,-0.0126,0.008,-0.0367,0.0175,0.0163,-0.0028,0.0338,0.0088,0.021,-0.0273,0.0312,0.0095,-0.0746,-0.1154,-0.0064,-0.0408,-0.051,-0.083,0.0254,-0.0264,0.0046,0.0183,0.0143,-0.0077,0.0031,0.0844,-0.0537,-0.0348,-0.0286,-0.0446,-0.0408,-0.0117,0.0578,0.0718,0.0211,0.0301,-0.0002,0.0208,0.023,-0.0409,0.0116,0.0825,0.0354,0.039,-0.0041,0.03,-0.0036,-0.0499,0.0037,-0.0625,0.0196,0.0176,-0.0492,0.0302,0.021,0.0589,-0.0392,0.0436,-0.0429,0.0259,-0.022,0.0391,-0.041,0.0927,-0.0388,-0.048,-0.0793,0.0337,-0.0304,-0.0074,-0.0334,0.1121,-0.0012,0.0026,0.0101,0.0076,-0.0356,-0.0039,0.0139,-0.0128,0.0699,-0.0522,0.0327,-0.0697,0.2093,0.2145,0.0828,0.0222,0.0003,-0.0469,-0.0475,0.0207,0.031,0.0347,0.0224,-0.0222,0.0191,0.0252,0.0255,0.0332,0.019,-0.0661,-0.0108,0.0295,-0.0771,-0.045,0.0041,-0.0279,-0.0302,-0.0023,0.042,-0.0055,-0.0103,-0.0699,-0.0723,0.0066,-0.0351,0.1143,-0.0005,0.0455,-0.0294,0.0121,-0.0158,0.0315,-0.0378,0.0421,-0.0078,0.005,-0.0502,-0.0387,-0.0018,-0.0035,0.0106,-0.0116,0.0651,0.0096,0.0076,0.0716,-0.0774,-0.0729,-0.0022,0.0213,-0.0432,-0.0301,0.0588,-0.0832,-0.0284,-0.0385,-0.0863,0.0135,0.0598,0.024,-0.0046,-0.0556,-0.0128,-0.0938,-0.0272,0.0743,-0.048,-0.0143,-0.0033,0.0532,0.0601,-0.049,-0.0619,-0.0118,0.0257,0.0259,-0.02,0.0374,0.0385,0.0256,-0.0039,0.0401,-0.0383,-0.0127,-0.0017,-0.0143,-0.0835,-0.0059,0.0347,0.0033,-0.1259,-0.1416,-0.0228,-0.0245,-0.1975,-0.0166,-0.0247,-0.0346,-0.0295,0.0054,-0.0159,-0.0219,-0.0094,-0.049,-0.0552,-0.064,-0.0576,0.0672,-0.0126,0.0061,-0.0498,-0.001,0.0775,0.0014,0.0407,0.0844,0.0738,0.0317,0.0288,0.0082,0.0096,0.0412,0.0601,0.0085,0.0215,0.0857,0.02,0.0059,-0.0751,-0.0175,0.0258,-0.0797,0.0171,-0.0335,-0.0775,-0.0647,-0.0058,-0.054,-0.0196,0.0201,0.0291,-0.0089,-0.0279,0.0135,-0.0135,0.0087,-0.0295,-0.0462,0.0572,-0.0557,-0.0176,0.0393,-0.0102,-0.0552,0.0809,0.008,-0.0001,-0.0164,-0.0429,-0.0405,-0.0928,0.0545,-0.0729,-0.0405,0.0242,-0.1292,-0.0201,-0.0522,-0.0455,-0.0685,-0.0352,0.0281,0.1583,0.1821,0.0223,-0.0047,0.0164,-0.0288,0.0252,0.0015,-0.0308,0.016,0.0769,0.0199,0.0772,-0.0206,0.0385,0.0008,-0.0381,0.0051,0.021,0.003,0.0097,0.0561,-0.035,0.0106,0.0743,-0.078,-0.057,0.0361,0.0708,0.0006,0.023,0.1753,-0.0975,0.0222,0.0259,0.0372,0.0245,0.0085,0.0166,-0.0244,-0.0278,-0.0321,0.0028,-0.0297,-0.0419,-0.0934,0.0108,-0.0346,-0.0046,0.0181,-0.0356,0.0303,0.0216,-0.0269,0.0143,-0.0083,0.0416,0.1175,-0.0315,-0.0111,-0.0068,0.0466,0.0316,-0.003,-0.0156,0.0074,0.0042,0.0549,0.0514,0.1054,-0.062,-0.0127,-0.0689,-0.0264,0.0905,-0.0661,-0.0234,-0.0931,0.0753,-0.1107,-0.0171,-0.0186,0.2144,0.0246,0.0271,-0.0846,-0.0581,0.0905,0.0774,0.0629,0.0953,0.024,0.0669,-0.0986,0.0548,0.0758,0.0029,0.0007,-0.0032,-0.0654,-0.0219,-0.0558,0.0245,-0.0195,0.0093,-0.0315,0.0217,0.022,-0.0212,0.0198,0.075,-0.0722,-0.0162,-0.0282,-0.0031,0.0172,0.1472,0.0446,0.0809,0.011,-0.0015,-0.1028,-0.016,-0.0096,-0.0043,-0.0052,0.0051,-0.0116,-0.0207,-0.0338,-0.0486,0.0245,-0.0621,-0.0836,-0.0621,-0.0038,-0.0325,-0.0434,-0.0164,-0.073,-0.0567,-0.0058,0.0544,-0.0713,-0.061,0.0224,0.0121,0.0119,-0.1583,-0.1443,-0.1311,-0.0237,0.0141,0.0108,0.0017,-0.0067,0.023,0.0034,0.0388,0.0627,0.0406,-0.022,0.0555,0.0306,0.0208,-0.0043,-0.047,-0.0194,-0.0048,-0.0234,-0.0394,0.0355,0.002,-0.0117,0.0138,-0.0218,-0.0177,0.0442,-0.0477,-0.0827,-0.0817,-0.0639,-0.0214,0.0126,0.0094,-0.0658,-0.0522,0.0765,0.0023,-0.0117,0.0417,0.0386,-0.0216,-0.0,-0.0105,0.0141,0.0359,0.046,0.0299,0.0569,0.0773,0.0018,0.0143,0.0038,-0.0121,-0.0952,-0.0532,-0.0092,-0.0648,0.0849,-0.0193,-0.0258,-0.0117,0.0443,0.0043,0.0358,0.056,-0.0309,0.0185,-0.0068,0.0025,0.0398,0.0108,-0.1068,0.005,0.0249,0.0238,0.0468,-0.0132,0.0616,-0.0131,-0.0046,0.0003,0.0009,0.0327,0.1462,0.0537,0.0428,0.0641,0.0429,0.0571,-0.0021,0.1263,0.0844,-0.0427,-0.0056,-0.0561,-0.0384,-0.0651,-0.0106,0.0246,0.0223,-0.0885,0.0189,-0.0586,-0.0308,-0.0311,-0.0132,0.0508,0.0059,-0.0044,0.0406,-0.0273,0.0524,-0.0047,-0.0265,-0.0241,0.0306,0.0458,0.0315,0.035,-0.0258,0.0458,0.09,-0.0872,0.0731,0.0276,-0.0158,-0.0056,0.0051,-0.0342,0.0408,-0.0018,-0.1341,-0.0932,-0.0133,0.0379,-0.0598,-0.0774,-0.016,-0.0209,0.0639,0.0089,0.0111,0.0787,-0.0295,0.0122,-0.0442,0.1885,-0.0094,0.0516,0.0409,-0.0201,0.0446,-0.1301,-0.1429,-0.0164,0.0777,-0.0132,-0.0017,0.0083,0.0356,-0.0295,0.0065,-0.0434,0.0163,-0.018,-0.0058,-0.0076,0.0326,-0.0372,0.0223,-0.0279,-0.0555,0.0033,-0.0182,0.0025,0.0717,0.0293,0.0676,0.0171,0.0459,0.0704,-0.0116,0.0294,-0.0761,-0.0636,-0.0257,-0.0441,0.0232,0.0585,0.0245,-0.0034,-0.0242,0.0192,0.0431,0.039,0.0057,-0.0186,0.0088,0.0702,0.0362,0.0601,0.1037,-0.0593,-0.0245,0.0091,0.0184,0.0142,-0.0221,0.006,-0.023,-0.0886,0.0062,0.0024,0.0501,0.0522,-0.0973,-0.0693,-0.0799,-0.018,0.0001,-0.0363,-0.0445,-0.0036,-0.0531,-0.0457,-0.1128,-0.0457,-0.0398,-0.0534,-0.0085,0.0313,-0.072,0.009,-0.0245,-0.0234,0.0057,-0.0287,0.013,-0.0195,-0.0623,0.0165,-0.0072,-0.0299,-0.0554,0.0028,0.0175,-0.0055,-0.0729,-0.0428,0.0599,-0.0277,-0.0214,0.007,-0.0103,-0.0468,-0.014,-0.0353,-0.0608,-0.0796,-0.1191,-0.111,0.0718,0.0404,0.0655,-0.0487,0.0218,0.0493,0.0429,0.0404,-0.0229,0.0462,0.0316,-0.0085,0.015,0.0273,-0.0305,0.0186,0.009,-0.0091,-0.0371,-0.0196,-0.0513,-0.0817,-0.0556,0.0547,0.0336,0.0872,0.0024,0.0054,-0.03,-0.0819,0.0166,-0.0463,-0.0324,-0.0168,-0.0059,0.0179,0.0435,-0.0049,0.0004,-0.0334,-0.0067,-0.0502,-0.0178,-0.0207,0.0826,0.108,0.1783,-0.0248,-0.029,-0.0043,0.0141,-0.0167,0.0454,-0.0399,-0.0227,0.0373,0.0018,0.0308,-0.0045,0.0385,0.0202,0.0135,-0.0273,0.0971,-0.1161,-0.052,-0.1022,-0.0264,0.0298,0.0032,0.0276,-0.0709,0.073,0.0207,-0.0123,-0.0073,-0.0126,-0.031,-0.0265,0.0311,-0.014,-0.0748,-0.0767,-0.0157,-0.0736,-0.0479,-0.0667,0.0131,-0.0195,0.0121,-0.0629,0.0117,0.0286,0.1085,-0.0356,0.0135,-0.0068,0.0093,0.0492,-0.0001,0.0299,0.0101,-0.0235,0.1246,0.1057,0.1175,0.0868,0.0874,0.025,0.1089,0.0464,0.017,0.0005,0.0073,0.0152,0.0074,0.0022,-0.0138,0.0151,-0.0109,-0.0508,-0.0331,-0.0205,0.005,0.0051,-0.0182,0.0337,0.0487,-0.0103,0.0426,-0.0434,-0.071,0.0319,-0.0277,-0.036,-0.0198,0.0532,0.0738,0.0575,0.091,-0.0253,-0.089,-0.0057,-0.023,0.0038,-0.0005,-0.0242,0.1115,-0.0428,-0.1171,-0.0581,0.007,0.0106,0.0822,0.1535,0.07,-0.0248,0.0237,0.0827,0.2489,0.2217,0.2151,0.0542,0.0604,0.0101,0.0433,0.0227,0.0333,-0.0428,-0.0231,0.0088,0.0804,0.026,-0.04,0.0199,-0.0005,-0.0258,0.0307,0.037,0.0022,0.1846,-0.0219,-0.0128,-0.0264,-0.0416,0.0045,0.0554,0.056,0.0147,0.0238,-0.099,-0.0598,0.0411,-0.0255,-0.0217,-0.0387,-0.0332,-0.029,0.0224,0.0476,0.097,-0.0517,-0.085,-0.0174,0.0128,0.0115,0.0432,-0.0725,0.0484,0.1182,0.0171,-0.1426,0.0368,0.0433,-0.029,-0.0571,-0.0088,-0.0215,-0.0108,-0.0812,-0.0098,0.0977,-0.0749,-0.0476,0.0204,-0.0423,0.0102,0.0264,-0.0686,-0.0688,-0.0782,0.0637,0.0003,0.0027,0.0125,0.0273,0.0454,-0.0018,-0.0119,0.0276,0.0068,-0.0293,-0.0413,-0.0281,0.1355,0.0342,-0.0603,-0.005,-0.0184,0.0099,-0.0154,0.0232,-0.0079,0.0006,0.006,0.0447,-0.0468,-0.0102,-0.08,0.0424,0.0124,-0.0564,0.0711,0.0711,-0.0317,0.0093,0.0258,0.0177,-0.0052,0.0088,-0.0913,0.1918,-0.076,-0.0792,-0.0342,-0.0601,-0.0116,-0.0226,-0.0389,0.054,0.0218,-0.0394,0.0408,-0.0036,0.1416,-0.0591,-0.091,-0.013,-0.055,0.0312,-0.031,0.0102,-0.002,-0.0603,-0.0403,-0.1018,-0.0621,-0.0726,-0.0542,-0.0038,-0.005,0.1961,0.1706,0.1572,-0.0223,0.1645,-0.0342,0.0154,0.0113,-0.0023,0.0071,-0.0636,0.0119,-0.0383,-0.0197,-0.0546,0.0565,0.0431,-0.0603,0.0226,0.0595,0.0423,-0.1156,-0.0457,0.01,0.0072,-0.0145,0.0245,0.0134,0.048,0.064,0.1012,0.0325,0.0132,0.045,-0.0264,-0.0705,-0.0684,0.0203,-0.0424,-0.056,-0.0202,0.0019,0.006,0.0252,-0.0351,-0.0098,-0.06,0.0276,0.0256,0.0249,0.0107,-0.0278,0.0238,-0.0272,-0.0771,-0.0636,-0.0794,-0.0155,-0.0121,-0.0602,-0.0588,-0.0062,-0.0069,0.0751,0.0783,-0.0064,0.0202,0.0127,0.0246,-0.0236,-0.0443,0.0412,0.0305,0.0677,-0.1422,-0.0195,0.0737,-0.0565,-0.0655,-0.0106,-0.0247,0.0045,-0.0423,0.079,0.0754,-0.0589,0.0479,-0.0206,0.0761,0.0804,0.0943,-0.0054,0.0416,0.0496,0.086,0.004,0.028,0.0062,0.0132,-0.0818,-0.0621,-0.0274,0.036,-0.0341,-0.0107,-0.0176,-0.0053,-0.0605,-0.0097,-0.0995,0.007,-0.0022,-0.0228,0.0187,0.0328,-0.0075,0.0018,-0.0426,-0.0257,0.0221,0.0201,-0.0203,0.0091,0.0304,-0.0256,0.026,-0.0048,-0.0303,-0.0266,0.0483,0.0408,-0.1234,-0.1641,0.0363,0.1628,0.2373,0.0081,-0.0215,-0.0103,0.0489,0.0446,-0.0359,-0.0605,-0.064,0.0362,-0.0972,0.0203,0.038,-0.0207,-0.0235,-0.0389,0.0173,-0.0966,-0.0822,0.0012,-0.0781,-0.0347,-0.0263,0.0994,-0.0309,0.038,-0.0016,-0.0011,-0.0075,0.0216,0.0366,0.029,-0.0039,-0.0083,-0.0249,-0.0241,-0.0409,-0.0489,0.0775,0.0709,0.1168,0.1011,-0.0098,-0.0194,-0.0335,0.0379,0.0005,-0.0002,-0.012,0.0068,0.0307,-0.0093,-0.0034,-0.0153,0.0641,0.0253,-0.0049,-0.005,-0.0335,0.0047,-0.0078,-0.0324,-0.0017,-0.0141,-0.066,-0.0674,-0.0923,-0.0518,0.0279,-0.0279,-0.0286,-0.0407,0.0009,0.0599,0.0916,0.028,-0.022,0.07,-0.0063,0.0002,-0.0425,0.0229,0.0009,-0.0518,0.063,0.1337,0.0695,-0.0155,0.0081,0.0113,0.1534,0.151,-0.1524,-0.1014,0.0149,-0.0259,0.0197,0.0434,-0.0554,-0.0036,-0.0327,-0.0187,0.0885,-0.021,0.1035,-0.0479,0.0573,0.0217,-0.0032,0.0778,0.1234,0.1562,-0.0398,0.053,0.0211,-0.0066,-0.0214,-0.0165,-0.0348,-0.0225,-0.0287,0.0569,0.0068,-0.0237,0.0032,-0.0786,-0.0217,-0.0797,-0.0793,-0.0645,0.0275,-0.0404,0.0226,-0.0283,-0.0661,-0.0817,0.0213,-0.0034,-0.0153,-0.0409,0.06,0.0318,-0.1207,-0.1442,-0.1056,-0.0646,-0.0267,-0.051,-0.0123,-0.0119,-0.0139,0.0124,0.0615,0.0334,-0.0252,0.0766,0.0276,-0.0217,0.129,-0.0195,-0.0678,0.0114,-0.1135,-0.009,-0.0571,0.0144,0.0014,0.032,0.024,-0.0114,-0.0256,0.0805,0.0216,0.0522,-0.0553,0.0316,0.0404,0.0153,-0.0185,0.0387,-0.0081,-0.0037,0.0071,0.0046,-0.0977,-0.0387,-0.0738,0.0189,-0.0277,0.0245,0.1476,0.0977,-0.0554,-0.0293,0.0441,0.0132,0.0251,0.0065,0.0354,-0.0215,-0.0263,-0.1128,-0.0269,-0.0182,0.0003,0.0018,0.0009,-0.0995,-0.1052,-0.1253,-0.0299,0.0043,-0.002,0.0454,-0.0262,-0.0322,-0.0462,0.1402,0.056,0.1883,-0.0429,-0.0116,0.0149,0.0323,0.1406,0.0513,0.048,-0.0084,0.0098,-0.0538,0.0292,0.0503,0.0696,-0.0473,-0.0094,-0.0379,-0.081,-0.015,-0.0007,0.0071,0.1324,-0.0377,0.0994,0.0972,0.0607,-0.0193,0.0213,0.0232,0.0477,0.0154,0.0063,0.0631,0.0029,0.042,-0.0731,-0.019,-0.0617,0.0152,-0.0125,-0.0254,-0.054,-0.0373,-0.0234,-0.0382,-0.0149,-0.0476,0.0776,-0.0167,-0.0549,0.0499,0.0103,-0.0069,0.0385,-0.0077,-0.0879,0.0866,-0.015,0.003,-0.0434,-0.0069,0.0007,0.0147,-0.044,-0.0252,-0.0327,-0.0009,-0.041,-0.033,-0.0484,-0.0685,-0.0033,0.0516,0.093,-0.0637,-0.0571,0.0082,-0.0124,-0.1399,-0.0565,0.0239,-0.0215,-0.0058,0.0537,-0.0161,-0.0806,-0.0387,0.0606,0.022,0.0117,-0.1343,-0.0197,-0.0472,-0.0357,-0.1544,-0.032,-0.0466,0.0315,-0.0346,0.0137,0.0333,0.048,-0.0401,-0.0347,-0.1054,-0.0614,-0.0072,0.0358,-0.0479,0.0424,-0.1061,-0.0523,0.0194,0.0251,0.0048,-0.0008,-0.0714,0.0358,-0.0993,-0.1363,-0.1096,0.0491,0.0093,-0.0436,-0.0091,-0.0229,-0.0455,-0.0217,0.0005,0.006,-0.0435,0.0126,-0.0456,-0.0151,-0.0362,0.0209,-0.1515,-0.0444,-0.0765,-0.0338,-0.0155,-0.0636,-0.1385,-0.1239,-0.0282,-0.085,0.0165,-0.1532,-0.1541,-0.0226,0.1052,0.0699,-0.0475,0.0504,0.0071,0.0594,0.0599,0.044,-0.1224,-0.1248,0.0025,0.0087,-0.0426,0.0324,0.0077,0.0258,-0.0119,-0.025,-0.0177,-0.0434,0.0371,-0.0119,0.0071,0.0452,-0.0428,-0.003,0.0364,0.043,0.1138,0.0932,0.0213,-0.0324,-0.0891,-0.0569,-0.0569,-0.0646,-0.0489,0.0864,0.033,0.0128,0.1938,0.1456,0.1489,0.1094,0.1384,0.1646,0.136,0.076,0.0983,0.0537,0.067,0.1596,0.183,0.2021,0.1514,-0.0801,0.1094,0.0738,0.1382,-0.0748,-0.0302,0.0339,-0.038,0.0254,0.1199,0.0407,-0.053,-0.0124,0.0887,-0.0289,-0.0446,0.0649,0.0077,-0.0355,-0.0202,-0.0435,-0.0402,-0.0354,-0.0474,-0.0406,0.0123,0.0424,-0.0279,0.0319,0.0161,-0.0905,-0.0488,-0.0589,-0.0472,-0.0258,-0.0802,-0.0434,-0.036,-0.0129,-0.0283,0.0233,0.0381,-0.0351,-0.0867,-0.1259,0.0642,-0.0688,-0.0247,0.0012,-0.0532,0.0326,-0.0488,-0.0351,-0.0536,0.0483,-0.0231,0.0027,-0.0194,0.0621,0.1478,0.0909,0.0178,-0.0315,-0.0158,-0.0729,-0.02,-0.0089,-0.008,-0.0326,0.0505,-0.0166,0.0164,0.0064,-0.0419,-0.0188,0.0294,0.0238,0.0033,-0.0229,-0.0335,0.0807,0.0222,-0.0097,-0.0795,-0.0019,0.0696,-0.0875,-0.0365,-0.0402,0.0364,0.0135,0.1254,0.0417,0.0015,0.0596,0.0738,0.0494,0.0028,0.1097,0.0347,-0.0263,-0.013,0.1039,0.1294,0.0546,0.0657,0.0205,0.0606,-0.037,-0.037,0.0271,-0.0166,0.0681,0.0866,0.0076,-0.0255,-0.0023,0.0536,0.0946,0.0874,0.0834,-0.0059,0.0069,-0.0011,0.0251,0.0296,0.0237,-0.0333,-0.0644,-0.0363,-0.0679,-0.0349,-0.0336,0.0128,-0.0256,-0.0037,-0.0207,-0.0238,0.048,0.0739,0.044,0.0306,0.0526,0.0132,-0.0366,-0.0078,0.0164,-0.0178,-0.0361,-0.0251,-0.0325,-0.0244,-0.0188,0.0451,-0.0111,-0.0475,0.0794,0.0235,0.0476,0.0428,-0.008,0.0272,-0.0103,-0.0387,-0.0463,0.0796,-0.03,-0.0554,0.0372,0.0532,0.0488,-0.0017,0.0224,0.0224,-0.0423,-0.0326,0.1632,0.008,0.0127,-0.0079,-0.0269,-0.0214,0.0711,-0.0328,-0.0015,0.0162,-0.0695,-0.0345,-0.0683,-0.0302,-0.0306,0.0343,0.0436,0.048,0.0709,0.0252,0.0226,0.1217,0.1235,0.0553,0.0864,-0.0941,0.0428,0.011,0.0856,0.1176,0.0649,0.0242,0.0281,-0.0255,0.0251,-0.0284,0.0193,0.007,-0.0105,0.0306,-0.0473,0.0197,-0.0386,0.0075,0.0539,-0.039,0.0456,-0.0263,0.1074,-0.018,0.044,0.0327,-0.096,-0.0497,0.0402,-0.0104,-0.0477,0.0705,0.0518,-0.0431,-0.016,0.0549,0.0233,-0.0758,-0.0135,-0.0005,-0.0563,0.0146,0.0139,0.0269,0.0427,0.0752,0.0948,0.1631,0.0585,-0.0065,0.0191,0.0624,0.0054,-0.0147,0.0241,-0.0051,-0.0274,0.0333,-0.0556,0.0115,-0.0788,-0.1137,-0.0682,-0.0301,-0.0916,-0.0299,0.0038,-0.0702,-0.0174,0.0319,0.0326,-0.0226,-0.0083,-0.0208,-0.0091,-0.0217,0.017,0.0553,-0.0323,-0.0276,-0.0587,-0.0038,-0.0183,0.0079,0.0597,-0.0328,-0.0334,0.0064,-0.0036,0.0074,0.0109,-0.0155,-0.0067,-0.0622,0.0011,-0.0297,-0.0244,0.0443,0.0003,0.0353,-0.0258,-0.1237,-0.0408,-0.0079,-0.0401,-0.0021,0.0234,-0.0608,-0.0388,0.0394,-0.0117,0.0099,-0.1112,-0.0311,-0.0668,-0.0958,-0.0377,-0.0406,0.0543,0.0543,-0.0509,-0.0035,0.0397,-0.0702,-0.0104,0.0081,-0.0183,-0.0673,-0.0716,-0.1577,0.0177,-0.0325,-0.0039,-0.0726,0.0979,-0.0467,-0.072,-0.0678,-0.0425,0.0004,-0.0008,-0.0476,0.0758,0.022,0.0982,0.1552,0.0986,-0.0064,0.045,0.0704,0.0237,0.0382,-0.1652,-0.1036,0.0181,-0.0515,0.004,0.0449,0.0218,0.0332,0.0235,-0.0161,0.0628,-0.0165,-0.0421,0.0063,-0.0087,-0.0805,-0.0414,-0.0927,0.0051,0.0111,0.0537,-0.0205,0.1964,0.2008,0.0666,0.104,0.06,0.0054,0.0195,0.013,0.0423,0.0037,-0.0096,0.0497,0.0182,0.0207,-0.0464,-0.015,-0.0001,-0.0563,0.0173,-0.0116,-0.0286,0.1101,-0.0709,0.1255,0.0478,0.1393,0.0051,0.0573,0.0798,0.0564,-0.0143,-0.042,0.014,0.0496,-0.0082,-0.0253,-0.055,-0.0065,0.0171,0.0088,-0.0123,0.0025,-0.0011,0.0124,-0.0136,-0.002,-0.0403,0.0167,0.0279,-0.0125,0.0154,-0.0095,-0.0829,-0.058,0.0509,-0.026,0.0096,0.0359,0.0211,0.0074,0.0708,-0.0126,0.0692,-0.0002,0.0287,0.0435,0.0094,0.0821,0.0187,-0.0155,0.029,-0.0434,-0.0621,0.0185,0.0552,-0.0253,-0.041,-0.0013,-0.0387,-0.0419,-0.0427,-0.0392,-0.0579,-0.07,0.0305,0.0169,0.0195,-0.0828,-0.0391,-0.038,0.0134,-0.0098,0.0152,0.0098,0.1298,0.0458,-0.0581,-0.0105,0.0067,-0.0,-0.058,-0.0525,0.0907,0.0773,-0.0652,-0.0072,0.0289,-0.0296,0.0653,0.0536,0.0577,-0.0429,0.0698,-0.068,0.0294,-0.0391,-0.038,0.0931,-0.0501,0.0592,0.0975,0.0716,0.0717,0.0553,0.0019,-0.0013,-0.1046,-0.034,-0.067,-0.0255,0.0372,-0.0512,-0.0509,-0.0475,-0.0853,-0.0834,-0.0596,0.0019,0.0054,-0.0237,-0.0247,-0.0238,-0.024,-0.0438,0.0219,0.0006,-0.0318,-0.1097,-0.0286,0.0356,0.0875,-0.0155,-0.0415,-0.0087,0.0049,-0.0203,-0.0344,-0.0039,-0.0136,0.0132,-0.0718,-0.0956,-0.0189,-0.0206,-0.0713,-0.0522,0.0108,0.0267,-0.0295,-0.0742,0.0063,-0.0151,0.0537,-0.059,-0.0633,0.0222,-0.0104,-0.0044,-0.0995,-0.025,0.0413,0.0953,-0.0587,0.0263,-0.0497,0.0499,-0.0111,0.0007,-0.0347,-0.0882,-0.0445,-0.0105,-0.0589,0.0074,-0.0148,-0.0176,-0.0096,0.0151,0.0379,0.004,0.0306,0.0312,-0.0283,-0.0209,-0.0063,-0.0401,0.003,-0.0757,-0.0313,0.0585,-0.0096,0.0558,0.0158,-0.0008,0.0226,0.1219,-0.0476,-0.0206,-0.0924,-0.0072,0.0337,0.0535,0.0656,0.0367,-0.02,-0.0009,-0.0057,0.0652,0.0847,0.0099,0.0209,-0.1158,-0.0308,0.0187,0.0298,-0.0158,-0.004,0.0998,0.0304,-0.0264,0.0226,-0.0008,-0.0237,0.0434,0.0494,0.0103,0.0525,0.0159,0.0049,-0.0248,0.0392,0.0346,-0.0014,0.0298,0.0745,0.0226,0.112,0.0514,0.0686,-0.0019,-0.0109,0.0095,0.0085,-0.0297,-0.1336,-0.1419,0.0501,0.0598,0.075,0.0001,-0.0147,-0.1073,-0.0848,-0.1,-0.0946,-0.0106,-0.0038,-0.0242,-0.0231,0.033,-0.0294,0.0002,0.0032,-0.0093,-0.004,0.1076,-0.0781,0.0292,-0.0695,-0.0235,-0.0251,0.0218,-0.0345,0.0326,-0.0342,0.1139,0.0075,0.0677,-0.0518,0.0587,0.0238,0.0207,0.0352,0.0679,0.0734,0.0746,0.0717,-0.0818,-0.0847,-0.0813,-0.0171,-0.0641,-0.0483,-0.0771,-0.0786,-0.0532,-0.0354,-0.0763,0.0373,-0.0593,0.016,-0.0303,-0.0281,-0.0119,-0.0123,-0.1317,-0.0805,0.1149,-0.0252,-0.0639,-0.0177,0.0824,-0.0234,0.0466,-0.0078,0.03,0.1051,0.0717,-0.0722,-0.0851,-0.0266,-0.0058,0.0367,0.051,-0.0085,-0.0205,-0.0023,0.0528,0.0491,0.0668,-0.0139,0.0422,-0.0734,-0.0916,-0.0452,-0.159,-0.0439,-0.0694,-0.092,-0.1036,-0.0369,0.0325,-0.0097,-0.0124,-0.0162,-0.0627,0.1193,0.1261,0.0914,0.0726,0.0249,0.0743,-0.184,-0.1181,-0.1759,0.0601,0.057,0.0534,0.0154,0.0157,0.1789,0.119,0.1472,0.0222,-0.0281,0.0137,0.0198,0.0502,0.0202,-0.0043,0.0381,-0.0509,-0.0371,0.0324,0.0481,0.0141,-0.0161,-0.036,-0.0284,-0.0038,-0.0261,0.0885,-0.01,0.0584,0.0212,0.0226,0.0617,0.0641,0.0337,-0.0176,0.0198,0.0582,-0.0106,0.0419,0.0786,-0.0296,-0.0063,0.0302,0.0668,0.0635,0.0203,0.0225,0.0575,0.0576,0.0073,-0.0305,0.0601,0.0327,-0.0329,-0.0038,0.0247,0.0642,-0.0371,-0.0585,-0.0132,-0.0047,0.1205,0.0363,-0.0723,-0.0537,0.0464,0.0306,0.0913,0.0137,0.0525,0.0013,-0.0027,0.0899,-0.1177,-0.0476,0.026,0.0885,0.0329,0.0241,0.0476,0.0324,-0.0297,-0.0492,0.0422,0.1596,0.0409,0.0013,-0.0261,-0.0333,-0.1213,-0.0746,-0.0941,-0.0546,-0.0441,-0.0292,-0.0243,0.001,0.0582,0.077,0.0272,-0.0636,-0.0447,-0.0769,-0.0206,-0.0453,-0.0014,-0.0518,-0.0577,0.0938,0.1048,0.0265,0.0324,-0.0348,0.0384,-0.1249,-0.0682,-0.0653,-0.0441,0.0567,0.0542,-0.0036,-0.0288,-0.007,0.0496,-0.0676,-0.0285,-0.0079,0.0098,-0.1408,-0.0915,-0.0969,-0.0866,0.018,-0.0396,0.074,0.0917,-0.0984,-0.0896,-0.0992,0.0267,0.0453,-0.0177,-0.0115,-0.1692,-0.0983,-0.0444,-0.1244,0.129,-0.0118,-0.0851,0.0256,-0.0791,0.0807,0.0633,0.0474,0.0601,0.0513,0.1222,0.0284,0.0811,-0.0229,-0.0171,0.0273,-0.0366,-0.0439,0.0138,-0.0198,0.056,0.0205,-0.032,-0.0356,-0.0316,0.0624,0.0377,-0.034,0.0643,-0.0295,-0.0296,-0.0052,0.0419,0.0323,-0.0173,0.008,0.0085,-0.0064,-0.0889,-0.0297,-0.0135,-0.054,0.0085,-0.0687,-0.0169,0.0508,0.0144,0.012,0.0172,-0.0213,0.0161,-0.0455,-0.0465,-0.0393,-0.0377,-0.0007,-0.0014,0.0137,-0.0116,0.0169,-0.022,0.0644,0.0096,-0.0169,-0.0186,0.0737,-0.0418,-0.0625,0.0172,0.0364,0.0273,-0.0341,-0.0721,0.02,-0.0609,-0.019,0.0121,0.0505,0.1157,-0.0239,-0.0302,0.0318,-0.0455,-0.0119,0.1078,-0.0275,0.1064,-0.1106,0.1811,0.1681,0.0209,-0.0419,-0.0114,-0.0445,-0.0214,0.0483,0.0522,0.0611,-0.0119,-0.0138,0.0114,0.0589,0.0144,0.0125,-0.0495,-0.0537,-0.057,0.0338,-0.0224,-0.1356,-0.0203,-0.047,0.0154,0.0128,0.013,-0.0001,0.1238,0.0002,-0.0543,0.216,0.0965,0.0347,-0.0126,0.0777,0.1012,0.1145,0.0361,0.0121,0.0144,-0.0204,0.0584,0.0582,-0.034,0.0668,0.0183,0.0066,-0.0271,0.1011,0.0563,-0.0112,-0.0423,0.002,-0.138,-0.0634,-0.0716,-0.0832,-0.028,-0.1305,-0.0009,-0.0938,-0.0912,0.0184,-0.0639,-0.1167,-0.1135,-0.0334,-0.059,-0.083,-0.1063,-0.1113,-0.1045,-0.0127,-0.0489,0.0157,0.026,-0.0074,-0.0089,-0.067,0.0527,-0.0294,0.0437,-0.0514,-0.0246,0.0049,0.0512,-0.0574,-0.0183,-0.1685,-0.1637,0.01,-0.0085,-0.0743,-0.0978,0.0239,-0.0634,-0.0573,-0.1207,-0.0222,-0.0315,0.0867,0.0308,0.0493,-0.0677,0.0597,-0.0092,0.0943,0.0649,0.1508,-0.0512,0.0626,-0.1516,0.0422,0.0158,-0.0114,-0.0049,0.0042,0.0641,0.0706,0.051,0.026,0.0686,-0.0773,-0.0433,0.0494,0.0396,-0.0067,0.0166,-0.003,0.0381,0.0611,0.0522,-0.1019,-0.0436,0.053,0.0628,0.0276,0.1114,0.042,0.0266,0.0039,-0.0434,0.0232,-0.0575,-0.0473,-0.0242,-0.0397,0.0191,0.0098,0.0597,-0.0116,0.0904,-0.0397,0.0747,-0.0442,0.0029,0.0047,-0.0035,-0.0336,0.0163,0.0053,0.0145,0.0044,-0.0475,0.0013,-0.0186,-0.0366,-0.0262,-0.0138,0.0224,-0.0354,0.0046,-0.0534,0.0086,-0.0039,0.0265,0.0475,0.0015,-0.0015,-0.0137,-0.0441,0.0404,-0.0289,0.0186,-0.0021,-0.0743,0.0679,0.0133,0.0675,-0.0766,0.0044,-0.1199,-0.0264,0.0752,-0.01,0.049,0.059,-0.0628,-0.0604,0.0169,-0.0077,-0.0008,-0.0033,0.0552,0.1625,-0.064,0.0022,-0.0132,-0.0133,0.0007,-0.0343,-0.0318,-0.0428,0.0304,0.0052,-0.0174,0.0149,-0.038,-0.0708,0.0347,0.0717,0.0546,-0.0007,0.0245,-0.0382,-0.045,-0.0217,0.0619,-0.0558,0.0226,-0.0886,0.179,-0.007,0.0283,-0.0174,-0.0141,-0.0831,-0.0714,-0.0653,-0.0071,-0.0603,0.0701,-0.0777,0.1674,-0.0288,0.0009,0.1623,0.032,0.0192,-0.0361,-0.0177,0.0413,0.0462,-0.0264,-0.0267,0.0524,0.1292,0.0386,0.0208,0.0797,0.0499,0.0253,0.0901,0.1179,0.1076,0.0663,0.0638,0.0637,0.0573,0.0629,-0.0121,0.1421,0.0096,0.1479,0.1682,0.0692,-0.0575,-0.0823,-0.0646,-0.0707,-0.1122,-0.022,-0.0665,-0.0012,0.1259,0.0967,-0.0781,-0.0684,-0.0591,0.0155,-0.0725,-0.0374,0.0387,-0.0425,-0.034,-0.0003,-0.0136,-0.0081,0.0204,0.0337,0.0362,0.0327,-0.0043,0.0078,0.0282,0.0028,0.0352,-0.0099,-0.0051,-0.0882,0.024,-0.0239,-0.0243,-0.1016,-0.0271,-0.1029,-0.0284,-0.1314,-0.0482,0.06,0.0619,-0.0743,-0.0456,-0.0389,-0.0497,-0.0447,-0.0426,0.0045,0.0438,-0.0061,-0.0139,0.059,-0.0606,-0.0576,0.0621,visual object detection
trm_5534111a8bc96,-0.0647,-0.0829,-0.0769,-0.1359,-0.0001,-0.01,-0.0376,-0.0686,-0.0443,-0.0633,0.004,0.0298,-0.0818,-0.0638,-0.0767,-0.0356,-0.0436,-0.0953,-0.0686,0.0154,-0.0064,0.0335,0.0426,0.0221,0.0106,0.0418,0.042,-0.1161,-0.1016,-0.0216,-0.0591,-0.0613,-0.0839,-0.0413,-0.1169,-0.0904,0.0133,-0.0561,-0.1006,-0.0211,-0.0618,-0.1077,-0.046,0.0994,-0.0701,-0.0815,0.2878,-0.0406,0.0464,-0.0859,-0.0275,-0.0163,0.0097,-0.0091,-0.1006,-0.0526,-0.0602,0.0137,0.0461,0.0099,0.0601,0.0529,-0.1403,0.0393,-0.0312,0.0583,-0.1659,-0.1385,-0.0632,0.0471,0.0705,0.0477,0.0522,-0.0232,-0.1126,0.0037,-0.0948,0.0968,-0.0125,0.0199,0.0213,0.0896,-0.0843,-0.0843,0.0054,0.0649,-0.0371,0.0022,0.0047,-0.1117,-0.0705,-0.0638,-0.0217,0.1003,0.1476,0.1079,0.1376,0.0313,0.1727,0.0016,0.0858,-0.0201,0.0503,0.0365,0.0779,-0.0737,-0.1381,0.1587,-0.0292,-0.0476,0.0196,-0.0596,0.084,0.1238,-0.0138,0.0022,-0.0597,0.0503,-0.0034,-0.025,-0.0576,-0.1487,-0.0849,-0.0228,-0.123,-0.0826,-0.0783,0.069,0.085,0.0467,-0.004,-0.0415,-0.0004,-0.1323,0.0036,-0.1577,-0.0164,-0.0595,-0.0429,0.0034,-0.0695,-0.082,-0.0142,-0.0224,-0.0605,0.0255,-0.041,0.0345,-0.0619,0.0577,-0.0692,-0.0531,-0.1223,-0.0975,0.1585,-0.0181,0.0568,0.0293,0.0077,-0.0553,-0.0642,-0.0168,-0.1349,-0.1208,0.0233,-0.0285,0.0249,-0.1275,-0.1217,-0.0306,0.0165,-0.0861,0.0762,-0.0792,-0.0596,-0.1153,-0.0673,-0.0595,-0.0478,-0.0549,-0.1229,0.1023,-0.0409,-0.0187,-0.0431,0.0097,-0.0321,-0.0149,0.003,-0.1375,-0.1436,0.0061,0.0042,-0.0717,-0.0576,-0.1785,-0.145,-0.02,-0.0267,-0.0801,-0.0115,0.1789,-0.1617,-0.1157,-0.0402,-0.0483,-0.0782,-0.0393,-0.0406,0.0106,-0.0596,0.0198,-0.0306,0.0386,0.044,0.0179,0.1314,-0.1245,-0.1049,0.0272,0.1413,-0.0666,-0.0912,-0.0702,0.0428,0.0672,-0.1134,0.1202,0.0178,0.0803,-0.058,-0.0893,0.2165,-0.0792,-0.0724,0.0384,-0.0089,-0.0141,0.0239,-0.0814,0.0511,-0.1328,-0.0569,-0.0559,-0.0699,-0.0849,-0.0622,-0.1531,-0.059,-0.0714,0.0098,0.043,-0.0689,0.0224,0.0211,-0.1227,-0.044,-0.124,0.1467,0.287,0.0712,0.3017,-0.0659,0.108,0.2106,0.3101,0.1063,0.0113,0.068,-0.0485,-0.0522,-0.0163,-0.0942,0.0418,-0.0278,0.1359,-0.0367,-0.0296,-0.0446,0.0391,0.0822,-0.0134,-0.0077,-0.1958,-0.1668,-0.078,0.0438,0.075,-0.0953,-0.106,-0.0768,-0.0205,-0.0145,-0.0223,-0.0492,0.0445,0.0082,0.0052,-0.0338,0.0492,0.0187,-0.0833,-0.1033,-0.031,-0.0304,-0.0279,-0.0817,-0.0559,-0.0083,-0.0298,-0.0094,-0.0208,-0.1357,0.0494,0.0615,-0.042,0.08,0.0114,0.0404,-0.1395,-0.0297,0.0377,-0.1282,-0.1777,-0.0462,-0.0868,0.0067,-0.0011,-0.0634,-0.0842,-0.0081,-0.0542,0.046,0.0321,0.0557,0.1439,-0.0373,-0.0108,0.0355,-0.0957,-0.0812,0.1099,0.0243,-0.0131,0.0875,0.0616,-0.12,-0.1157,-0.0743,-0.0423,-0.0407,0.1547,-0.0194,-0.0118,-0.0136,-0.034,-0.0516,-0.1248,-0.0412,-0.0697,-0.0168,-0.047,-0.1033,-0.0386,-0.038,0.0546,-0.1131,0.0979,0.056,-0.059,0.0032,0.0531,-0.0194,0.0982,-0.1121,-0.0649,-0.1032,0.0663,0.1458,0.1161,0.1666,-0.0016,-0.0822,0.0078,-0.0255,0.0286,-0.1166,-0.0281,0.0493,-0.0394,-0.0117,-0.0373,-0.0542,-0.014,0.0463,0.005,-0.0442,-0.0814,-0.0684,-0.0771,-0.0597,0.0424,0.001,0.0014,0.0868,0.0441,0.0463,0.0782,-0.0302,-0.0174,0.0074,-0.1196,-0.0418,0.1696,-0.0591,-0.0294,0.131,-0.073,-0.094,-0.055,0.0045,-0.1899,-0.1041,-0.2688,-0.2357,-0.0815,-0.1042,-0.0506,-0.0966,-0.1336,-0.0269,-0.0055,-0.0423,-0.0687,0.032,0.0835,-0.0396,0.0444,-0.1688,-0.1321,0.0636,0.0588,0.0045,0.0202,0.055,-0.0346,0.0342,0.1368,-0.1402,-0.1449,-0.0613,0.0618,-0.0789,-0.0776,-0.0496,-0.1092,-0.0183,-0.0877,-0.087,-0.0134,0.0284,-0.0404,-0.0372,0.0548,-0.056,-0.1096,-0.0279,0.2856,-0.0605,-0.016,0.0385,0.0809,-0.0099,-0.0577,-0.0499,-0.0373,-0.0036,0.0129,-0.0255,-0.0369,0.0545,0.0159,-0.0405,-0.0016,0.0139,0.0861,-0.0364,-0.0057,-0.0411,-0.0207,0.1206,0.004,-0.1179,-0.1603,0.066,0.0829,-0.1923,-0.0281,0.0417,-0.0802,-0.0689,0.0173,-0.0043,-0.1264,-0.0651,-0.1225,-0.0697,-0.0422,-0.0341,0.1025,-0.1392,0.0062,-0.1238,0.0262,0.1301,0.0068,-0.0503,-0.0324,0.0838,-0.0377,-0.062,-0.0258,0.0993,0.0453,0.0652,0.0564,0.1058,0.165,0.0648,0.0347,-0.109,-0.0535,-0.089,-0.214,-0.0131,0.0146,-0.1074,-0.1349,-0.0679,-0.0943,0.0249,0.0479,0.0038,-0.0246,-0.0705,-0.0211,-0.0381,0.0362,0.0014,0.0248,0.0679,-0.0556,-0.1117,-0.0312,-0.0028,-0.0998,0.0823,0.0413,0.0567,-0.0183,-0.0658,-0.0291,-0.1058,0.0545,-0.0647,0.0613,0.1194,-0.0797,-0.0179,-0.0902,-0.0913,-0.0499,-0.0774,0.0488,0.0104,-0.0313,0.0571,-0.0072,0.0648,0.0292,-0.001,-0.0752,-0.0159,-0.0223,0.0505,0.0028,-0.0019,0.0071,0.0328,-0.0224,-0.0883,-0.0546,0.0392,0.0333,-0.0535,-0.0514,-0.1261,-0.0244,0.0702,-0.0346,0.0497,0.0698,0.0841,0.0949,0.0785,-0.0106,-0.0294,-0.0611,-0.059,-0.0226,-0.1496,-0.0579,0.0377,-0.0643,-0.1683,-0.0355,-0.0397,0.0113,0.0596,-0.1842,-0.0725,-0.1613,0.0356,0.0279,-0.0096,0.0268,-0.081,-0.0675,-0.0818,0.0064,0.0647,0.0152,-0.068,-0.0122,-0.0983,0.0228,0.0112,-0.0353,-0.026,-0.0842,-0.0372,0.0943,0.0042,-0.1037,-0.1129,-0.0117,-0.2107,-0.098,0.0535,-0.1769,-0.0703,-0.1779,0.1613,-0.1199,-0.0387,-0.0682,-0.0115,-0.0663,-0.0398,-0.0987,-0.1405,0.0419,0.1819,-0.1035,0.0482,0.0575,-0.084,-0.0381,-0.0098,-0.0684,-0.0557,-0.0599,-0.0531,-0.0266,-0.044,-0.0877,0.1912,-0.0519,0.059,-0.0536,-0.0065,0.0769,0.0565,0.0765,0.197,-0.1414,-0.0513,0.044,0.0096,-0.0014,0.0363,0.1376,0.0735,0.1271,0.1528,-0.0655,0.0201,0.0081,-0.038,-0.0157,-0.0422,-0.0415,-0.0263,-0.0952,-0.0486,-0.0842,-0.1082,-0.0847,-0.0572,0.0089,0.1172,-0.0831,-0.071,-0.0349,-0.0539,-0.0113,-0.0424,0.0204,-0.0479,0.033,0.0751,-0.04,-0.2706,-0.2617,-0.1906,-0.022,-0.0413,-0.071,0.0299,-0.0422,0.1231,-0.039,-0.0023,0.0395,0.0412,0.0461,-0.0567,0.0474,0.0877,0.0552,-0.0768,-0.0184,-0.1085,0.0074,0.0136,-0.0535,0.0504,0.0348,0.0004,-0.0337,-0.0031,0.1043,-0.1257,-0.1581,-0.1463,-0.1032,0.0891,0.2382,0.004,-0.1056,-0.0803,0.0474,0.0352,0.091,0.0299,0.0161,-0.0843,-0.07,-0.0091,0.0988,0.1502,0.1303,0.0111,0.0085,-0.0018,-0.041,0.0471,-0.0298,-0.0473,-0.0425,-0.1105,-0.0647,-0.0647,0.091,0.0587,0.0088,-0.0307,0.0007,0.0049,0.0947,0.0008,-0.119,0.0929,-0.0179,0.0225,0.0234,0.0521,-0.097,0.0307,-0.0686,-0.0677,0.0996,0.1375,0.2351,-0.0012,0.0262,0.0093,0.0083,0.0094,0.2879,0.0633,0.0295,0.0728,0.1377,0.0874,-0.0085,0.2153,0.1809,-0.0808,-0.0153,0.0326,-0.1528,-0.1262,-0.036,-0.0613,0.0944,-0.1462,-0.0483,-0.1031,-0.028,-0.1051,0.1445,0.0756,0.1394,-0.0618,-0.0348,-0.03,0.0218,0.0548,0.0054,0.0281,0.1136,0.0391,-0.0244,-0.0082,-0.0072,0.093,0.1605,-0.0775,0.0884,0.0141,0.0194,-0.0451,-0.0836,-0.0418,0.0744,-0.0995,-0.2476,-0.1747,-0.0152,0.0534,0.0514,-0.0597,-0.0359,-0.0133,-0.0311,-0.0564,-0.076,0.0356,-0.0765,0.0441,-0.149,0.0055,-0.0509,0.0768,-0.0534,-0.0458,-0.0309,-0.2377,-0.2111,-0.0484,0.2601,-0.0678,-0.0624,-0.0732,0.0897,0.0507,-0.0732,-0.0308,-0.0635,-0.0342,-0.0176,0.0766,0.0235,0.0138,0.127,-0.1544,-0.0641,-0.0033,0.0181,-0.0808,0.0341,0.2045,0.0678,0.0964,0.3515,0.133,-0.0372,-0.0422,-0.0974,-0.0686,-0.0115,-0.0236,0.0018,0.1106,0.0838,0.0292,-0.0391,0.0837,0.1384,0.0216,-0.0408,-0.0386,-0.034,-0.1076,-0.0361,-0.0336,0.0564,0.03,-0.0432,-0.0113,0.1091,0.0324,-0.0931,-0.0217,0.0377,-0.0091,0.0042,-0.0156,-0.0536,-0.0498,-0.1447,-0.1498,-0.1201,0.0568,0.0046,-0.016,-0.1181,-0.0234,-0.1043,-0.0172,-0.1203,-0.0418,-0.0593,-0.0063,0.0758,0.0793,-0.0416,0.0542,-0.0076,0.0337,0.084,0.1091,0.1209,0.0432,-0.0567,-0.0184,0.0293,-0.0816,0.0113,0.0637,0.1047,-0.0121,-0.0342,0.0425,0.1709,-0.023,-0.0414,0.0072,0.1123,0.007,0.1483,-0.1289,-0.0408,-0.0746,-0.1256,-0.091,0.0509,0.027,0.0112,0.0615,0.1782,0.1714,-0.0175,-0.0033,0.0136,-0.045,0.0365,0.005,-0.0003,-0.0618,-0.0996,-0.0321,0.0723,0.0585,-0.0963,-0.1142,-0.0584,-0.1979,-0.1146,0.1122,0.0952,0.0607,0.0969,0.0955,-0.0765,-0.0386,0.0575,-0.0051,-0.0211,-0.0291,-0.0087,-0.0217,0.0175,-0.0173,0.0278,-0.1122,0.017,-0.0809,0.0131,-0.1011,0.0167,0.0661,0.089,-0.0799,-0.0373,-0.0178,-0.0575,0.0058,-0.043,-0.0597,-0.0545,0.0062,-0.0244,0.0306,-0.0741,-0.032,0.0101,0.0418,-0.0008,-0.0474,-0.0643,-0.1086,-0.1338,-0.0946,0.1003,0.007,0.0619,-0.1455,0.2126,0.0852,-0.0211,0.0062,0.0271,0.0025,-0.0406,0.1221,-0.0779,-0.1308,-0.0405,-0.0372,-0.0796,0.0011,-0.0606,0.0893,0.0671,-0.0723,-0.0061,-0.0547,0.0173,-0.0582,0.0066,0.0198,0.0003,-0.0937,-0.0392,-0.0297,0.0948,-0.0157,-0.0166,0.4504,0.3105,0.3109,0.1636,0.1906,0.1157,0.3024,0.1833,-0.0657,0.258,0.231,0.1903,0.1709,0.223,0.0848,0.1242,0.0602,-0.0333,0.0348,-0.0211,0.0542,0.0111,-0.0543,0.0646,0.09,0.0093,0.1162,-0.029,-0.1173,0.0704,-0.0035,-0.063,-0.0226,0.0117,0.0683,0.0712,0.1818,-0.0293,-0.1185,-0.0236,0.0423,0.0453,0.1845,0.1144,-0.0247,-0.0429,-0.1403,-0.0726,-0.0441,0.2285,-0.0293,0.2843,0.2432,-0.0807,0.0321,-0.0294,0.0042,0.0305,-0.0037,0.2158,0.1031,-0.0467,-0.0068,0.0049,-0.0051,-0.1185,-0.0107,-0.0455,0.0463,0.0039,-0.0875,-0.0138,-0.0975,-0.0522,0.013,0.0206,-0.1649,-0.0174,0.1187,-0.0048,0.023,-0.0552,0.1009,0.0989,0.0422,-0.0708,-0.0709,-0.0752,-0.1009,-0.0394,-0.0922,-0.0076,-0.0705,-0.0639,0.0031,0.0312,0.0663,0.1926,-0.0671,-0.1066,-0.0644,0.0624,-0.0329,0.0666,-0.1136,0.0763,0.1902,0.0287,-0.1611,0.1431,0.1428,-0.081,-0.117,0.0134,-0.1644,-0.0658,-0.2315,-0.0167,0.087,-0.0876,-0.0899,0.0301,-0.0611,-0.0197,-0.0484,-0.0738,-0.0815,-0.0704,-0.0888,0.0704,-0.0182,0.3198,0.2302,0.2363,0.2705,-0.0879,0.0038,-0.079,-0.077,-0.0871,0.0133,-0.0309,0.2345,-0.0675,-0.0285,0.0622,0.0694,-0.0141,0.0571,0.0311,-0.0187,0.0053,0.0096,-0.044,-0.0508,-0.0996,0.1171,0.0171,0.0167,-0.0411,-0.0411,-0.1018,0.0403,-0.0265,0.0095,-0.0672,0.0661,-0.0616,0.1888,-0.1652,-0.1591,0.0264,-0.0269,-0.1169,-0.1245,-0.1269,-0.0306,-0.0505,-0.0503,0.0203,-0.0241,0.1441,-0.0099,0.0394,-0.0618,0.0739,-0.0236,-0.0194,0.005,-0.0281,-0.0521,-0.0383,-0.098,-0.0311,-0.0382,0.0183,0.0549,0.0178,0.0281,-0.0041,0.0186,0.0141,0.1279,-0.0122,0.0471,0.0102,-0.0938,0.0564,-0.1304,-0.1962,-0.0107,-0.0443,-0.1349,-0.0354,-0.077,-0.122,0.0103,-0.0391,0.0467,-0.1618,0.0004,-0.0403,-0.1117,0.0348,0.0356,-0.0207,0.325,0.1025,0.065,0.0503,-0.0031,0.0514,-0.039,-0.0487,-0.0431,0.0367,-0.0485,0.0211,-0.0213,0.0143,0.05,0.0225,0.0079,-0.0603,-0.0591,-0.0136,-0.0327,0.0171,-0.0465,-0.003,0.0773,-0.0159,-0.0918,-0.0516,-0.1071,-0.0609,-0.0179,-0.0925,-0.1162,0.017,0.0251,0.129,0.1119,-0.0259,-0.0684,-0.0672,0.0249,-0.0671,-0.009,-0.0288,-0.0201,-0.0796,-0.1644,-0.0068,0.1301,0.0818,-0.0099,0.0593,-0.0054,0.1951,-0.0264,0.0118,-0.0006,-0.1452,0.1451,-0.0061,0.1364,0.0502,0.1876,0.0317,-0.0987,-0.0648,0.1462,-0.0438,0.0617,-0.0712,-0.0335,-0.1135,-0.0651,-0.0363,0.0797,-0.0684,0.0097,-0.1171,-0.0162,0.0144,-0.0177,-0.0178,-0.1161,-0.0008,0.0098,-0.0388,0.0431,-0.0038,-0.0316,-0.0242,-0.0633,-0.0569,-0.0657,-0.0671,-0.0485,0.0153,0.0047,0.0925,-0.0599,-0.0269,-0.0111,0.0177,-0.0037,-0.09,-0.1911,0.0849,-0.078,-0.011,0.0128,0.0654,0.0813,0.0651,0.0536,-0.0604,-0.0589,-0.0672,-0.0033,-0.1477,0.0108,-0.0522,-0.0138,0.0552,-0.0205,-0.0773,-0.1381,-0.1087,0.0107,-0.0404,-0.0366,0.2739,-0.0232,-0.0177,0.0218,0.1473,-0.0061,-0.0405,0.0749,0.1778,0.0003,0.0059,-0.0488,-0.0515,-0.0584,-0.0442,0.028,-0.0031,-0.0519,0.1315,0.1732,-0.0542,-0.0865,-0.039,-0.0142,0.0398,0.0365,-0.1348,-0.0472,0.0038,-0.1183,-0.1142,0.0656,0.1333,0.0522,-0.0388,0.0377,0.0124,-0.125,-0.027,-0.057,-0.0615,-0.1087,-0.0635,-0.0624,-0.0881,-0.1121,0.1497,-0.0178,-0.0147,-0.0089,0.0249,0.1489,0.1433,-0.0421,0.0742,-0.019,-0.0762,-0.0405,-0.0224,0.0649,-0.0034,-0.0045,0.1163,0.067,0.0618,-0.0358,-0.0627,-0.0382,0.3379,0.3328,-0.1357,-0.1202,0.0307,-0.0453,-0.0181,-0.0553,-0.1225,0.0237,-0.0559,-0.0377,-0.0022,-0.037,0.1181,-0.0873,0.0717,0.073,-0.0939,0.0282,0.324,-0.0608,-0.0493,0.2608,0.0432,0.0276,0.0457,0.0242,-0.0559,0.0714,0.002,-0.0425,-0.018,-0.0436,0.0266,-0.0065,0.0416,-0.115,-0.0473,-0.0487,0.1085,-0.1111,0.0344,0.0881,-0.0748,-0.0794,0.0389,0.0055,-0.0785,0.0118,0.0695,-0.0243,-0.0922,-0.1597,-0.0343,0.0155,-0.0218,-0.0333,0.0377,0.0692,0.0514,0.1492,0.118,0.159,0.0386,0.1023,-0.0242,-0.0107,0.4504,-0.0801,-0.1487,-0.063,-0.1114,0.0134,0.0439,0.0168,-0.0154,0.0514,0.0283,-0.038,0.0037,-0.0002,-0.0325,-0.005,-0.0118,0.0246,0.0666,0.0934,0.148,0.2003,-0.0224,-0.0665,-0.0607,-0.0119,-0.0571,-0.0288,-0.0159,0.0884,0.0635,-0.011,0.05,-0.0809,-0.1237,-0.0851,0.0761,0.0842,0.0173,0.0858,0.034,0.2255,0.1638,-0.0903,-0.0161,-0.0988,-0.0122,0.0257,0.0364,-0.0832,-0.1192,-0.1389,0.0424,-0.014,0.0067,0.0962,-0.0468,-0.0424,0.0578,0.0509,0.0225,0.1058,0.016,0.0758,0.0693,0.053,0.1337,0.2003,0.2174,-0.0119,0.0412,0.0148,0.0246,-0.0623,-0.0262,-0.1332,-0.0734,-0.0165,-0.0924,0.0482,0.0879,-0.0763,-0.0869,-0.0293,0.0441,0.0487,-0.0272,0.0221,-0.0081,-0.0251,-0.0292,-0.092,-0.0222,0.1638,0.0085,0.0619,-0.1501,-0.0838,-0.1156,0.0018,-0.0085,-0.0933,-0.0444,-0.031,-0.1091,-0.0448,0.0855,-0.0185,0.1087,0.0707,0.0034,0.0271,0.0087,0.0251,0.0168,-0.0362,-0.1535,0.0249,-0.1023,-0.0406,-0.0236,0.0349,0.0374,0.2543,0.1425,0.0478,0.0353,-0.0666,-0.1649,-0.0929,-0.1205,-0.0887,0.0741,-0.0313,0.0583,-0.0805,-0.1129,-0.1397,-0.0746,-0.0899,0.013,-0.0103,-0.0055,-0.0074,0.0027,-0.0988,-0.0823,-0.0181,0.0916,0.0048,0.0293,-0.2458,-0.1067,-0.1549,-0.107,-0.3095,0.0523,-0.0141,-0.0318,-0.0245,-0.0513,-0.0553,0.0329,-0.1301,0.0035,-0.1279,-0.0136,0.0561,0.0468,0.0231,0.0295,-0.1668,-0.0281,-0.0103,0.0954,-0.0643,-0.0501,-0.1083,0.1178,-0.1781,-0.2067,-0.1569,-0.0416,-0.0282,-0.0964,-0.0448,-0.0478,-0.0515,-0.0591,-0.0087,-0.0185,-0.1428,0.039,-0.072,-0.0642,-0.0638,-0.0323,-0.0706,-0.0929,-0.0644,-0.0432,0.2251,-0.0268,-0.0924,-0.2,-0.1017,-0.0985,-0.0488,-0.2293,-0.1566,-0.0118,0.0961,0.1049,-0.0334,-0.0474,0.0192,0.1941,0.2022,0.1255,-0.2535,-0.2461,-0.0383,0.0549,-0.0316,-0.0836,0.0349,0.002,0.0488,-0.0447,-0.0798,-0.0639,0.0243,-0.0357,-0.0801,0.0182,-0.0916,-0.0382,0.003,-0.0329,0.1555,0.1789,-0.1009,-0.1053,-0.1731,-0.1298,-0.0716,-0.115,-0.0663,0.3925,-0.0773,-0.0816,-0.0143,-0.0065,-0.1044,-0.0425,-0.0384,-0.0111,0.0627,-0.0809,0.0686,-0.0149,-0.1271,-0.0154,-0.0207,0.093,0.3062,-0.2028,0.0249,0.0999,0.4103,-0.033,-0.0328,0.0013,0.0013,0.0095,0.0141,0.2028,-0.0097,0.0442,-0.0906,-0.0943,-0.1312,-0.0391,-0.0382,0.0183,0.1042,0.0885,0.0933,0.0486,0.0015,0.1434,0.1092,0.0792,-0.0083,0.013,0.0792,-0.1947,-0.0757,-0.1291,-0.0809,-0.0097,-0.1284,-0.0869,-0.054,0.0433,-0.0523,-0.1624,-0.0737,-0.0827,-0.115,-0.2472,0.0534,-0.1807,-0.0534,0.0228,-0.0889,0.0283,-0.0958,-0.0804,-0.0501,-0.0525,-0.0266,0.0355,-0.1318,0.1024,0.0766,0.1465,0.0023,-0.1269,0.0145,-0.062,0.0086,0.0736,-0.0173,-0.0248,0.0434,0.0018,-0.0141,-0.105,-0.1129,-0.0406,0.0234,0.0572,-0.0177,-0.0666,-0.0792,-0.0173,-0.0642,0.1233,-0.1528,-0.0217,-0.0036,-0.0919,-0.0938,0.0139,0.0647,-0.1386,0.0005,-0.0593,-0.0826,0.1103,0.1781,0.1856,-0.0151,0.4062,0.264,-0.1134,-0.0852,0.3898,0.1618,0.0269,0.1638,0.1649,0.109,-0.0847,-0.0812,-0.0545,-0.0956,0.5357,0.4526,0.3032,0.0984,0.2068,0.2303,0.4135,0.4052,0.3329,0.0297,0.0158,-0.0456,0.0737,-0.0441,0.0253,-0.1104,-0.0845,0.0149,-0.0342,-0.1269,-0.1047,0.099,-0.0132,-0.001,0.0005,0.0807,0.0685,0.1166,-0.0445,-0.0555,-0.0636,0.0192,0.0362,0.0082,-0.0343,-0.0637,-0.073,0.0175,-0.0926,-0.1481,-0.1324,0.0009,-0.0689,-0.0214,0.2575,0.0321,0.1681,0.099,0.0547,0.1415,0.0035,-0.153,-0.1682,-0.0473,0.0491,-0.0177,0.1129,0.075,0.105,0.0065,-0.0771,-0.0727,-0.047,-0.04,0.0145,-0.1452,-0.0924,0.0061,-0.0403,0.0338,-0.0411,-0.0163,0.0568,0.0088,0.0037,0.0481,-0.0331,-0.0799,-0.115,-0.0035,0.0438,-0.0603,-0.0553,-0.0562,0.074,0.1886,0.1513,0.0356,0.2022,-0.0665,0.0477,0.0514,0.0609,0.1568,0.1408,0.0918,0.0665,-0.0128,0.1477,0.1633,-0.0349,-0.0383,-0.098,-0.0555,-0.0881,0.0353,-0.0101,-0.0328,0.0136,0.0096,0.0744,0.0161,0.1503,-0.0345,0.161,0.1872,-0.1717,-0.1427,-0.0808,-0.1233,-0.1169,0.1823,0.0601,-0.0795,-0.06,0.1401,-0.0539,-0.205,-0.0298,0.0332,-0.0744,0.0504,0.0444,0.0513,0.1697,0.2853,0.3918,0.0875,0.0304,-0.0587,-0.0615,0.0284,-0.0572,-0.0863,-0.0387,0.0259,-0.0227,0.0555,-0.0576,-0.0559,-0.0882,-0.1898,-0.1523,-0.128,-0.0828,-0.0459,-0.0552,-0.1434,-0.0637,-0.0081,-0.0029,-0.0418,-0.0241,-0.0488,0.0291,0.0748,0.0375,-0.0093,0.1047,0.0607,-0.0299,0.0823,-0.0997,-0.0799,0.0632,-0.0018,-0.0094,-0.0144,0.0012,0.0478,0.0127,-0.0266,-0.0209,0.0118,-0.0091,0.0537,-0.0704,0.107,0.0067,0.089,-0.002,-0.1714,-0.0617,-0.0258,-0.0687,-0.0623,-0.0534,-0.0553,0.0056,0.0383,-0.0187,0.0584,-0.2051,-0.1027,-0.1242,-0.1645,-0.132,-0.092,-0.046,-0.046,-0.041,-0.0082,0.0707,-0.1701,-0.013,-0.0627,-0.0675,-0.0227,-0.009,-0.2998,0.0649,-0.0651,-0.017,-0.074,0.1846,0.047,-0.051,-0.098,-0.0943,0.0087,0.0463,-0.036,0.1526,0.0105,-0.0138,0.0615,0.0667,-0.0227,0.0284,-0.0454,-0.0581,-0.0216,-0.1203,-0.1238,-0.0198,-0.0628,-0.0303,-0.0293,-0.0299,0.0459,-0.0068,0.0156,0.0442,0.1342,-0.0509,0.1158,0.0205,-0.229,-0.071,-0.2627,-0.0388,-0.0714,-0.0146,-0.0653,0.0517,0.0575,-0.0329,0.0958,0.1326,0.011,0.1507,0.0418,0.2792,0.1041,-0.0176,0.0918,-0.0808,0.0608,0.019,0.059,0.0265,-0.055,0.0235,-0.0483,0.0091,-0.0768,-0.0466,-0.1198,-0.0469,-0.0587,-0.0297,-0.1019,0.3239,0.0169,0.0514,0.0578,-0.0276,0.0158,-0.0299,-0.0038,-0.1069,-0.0855,0.0967,0.0852,-0.0523,-0.0142,-0.0434,0.0236,0.0403,0.1256,-0.0116,-0.0084,0.0018,-0.0378,0.0766,-0.0785,-0.0211,-0.0279,-0.0246,-0.0075,-0.0307,-0.069,-0.0362,0.0225,0.0197,-0.0692,0.0762,-0.0169,0.0824,0.0299,0.0128,0.1044,0.0052,-0.0594,-0.0185,-0.0557,-0.0603,-0.0096,0.0709,-0.0295,-0.0646,-0.0161,0.0229,-0.021,-0.0901,-0.0898,-0.1472,-0.1089,0.1329,-0.0087,-0.0018,-0.0937,-0.0502,-0.0442,-0.0613,-0.0777,0.0457,0.0162,-0.0454,0.178,-0.0807,-0.0649,-0.0394,-0.0235,-0.0953,-0.0765,0.1317,0.0597,-0.1493,0.0772,0.0487,-0.047,0.1481,0.0925,0.0247,0.053,-0.003,-0.0892,-0.0431,-0.1296,-0.1104,-0.0329,-0.0889,0.0489,0.0577,0.11,0.1002,0.1068,-0.1059,-0.0672,-0.0551,0.0464,0.0937,0.0237,-0.0069,0.0041,-0.0225,-0.139,-0.059,-0.1463,-0.0565,-0.011,-0.0299,-0.062,-0.0881,0.1075,-0.0239,-0.0158,0.1862,0.0338,0.0063,-0.1541,0.0144,-0.0023,0.077,-0.1179,-0.0378,0.0018,-0.033,-0.1071,-0.0351,-0.0659,-0.0624,0.0125,-0.0739,-0.2128,-0.0142,-0.0469,-0.0446,-0.031,0.0019,-0.0253,0.0341,-0.0956,0.0837,-0.0793,-0.0345,-0.0768,-0.1113,-0.0122,-0.1377,-0.0916,-0.2009,-0.0885,-0.0913,0.0275,-0.1176,-0.0149,-0.0867,0.1146,0.041,0.0682,-0.1026,-0.1341,-0.0413,0.0223,0.0221,0.0733,-0.0853,-0.0176,-0.0811,0.046,0.0724,0.0296,0.1035,-0.0173,-0.0612,0.0228,-0.0305,-0.0359,0.019,-0.0641,-0.0708,-0.063,0.019,0.1173,-0.0094,0.0945,0.0898,-0.0578,0.0084,-0.0011,-0.1642,-0.0169,0.0017,0.0923,0.1199,0.0235,0.004,0.0146,-0.0184,0.1263,0.1449,0.0768,0.058,-0.1761,-0.0398,-0.0241,0.1337,-0.0201,0.0164,0.0511,-0.023,0.0236,0.0484,0.0617,-0.0398,0.0901,-0.0099,-0.0861,0.1071,0.0965,0.0504,-0.015,0.0635,0.1126,0.0355,0.0176,0.1258,-0.0028,0.0569,0.1423,0.1606,0.0406,0.0021,0.1156,-0.0215,-0.1218,-0.2925,-0.2873,0.016,0.1146,0.0404,0.0061,0.0111,-0.1071,-0.1174,-0.0712,-0.1023,0.0188,-0.0645,-0.0047,-0.0241,0.0544,-0.0132,-0.1078,-0.0119,-0.0779,-0.108,-0.0236,-0.081,0.0462,-0.1448,-0.0617,-0.0038,-0.0138,-0.0093,0.0849,-0.0121,-0.0854,-0.0493,0.2425,-0.0977,0.0807,0.0348,0.0189,0.0237,0.1348,-0.078,0.1827,0.1816,-0.0654,-0.0463,-0.0843,0.0477,-0.0647,-0.0916,-0.1009,-0.1563,-0.0483,0.0232,-0.0338,0.0674,-0.0214,-0.0161,-0.1366,-0.1417,0.1594,0.1269,-0.1354,-0.0615,-0.0194,-0.066,-0.1326,0.1708,0.1545,-0.0757,0.0368,0.1209,0.0342,-0.0915,-0.1033,-0.1414,-0.2125,-0.0547,-0.0447,0.0661,0.026,0.0488,0.0101,-0.0445,0.0632,0.3615,0.2614,0.075,0.2874,-0.2458,-0.2066,-0.1266,-0.1434,-0.0817,-0.0761,-0.1606,-0.063,-0.0586,-0.0802,-0.1165,-0.0309,0.2261,-0.0685,-0.0767,-0.0757,0.0955,0.1025,0.1722,-0.0646,-0.1969,-0.1248,-0.1749,0.0505,0.1066,0.0988,0.0509,-0.0061,0.0059,0.0678,0.0279,0.0179,-0.0204,-0.0716,-0.0059,-0.0324,0.0404,-0.0036,-0.0075,0.0288,0.0182,0.0628,0.0275,-0.0184,-0.0177,-0.1314,-0.1167,-0.0161,-0.1315,0.3624,0.0472,0.2271,0.0563,0.0451,0.0142,0.0376,0.111,0.0011,0.1416,0.2083,0.0356,0.0729,0.043,0.0426,-0.072,-0.0498,-0.0854,0.004,0.2547,0.1105,-0.0375,-0.0452,0.0412,-0.0126,0.0283,0.0879,-0.0705,-0.068,0.0033,-0.0983,0.0234,-0.0494,0.0451,0.0695,0.0874,0.0253,-0.0045,-0.07,0.0254,-0.016,0.0991,0.134,-0.0106,0.0684,-0.0504,0.1143,-0.1093,-0.0999,-0.0119,0.1707,0.0327,-0.04,-0.0912,-0.0354,-0.0617,-0.0865,0.0384,-0.0371,-0.055,0.0168,-0.0534,-0.0666,-0.1474,-0.1256,-0.1312,-0.0836,-0.0545,-0.0188,-0.0499,-0.0133,-0.099,-0.115,-0.0703,-0.042,0.0254,-0.0694,-0.0842,0.0942,0.1909,0.0336,-0.0854,0.3289,0.3298,0.1698,-0.0049,0.0977,0.014,-0.1089,-0.0263,-0.0385,0.0197,0.1391,0.2067,0.042,0.0167,0.0546,0.0575,-0.0892,-0.0544,-0.0213,-0.0124,-0.1009,-0.0535,-0.0386,-0.0943,0.0196,-0.0916,-0.104,0.1228,-0.05,-0.1782,-0.0147,0.0878,0.1203,-0.0584,-0.0897,-0.322,-0.2523,-0.1326,-0.23,0.2442,0.0109,-0.0366,0.0963,-0.0094,-0.0357,-0.0138,-0.0241,0.3011,0.1311,0.3078,0.1857,0.1053,-0.0358,-0.0293,0.0369,-0.0069,0.0037,-0.0004,-0.0359,0.2633,0.1697,-0.1308,-0.1645,-0.0398,-0.061,-0.0954,-0.0401,-0.1229,0.0604,0.0562,0.0127,0.0509,0.0445,-0.0901,0.0354,-0.0428,0.0151,-0.1105,-0.1234,-0.0022,0.0601,-0.0407,-0.0588,-0.0502,-0.0948,-0.052,-0.1075,-0.0842,-0.0758,-0.0514,-0.0314,-0.0396,-0.0303,-0.0703,0.0396,0.0008,-0.0012,-0.05,-0.0299,-0.1012,0.0331,0.1032,0.0151,-0.0576,0.1287,-0.0838,-0.0859,0.0928,0.0921,0.0692,0.0288,-0.0192,-0.0456,-0.0784,-0.0189,0.1616,0.2689,0.3152,-0.0007,0.0797,-0.0093,0.0732,-0.0557,0.1349,-0.0536,0.208,-0.0209,-0.0196,-0.0449,0.0411,-0.0537,-0.023,-0.0018,0.0411,-0.0565,-0.0442,0.103,0.0571,0.004,-0.08,0.0907,0.0885,0.0749,-0.1115,-0.1043,-0.0991,-0.0222,-0.0703,-0.1768,0.0271,-0.0148,-0.0116,-0.0371,-0.0608,-0.0411,0.0923,0.0068,-0.1139,-0.0381,0.2539,0.0345,-0.0734,0.1794,0.1088,0.0474,0.0084,0.0949,-0.1049,-0.0146,0.2372,0.0745,-0.0654,0.1808,0.061,0.0266,0.0399,0.1246,0.0391,-0.0599,-0.0953,-0.0708,-0.013,0.0915,-0.0657,0.0477,-0.0595,-0.0837,-0.0611,-0.1018,-0.0121,0.1835,-0.0601,-0.1365,0.0085,-0.0094,-0.0835,-0.0235,-0.078,-0.1015,-0.1054,-0.0776,-0.0395,-0.0774,-0.0377,0.0708,0.1365,-0.0818,-0.03,-0.0184,0.0182,-0.0374,-0.0889,-0.0576,-0.0998,-0.0022,0.019,-0.1927,-0.2079,-0.0425,-0.0442,-0.0359,-0.1737,0.0087,-0.1198,-0.1128,-0.1743,-0.0166,-0.011,-0.0489,0.0293,0.0122,-0.0421,0.0868,-0.0746,0.0434,0.1357,0.0648,-0.1117,-0.0111,-0.1534,-0.0558,-0.0247,-0.0017,-0.0136,0.042,0.0879,0.1022,-0.01,-0.0544,0.0894,-0.0621,-0.0299,0.1352,-0.0999,-0.02,-0.0517,0.0416,0.0287,0.0847,-0.032,-0.1848,-0.1545,-0.049,-0.029,0.0251,0.1187,0.1558,0.0409,-0.0524,-0.054,-0.0174,-0.1083,-0.1913,-0.0559,-0.0874,0.0756,0.0066,0.0994,0.0133,0.1249,-0.0468,0.0278,0.0101,0.075,0.0794,0.062,-0.0166,0.0257,-0.0956,0.0029,-0.0558,-0.071,-0.0281,-0.0138,-0.0524,-0.0116,-0.0447,-0.053,-0.0405,-0.0289,-0.1191,-0.0274,0.0164,0.1047,0.0131,0.1263,0.042,0.0269,-0.0382,0.0427,-0.026,0.0009,-0.095,-0.0631,0.1721,0.0156,-0.012,-0.0688,-0.0547,-0.1058,-0.0554,-0.002,-0.0212,0.0255,0.103,-0.1769,-0.066,-0.0147,-0.0955,-0.061,-0.0185,0.437,0.3922,-0.1263,0.0738,-0.0428,0.0213,-0.0705,-0.125,-0.1477,-0.1256,0.0305,-0.045,-0.0777,0.0112,-0.0849,-0.0544,0.1111,0.0245,0.0138,0.0078,-0.0128,-0.0026,-0.0886,0.0032,0.1015,-0.1129,0.0398,-0.1529,0.1033,-0.1081,0.3317,0.0014,0.0287,-0.1864,-0.1746,-0.0945,0.0064,-0.0391,0.0328,-0.1173,0.0441,-0.024,0.0507,0.0376,0.1232,0.0948,0.1418,0.1137,0.2234,0.2711,-0.0755,0.1021,0.375,0.5707,0.2569,0.1788,0.4496,0.3001,0.2531,0.3676,0.1819,0.3144,0.2573,0.1898,0.3216,0.199,0.2768,0.1714,0.2736,0.1681,0.2877,0.1552,0.244,-0.1313,-0.1241,-0.1575,-0.0825,-0.0583,-0.1261,-0.1496,-0.0441,-0.0146,-0.0279,-0.1478,-0.1122,-0.085,-0.0033,-0.0039,-0.1097,0.1474,-0.0394,-0.1014,-0.0783,-0.1094,-0.0565,-0.0403,-0.0035,-0.048,0.0744,-0.0695,-0.09,0.072,-0.013,-0.032,0.0231,0.0259,-0.0745,0.0712,0.0517,-0.0666,0.0051,0.1721,-0.0745,0.0329,-0.0477,-0.075,0.104,0.1043,-0.0345,-0.0552,0.0465,-0.0064,0.029,-0.0833,-0.0509,0.1218,-0.0793,-0.0836,-0.017,-0.0179,-0.0373,-0.0369,punishment processing
trm_557b4b7176394,-0.0668,-0.0228,-0.0181,-0.0488,-0.0301,0.0099,-0.0164,-0.1222,-0.0982,-0.0403,0.018,0.0365,-0.0202,0.0385,0.019,-0.0251,0.0037,0.0795,-0.0476,0.1382,0.0285,0.02,0.0435,0.0493,0.0165,0.0041,0.0057,0.0524,0.0084,-0.0266,0.0655,0.0959,0.0551,-0.028,0.132,0.0678,-0.025,-0.0322,0.0069,0.0071,0.0138,-0.0225,0.0087,0.0354,0.0077,0.0831,0.0473,-0.0378,-0.0735,-0.0316,-0.0208,-0.1373,-0.0707,-0.1427,0.0059,0.0257,0.0007,0.0576,0.0004,0.0282,0.0054,-0.0106,0.0863,-0.0898,-0.0678,-0.1567,0.0799,0.1386,0.0393,0.0309,-0.0404,-0.0139,-0.0269,0.1314,-0.0828,0.0593,-0.0399,0.0157,-0.0205,0.0605,0.0724,-0.025,0.0457,0.1069,-0.0974,-0.0703,-0.0412,-0.0409,0.0422,-0.0102,0.0409,-0.1041,0.0456,-0.1952,-0.0594,-0.1141,-0.0831,-0.0915,-0.2904,-0.2173,-0.0323,0.0062,-0.1262,-0.2073,-0.0796,0.071,0.1327,-0.0112,-0.0469,-0.0578,-0.0028,0.0669,-0.061,-0.1118,-0.0115,0.0257,0.0245,-0.1033,0.014,-0.0053,0.1195,0.0905,0.1337,0.0359,0.03,0.1412,0.0571,-0.061,-0.0415,-0.0136,0.178,-0.0047,0.042,0.1861,0.0375,0.0872,-0.0706,0.0823,0.0422,-0.0169,0.0306,-0.0369,0.1077,0.0508,0.0095,-0.0799,-0.1096,-0.0101,0.0566,0.0141,0.0079,0.1087,0.0879,0.1239,-0.0536,-0.036,-0.0454,-0.0154,0.0363,0.0394,-0.0079,0.0699,0.1385,0.0868,0.0204,0.0201,0.0663,0.1566,0.1507,0.0543,0.0611,0.1182,-0.0697,0.308,0.1213,0.2231,0.1547,0.1595,0.1403,-0.0425,0.0903,0.0652,0.0573,-0.0786,-0.0211,0.0212,0.0559,0.2321,0.2104,0.0184,0.0204,0.0923,0.0442,0.082,0.0872,-0.025,-0.032,0.1373,0.0923,-0.1751,-0.1465,-0.2264,0.1529,0.055,-0.0917,0.0522,0.3063,-0.0317,-0.0168,0.004,0.1667,0.129,-0.0052,-0.0191,0.0677,0.0531,0.0436,-0.027,-0.152,0.0184,-0.0014,0.0782,0.1201,0.0181,-0.0899,0.0272,0.0276,-0.0385,0.0666,-0.1116,-0.068,0.1605,-0.0436,0.015,0.0019,-0.2058,0.0886,-0.0224,-0.03,0.0747,-0.0579,0.0776,-0.0408,-0.0411,-0.0036,0.0685,0.1341,0.0621,-0.0328,0.1717,-0.0005,0.0177,0.036,-0.0265,-0.0448,0.1264,-0.0672,-0.0606,0.0064,0.008,-0.0441,-0.1325,0.0245,-0.072,-0.1175,-0.1671,-0.0881,0.0534,0.0763,0.0745,-0.0115,-0.0576,0.144,0.0762,-0.0083,0.077,-0.067,0.0489,-0.0585,-0.0496,-0.0055,0.145,0.1157,0.2574,0.2392,0.0295,0.019,0.0561,-0.0336,0.0294,0.0711,0.0739,0.0049,0.1036,0.0161,-0.0305,0.1191,-0.1375,-0.0359,-0.1602,-0.077,0.1506,0.0055,0.0981,-0.2082,-0.2371,0.0088,-0.0122,-0.0244,0.0177,-0.0404,0.0078,-0.0216,-0.0137,-0.0219,-0.0602,-0.0886,-0.0311,-0.0096,0.0573,0.0118,-0.0036,0.106,0.1371,0.0298,0.0104,0.054,0.074,-0.0006,0.0505,-0.037,0.0178,0.0893,0.0542,0.0385,-0.1622,-0.0504,0.0562,0.1852,0.0931,0.0694,0.0815,-0.1324,-0.1175,0.0067,-0.0439,0.0469,0.0189,0.0097,0.0483,0.036,0.0001,-0.0772,-0.0479,0.0394,-0.0406,-0.0186,0.1102,-0.0171,0.0192,-0.0176,0.0299,-0.1506,-0.1051,-0.1183,-0.1193,-0.0345,-0.239,0.0347,0.0308,0.0258,-0.0884,0.016,-0.0999,0.1189,-0.0138,0.0587,-0.0102,0.1799,-0.0257,0.1326,-0.1941,-0.0398,-0.1077,-0.0031,-0.0265,0.0675,0.0011,-0.0518,-0.0135,-0.0881,0.0267,-0.0974,0.0695,-0.253,-0.3006,-0.1546,0.048,-0.0498,0.0149,0.0423,-0.0229,-0.0054,0.0212,-0.0244,-0.0644,0.0411,0.0023,0.0413,0.0065,-0.0611,0.116,0.0546,0.0119,0.1744,0.071,-0.0166,-0.0138,0.0216,-0.0527,-0.0313,0.0036,-0.022,0.0164,0.0396,-0.0865,0.0131,-0.0919,0.0259,-0.1242,0.0526,-0.0387,0.0374,-0.0433,0.1292,-0.0179,-0.0418,-0.0131,0.0764,0.0176,0.1047,-0.067,-0.0206,0.0141,0.0642,0.0056,-0.0218,-0.1211,0.1426,-0.1012,-0.1871,-0.0841,0.0262,-0.0175,-0.1243,0.1335,0.027,-0.0404,-0.0371,-0.0593,-0.0806,-0.0692,0.0682,0.0752,0.1122,0.0481,-0.0146,-0.0662,0.0596,-0.0135,-0.0548,-0.0201,-0.2058,0.0613,0.1642,-0.0283,-0.0853,-0.0683,0.0215,-0.0146,-0.1513,-0.1273,-0.1367,-0.1071,-0.0875,-0.062,-0.0112,-0.0249,0.1136,-0.0201,0.0781,-0.1696,0.07,0.0909,-0.026,0.1244,0.1453,-0.0611,0.012,0.0613,0.0565,0.0326,0.024,0.0109,-0.0331,0.0886,0.0801,0.1323,0.0172,-0.1042,0.0639,-0.0894,0.0592,-0.0073,0.0231,-0.0819,0.0725,0.0362,-0.168,0.0456,-0.033,-0.0041,0.0569,-0.2033,-0.0932,0.0246,-0.0779,-0.0804,-0.0289,-0.0462,-0.0067,-0.029,-0.0313,0.1121,0.1615,-0.0025,0.1265,-0.0151,0.0423,0.0983,0.0645,0.0193,-0.03,-0.0136,0.0477,0.0027,-0.0128,0.0163,0.0549,0.066,-0.0722,0.0507,-0.024,-0.1583,-0.0181,0.1382,-0.0622,-0.0377,0.0484,-0.0242,0.1248,0.0546,0.1336,-0.0305,0.0948,0.0439,0.0262,0.2432,0.0005,0.079,0.0886,0.1151,-0.0472,-0.011,-0.2245,-0.2151,-0.0142,-0.1044,-0.0562,-0.0163,-0.008,0.0539,0.0592,-0.0259,-0.1909,-0.0474,-0.3005,-0.0338,-0.1191,0.0339,0.0693,-0.1107,-0.1538,-0.1205,-0.1323,-0.1333,0.085,0.0525,-0.1349,0.0512,0.0595,-0.016,-0.0154,0.0253,-0.0458,-0.2507,0.0888,0.0409,0.0308,-0.1186,0.0409,-0.0321,-0.0334,0.0426,0.0941,0.0617,0.0272,-0.0256,0.066,0.1206,-0.0537,0.0518,-0.0314,0.0146,0.0466,-0.0796,-0.0597,0.124,-0.1151,-0.0754,-0.0793,-0.2324,0.0634,-0.0595,-0.1866,-0.1615,-0.0781,-0.0739,0.0693,-0.1127,-0.0397,-0.0895,-0.089,-0.1504,0.0362,-0.0099,0.1819,0.1702,-0.1459,0.1578,-0.1048,0.109,-0.1823,0.1597,0.064,-0.0565,-0.2299,-0.0531,0.0187,-0.0183,0.1972,-0.1817,-0.0716,-0.1677,-0.1277,-0.0981,-0.1359,0.1492,-0.1809,-0.1375,-0.0239,0.068,0.0192,-0.0052,-0.0128,0.0113,-0.1325,0.1043,0.0705,0.0189,-0.0047,-0.0181,0.0246,-0.0422,-0.0528,0.0541,0.0154,0.065,-0.0282,-0.0583,-0.137,-0.1096,-0.1592,0.0242,-0.0344,0.1313,-0.0008,0.0253,0.0009,-0.0836,-0.0665,-0.006,0.0235,0.1137,0.0839,-0.037,0.0662,0.0542,0.0477,-0.0392,0.0132,0.0316,0.0279,0.0353,0.0748,0.075,-0.0549,0.0646,0.1304,-0.0276,-0.0137,0.023,0.1985,0.1786,0.1702,-0.0025,-0.0054,0.0335,0.0005,-0.0517,0.0871,0.0523,-0.0446,-0.1018,-0.1116,0.0016,-0.0384,-0.0728,-0.1166,-0.2075,0.1813,0.0586,-0.0295,0.0217,0.0929,0.1104,-0.0221,-0.0117,0.0688,0.0016,0.0197,0.0371,0.1293,0.2319,0.2009,0.1479,0.0285,0.0548,0.0514,0.0157,0.1073,-0.1454,-0.0698,0.0569,-0.0839,-0.018,0.1038,0.023,-0.068,-0.066,-0.0413,-0.0155,-0.0363,-0.0377,-0.0613,0.0309,-0.0147,0.035,0.0984,0.0199,0.1245,0.1137,0.1183,-0.0357,0.0138,0.0007,0.0144,0.0081,-0.0338,-0.0523,-0.0564,0.0218,0.0796,0.0111,-0.0409,-0.0698,-0.0633,0.0858,-0.1264,0.0879,0.0775,-0.0901,0.0687,0.0055,0.0576,0.0925,0.0049,-0.0309,-0.0262,-0.0686,-0.0249,-0.1341,-0.0051,-0.018,0.0119,-0.0086,-0.074,-0.0535,-0.005,-0.0283,0.0011,0.0616,0.1204,-0.0684,0.0868,0.184,0.1622,0.0274,0.1403,0.0922,0.1755,0.0703,0.0391,0.1,0.0079,-0.0589,-0.033,-0.1686,-0.0831,0.0363,-0.0083,-0.0689,-0.0081,-0.0469,-0.0951,0.0082,-0.0742,-0.1058,0.0887,-0.1264,-0.048,0.02,0.0476,0.0424,0.0321,-0.0551,-0.2096,0.1998,0.1285,0.0182,-0.0138,-0.0769,-0.0504,-0.0277,-0.0634,-0.1693,-0.0375,0.0293,-0.2088,-0.0403,0.0193,0.1303,-0.2587,0.0438,-0.075,-0.2632,-0.0243,-0.2661,0.1808,0.2067,0.0554,-0.0744,-0.0039,0.0249,0.0528,-0.037,0.0141,0.0619,0.0743,0.0719,-0.0862,-0.0261,0.1014,-0.0567,0.11,-0.0084,0.0477,0.0803,0.0187,-0.0579,0.0557,-0.0925,0.108,-0.0456,-0.0528,0.0997,-0.0545,0.1249,0.0067,0.1275,0.0318,0.1002,0.0537,0.0035,-0.0622,-0.0573,0.0474,0.0485,-0.0605,-0.106,-0.1683,-0.0816,-0.0346,0.0287,-0.113,-0.0219,-0.0099,-0.0307,0.0254,0.1139,-0.0472,0.0533,0.0335,-0.0456,0.0321,0.0233,0.1162,0.0578,0.0371,0.0553,0.048,0.3108,0.1242,0.3327,0.1294,0.0857,0.138,0.094,0.1794,0.1685,0.2818,0.2731,0.0752,0.0978,-0.014,0.027,-0.0633,0.031,-0.0273,-0.0498,0.0595,-0.0264,0.0935,0.0519,0.0477,0.0153,-0.0769,-0.0767,-0.0059,0.0406,-0.0108,-0.0478,-0.0238,-0.0355,0.1325,0.0551,0.0821,0.0117,-0.045,0.0535,0.0157,0.0198,0.0736,0.0931,0.0622,0.1853,0.1593,-0.0703,-0.0753,-0.1196,-0.0046,0.0426,0.054,-0.1812,-0.1128,0.0031,-0.0692,-0.0783,0.0043,-0.0173,-0.0076,-0.0274,-0.0046,-0.0099,0.0126,0.016,-0.0046,0.0959,0.1194,0.1174,-0.1317,-0.0797,-0.167,0.0223,0.054,0.1326,0.1006,-0.0059,0.0181,0.0418,-0.0131,0.0271,0.022,-0.0524,-0.0195,-0.0194,0.0272,0.0262,0.0316,-0.0077,-0.0185,-0.116,-0.1719,-0.3551,-0.2173,-0.0708,-0.0668,-0.152,0.0404,0.0343,0.0525,0.0548,-0.0208,-0.0431,-0.0726,-0.0769,-0.058,-0.1199,0.0076,0.0839,-0.1027,0.1634,0.0811,0.1871,0.0542,-0.1078,-0.0147,-0.0177,0.1317,-0.0477,0.0184,-0.0159,0.0973,0.0618,0.0655,0.023,-0.0305,0.0556,0.0877,0.0804,-0.0103,0.1493,0.1278,0.1108,0.1647,0.249,0.0383,0.1067,0.0211,0.0299,-0.1008,0.0187,0.0121,-0.0908,0.009,-0.1388,0.1328,0.0498,0.0171,0.1201,0.0656,0.0159,-0.1657,-0.2177,-0.2147,-0.0457,-0.1475,0.0423,0.0873,0.3086,0.2287,0.2205,0.1432,0.3337,0.2674,0.1652,0.2261,0.1246,0.0812,0.0162,-0.0773,-0.0254,0.1001,-0.0418,-0.0176,0.0376,-0.0417,0.0006,0.0565,0.0982,0.0944,0.0891,-0.0294,0.0322,-0.0654,-0.0185,-0.1137,0.0185,0.1335,0.2447,0.2334,0.1713,0.0616,0.0816,-0.1523,0.0274,0.1815,0.168,0.0231,0.2186,-0.0499,-0.132,-0.1405,0.0884,0.0403,-0.1075,-0.3221,-0.3238,-0.2849,-0.0144,-0.0074,-0.0847,-0.1209,-0.0629,0.0384,0.1193,-0.1329,0.0654,-0.1539,0.0195,0.0014,-0.0686,0.0779,0.0574,-0.0158,0.1023,-0.099,-0.2072,0.074,0.1113,0.0074,0.0195,-0.0463,-0.059,-0.0984,0.0927,0.0811,0.1092,-0.0051,-0.0783,0.0312,0.0794,-0.0018,0.0317,-0.258,-0.151,-0.1811,-0.2452,-0.0645,-0.1045,-0.0018,-0.0818,-0.1678,-0.2103,0.0462,-0.2009,-0.2683,-0.1121,0.1261,-0.1946,-0.1697,0.0083,0.0983,-0.0095,0.0738,0.0533,0.1009,0.0441,-0.1793,-0.009,-0.0186,-0.097,-0.0102,0.0055,-0.0364,0.0287,-0.0114,0.0662,-0.176,-0.0295,0.0229,0.2486,0.2204,0.1066,0.2318,0.0953,-0.0067,0.0393,0.0669,0.0061,0.0693,-0.2366,0.0791,0.1492,0.1206,-0.0351,-0.0257,0.014,-0.0234,-0.0065,-0.0737,-0.0197,-0.2027,0.091,0.1147,-0.0394,0.0057,-0.0776,0.0453,-0.1113,-0.1113,0.1188,-0.0149,-0.0334,-0.0335,-0.0826,0.038,0.0169,-0.1852,0.1525,0.1533,-0.0248,0.0588,0.0986,0.1162,0.0381,-0.0468,0.0095,0.0862,0.0241,-0.0261,-0.2149,0.0491,0.0319,0.0182,0.0188,-0.0587,-0.0787,-0.0542,-0.0365,0.0661,-0.0298,0.0758,0.0851,0.092,-0.0471,-0.0209,0.1128,-0.2612,-0.1746,-0.2663,-0.0266,-0.1692,0.2357,0.1476,-0.0234,0.103,0.0149,0.0867,-0.0044,-0.0179,0.0887,0.0952,-0.1268,-0.0288,0.1092,0.0027,-0.1057,-0.0287,0.0305,0.0289,0.0199,-0.1227,0.1149,-0.1287,0.0313,0.0574,-0.1439,-0.2283,-0.1811,0.0107,-0.0511,0.0594,0.0344,0.0425,0.0133,0.0805,0.0446,0.1345,0.0353,0.0088,-0.0423,0.0566,0.1715,0.1125,-0.0798,-0.0352,-0.0724,-0.0218,0.1169,-0.0106,0.0981,0.0741,0.1951,0.2477,0.0737,0.057,0.1051,0.0917,0.0244,0.0314,0.1056,-0.0182,-0.084,0.0389,0.0263,-0.1003,0.1433,0.0202,-0.0225,-0.13,-0.0953,0.0938,0.0236,-0.0893,0.1736,0.028,0.0464,0.045,0.1097,-0.0804,-0.0866,-0.0999,0.1428,0.0361,-0.0292,0.0464,-0.2639,0.1447,-0.0357,-0.0817,-0.1115,-0.1092,0.0531,0.0329,0.1383,0.0312,0.0713,0.1316,0.0814,-0.1243,-0.0734,0.1047,0.1314,0.0347,0.1282,-0.0094,0.1456,0.0437,0.0279,0.0282,-0.0243,-0.0662,0.0416,-0.0346,0.0504,0.0515,0.0454,0.0265,0.0667,-0.0157,-0.0402,0.0443,-0.0751,0.0445,0.0121,0.005,-0.1128,-0.0746,0.0769,0.1164,-0.0419,-0.1381,-0.1992,0.0093,0.0741,0.0438,-0.0623,-0.0403,0.0018,0.0648,0.14,-0.0329,0.2087,-0.0086,-0.0135,0.0046,0.1147,0.0094,0.029,0.1078,0.1293,-0.2088,-0.1019,-0.0555,0.1743,-0.3364,0.0128,-0.1118,0.1126,0.0418,0.0101,0.1229,-0.0328,-0.0973,-0.0806,-0.1496,-0.1251,-0.0564,0.0883,0.0211,-0.1391,-0.1781,-0.1016,0.0009,0.0395,0.0663,0.0583,-0.1295,-0.105,0.0083,-0.0809,-0.1061,-0.1098,-0.1101,-0.1351,0.1021,-0.0546,0.0246,-0.0132,0.0327,0.0704,0.0387,0.0173,-0.0512,-0.0301,-0.0312,0.1112,0.0341,0.1355,-0.0589,-0.007,0.0655,0.061,0.1085,0.0205,0.0032,-0.2412,-0.0071,0.0455,-0.0928,-0.0279,0.0267,0.0955,-0.042,-0.0325,0.0547,-0.0756,-0.1578,-0.1191,0.039,0.0453,-0.1245,-0.2536,-0.2572,0.1419,0.0635,-0.1051,0.0071,-0.0081,0.0052,0.0669,-0.0118,0.029,0.0793,-0.0511,-0.0733,-0.2654,-0.0106,-0.2468,0.0321,-0.0677,-0.1895,-0.2264,-0.204,0.0427,-0.0332,-0.0082,-0.0658,0.0239,0.0175,0.0426,0.0141,0.0105,-0.1321,0.006,0.0847,0.0761,0.0907,0.0302,0.1056,0.0739,0.0728,-0.034,0.0946,0.0207,0.0712,0.1159,0.1379,0.0235,-0.0532,0.0331,0.0623,-0.0229,0.0081,-0.0125,0.0915,0.0328,-0.0289,0.0219,0.0777,-0.0004,0.1112,0.0283,0.0171,-0.1281,-0.0328,0.1067,-0.0264,-0.1334,-0.0569,0.1033,0.1214,0.0735,-0.1513,0.1861,-0.0857,-0.0296,-0.1377,0.0164,-0.0102,-0.0033,-0.0168,-0.035,-0.0684,0.0283,-0.0547,-0.0285,-0.0691,0.0416,-0.0313,-0.1127,-0.1052,0.0153,0.0133,0.0581,0.0194,-0.0334,0.0259,0.1803,0.0671,0.0773,-0.0737,-0.1134,-0.1456,0.1984,0.0823,0.0559,-0.0535,-0.0515,0.0059,-0.0403,0.0355,0.0102,-0.0051,0.058,0.0294,-0.0029,0.0106,-0.0684,0.0255,0.0537,0.0116,0.0403,0.0107,0.0141,-0.2828,0.1155,0.149,0.0854,-0.3079,-0.1607,-0.2141,0.126,0.0478,-0.0162,-0.0476,-0.1446,-0.0847,-0.0377,0.0064,0.0039,0.0705,-0.1468,0.0349,-0.1718,0.1542,0.0197,0.0531,0.0744,0.0233,0.0771,-0.1206,-0.1664,0.0663,-0.1371,-0.1268,-0.1342,0.0422,-0.0255,-0.035,-0.049,-0.1043,-0.1314,-0.1177,-0.1854,-0.2819,0.1461,0.0812,0.1473,0.0127,-0.0438,0.0498,0.0976,0.1595,0.0431,0.0853,-0.0107,0.0021,-0.1811,-0.0199,0.0283,-0.0969,-0.0192,0.0314,-0.0342,-0.0954,0.0359,-0.0531,0.0787,-0.0173,0.1183,0.0913,-0.0458,0.0766,0.1444,0.0096,-0.0021,-0.0758,0.1494,0.1133,0.1061,0.1264,0.008,-0.0231,-0.0811,0.136,0.1414,-0.0192,-0.034,0.0979,0.0783,-0.0416,0.0239,0.0443,0.0121,0.0639,0.0622,0.0843,-0.0637,-0.0541,-0.0082,0.2603,-0.0773,0.063,0.1943,0.2854,-0.0157,0.169,-0.0236,0.032,-0.042,-0.074,-0.0138,0.0488,0.0838,0.2516,-0.0568,0.1351,-0.2316,0.0728,-0.0598,0.0772,-0.0747,-0.1574,-0.285,0.0078,0.0001,0.0089,-0.116,0.1856,0.2306,0.2321,-0.0513,0.0783,0.0845,0.1141,0.0501,0.0744,-0.0062,-0.0141,-0.0136,0.1554,0.0361,-0.0255,0.0086,-0.0325,-0.0131,0.0507,0.0417,-0.1427,-0.0169,0.0742,0.0255,0.1813,0.1533,0.0267,0.1403,-0.021,0.2248,0.2039,-0.0424,-0.0784,-0.0334,-0.0058,-0.005,0.0027,-0.0882,-0.0631,-0.1102,0.1509,0.1835,-0.1091,-0.0863,0.0186,-0.0806,-0.0437,0.0449,0.0861,-0.0352,0.0186,0.0897,-0.0423,0.0162,0.0661,0.0226,0.0814,-0.1268,-0.0164,-0.1874,-0.121,-0.0655,-0.0531,0.1505,0.1912,0.0593,0.1097,0.2075,0.1283,0.0783,0.0361,0.0617,-0.3687,-0.25,-0.2298,-0.3,-0.1945,-0.2138,-0.2262,-0.1371,-0.1846,-0.1189,-0.2601,-0.23,-0.2966,-0.2931,-0.0708,0.1811,-0.1016,-0.0481,-0.0109,0.0813,0.1544,-0.0312,0.1008,-0.0651,-0.2396,-0.0261,0.0746,0.0962,-0.1209,-0.0583,-0.0634,-0.2028,0.0157,0.0273,-0.0614,-0.0336,0.1404,0.1279,0.0432,0.0243,0.0153,0.0248,-0.0075,0.0248,0.0208,0.2804,0.0963,0.068,0.1595,0.1835,0.1361,0.18,0.1135,0.0792,0.0926,-0.0565,-0.0849,-0.1603,0.0196,0.2022,-0.1684,-0.0999,-0.0855,-0.0107,0.0232,-0.0912,0.0342,0.0871,0.0318,0.0444,0.0476,-0.0432,-0.0276,-0.0289,-0.1197,-0.0604,-0.0517,0.0992,0.0134,0.1066,0.3178,0.205,0.1759,0.114,-0.0781,0.0024,0.0097,-0.152,0.04,-0.0039,-0.0909,0.0385,0.0328,0.0113,0.0054,-0.0757,-0.0132,0.0015,0.067,0.064,-0.099,-0.0109,-0.0327,0.0714,0.0259,-0.1271,-0.0957,-0.0405,0.104,-0.1794,-0.2249,-0.1759,-0.0459,0.0551,0.1072,-0.003,0.0361,0.1246,-0.0865,-0.0219,0.0352,0.116,-0.0076,0.057,0.053,0.0136,-0.0232,0.1494,0.0915,0.126,0.0785,0.0251,0.0836,0.0559,0.0738,0.057,0.0815,0.0021,-0.0305,0.0118,-0.056,-0.0327,0.1951,0.0839,0.0214,0.0711,0.0093,0.0267,0.0028,-0.0485,-0.057,0.0075,0.0638,-0.1447,-0.1688,-0.145,-0.1078,-0.2063,0.0083,0.0327,0.0217,-0.0593,0.0267,0.0801,-0.0444,0.135,0.207,0.1834,-0.1829,-0.0839,0.0128,0.0729,-0.0244,-0.1305,-0.0338,0.009,-0.0444,0.028,0.097,0.1111,-0.1906,-0.002,0.1342,-0.0452,-0.0525,-0.1391,-0.2202,0.0187,0.0093,0.0466,0.036,-0.2828,-0.0988,-0.1528,-0.0228,0.0913,0.0194,-0.1113,0.0571,-0.0744,-0.0494,0.2052,0.0868,0.1876,0.1121,0.0888,-0.0612,0.01,0.0044,-0.1521,-0.0921,0.0022,-0.3593,-0.325,-0.1521,-0.166,0.0967,-0.1483,-0.0599,-0.2575,-0.2293,-0.2214,0.046,-0.0703,-0.008,-0.1346,-0.0147,-0.0998,-0.0906,-0.098,-0.1078,0.0622,-0.0006,0.0925,-0.0918,-0.094,0.0295,-0.0421,0.0447,-0.1117,0.0104,0.0863,0.0854,0.1547,0.0777,0.0267,0.0179,0.13,-0.015,0.026,0.079,-0.0215,-0.1245,-0.1212,0.1434,-0.0439,0.017,0.2084,-0.0227,0.0123,0.0628,0.011,0.0559,0.0136,-0.2761,-0.2962,-0.0695,-0.0861,-0.1862,0.0563,0.0461,-0.107,0.0168,-0.0418,-0.0304,-0.0227,0.0121,0.2007,0.184,0.1892,0.1899,0.0591,0.0498,0.0655,-0.0257,-0.0358,-0.1255,-0.0532,0.0161,-0.0299,-0.0643,-0.1955,0.1571,0.0005,0.05,0.1291,0.2477,-0.0985,0.0749,0.0418,-0.0223,-0.2528,-0.0027,-0.0035,0.0179,0.0358,-0.0087,-0.0129,-0.0796,0.0094,0.0937,0.0019,0.0383,0.142,-0.0462,0.0632,-0.0889,0.0545,0.2207,0.0945,-0.024,0.0355,0.0098,0.0074,0.1394,0.0549,-0.0518,-0.0289,-0.0465,0.2815,0.0888,0.0425,0.2252,0.1246,0.0702,0.0491,0.0491,0.1309,-0.0037,-0.1288,0.1008,0.0618,-0.0604,-0.0178,0.0577,0.1251,0.2125,-0.0621,-0.0371,-0.0438,0.0524,-0.2488,0.062,0.0908,0.1532,-0.056,0.0252,0.0578,0.0532,-0.1923,-0.1038,-0.2876,-0.3655,-0.269,0.0212,-0.0247,-0.2363,-0.1652,-0.0168,0.0885,0.122,0.0474,0.0838,0.0335,-0.0019,-0.0298,-0.0813,-0.0021,0.0487,-0.1346,0.0854,0.0993,0.0015,0.1239,0.002,-0.0392,0.0343,-0.0206,-0.089,-0.236,0.0976,-0.3677,-0.3497,-0.1535,-0.2632,-0.1704,0.0345,0.0214,0.0691,0.0665,0.0533,-0.0,-0.1697,-0.0353,-0.0598,-0.0504,0.0002,-0.0113,0.0978,-0.0139,0.0163,0.0264,-0.1895,0.0297,-0.2198,-0.1437,-0.1757,-0.07,-0.1348,0.0413,-0.0524,0.0796,0.1181,-0.063,0.0393,0.0082,0.0757,0.076,0.0039,-0.0521,-0.0588,-0.0186,-0.0371,0.0475,-0.0787,0.0031,0.0708,-0.119,-0.0557,-0.0335,-0.0412,-0.0781,-0.0315,0.0267,-0.1957,-0.0211,0.0412,0.044,0.0307,0.0142,-0.0657,-0.0642,0.013,-0.0666,-0.0884,0.0754,-0.0766,-0.0489,-0.0897,-0.1056,0.0049,0.0163,0.0233,0.0169,-0.098,0.0018,0.0117,0.0445,0.083,-0.0583,0.1123,0.1453,0.1108,0.066,0.1013,0.0382,0.0155,-0.0204,0.119,0.1021,0.1144,-0.0431,0.0403,-0.0566,-0.0111,-0.1739,-0.0196,0.1297,0.0926,-0.0159,-0.012,-0.0468,0.1208,-0.1049,-0.1338,0.0308,0.0555,0.0021,0.0062,-0.0221,0.0168,-0.0642,0.0086,-0.0603,0.1618,-0.0746,0.0651,0.1118,-0.0887,0.0646,-0.0913,-0.1445,-0.1391,-0.1424,-0.1112,0.0344,0.1942,0.0937,-0.0085,0.0109,0.0825,-0.0056,0.1084,-0.0011,0.0169,0.0344,0.0464,0.1105,0.0167,-0.0284,0.0447,0.0809,0.1833,0.0781,0.0382,0.1467,0.0848,0.0555,0.1223,0.0496,0.0058,-0.0217,-0.0291,-0.0663,-0.1623,-0.0982,0.0002,0.0281,0.0108,0.0605,0.0439,0.0666,0.2024,0.0304,0.002,0.0174,0.1043,-0.0273,-0.0146,0.0063,0.0506,0.0044,0.0598,0.0526,0.1243,0.0988,-0.0772,0.0691,0.0692,0.1812,0.0294,-0.104,-0.3264,0.0895,0.0779,-0.0293,-0.0289,-0.0282,0.0157,0.0355,0.1223,0.0738,0.1031,0.1148,0.0194,-0.0435,0.0525,0.0135,-0.0402,-0.0387,-0.0472,-0.0622,0.0262,-0.0011,-0.0416,0.0386,-0.0316,0.0846,0.1241,0.0486,-0.1682,-0.0058,0.0087,-0.0362,0.0001,-0.0094,-0.1775,0.0056,0.0954,0.0954,0.05,0.0498,-0.1231,-0.0662,-0.0217,0.076,0.0605,-0.0522,-0.2287,-0.0479,-0.0893,-0.1175,0.2252,0.0477,-0.0436,0.0536,0.1029,-0.1042,-0.1278,-0.1164,0.0088,-0.0426,-0.0067,0.0458,0.0057,-0.1074,0.0603,-0.1737,-0.0108,0.0032,-0.007,-0.0334,0.0672,0.0365,0.018,-0.015,-0.1719,-0.2833,-0.0799,-0.1379,0.1359,-0.046,0.1571,0.0103,0.0237,0.1698,0.1801,-0.0454,-0.0528,-0.1476,0.0771,-0.0161,0.0657,0.1115,0.1641,0.1536,0.014,0.0384,-0.0112,-0.0,-0.0687,-0.0081,0.1265,0.053,0.0915,0.0783,-0.1803,0.2007,0.0153,0.1209,0.0531,0.069,-0.033,-0.0137,-0.0175,-0.0244,-0.1221,0.0768,-0.0867,0.0589,-0.1409,-0.1302,-0.1323,0.0149,0.0334,-0.1851,-0.189,-0.1623,0.183,0.1315,0.0002,0.1027,0.1891,0.0103,-0.0231,0.129,0.0584,0.041,0.1987,-0.0,0.0849,-0.0397,0.0096,0.0734,0.1955,0.2288,0.1606,0.0992,-0.1921,0.0442,0.1184,0.2245,-0.079,0.0207,-0.0525,0.0008,-0.0467,-0.1853,-0.1652,0.0541,0.04,0.0392,-0.0021,-0.0044,-0.1291,-0.014,-0.0173,-0.0515,-0.2545,0.13,-0.0819,-0.0061,0.1169,0.1561,0.2008,0.0991,0.1379,0.0646,0.0775,0.1332,0.0888,-0.0143,-0.1256,-0.0583,0.053,0.1386,0.1421,-0.2095,-0.1706,-0.1425,-0.0549,0.0361,-0.162,0.0874,0.0178,0.0823,-0.0679,-0.1315,-0.1292,0.0089,0.0291,-0.2919,-0.2535,-0.3011,-0.1597,0.0032,0.0615,-0.006,-0.0727,-0.0548,-0.0098,-0.0514,-0.0758,-0.0317,-0.0484,-0.0587,0.0187,0.0359,0.1058,0.0806,0.119,0.0006,-0.0001,0.0654,0.01,-0.1346,-0.1125,0.0074,0.0216,-0.0733,-0.0665,-0.1235,-0.1028,-0.0315,-0.1603,-0.0592,-0.002,0.0171,0.0058,-0.1473,-0.1665,0.0255,-0.0119,-0.0575,-0.0065,-0.0476,-0.0669,0.0125,0.0645,0.0207,0.0231,-0.0664,-0.126,-0.0118,0.0622,0.0216,0.0019,-0.1723,-0.0739,0.0813,0.0551,-0.1151,-0.0158,-0.0975,-0.0933,-0.0419,-0.0463,-0.0815,-0.0369,0.0652,0.0272,-0.0739,0.0287,-0.1067,-0.0881,-0.0639,0.0443,0.0817,0.0381,-0.1214,-0.3902,0.045,0.0126,0.0648,0.1155,0.3437,0.2083,0.1866,0.1711,0.1717,0.1394,0.0429,-0.0414,-0.1584,-0.1209,-0.1634,0.0525,-0.0579,0.0339,0.0595,0.0781,0.0555,-0.0204,-0.0909,-0.1484,-0.1191,-0.0682,-0.0921,0.0145,0.0207,0.0771,-0.05,-0.0217,0.1037,-0.0358,0.0233,0.0682,0.0693,0.0244,-0.1323,0.0534,0.1377,0.1282,0.0457,-0.0299,-0.0351,-0.0928,-0.0035,-0.1132,0.0176,-0.0861,-0.1872,0.0151,0.1385,0.0794,-0.0763,-0.0967,0.0674,0.0279,0.2229,0.1567,0.0647,0.1659,0.0107,0.0988,0.1345,0.0106,-0.0126,-0.1127,-0.1524,-0.0378,0.1118,-0.0397,-0.1119,-0.0799,-0.1885,-0.1109,-0.1104,-0.2073,0.0629,-0.0197,-0.0723,-0.0559,-0.0467,-0.085,0.0546,0.1457,0.1173,-0.063,0.0449,0.0904,-0.1167,0.0277,0.0472,0.0416,-0.1423,-0.0915,0.1193,0.0456,0.1088,0.0725,0.0764,0.0574,-0.0078,0.1297,-0.057,0.0903,-0.053,-0.0899,-0.0305,0.1327,-0.0446,0.1266,-0.0365,0.1038,0.1516,0.0529,0.0091,-0.0095,-0.1219,-0.0801,0.0439,0.0698,0.0202,-0.042,0.004,-0.1015,-0.0345,-0.2203,0.0098,0.1025,0.0324,-0.111,0.0992,0.1081,0.0826,-0.1102,-0.0109,0.0683,-0.0094,-0.098,-0.2196,0.0866,0.1104,-0.0365,-0.0845,-0.0831,-0.198,-0.0615,-0.2582,0.0969,-0.3918,-0.3778,-0.0392,-0.0261,-0.06,-0.0055,-0.0222,-0.1887,-0.1798,-0.0401,0.0616,0.0507,0.0854,-0.0871,-0.134,-0.1563,0.1064,0.1144,0.1218,-0.0082,0.0495,0.0018,0.0806,-0.0215,-0.0441,0.0195,0.0585,0.0884,-0.1584,0.0656,0.0487,-0.3157,-0.1807,-0.0413,0.0474,-0.1243,-0.3387,-0.1875,-0.1182,-0.1169,-0.0513,-0.0359,-0.0421,-0.1918,0.0741,-0.1067,-0.0806,-0.1036,-0.0084,-0.3687,-0.0602,0.0586,0.0354,-0.0356,0.2259,0.1825,0.1309,0.119,0.0616,0.0973,-0.0492,0.2352,0.1883,0.0864,0.1129,0.2211,0.1934,-0.0035,-0.0352,0.0911,0.0842,0.1317,0.1453,-0.0168,0.0496,0.0993,0.0793,-0.0466,-0.0536,-0.023,-0.0603,0.0107,0.0134,0.0052,0.042,-0.017,-0.0738,0.0836,-0.0058,0.2099,0.2667,0.0549,0.0807,0.1277,0.1651,-0.0728,0.0517,0.0412,0.0903,0.126,0.1464,-0.0662,-0.093,-0.0411,-0.0102,-0.1415,0.007,-0.1435,-0.1522,-0.2001,0.0952,-0.0884,0.206,0.0828,0.0479,-0.0782,-0.0787,0.0254,-0.0295,0.0146,-0.0433,-0.011,-0.0668,0.1094,0.0081,-0.1264,-0.0333,0.0573,0.0495,0.0387,-0.003,-0.111,-0.1656,0.1726,0.1758,-0.1186,-0.1332,0.0091,-0.1546,0.0468,0.0198,0.1035,0.1436,-0.0055,0.0846,0.1405,0.0557,0.0252,-0.1274,-0.02,-0.1794,0.0083,-0.1156,0.013,-0.0517,-0.0229,-0.0171,0.0059,-0.0012,-0.0067,-0.0166,-0.059,-0.0814,-0.022,-0.0167,0.0335,0.0279,0.0523,0.0131,-0.0076,-0.0323,0.0543,0.0812,0.1808,0.0089,-0.0474,0.1207,0.0008,0.0628,0.0127,0.0204,0.0809,0.1079,-0.0065,0.0337,0.0634,0.1304,-0.122,-0.1553,-0.1159,0.0538,-0.0868,0.0983,0.0999,-0.0282,0.0532,-0.1284,-0.057,0.1121,0.1222,-0.0833,0.0747,-0.0226,-0.0047,0.1086,-0.0055,0.2689,0.0081,0.0939,0.0239,-0.0123,0.212,0.1153,0.0394,-0.0248,0.0409,0.0204,0.0284,0.0801,0.0274,-0.0303,-0.069,-0.0142,0.0006,-0.0302,0.0349,0.1218,0.0859,0.1202,0.1027,-0.0036,0.2109,-0.2759,0.135,0.1758,-0.1548,-0.1246,0.2931,0.2522,-0.0879,-0.2453,-0.1188,-0.2923,-0.0233,-0.168,-0.163,0.0762,-0.1672,0.0745,0.1052,0.1666,0.1166,0.249,0.233,-0.0048,-0.0066,0.0721,0.0287,-0.0192,-0.0058,0.0789,0.1145,0.0599,0.043,-0.1256,0.013,0.0655,-0.0765,0.0628,-0.0204,0.043,0.0473,-0.1622,0.0069,-0.111,-0.1935,-0.0701,0.1195,-0.067,0.225,-0.064,0.0662,0.1442,0.1063,0.0593,-0.2466,-0.1356,0.2205,0.1988,0.0839,-0.0149,0.0751,0.1731,0.0698,0.0417,-0.0165,-0.0762,0.0178,-0.0093,-0.0512,0.0816,0.0581,-0.0645,0.1157,0.0961,-0.0474,-0.0304,-0.0762,0.0334,0.0168,0.1253,-0.2262,-0.1348,0.09,-0.0027,0.0694,0.0574,0.0532,0.0487,0.0216,-0.3786,-0.3847,0.1523,0.0654,0.0841,0.1418,0.0817,0.0299,0.0173,0.0219,-0.0033,0.0249,-0.086,0.0218,0.0466,-0.1032,visual recognition
trm_4a3fd79d0afcf,-0.0644,0.0253,-0.0648,-0.0268,-0.0662,-0.0153,-0.0502,-0.0468,-0.0225,-0.0562,-0.1041,-0.079,0.015,-0.0678,-0.0609,0.0108,-0.006,-0.1095,-0.0458,-0.0952,-0.0681,-0.046,0.0313,-0.0388,-0.0278,-0.0584,-0.0535,0.0327,0.066,-0.0125,-0.0286,-0.0651,-0.0406,-0.0281,0.0036,0.0218,-0.0225,0.0097,-0.0312,0.0101,-0.013,0.0145,-0.0197,-0.0251,-0.0199,0.026,-0.1287,-0.0238,-0.0023,0.1196,0.1034,0.0231,0.0026,-0.0693,0.0193,0.0355,0.0955,-0.08,-0.0407,-0.0694,-0.071,-0.0519,-0.0052,-0.0523,-0.0235,0.0657,-0.0422,-0.0434,-0.0274,0.0225,-0.0384,0.0132,-0.0396,-0.0364,-0.0206,0.0644,0.0929,-0.0663,-0.0933,0.1144,-0.03,-0.026,-0.0251,0.0039,-0.0107,0.054,0.0626,0.043,-0.009,0.6616,0.0391,0.1502,0.0364,-0.1425,-0.0981,-0.116,-0.0399,0.0045,-0.0086,0.028,0.0124,0.0047,0.0121,-0.0238,-0.0681,-0.0065,-0.0228,0.0183,0.0855,-0.0185,-0.0478,-0.0178,-0.0307,-0.0105,-0.0097,0.0243,-0.0558,0.0789,-0.084,-0.0279,-0.0654,0.0015,-0.0674,0.0116,0.0185,-0.0272,-0.0152,-0.0532,-0.0477,0.1901,-0.0104,-0.0288,-0.0218,0.0398,0.0645,-0.0598,-0.0189,-0.0294,-0.0028,-0.0222,-0.0297,0.0073,-0.0662,0.0437,-0.0756,0.0046,0.0228,-0.0687,0.0244,-0.0147,0.0043,-0.0429,0.0019,-0.0449,-0.026,0.036,-0.0522,-0.0273,-0.0336,0.0289,-0.0295,0.0637,-0.0368,-0.0002,0.0156,0.0087,0.0225,-0.034,-0.0501,0.0369,0.0551,-0.0622,0.008,-0.0356,0.0128,0.0057,-0.0074,-0.0479,-0.0113,-0.0115,0.109,0.0064,0.0302,-0.0145,0.083,0.0748,0.0588,0.0214,-0.0399,-0.0257,-0.031,-0.0022,-0.0506,-0.0182,-0.0286,0.0113,-0.0296,-0.073,-0.0504,0.0885,0.0521,-0.0859,-0.0494,0.0571,-0.0845,0.3034,0.0703,-0.0021,-0.0583,-0.0442,-0.0673,-0.0842,0.0701,-0.0043,-0.0324,0.0129,-0.0206,-0.0364,0.0924,-0.058,-0.0641,-0.0301,0.0174,0.0161,-0.0134,-0.0211,0.021,0.0404,0.1635,-0.1093,-0.0112,-0.0069,-0.0782,-0.0078,0.0047,0.2118,-0.0331,-0.0712,0.0941,0.075,-0.0547,-0.0155,-0.0376,-0.0256,-0.0754,-0.0187,0.0016,0.0528,0.136,-0.041,-0.0018,-0.0033,0.041,-0.0233,0.1719,-0.0375,0.0688,-0.0196,-0.0677,-0.0759,0.0408,-0.1066,-0.0688,-0.0724,-0.0814,-0.0948,-0.0467,-0.0841,-0.0674,-0.06,0.0034,0.0292,-0.013,-0.0619,0.4076,0.4285,0.7521,0.7439,0.5569,0.469,0.3683,-0.0277,-0.0333,-0.0149,-0.0157,0.0031,0.0367,0.0308,-0.0419,0.02,-0.015,-0.0773,0.0079,-0.0486,-0.0048,-0.0277,-0.0339,0.0058,-0.0531,-0.006,0.0065,-0.0658,0.0632,0.0812,-0.0076,-0.0117,0.0058,0.09,0.162,-0.0378,0.1066,0.0155,-0.088,-0.0754,-0.0423,0.0164,-0.061,-0.0684,0.0007,-0.0357,-0.0536,-0.0615,-0.0004,-0.0251,0.0017,-0.0517,0.0178,0.064,-0.0404,0.0338,0.063,-0.007,-0.0924,-0.0587,-0.024,0.0858,0.0612,-0.008,-0.0665,-0.0659,-0.0642,-0.0676,0.0121,0.0321,-0.0766,0.0281,0.0491,0.0222,0.0355,0.0592,-0.0368,-0.1463,0.083,0.1098,0.0042,0.0265,0.0168,0.0123,0.0657,0.0099,-0.1018,0.0062,0.1824,-0.009,0.0313,-0.0287,0.0461,-0.0835,0.0087,-0.0173,-0.0605,-0.0912,0.041,0.006,-0.0479,0.0042,0.0348,-0.0617,-0.035,0.1081,0.0194,-0.0453,-0.063,-0.0667,-0.063,-0.0144,-0.0235,-0.0412,-0.0491,-0.015,0.112,0.0341,-0.0532,-0.0642,-0.0839,-0.031,0.0323,0.0157,0.0872,0.0524,-0.0401,-0.0134,0.0424,0.0879,-0.0045,-0.0125,-0.099,-0.034,0.0206,-0.02,-0.0601,-0.0924,-0.0439,-0.118,-0.024,0.0675,-0.0923,-0.0775,-0.0456,-0.0727,-0.0267,-0.0082,-0.0161,-0.0358,-0.0335,-0.0238,0.0483,-0.0496,-0.0493,-0.0357,-0.0546,0.0289,0.0097,0.0562,0.0301,-0.076,0.0865,0.151,-0.0012,-0.0563,-0.0346,-0.0563,-0.0206,-0.0362,0.0093,0.0083,0.1394,0.093,-0.0915,-0.0967,-0.0953,-0.0254,0.0104,0.0589,-0.0366,-0.0441,0.139,-0.0433,0.0177,-0.0368,-0.1018,-0.0213,0.069,-0.036,-0.0701,0.0943,-0.0796,-0.192,0.0733,0.1961,0.061,0.0615,-0.0612,0.0396,0.1464,0.0163,-0.0332,0.0278,0.072,-0.0636,0.0715,0.0603,0.0688,-0.0902,-0.0647,-0.031,0.045,-0.0354,-0.0733,-0.018,0.0905,0.1382,0.0361,0.0597,0.0093,-0.0089,0.2609,-0.0366,0.027,-0.0609,-0.0616,0.003,0.0992,0.0011,0.0089,-0.0359,-0.0261,-0.0002,-0.0338,-0.0728,0.0134,0.0626,-0.0314,0.0357,-0.0655,-0.0312,-0.0371,-0.0359,0.123,-0.0385,0.0545,0.1015,-0.1069,-0.1135,-0.0782,-0.0857,0.0767,0.0691,0.1337,-0.0555,0.0323,0.0244,0.0434,-0.0451,-0.0857,0.056,-0.0508,-0.0089,-0.014,-0.0251,-0.0343,-0.0628,0.1262,0.0978,-0.0295,0.0336,-0.0559,-0.0164,0.0619,-0.0856,-0.0267,-0.0438,-0.0165,0.1087,0.0478,-0.0065,-0.0027,-0.0263,-0.0041,0.0834,-0.0579,-0.0347,-0.0692,0.0199,0.1074,0.1436,0.065,0.0507,0.0177,0.0462,0.0053,-0.0735,0.1393,0.0298,0.0274,0.0391,0.0407,0.0188,0.0631,-0.0136,0.0792,-0.0821,-0.0378,-0.0077,0.0041,-0.0805,-0.0748,0.0187,0.0703,-0.0175,0.0697,-0.0512,-0.0816,-0.0139,0.0648,0.005,-0.0394,-0.0565,-0.0063,0.1053,0.0643,0.0286,-0.0762,0.1142,-0.0768,-0.0276,0.0468,-0.0093,-0.0173,-0.0917,0.0015,0.044,-0.0702,0.0046,-0.0512,-0.1188,-0.0681,0.0231,0.0317,-0.0231,-0.0045,-0.0039,0.0168,0.0078,0.0846,0.0218,-0.0153,-0.0301,-0.0018,0.0079,-0.0208,-0.0371,0.0003,-0.083,-0.0879,-0.0251,-0.072,0.0745,-0.0013,0.0313,0.0165,-0.0422,0.0289,-0.0304,-0.0362,0.0132,-0.0621,-0.0439,-0.0801,-0.0654,-0.0987,-0.0187,-0.0822,-0.0387,-0.0095,0.074,-0.055,-0.0002,-0.0609,-0.0362,-0.0484,0.0782,-0.0479,-0.0297,-0.0291,0.0081,0.0254,-0.001,0.1187,-0.0869,-0.0132,-0.0606,-0.0006,0.1147,-0.0237,-0.0394,0.0865,-0.031,0.0386,-0.0092,-0.0665,-0.0554,-0.0831,0.1164,0.1984,0.0257,0.01,-0.0097,-0.0178,0.0173,-0.0684,-0.107,-0.0827,0.0117,-0.048,-0.007,-0.0093,0.0777,-0.0083,-0.0804,-0.0413,0.0047,-0.0039,-0.0058,-0.0119,-0.0222,-0.0266,-0.01,0.0384,0.05,-0.0511,-0.0696,-0.1271,0.0456,-0.142,-0.0006,-0.0771,0.243,-0.0412,-0.042,0.0643,-0.0026,-0.0359,-0.0155,-0.0485,-0.0394,-0.0579,-0.0682,-0.0784,-0.0251,0.0177,0.0371,0.0351,-0.0885,-0.0893,0.0118,0.0697,-0.0715,-0.1028,-0.0721,-0.0122,-0.0179,-0.0325,-0.0218,-0.078,-0.0588,-0.0631,0.0282,-0.0008,0.0039,0.0553,-0.0725,-0.0471,-0.0497,-0.0385,-0.0227,-0.0116,-0.1132,-0.052,0.0597,-0.0134,0.0632,-0.0178,0.0696,-0.0176,-0.0328,-0.0627,-0.0302,0.0264,0.0205,0.0844,-0.0235,0.1169,-0.0052,-0.0428,0.0175,-0.0622,0.0151,-0.0302,0.0293,-0.0282,-0.0104,-0.0182,-0.0639,-0.0744,0.0184,0.0458,0.017,-0.0295,-0.0624,-0.0039,0.0208,-0.1084,0.0417,0.0619,-0.0051,-0.0454,0.0305,-0.0504,0.0137,0.0139,-0.0755,-0.0845,-0.108,-0.0307,0.0227,-0.0226,0.0775,-0.0819,-0.0509,-0.0267,-0.0373,-0.062,-0.0496,-0.0251,0.0497,0.1021,0.0059,0.0755,0.0197,0.0543,-0.0477,-0.0639,0.0083,-0.0085,-0.0904,-0.0887,-0.0684,-0.001,-0.0581,-0.0741,-0.01,-0.0486,-0.0493,-0.0107,-0.0375,-0.0523,0.0672,-0.0073,-0.0597,0.0355,-0.0466,0.0808,-0.0421,0.0085,-0.0032,-0.0735,-0.0981,0.0244,-0.0617,-0.0488,0.107,-0.0241,-0.043,0.0136,-0.1034,-0.0988,-0.0324,-0.0707,-0.03,0.057,0.0702,0.0977,0.0135,0.1347,0.0929,-0.0506,-0.0158,-0.0958,-0.0695,-0.0519,-0.0589,0.0011,0.001,-0.031,-0.1481,-0.0817,-0.1499,-0.0241,-0.0487,-0.0998,-0.0742,-0.0408,-0.0761,0.0072,0.0032,-0.0207,-0.0752,-0.0347,0.0614,0.104,0.0641,0.0315,-0.0212,0.0095,-0.0441,-0.0843,-0.0246,0.0131,0.0684,-0.0444,0.0342,-0.0716,-0.0719,-0.0437,-0.1466,-0.0511,-0.0661,0.0058,-0.0146,-0.0695,0.0658,-0.0167,-0.0529,-0.0804,-0.031,0.0057,0.0387,-0.1169,-0.0327,0.0636,0.1145,0.0211,-0.0644,0.0675,0.0512,0.0526,0.0047,-0.0698,-0.0056,0.0961,-0.0178,-0.048,0.0341,-0.0361,0.0286,0.0115,-0.0321,-0.0706,-0.0323,-0.0274,0.0231,-0.0436,-0.0075,-0.0312,-0.0101,0.0822,0.0522,-0.0297,0.072,-0.0151,0.0358,-0.0162,-0.018,0.0304,-0.0768,-0.0677,0.0672,-0.0742,0.0918,-0.0007,-0.0175,-0.1027,-0.136,-0.0531,0.0803,0.1157,-0.0529,0.0101,-0.0274,-0.0531,-0.0205,-0.0054,0.1712,0.0428,-0.0299,0.06,0.0063,0.0084,0.0361,0.2536,-0.0078,0.0039,-0.0542,-0.0862,-0.1153,-0.1114,-0.0323,0.0341,0.0204,-0.0286,-0.0577,-0.0737,-0.0731,-0.0775,-0.0021,0.0116,-0.0675,-0.0358,-0.0017,-0.0006,0.0441,-0.0032,-0.0267,-0.0155,0.0519,0.0165,-0.0572,0.0017,-0.038,-0.0708,0.0019,-0.1125,0.0067,-0.0876,-0.0277,-0.0007,0.0196,-0.002,0.0068,0.0825,-0.0915,0.0319,0.1416,0.025,-0.1163,-0.0019,-0.0195,0.0097,-0.0359,-0.0131,0.006,-0.0475,-0.0839,-0.102,-0.0804,-0.064,-0.0262,-0.0173,-0.0251,0.027,-0.0143,-0.0043,0.0095,0.1166,0.0721,-0.0085,-0.006,0.0207,0.0173,0.0361,0.0016,0.0693,-0.046,-0.0202,0.0542,0.0024,-0.0014,0.023,-0.0818,-0.0377,0.0042,-0.0251,-0.0798,0.0206,-0.0277,0.0462,-0.0023,0.0039,0.0276,0.0923,0.0078,-0.0215,0.0483,-0.061,-0.0433,0.0118,0.0623,0.0984,0.0005,-0.0269,0.0502,-0.0029,-0.0206,0.0782,-0.0429,-0.0026,-0.0552,0.0794,0.0434,-0.2337,-0.1588,-0.1032,-0.0712,-0.0754,0.0076,-0.0831,-0.075,-0.025,-0.1533,-0.1518,-0.1323,-0.0911,-0.1545,-0.0342,-0.0057,-0.0482,0.0194,0.06,0.0156,0.0249,-0.0444,-0.0227,0.0758,0.0182,0.0402,0.0178,-0.03,0.0003,-0.0855,-0.0703,-0.0448,-0.0117,0.014,0.0665,0.0927,-0.0388,0.0137,-0.0546,-0.0346,-0.0598,-0.0517,0.0022,0.1551,0.103,-0.005,0.0201,-0.0046,-0.0062,-0.1496,0.0134,-0.1532,-0.02,0.0399,0.0501,0.1266,-0.0386,-0.0825,-0.0113,-0.1124,0.0614,-0.0318,-0.0648,-0.0236,-0.045,-0.0912,-0.0058,-0.0043,0.0259,0.0077,0.0713,-0.001,-0.0033,-0.0094,-0.0875,-0.077,-0.0064,-0.0487,-0.0239,-0.0599,0.0235,-0.0228,0.039,0.1197,0.0692,-0.0335,-0.0191,0.0369,0.012,0.1243,0.1682,-0.0732,0.0107,-0.0596,0.0306,-0.0344,0.1078,-0.0697,0.0379,0.1447,-0.045,-0.0346,0.0511,-0.0854,0.0681,-0.0886,-0.1161,-0.0252,0.1506,-0.0823,-0.0451,-0.0655,0.115,-0.0093,-0.0601,0.008,-0.087,-0.081,0.0318,0.0559,0.0589,0.1197,0.0671,0.1241,0.0833,0.0779,0.0441,-0.0347,-0.0385,-0.0465,0.0086,-0.1691,-0.1515,-0.1209,-0.1111,-0.1044,-0.0342,0.0111,-0.0155,-0.0533,0.0355,-0.0111,-0.0807,-0.0159,-0.0688,0.018,0.0287,-0.1174,-0.0467,-0.0258,0.0721,-0.0408,0.0085,-0.0948,-0.0747,0.07,0.032,-0.0138,-0.0196,-0.0414,-0.0414,0.032,-0.1393,-0.075,-0.0714,-0.0025,-0.0771,-0.0153,-0.1242,0.0241,0.0181,0.0144,0.093,-0.0155,-0.0074,0.0199,-0.0179,0.0156,-0.0853,-0.0138,0.0607,-0.1066,0.1311,0.2749,0.049,0.0494,-0.0296,0.1043,0.0231,0.0594,-0.0137,-0.0164,0.1113,0.0037,-0.0663,0.5617,0.2257,-0.0188,-0.0842,-0.0386,-0.0175,-0.0037,-0.0987,0.0003,-0.0196,-0.0747,-0.0676,0.0266,0.0243,-0.1052,-0.0052,-0.0772,-0.043,-0.0146,-0.034,0.0043,0.0063,0.0337,-0.0489,0.434,0.4369,0.0033,0.0574,-0.0271,-0.0363,-0.0742,-0.1114,0.1401,0.0932,0.1213,0.1226,0.073,0.0641,0.6734,0.6652,-0.061,0.0212,0.3051,-0.1007,0.0471,0.0014,-0.0538,-0.013,-0.0309,-0.0544,0.0386,0.153,0.1932,0.0438,0.0678,-0.062,-0.0179,0.0485,-0.0957,-0.0642,-0.0888,0.0352,-0.0107,0.0004,-0.0591,-0.0582,0.0572,-0.1217,-0.0249,-0.0802,-0.0667,0.0506,-0.0264,-0.0313,0.0275,0.0283,0.1049,0.0669,0.0077,0.034,0.0101,0.0012,0.0597,0.0361,-0.0292,0.1039,0.027,0.0626,-0.012,0.0287,0.0762,-0.0378,-0.0284,-0.2294,-0.0029,-0.0031,-0.0508,-0.1215,-0.0345,0.0075,-0.0423,-0.0837,-0.0848,-0.0286,-0.0278,-0.0973,0.0385,-0.0476,-0.0741,0.0498,-0.0324,0.0733,0.0389,0.0681,-0.0273,-0.0159,0.0182,-0.0918,0.0676,-0.0204,0.0937,-0.0681,-0.0351,-0.0224,-0.0378,-0.0003,-0.0118,0.058,0.1191,-0.0682,0.026,-0.0434,0.0716,0.0602,0.0069,0.0638,0.0351,-0.0383,-0.0219,-0.0272,-0.0676,-0.0674,-0.0759,-0.029,0.0905,0.0331,-0.0555,0.0304,-0.0753,0.0147,0.0323,0.0171,-0.0188,0.0333,-0.0166,0.0082,0.0013,0.0857,0.161,0.0896,-0.0746,-0.0581,-0.0274,-0.0875,-0.0469,-0.0008,0.0245,-0.0445,0.0657,-0.0464,-0.0298,-0.055,0.0119,-0.0296,0.0254,-0.0174,-0.0692,0.0376,0.1582,0.0647,-0.0716,-0.0479,-0.0187,0.0191,-0.0252,-0.0676,0.1049,0.0096,0.1036,0.0839,0.0756,-0.0742,0.0345,0.1437,0.0012,0.2969,-0.008,-0.0152,-0.0616,0.0807,-0.0384,0.102,-0.0625,-0.0459,-0.0443,0.0728,-0.018,-0.011,0.0006,0.0365,0.0172,-0.0199,-0.104,-0.0122,-0.0039,-0.0277,-0.0454,-0.0219,-0.0292,0.0456,0.0456,0.1071,-0.0197,-0.0696,0.0088,-0.0125,-0.0123,0.0237,-0.165,-0.1529,0.0498,-0.0189,-0.0526,0.0474,0.0656,-0.0168,0.0362,0.0741,-0.0438,0.013,-0.0313,-0.0215,0.0012,0.0058,0.0511,0.0268,-0.0413,-0.0351,-0.1128,-0.0016,-0.0153,-0.0693,0.0637,-0.0156,0.064,0.0016,-0.0365,-0.0751,-0.1354,-0.0327,0.0264,-0.0533,-0.0356,-0.0424,-0.025,-0.0692,-0.0287,-0.0252,0.0262,-0.0679,-0.0531,-0.0915,-0.053,-0.0141,-0.0914,0.0376,0.0095,-0.0106,-0.0606,0.0052,0.2766,0.2501,0.1425,0.1474,-0.0496,-0.0382,-0.0072,-0.0233,-0.0363,-0.0868,0.0619,-0.0316,-0.0626,-0.2171,-0.0825,-0.0692,-0.2442,-0.0654,-0.0657,-0.1425,0.1002,0.1136,0.2067,0.1716,0.0135,0.0457,-0.0135,0.0704,0.0021,-0.0563,-0.0818,0.0337,0.0882,-0.0277,-0.0482,-0.0396,-0.0662,-0.0142,0.127,0.027,-0.025,0.049,0.17,0.0581,-0.0295,0.0003,0.0254,-0.0008,-0.0721,-0.0117,0.0061,-0.0203,-0.0594,0.018,-0.0257,0.0169,-0.0854,-0.0872,-0.0482,0.3162,-0.072,-0.0393,0.0001,-0.0649,0.0411,0.5842,0.4679,0.6978,-0.0731,-0.0737,-0.1028,-0.0763,-0.0052,-0.0961,0.0225,-0.0825,-0.0538,-0.1094,-0.0441,0.0738,0.2183,0.0178,0.0166,-0.0239,-0.121,-0.0347,-0.0159,-0.0421,0.0166,-0.0712,-0.0038,0.0734,-0.0252,-0.0019,-0.0123,-0.0313,0.1595,-0.0295,-0.0247,-0.0146,0.0047,0.0152,0.0055,0.1536,0.0032,-0.0764,-0.0615,0.0543,-0.0086,-0.0293,-0.0204,-0.0525,-0.0182,-0.0381,-0.0248,-0.0093,-0.0706,-0.1116,0.0195,0.0396,0.0318,-0.032,0.0624,0.0122,-0.0585,0.0564,-0.0585,0.0282,0.0179,-0.0582,-0.0409,0.057,0.1243,-0.0072,-0.0133,-0.0363,0.05,-0.0735,-0.0561,-0.0896,-0.0977,-0.0428,-0.0266,0.0364,0.0062,0.0461,0.0128,-0.0248,-0.0553,-0.0048,-0.03,-0.0336,-0.0082,0.0162,0.0098,0.1986,0.0528,0.046,-0.0473,-0.0123,0.0255,-0.0536,0.0894,-0.1303,-0.0071,0.0329,-0.0314,-0.1426,-0.1049,-0.0561,-0.0469,-0.0523,0.002,-0.0923,0.0323,0.0285,-0.048,-0.001,0.0011,0.0008,0.1876,-0.0895,-0.1558,-0.097,-0.07,-0.1035,-0.084,-0.0725,-0.0615,0.0003,-0.1085,-0.0589,-0.0604,-0.0739,-0.0591,-0.0115,0.032,-0.0414,-0.0463,-0.005,-0.0531,-0.0434,-0.0085,0.1112,0.0642,-0.0849,-0.0579,-0.0548,-0.0415,-0.0237,-0.0453,0.1057,-0.0104,0.145,-0.0137,0.0605,-0.0371,-0.1194,0.2064,0.1437,0.0025,0.0154,-0.0153,0.0497,0.0007,-0.0027,0.0014,-0.0615,-0.0739,0.0192,-0.0311,-0.0699,0.1994,0.1694,0.2566,-0.0143,-0.012,0.0664,0.0268,0.0336,0.0278,-0.0434,-0.0092,0.037,-0.0033,0.0306,0.0224,0.1498,0.0039,-0.0347,-0.0537,-0.0387,0.1356,0.003,-0.0336,-0.0921,-0.0677,-0.0015,-0.022,-0.0414,0.0193,0.0709,-0.0042,-0.011,-0.1226,-0.0541,-0.0566,0.0047,0.0166,0.0188,-0.0474,-0.0438,-0.048,-0.0505,-0.0126,0.0114,-0.0072,0.0025,-0.0439,0.0089,-0.0479,-0.1199,-0.0659,-0.0002,0.0028,-0.1469,0.1801,-0.1041,-0.0082,0.1657,-0.0208,-0.0021,0.2065,0.0358,0.1383,0.0086,0.5397,0.4935,0.2997,-0.0868,-0.0125,-0.0002,0.1059,0.2009,0.1504,0.0136,-0.131,-0.0776,-0.0823,-0.0476,-0.0784,-0.0531,-0.0824,-0.0016,-0.0173,-0.0314,-0.0659,-0.0241,-0.1243,-0.0596,-0.0067,-0.0176,0.0373,0.0094,0.0189,0.0044,-0.0241,-0.024,-0.0341,-0.0073,-0.0627,0.0463,0.1359,-0.0031,-0.0006,-0.0263,0.0163,-0.0479,-0.0486,-0.0098,-0.0848,-0.0919,0.0151,0.0499,-0.0405,-0.1075,0.0541,-0.0287,-0.0694,-0.0716,0.0589,-0.073,-0.0445,-0.0335,0.0377,-0.0061,-0.0482,-0.0438,0.4695,0.0793,0.0377,-0.0069,-0.0133,0.012,0.023,0.0404,-0.0321,0.0145,0.0279,0.0516,0.0537,0.04,0.0028,-0.0341,-0.0392,0.0023,-0.1289,-0.1072,-0.0697,-0.0001,-0.2084,-0.1507,-0.0162,0.0376,-0.2178,-0.0871,-0.0302,-0.1181,-0.1158,-0.053,-0.0525,-0.0543,0.0031,0.0354,-0.2756,-0.1917,-0.1322,-0.0293,-0.1039,-0.1206,-0.1997,-0.1865,-0.1492,-0.0831,0.0366,0.0186,0.0889,0.041,0.1709,-0.0556,0.0074,-0.0637,-0.0209,-0.048,-0.0711,0.0107,-0.0106,0.0041,0.1219,0.0042,-0.1024,-0.0583,0.1381,0.092,0.1224,0.025,-0.0186,-0.0572,0.049,0.0359,-0.0383,0.0951,-0.0264,-0.0707,-0.0618,0.1525,0.1511,-0.0039,-0.1815,-0.1143,0.0045,-0.0552,0.0204,-0.0169,-0.0664,-0.0339,-0.0497,0.1229,-0.0345,0.0868,-0.0411,-0.0792,-0.0262,0.1404,0.0369,0.0354,0.0588,0.029,0.0422,0.0129,0.0197,0.0373,0.0333,0.0392,-0.0414,0.0247,0.078,0.0312,-0.1485,-0.0811,-0.122,0.0709,0.0534,-0.0686,-0.0783,0.0518,-0.0115,0.0115,0.0566,-0.1591,-0.1452,-0.1019,-0.0457,0.0105,-0.0478,-0.0258,-0.0739,-0.0957,-0.0822,-0.111,-0.0524,-0.0067,-0.0323,-0.0852,-0.0284,-0.0285,0.1243,0.092,-0.0436,0.0324,-0.0249,0.0088,0.0076,0.0523,0.0106,-0.1079,-0.0179,0.247,-0.103,0.0686,-0.06,0.0244,-0.0187,-0.0186,-0.0345,0.0625,-0.02,-0.0236,-0.047,-0.0651,0.022,-0.0445,-0.0071,0.0956,-0.0704,0.0384,0.1309,0.0541,0.1304,0.2044,-0.0074,-0.089,-0.1201,-0.0136,-0.0148,-0.0134,0.002,-0.0177,0.0234,-0.0488,0.097,-0.0199,0.1207,0.0153,-0.1245,-0.0508,-0.0645,-0.047,0.037,-0.1341,0.0253,-0.1223,-0.0168,-0.0238,-0.0143,0.0092,0.123,0.3641,0.2132,-0.0986,0.0259,-0.0223,-0.0863,-0.1577,0.6,-0.0908,-0.0595,-0.0352,-0.0786,0.6244,0.6267,0.0225,-0.0653,-0.0063,-0.0675,0.0606,0.0677,-0.0253,0.0062,-0.0217,0.0883,-0.0024,-0.1079,-0.0773,-0.0227,0.0198,-0.0523,-0.064,-0.0002,-0.0466,-0.0683,-0.0336,-0.0166,0.123,0.0653,0.0065,-0.0246,0.0115,0.05,-0.0439,-0.0837,-0.024,-0.0334,-0.0334,0.0269,-0.0001,0.0541,-0.008,0.0368,0.0359,0.0313,0.0827,0.1228,-0.0469,0.0262,0.1312,-0.0664,0.1374,-0.1225,0.3123,0.1586,-0.0173,0.0271,-0.019,-0.0413,0.0709,-0.0847,-0.0004,-0.0276,-0.0841,-0.0576,-0.0258,0.0102,0.0458,0.0386,0.003,-0.0808,-0.0835,0.0062,-0.0034,0.0102,-0.0332,-0.0492,0.0694,-0.0394,0.0849,0.0164,0.0233,-0.0166,-0.0447,-0.04,-0.195,-0.0579,-0.1632,-0.0678,-0.0498,-0.1173,-0.0439,-0.0102,0.0165,0.0586,-0.0892,-0.0521,0.0375,0.1058,-0.0242,0.0515,0.011,0.0449,-0.0386,0.0733,0.0321,0.0321,-0.063,0.0095,-0.0035,-0.0327,0.045,-0.0187,0.1266,0.6498,0.0226,0.0528,-0.0362,0.1439,0.0269,-0.1348,-0.0206,-0.0026,0.0014,-0.0328,0.034,0.0163,-0.0204,0.004,-0.0169,-0.0344,-0.0345,0.0717,-0.0532,0.0021,0.0238,-0.0282,0.113,-0.0463,-0.0364,0.0118,0.1154,0.1284,0.0722,0.1101,0.3327,0.0169,0.1328,-0.0343,-0.0408,0.022,-0.0078,-0.0104,0.0612,-0.0278,0.0765,0.0981,-0.0815,-0.1001,0.0026,-0.0452,-0.0657,0.0659,-0.0205,-0.0245,-0.024,-0.0963,0.0304,0.0278,-0.0066,0.1383,0.1596,-0.0926,-0.0397,-0.0328,0.0174,0.036,-0.0278,-0.0577,-0.0207,-0.0403,-0.0598,0.0236,-0.0016,0.2184,0.0148,0.0063,-0.1245,0.0587,-0.013,-0.0019,0.0311,-0.0255,-0.001,-0.0154,0.0447,0.1041,0.0299,-0.0206,0.013,0.026,0.0044,0.0035,-0.0667,-0.0052,0.0205,0.0309,0.011,-0.0014,0.0179,-0.0197,-0.095,-0.0477,-0.1472,-0.1344,-0.0936,-0.0053,-0.046,0.0451,-0.0288,0.0544,-0.0118,0.0462,-0.0039,-0.0538,0.0081,-0.112,0.0601,0.0187,-0.0578,0.0016,-0.0242,-0.037,-0.107,-0.106,-0.0184,-0.1128,-0.0266,0.0361,-0.071,0.0987,-0.0082,0.0607,-0.0157,0.0479,0.0507,0.0199,0.0658,-0.0291,-0.0697,-0.033,-0.0747,-0.0387,-0.049,0.0729,0.0197,-0.0235,0.0093,0.0826,0.0041,0.0074,-0.01,0.0318,-0.0156,0.0053,-0.009,-0.0112,0.0928,-0.045,-0.0481,-0.0388,-0.0036,0.0479,0.0372,-0.001,-0.085,0.0586,-0.0359,-0.0821,-0.069,-0.093,-0.0038,0.0336,-0.0274,0.0297,-0.106,0.0316,0.005,0.0239,0.0038,-0.0137,0.0425,0.0213,-0.0013,0.0708,-0.0468,-0.0073,-0.0811,-0.1201,-0.0768,0.0223,0.0192,-0.0715,-0.0496,-0.0064,0.1006,0.035,0.0167,-0.0182,-0.0577,-0.0376,0.0487,-0.0466,0.0098,-0.0359,-0.0505,0.0176,-0.0351,0.0307,-0.0677,-0.0993,-0.0051,-0.0921,-0.0202,-0.0384,0.0463,-0.0753,-0.0228,-0.0515,0.0161,0.0133,0.0619,-0.0185,0.0712,-0.0238,-0.1163,-0.05,0.0273,-0.025,0.0409,0.0408,-0.0869,0.0641,0.0677,0.0173,0.0717,0.0177,-0.0503,-0.0514,-0.0607,-0.0544,0.0873,0.055,-0.03,0.0242,-0.0433,-0.0388,-0.0439,-0.0155,0.0519,0.0067,0.0593,-0.0642,-0.1057,-0.0221,-0.0801,-0.0623,-0.042,0.0733,0.0673,-0.0422,-0.0205,0.053,-0.045,-0.0354,0.002,-0.0446,0.0953,0.0563,-0.0573,-0.0951,-0.0403,-0.0606,0.0625,-0.0246,-0.0859,0.0532,-0.087,-0.0306,-0.1216,-0.0104,-0.1044,-0.0745,-0.053,-0.0402,-0.0611,0.0428,-0.1116,-0.071,0.0599,-0.0683,-0.032,-0.0324,-0.1238,-0.0381,0.256,-0.0328,-0.002,-0.0439,-0.0185,-0.0133,-0.0161,0.0978,0.0571,-0.0175,-0.124,-0.1509,0.0143,0.1043,-0.014,-0.0227,-0.0241,-0.066,-0.0729,0.0597,-0.047,-0.0641,0.0479,0.0553,0.0634,0.0257,-0.0285,0.0014,-0.0125,-0.0702,-0.0155,0.0663,-0.082,-0.0065,-0.0414,-0.0442,0.0135,-0.0226,-0.0793,-0.0796,-0.0501,-0.0293,0.0949,0.0546,0.0397,-0.0014,0.0917,0.0449,0.0505,0.0288,0.0101,0.0689,0.0383,0.0167,-0.0214,0.2385,0.0344,0.1264,0.0278,0.2367,0.1652,0.321,-0.016,-0.0207,-0.0371,-0.0438,0.0846,0.0252,0.1497,-0.0129,0.0483,0.0788,-0.0867,-0.0047,0.0743,0.0405,-0.0192,-0.0702,-0.0286,0.0141,-0.0444,-0.0489,0.0176,-0.0535,-0.0068,-0.0145,-0.023,-0.0448,-0.2062,0.0342,-0.1219,-0.0611,0.05,0.006,-0.026,0.0796,0.1872,-0.0572,-0.0107,0.109,0.0475,-0.0398,0.1022,-0.0097,0.0379,0.0665,0.0203,-0.0577,0.0572,0.1283,0.0699,0.0673,0.0281,-0.0595,0.1025,0.1419,0.0404,0.0236,0.108,0.2877,0.0088,0.0218,-0.0327,0.0143,-0.0522,-0.0258,0.0051,0.1526,0.0337,0.0237,0.0502,0.1448,0.0299,0.1145,0.0337,-0.0052,-0.0099,-0.0133,-0.1541,-0.0127,0.0937,0.0085,-0.0386,0.022,0.071,-0.0091,-0.0232,-0.0069,0.0032,-0.0786,-0.0688,-0.062,-0.0192,0.002,0.0456,-0.0156,-0.0289,0.0217,-0.0794,0.0645,0.0242,0.0692,-0.0373,0.6135,0.7281,0.0802,0.1719,-0.0642,0.0988,0.3091,-0.125,-0.1045,-0.0138,-0.0207,0.0922,-0.0145,0.4618,0.1938,0.3294,-0.0228,0.08,-0.0572,-0.0076,-0.0046,0.027,0.0259,0.5033,0.0027,-0.0213,-0.0155,0.6457,0.5223,0.3606,0.4806,-0.0786,0.0081,-0.0109,-0.0951,0.5094,-0.0548,-0.0166,-0.0098,0.0999,0.0603,-0.0139,-0.0015,-0.0782,-0.0295,0.0117,-0.0519,0.0733,-0.0033,-0.0179,0.6064,0.0807,0.1405,0.0616,0.1391,0.0971,0.1199,0.0114,-0.0658,0.0748,0.0227,-0.0669,0.0903,-0.0494,-0.0771,-0.0183,0.1311,0.1704,0.0344,-0.0186,-0.0538,-0.0471,-0.0525,-0.0209,0.0317,0.044,0.0716,-0.0707,-0.0927,-0.0719,0.0229,-0.0053,-0.0467,0.1196,0.1401,-0.0123,0.0457,0.3949,-0.0653,-0.0303,0.0392,0.0369,0.0458,-0.0376,0.1046,-0.1051,0.0264,-0.0045,-0.0842,-0.0276,0.0155,-0.0757,-0.0481,-0.0161,-0.0587,-0.048,0.0308,-0.0411,-0.0537,0.1006,-0.0164,0.0443,-0.0395,-0.0106,-0.0218,0.1552,-0.081,0.029,-0.0174,-0.0123,0.0058,-0.0337,-0.0012,0.1577,-0.1073,0.1415,0.3057,-0.0099,0.4818,-0.0822,-0.0706,0.2108,-0.1143,0.6175,-0.0034,0.0091,-0.0188,0.0349,0.0513,0.0212,0.0665,0.2054,0.1751,-0.0244,0.0091,0.1039,-0.0027,-0.0737,-0.0918,-0.0896,-0.0349,-0.0214,-0.0563,0.0362,-0.0262,0.2205,-0.0011,0.0236,0.0151,-0.0069,0.0188,0.014,0.0211,-0.016,-0.0466,0.0287,-0.0181,0.1098,0.0048,-0.0349,-0.1668,-0.0441,0.0008,-0.0974,0.0023,-0.0418,-0.0383,-0.091,-0.0055,-0.0403,-0.0701,-0.0783,-0.0071,-0.0857,-0.0369,-0.0011,0.0712,0.0643,0.3923,0.1902,0.1108,0.1866,0.3086,0.4786,0.1375,0.0907,0.1194,-0.0629,0.0432,0.0329,0.4021,0.6267,0.0472,0.0834,0.0886,0.0068,-0.0162,-0.0633,-0.0481,0.0181,0.0394,-0.03,-0.0582,0.0148,-0.0414,-0.1068,-0.0278,0.0311,0.0052,0.0306,0.0072,-0.0875,-0.0559,-0.0298,-0.0018,0.0139,-0.0327,0.0025,-0.0081,-0.0004,-0.0316,-0.0864,-0.0084,-0.0537,-0.0666,0.0011,-0.0157,0.0309,0.0969,-0.0882,0.032,-0.042,-0.0697,0.1549,0.0767,0.1139,-0.0064,-0.0357,-0.0219,0.3895,0.5203,-0.0471,0.0172,-0.0572,-0.0493,-0.0549,0.0143,-0.0342,0.0032,-0.0534,0.0143,0.0257,0.0508,-0.0189,0.0098,-0.03,0.0835,-0.0541,-0.0712,-0.0013,0.0091,-0.0549,0.078,-0.037,0.0051,-0.0479,-0.0778,-0.0281,-0.0127,-0.0546,-0.0159,0.0088,-0.0088,-0.0624,-0.0888,0.0319,-0.0252,0.0271,-0.0322,-0.0532,-0.0025,-0.0016,-0.0564,0.0105,0.0497,-0.0408,-0.0144,-0.0393,-0.0716,-0.0606,-0.0234,-0.0605,-0.0166,0.0313,0.0055,-0.0321,-0.036,-0.0111,-0.0327,0.1099,-0.0306,0.0394,0.2034,-0.0098,-0.0037,0.0206,-0.027,0.039,-0.0692,0.0628,0.0619,-0.0306,-0.0592,0.0031,0.0234,0.0449,0.084,-0.0114,-0.0022,0.0822,-0.0898,0.0487,-0.0177,0.0328,-0.0234,-0.0452,0.0022,0.0414,-0.1612,-0.0988,-0.0026,-0.0287,0.0246,-0.0344,0.0545,-0.0479,-0.0237,0.1414,0.0079,-0.0251,0.0042,-0.0039,0.0376,0.0771,0.0831,0.0193,-0.02,0.0164,-0.0085,0.1465,-0.0146,-0.0079,-0.121,-0.0075,-0.0646,0.0012,-0.0071,-0.0267,-0.1482,-0.0678,-0.0726,-0.0318,-0.033,0.0492,0.0895,0.032,-0.0011,0.0561,-0.0184,-0.0165,-0.1097,-0.063,-0.0212,-0.0511,-0.0272,-0.0278,-0.1803,-0.1867,0.0451,-0.0943,-0.0289,-0.1743,-0.0862,0.2754,-0.1416,-0.0998,-0.0302,-0.158,-0.0681,-0.1079,-0.0807,-0.1261,-0.0323,0.068,-0.0599,-0.071,-0.1214,-0.0194,-0.08,-0.1085,-0.1497,-0.0051,-0.0162,-0.065,0.4598,0.5231,0.0076,0.0061,-0.0395,0.0528,0.0501,-0.0029,-0.0051,0.0716,0.0009,0.0026,-0.0425,-0.034,0.0139,0.0391,0.0013,0.0193,-0.018,-0.0586,-0.0605,-0.0025,-0.0503,0.0335,0.0034,-0.0341,-0.0063,0.0328,-0.0522,-0.0488,0.0773,-0.1138,-0.0781,-0.0816,0.0625,-0.0549,-0.0051,0.0367,0.1439,0.0956,-0.0717,-0.0698,0.0416,-0.0512,0.0534,-0.0093,0.0416,0.0087,0.0013,-0.037,-0.0997,-0.0751,-0.0524,-0.0073,-0.0192,0.0035,risk
trm_4a3fd79d09d93,0.0279,0.0433,0.0617,0.0895,0.0189,0.0368,0.0155,-0.0238,-0.0719,0.0438,-0.0234,-0.0036,0.0348,0.0161,0.0626,0.0233,0.0916,0.1431,-0.0021,0.0645,0.0886,0.0423,-0.0057,-0.0518,0.0296,0.0036,0.0034,0.1434,0.1028,0.0532,0.0669,0.09,0.0387,0.0517,0.1127,0.1128,-0.0014,0.0401,0.0272,0.0813,0.0806,0.046,0.0103,-0.0086,0.0825,0.1135,-0.1234,0.0259,-0.0489,0.1377,0.0617,-0.0024,-0.012,-0.0133,0.1265,0.0673,0.1025,0.0083,-0.0335,0.0306,-0.0005,-0.0202,0.1316,-0.0326,0.0015,-0.0771,0.1589,0.2176,0.1241,-0.0014,-0.0713,-0.0191,-0.0438,0.0336,0.0341,0.0337,0.0429,-0.0028,-0.0633,-0.0245,-0.0279,-0.0061,0.0436,0.0876,0.0016,-0.0607,-0.0043,-0.0338,0.0055,0.2859,0.0625,0.0035,-0.0117,-0.3915,-0.3313,-0.3488,-0.1297,-0.1091,-0.1939,-0.177,-0.0595,0.0651,-0.081,-0.1953,-0.144,0.1147,0.1368,-0.095,0.0445,-0.0108,0.0019,0.0777,-0.0419,-0.1271,-0.0068,0.0158,0.0887,-0.1527,0.0528,0.044,0.129,0.1333,0.1549,0.0411,0.1354,0.1331,0.1467,-0.0766,-0.0545,0.0253,0.0621,0.0744,-0.0022,0.157,0.1109,0.2209,0.0017,0.0991,0.035,-0.0118,0.0644,0.1093,-0.0515,0.0936,0.098,-0.0568,0.0463,0.0109,0.058,-0.0055,0.0468,0.1021,0.0506,0.1666,-0.0628,0.0065,-0.1078,-0.0617,-0.0097,0.0432,0.0412,0.1377,0.1804,0.1133,0.0255,-0.0313,0.0188,0.144,0.1329,0.0531,0.0424,0.1185,-0.0577,0.1478,0.1142,0.1253,0.084,0.1033,0.0767,-0.0185,0.1523,-0.045,0.0938,-0.0049,0.0629,0.0686,-0.0033,0.1037,0.0608,0.0945,0.0918,0.1073,0.0078,0.1487,0.1364,0.1377,0.1376,0.0666,0.0176,0.0203,-0.0204,-0.3607,0.1249,0.1208,0.0364,0.1383,0.1999,0.0745,0.0182,0.0228,0.1488,0.0181,-0.0359,0.0623,0.0075,0.01,-0.0504,0.0169,-0.0338,-0.0162,-0.1588,0.0871,0.0827,0.056,-0.0753,-0.0634,0.0671,-0.1027,0.1179,-0.0752,-0.1875,0.0465,-0.1734,0.043,0.0433,-0.0357,0.0414,-0.0153,0.0317,0.082,-0.048,0.0865,-0.0196,0.0028,0.0642,0.0729,0.0816,0.1493,0.0711,0.1861,-0.0103,-0.0551,0.0349,-0.0232,0.0478,0.1338,0.0031,0.0192,-0.1097,-0.1234,-0.0532,-0.2043,0.0843,-0.0988,-0.1313,-0.2071,-0.0598,0.0295,-0.0594,0.0023,0.023,0.004,0.0698,-0.0031,0.0843,0.0849,0.2406,0.2882,0.1688,0.1506,0.0825,0.0559,0.0468,0.2291,0.2006,0.0358,-0.0494,-0.0556,-0.0125,0.0405,0.0418,0.0409,0.0435,0.0341,0.0594,-0.0391,0.067,-0.0275,0.0328,-0.0797,-0.0049,0.1902,0.0513,0.0864,-0.0743,-0.0949,0.0488,0.0924,-0.0728,0.008,0.034,0.0001,0.0603,0.0045,-0.0168,0.0154,-0.0995,-0.083,0.0024,0.1078,-0.0145,0.0069,0.0843,0.121,0.0139,0.0478,0.0323,0.042,-0.0116,0.0451,0.0387,0.0879,0.0166,-0.0039,0.0421,-0.0677,0.0081,0.0869,-0.0023,0.1466,0.135,0.0286,-0.0645,-0.026,-0.0873,-0.0202,0.0933,0.0372,0.0577,0.0412,-0.0317,-0.2985,-0.0387,-0.0471,0.0118,-0.0311,0.0352,0.0779,0.1048,0.0864,-0.0645,-0.0107,0.0994,-0.018,-0.0414,-0.1096,0.1241,-0.1215,-0.0419,0.0607,0.029,-0.099,0.0236,-0.1422,0.0947,-0.0315,0.0724,-0.0584,-0.0702,-0.0279,-0.0515,-0.1427,0.0766,0.0091,-0.0906,-0.0947,0.0257,0.002,0.0016,0.0317,-0.0459,0.0245,-0.0647,0.034,-0.0601,-0.0952,-0.1094,0.0483,0.0222,0.093,0.0842,-0.0049,0.0052,0.0229,-0.0259,0.009,-0.0715,-0.0164,0.0726,0.0027,-0.0284,0.0689,0.0358,-0.1812,0.1233,0.1477,-0.1252,0.0451,0.1042,0.024,-0.0354,0.083,0.0394,0.1842,0.1684,0.0224,0.1333,-0.124,0.0558,-0.0484,0.0012,-0.0453,0.0235,0.0145,0.0827,-0.0216,-0.0922,0.0278,0.1287,0.0679,-0.1281,-0.1327,0.0026,-0.0701,0.0349,0.0217,-0.0225,-0.1704,0.1254,0.1238,0.0466,-0.0059,0.0974,0.1067,-0.0186,0.1546,0.0602,0.0695,0.0721,0.0133,-0.0362,-0.0038,0.0442,-0.0101,0.0677,0.1189,-0.09,-0.2194,0.0595,0.0445,0.0045,-0.0242,-0.0939,0.0184,0.041,0.0346,-0.1017,-0.0314,0.0404,0.0134,-0.1697,-0.0103,-0.0571,-0.067,0.0193,-0.0136,-0.017,-0.0243,0.131,0.0074,-0.0991,-0.0599,0.106,0.1507,-0.0387,-0.0079,0.2791,0.0118,-0.0054,0.0895,0.0795,0.0117,0.0855,0.0473,0.0682,0.0474,0.005,0.0601,0.0327,-0.1927,0.1254,-0.0367,0.0648,0.0057,-0.1179,-0.0563,0.1298,0.1032,-0.1292,0.0426,0.0492,0.0989,-0.0522,-0.0453,-0.0859,-0.045,-0.0327,-0.1217,0.0049,-0.0749,0.0576,-0.0066,-0.0238,0.1169,0.0594,0.0072,0.1075,0.0347,0.0106,0.0769,0.0378,-0.0395,0.0214,0.0384,0.0575,-0.0132,0.0323,-0.0171,0.0341,0.0429,-0.0902,0.0721,0.0189,-0.0742,-0.0171,0.0992,-0.0221,-0.0327,-0.0023,-0.0094,0.0333,0.0135,0.0722,-0.0366,0.1009,0.0062,0.0217,0.1487,0.0484,0.0981,0.0739,0.0826,0.0809,0.0212,-0.2606,-0.198,-0.0611,-0.0576,-0.0366,0.0036,0.0099,0.0287,0.0437,0.007,-0.0165,-0.029,-0.0994,0.0071,-0.0788,0.0478,0.0981,-0.0115,-0.0587,0.0146,0.035,0.033,0.1845,0.036,-0.1371,0.1231,-0.0501,0.0094,-0.043,-0.0099,-0.1066,-0.2411,0.0871,0.0729,0.0607,0.0166,0.1393,0.0446,-0.0164,0.0504,0.1201,0.0667,0.0227,0.0595,0.0113,0.1315,0.041,0.1072,-0.0926,-0.016,0.0343,-0.0769,0.0299,0.0585,-0.014,-0.0149,-0.0464,-0.101,0.0176,0.0429,0.002,-0.1386,-0.0403,-0.0174,0.1002,-0.018,0.031,-0.1251,-0.0783,-0.1954,0.0682,0.0491,0.1643,0.1065,-0.1632,0.1117,0.0411,0.0772,-0.2166,0.0977,0.0564,-0.0353,-0.2347,0.0047,-0.0088,0.0943,0.125,-0.1948,-0.1288,-0.17,-0.1741,-0.1066,-0.0715,0.1097,-0.0888,-0.0074,0.0197,0.0022,0.0059,-0.0036,0.0357,0.0713,-0.1521,0.0363,0.0205,0.0629,-0.0028,-0.0997,-0.071,0.0243,-0.0558,0.1407,0.0606,-0.028,-0.0282,-0.0471,0.0123,-0.1341,-0.1486,-0.0263,0.041,0.1408,-0.0312,0.0432,0.0427,0.0516,0.0033,0.0283,0.0473,0.0818,0.0756,0.0043,0.0712,0.0545,0.0477,-0.001,-0.03,0.0712,0.0618,0.0291,0.0962,0.0689,-0.0034,0.118,0.0941,-0.0195,-0.0556,0.0656,0.2023,0.2,0.1385,0.0358,0.0489,0.0756,0.051,-0.0501,-0.0565,0.0322,-0.0054,-0.0638,-0.1139,-0.0265,0.0587,-0.0847,-0.1054,-0.0893,0.1373,-0.0487,-0.0037,-0.0586,0.0097,0.1008,-0.0446,-0.0463,0.0071,-0.0142,0.016,-0.1112,0.1444,0.216,0.1916,0.1491,-0.0449,-0.1127,-0.0085,0.0526,0.0261,-0.053,-0.0511,-0.0008,-0.0079,-0.0555,0.0637,0.0126,-0.0416,-0.0167,-0.0568,-0.1409,0.0268,0.0154,-0.0887,0.0854,-0.0602,0.0944,0.0892,0.1081,0.1202,0.101,0.0674,-0.1268,-0.0375,0.0076,0.0594,0.0255,-0.0226,-0.0735,-0.0221,0.0775,-0.0408,-0.002,-0.0196,-0.0563,-0.0777,0.114,-0.0771,0.1578,0.1504,-0.0774,-0.0683,-0.1672,0.017,0.0321,-0.0578,0.0423,-0.1463,-0.2149,-0.0544,-0.1173,-0.1106,-0.1241,-0.0961,-0.0316,-0.1278,-0.0777,0.0269,-0.0347,0.033,0.1127,0.1251,-0.0513,0.0294,-0.0497,0.2371,0.0709,0.1516,0.1087,0.1538,0.001,0.0118,-0.0861,0.0965,0.042,0.0595,-0.0516,-0.0486,-0.0119,-0.0283,-0.052,0.0052,-0.0831,-0.0288,0.0042,-0.0714,-0.089,0.083,-0.1044,-0.0721,0.009,0.0478,0.0447,0.0803,-0.053,0.0127,0.1782,0.1484,-0.0135,-0.0409,0.0408,0.0554,0.04,-0.0401,-0.1505,0.0437,0.0676,-0.1694,0.0858,-0.0517,0.0797,-0.2937,0.0554,-0.0988,-0.0125,0.0445,-0.0338,0.1812,0.1603,0.0441,-0.2166,0.0748,0.0654,0.0316,-0.043,-0.0057,0.0789,0.0647,0.1225,0.0003,0.0051,-0.0964,-0.1212,0.0432,-0.0726,0.0868,0.0608,0.0403,0.0572,0.0621,0.0007,0.0072,-0.0212,-0.03,-0.1566,-0.0914,0.051,0.0964,0.0904,0.0608,0.0929,0.0761,-0.1267,-0.1699,-0.0397,0.0409,0.0662,-0.1267,-0.1249,-0.0415,0.0198,0.0736,0.0254,-0.0447,0.0405,0.0457,-0.1269,-0.0235,0.0863,0.0363,-0.0584,-0.0626,0.0599,0.0305,-0.0097,0.0827,0.0067,-0.0382,0.0919,0.0899,0.211,0.1183,0.1922,0.057,0.0607,0.0959,0.1144,0.0886,0.1417,0.1045,0.1817,-0.0187,-0.0429,0.0127,-0.0679,-0.0846,0.0472,-0.0581,-0.0055,0.0114,-0.0686,-0.0182,-0.0164,0.0445,0.0816,-0.0022,-0.0543,0.0431,-0.0216,-0.0213,-0.0369,-0.0333,0.0485,0.0313,-0.0618,0.0353,0.0067,-0.0339,0.0015,0.1232,0.0308,0.1337,0.1072,0.0944,0.1668,0.1414,-0.0692,-0.0191,-0.0781,-0.0466,-0.0359,-0.0523,0.0189,-0.0106,-0.0365,0.0085,-0.0709,-0.0218,0.0322,0.0458,0.0296,0.0334,-0.032,-0.0083,0.0514,0.0601,0.0942,0.1657,0.0953,-0.1068,-0.0923,-0.1178,0.0306,-0.0422,0.0859,0.0387,-0.0142,-0.0064,-0.0026,0.0472,0.0021,-0.0031,-0.0326,-0.0451,-0.0184,0.0819,-0.01,0.1056,-0.0041,0.0587,-0.0548,-0.2182,-0.3702,0.0168,-0.0147,0.0462,0.0132,0.0063,0.0228,0.0466,0.0767,-0.0318,-0.0057,-0.003,0.0212,0.0066,0.0113,-0.0182,0.0338,-0.0684,0.0285,0.0778,0.0674,0.0519,-0.0998,0.0103,-0.0742,0.1432,-0.2195,-0.0914,0.0581,0.0245,0.0399,0.0474,0.0585,-0.0463,0.0537,0.0877,0.0393,0.075,0.1436,0.0396,0.0881,-0.0114,0.0154,0.0878,0.0231,0.1039,-0.0576,-0.1695,0.0047,-0.045,-0.0793,0.041,-0.0816,0.1058,0.0019,0.0499,0.097,-0.2863,-0.1776,-0.2868,-0.216,-0.2556,-0.1002,-0.2686,-0.0909,0.1397,-0.1053,-0.1209,-0.0979,-0.0576,-0.0358,0.021,-0.0443,-0.0101,0.077,-0.0117,0.0485,-0.0352,-0.0412,0.0845,-0.0741,-0.0902,0.0423,-0.0788,0.0137,0.1124,-0.1353,-0.0175,0.1333,-0.0203,0.1001,-0.0482,-0.0423,-0.1415,0.0518,0.1178,0.1023,0.0564,0.0202,-0.0536,-0.0497,-0.0849,0.041,0.0849,0.0943,0.0325,-0.1221,0.0886,-0.2021,-0.2345,0.0944,-0.0609,-0.0948,-0.3472,-0.339,-0.248,-0.1745,-0.0305,-0.0066,-0.0912,-0.0584,-0.028,0.0994,0.0149,0.074,-0.2066,-0.0387,0.0862,-0.0012,0.0422,0.0033,-0.0682,0.0154,-0.0706,-0.2205,-0.0815,0.0598,0.0393,0.038,-0.0517,-0.0547,-0.0363,0.1532,0.1461,0.0933,0.1045,0.0386,0.1047,0.0937,0.0056,0.0479,-0.0021,-0.0352,-0.0394,-0.2589,0.0709,0.1133,0.1201,0.0104,-0.0124,-0.114,0.1325,-0.1082,-0.2662,0.0205,0.221,-0.1414,-0.1225,0.0288,0.1342,0.0009,0.1007,0.1163,0.1293,-0.0074,-0.1407,0.0694,0.0406,-0.032,0.0052,0.0367,0.0948,0.0103,0.0177,0.1145,0.0447,-0.0186,-0.0244,-0.1518,-0.1422,-0.1214,-0.1247,0.0706,-0.0073,0.0846,0.0894,0.0683,0.0579,-0.092,-0.1475,0.1657,0.098,-0.0544,-0.081,0.0136,-0.0955,-0.029,-0.0079,-0.0254,-0.1598,0.1116,0.1175,0.0854,-0.1976,-0.0199,0.028,-0.0509,-0.0509,0.1646,-0.1258,-0.1019,-0.0795,0.0034,-0.0089,0.0091,-0.3937,0.231,0.2234,-0.0038,0.0632,0.1535,0.175,0.1415,0.0188,0.0061,0.0699,0.0146,-0.0216,-0.3001,0.1009,0.1401,0.042,0.0243,0.0235,0.0562,-0.0826,0.0123,0.0641,0.0652,0.1418,0.0721,0.0545,0.1854,0.0349,0.0027,-0.3798,-0.2205,-0.254,0.0105,-0.3464,0.1076,0.0746,-0.0039,0.096,-0.0182,0.1376,0.0975,0.0081,0.0509,0.1705,-0.1212,-0.0285,0.1149,0.0081,-0.0549,0.0406,0.2614,0.1138,0.0757,0.0049,0.043,-0.0522,0.0401,-0.1484,-0.0839,-0.1153,-0.0776,0.0272,0.0124,0.0586,0.2665,0.2603,0.0201,0.0847,0.1212,0.1145,0.0136,0.0021,-0.0407,0.0339,0.1318,0.1405,-0.0078,0.0324,-0.0051,0.0125,0.1031,-0.0233,0.0148,0.0667,0.1383,0.1971,0.1268,0.0225,0.1053,0.0981,0.0032,0.0016,-0.1075,-0.1279,-0.0453,0.0412,0.0753,0.0063,0.0929,0.0455,-0.0635,-0.0358,-0.0782,0.1599,-0.0367,-0.0761,0.0399,-0.0103,0.0241,0.0569,-0.0372,0.0645,0.0092,0.0221,0.1746,-0.1297,0.0472,-0.0511,-0.2364,-0.0957,0.0223,-0.0732,-0.0885,-0.2261,0.0398,-0.0516,0.0662,0.0112,0.1191,0.1069,0.0735,-0.0505,0.0008,0.0801,0.098,0.0375,0.0569,0.0252,0.1052,0.0904,-0.0361,-0.023,-0.0073,-0.0651,0.0601,0.0273,0.0524,0.0886,0.0355,0.0437,0.0477,0.0559,0.0049,0.0275,-0.0508,-0.0001,0.0446,0.0593,0.0002,-0.0535,0.0739,0.1824,-0.0718,-0.1517,-0.2704,0.0048,-0.03,-0.005,-0.0844,-0.0696,0.0795,0.0709,0.0358,0.0213,0.1727,-0.0026,-0.0353,-0.0235,-0.0218,0.0317,0.0149,0.0786,0.1219,-0.0401,0.0685,0.0663,-0.1022,-0.2063,0.0464,-0.1045,-0.0606,0.001,-0.0044,-0.0229,-0.0622,-0.0148,-0.0211,0.0163,0.019,0.0065,0.0891,-0.0326,-0.0849,-0.0319,-0.1389,-0.1568,0.0502,0.0512,0.0001,-0.0412,-0.0285,-0.0041,0.0562,-0.028,-0.0259,0.0516,0.0197,-0.0614,-0.0826,0.0404,0.0083,-0.0105,-0.0616,0.1254,0.0618,-0.0338,-0.0346,0.0847,0.0471,0.0422,0.0071,0.0019,-0.0767,0.0227,0.0357,-0.0311,0.0363,-0.1829,-0.148,0.0011,0.0693,-0.0611,-0.025,-0.0001,0.054,-0.0722,0.031,0.0494,-0.1502,-0.1047,-0.0288,0.0417,0.0393,-0.0316,-0.4084,-0.3834,0.1194,0.0859,-0.0808,0.0676,0.0139,0.0123,0.1116,-0.0014,0.0315,0.0409,-0.0445,-0.0511,-0.1853,0.1004,-0.0787,-0.0702,-0.0039,-0.1461,-0.2884,-0.2076,0.0919,-0.1371,-0.0549,-0.0659,-0.0036,-0.0344,0.0341,-0.0162,-0.0097,0.0349,-0.0611,-0.022,-0.0249,0.0476,0.0162,0.1058,0.0424,0.0798,-0.1088,0.0984,0.0042,-0.0571,0.0383,0.0703,0.0143,-0.0004,0.0654,0.0403,-0.077,0.0441,0.136,0.2195,0.1074,-0.007,-0.0206,0.0271,-0.0338,0.0136,-0.0101,-0.02,-0.0606,-0.0384,0.0582,-0.2077,-0.0094,-0.0374,-0.3695,0.1133,0.1054,-0.0042,0.1636,-0.0473,0.0577,-0.0453,0.0431,-0.0053,-0.0559,0.0292,-0.0214,-0.0195,0.024,-0.0609,-0.0097,-0.0517,-0.0287,-0.1442,-0.1426,-0.1581,0.111,0.0204,0.0236,0.0665,0.0459,-0.0252,0.0933,-0.021,-0.0006,-0.0364,-0.0794,-0.1608,0.1298,0.0611,-0.0649,-0.0669,-0.0317,-0.0843,-0.0356,0.0248,0.0335,0.1669,-0.0117,0.0836,0.0357,-0.0417,-0.0146,0.2722,0.2396,0.3206,-0.0416,0.05,0.035,-0.1181,0.1682,0.0929,0.1161,-0.2194,-0.1095,-0.1032,0.0007,-0.0184,-0.031,-0.0237,-0.1779,-0.1964,-0.164,0.0283,-0.0005,0.0556,-0.0514,0.0636,-0.0535,0.1641,0.0836,0.1551,0.1074,0.0251,0.025,0.0444,-0.2491,0.0493,-0.088,-0.0751,-0.1286,0.0761,-0.0368,-0.0448,-0.0556,-0.046,-0.0338,-0.1507,-0.0371,-0.0715,0.1924,0.0837,0.1599,0.0199,-0.0148,0.0923,0.1021,0.0606,0.0751,0.0715,-0.0358,0.0738,-0.1506,-0.019,-0.0329,-0.1681,-0.0427,0.0016,-0.0195,-0.0219,0.1115,0.0358,0.119,0.0909,0.1001,-0.0219,-0.0487,-0.1387,-0.0817,0.0256,-0.0093,-0.016,0.2563,0.1572,0.1817,0.1283,0.0486,-0.0582,-0.0551,0.1168,0.1558,0.0886,0.0491,0.1223,-0.0114,-0.0278,0.0092,-0.0246,0.0315,0.093,0.0666,0.0181,-0.0748,0.027,0.0084,0.2179,0.0249,0.0517,0.0909,0.2384,-0.0595,0.1257,-0.0249,0.0552,0.008,0.011,-0.0062,0.1284,0.0873,0.1772,0.0989,0.0121,-0.0808,0.0509,0.0147,0.1206,0.1025,0.0396,-0.1299,0.0223,0.011,0.0173,-0.1083,0.1496,0.1734,0.1003,-0.0183,0.0623,0.1312,0.1049,0.1192,0.1107,0.0477,-0.0104,-0.0117,0.1949,0.0483,0.0648,0.0808,0.0538,0.0735,0.2008,0.0476,0.0923,0.0322,-0.0518,0.1165,0.2067,0.1245,0.1011,0.1419,0.0182,0.1872,0.1459,-0.0351,-0.2644,-0.2071,0.0046,0.0546,0.0068,-0.0517,-0.0487,-0.0811,0.176,0.202,0.024,-0.0604,0.0024,0.008,0.006,-0.0168,-0.0188,0.0099,0.0613,0.0673,-0.0004,0.0444,0.0755,0.0237,0.0806,0.0004,0.0058,-0.0227,-0.2475,-0.2068,0.018,0.1757,0.1188,0.1043,0.1424,0.2108,0.1374,-0.2966,0.0259,0.0147,-0.3442,-0.2176,-0.2469,-0.2809,-0.1402,-0.202,-0.192,-0.1588,-0.0691,-0.0811,-0.2131,-0.27,-0.2867,-0.3822,-0.3407,0.1701,0.0255,-0.0659,-0.3151,0.1547,0.1018,-0.0661,0.076,0.0138,-0.1231,-0.1113,0.0434,0.0737,-0.1096,0.2358,0.2216,-0.006,-0.0347,0.063,-0.1377,-0.0679,0.0941,0.0545,0.0159,0.0058,-0.0963,-0.0411,-0.0062,0.0009,-0.0566,0.2354,0.1004,0.0895,0.0975,0.0472,0.1192,0.131,0.0875,0.0806,0.1036,0.025,-0.074,-0.0772,0.0654,0.1851,-0.1243,0.0264,-0.0276,-0.0638,0.1035,-0.0561,0.0971,0.0918,0.0832,0.0486,0.0904,-0.0009,0.0027,-0.1919,-0.1223,-0.1544,-0.045,0.0748,0.0184,0.0898,0.0778,0.0296,0.0393,0.102,-0.0498,0.0369,0.1115,0.0083,0.053,-0.0633,-0.0297,0.2018,-0.0124,0.0889,0.0923,0.0864,-0.0004,-0.0413,0.0982,0.0725,-0.0696,0.0341,0.0882,0.0322,-0.0149,0.0311,0.0494,0.0792,0.0847,-0.1245,-0.186,-0.1513,0.049,-0.3745,-0.1694,0.078,0.1196,-0.345,-0.3677,-0.0602,-0.2367,-0.1751,-0.2359,0.0893,0.0868,0.0579,0.0669,-0.2821,-0.2482,-0.1189,0.0127,-0.0525,-0.1168,-0.3144,-0.3149,-0.2857,0.0181,0.0266,0.0171,-0.0102,-0.0254,0.0389,0.1226,0.0466,0.0245,0.1214,0.126,0.1044,-0.0448,0.0306,0.0238,0.008,0.0196,-0.1182,-0.1151,-0.079,-0.0096,-0.0557,0.0025,-0.0014,-0.0375,0.071,0.0755,0.0759,0.0039,0.1523,0.1617,0.1499,-0.0362,-0.0354,-0.0296,-0.1257,-0.0844,-0.1086,-0.0911,0.0324,-0.1624,-0.0053,0.1292,0.1614,-0.1029,-0.0359,0.0725,-0.106,-0.0927,-0.1449,-0.0927,0.0626,0.058,0.0427,0.0229,-0.2262,-0.0277,-0.0623,-0.0075,0.0799,0.0099,-0.0509,-0.0078,0.0068,-0.0011,0.1356,0.0617,0.1283,0.1301,0.127,-0.0881,0.0111,-0.0128,-0.0052,0.0407,-0.0499,-0.3433,-0.2889,-0.1249,-0.1856,0.1192,-0.1128,-0.0454,-0.2453,-0.2267,-0.171,-0.0722,-0.0464,-0.0125,-0.1574,-0.1186,-0.0485,-0.0386,0.0416,-0.0096,0.0431,-0.0256,0.0219,-0.0346,0.033,-0.0583,-0.0399,-0.0474,-0.1554,-0.0034,-0.1478,-0.0773,0.1681,0.123,0.1514,0.0787,0.1457,-0.0904,0.025,0.043,-0.011,-0.1489,-0.0672,0.1194,-0.0311,-0.0014,0.0662,-0.005,-0.0046,-0.0793,-0.068,-0.137,-0.1984,-0.2341,-0.1073,0.0044,0.0302,-0.1371,0.0403,0.0634,-0.0092,0.0107,0.0556,-0.0907,0.0687,0.0547,0.0528,0.1569,0.1744,0.1336,0.1195,0.0137,0.1198,0.0659,0.062,-0.059,0.0031,-0.0356,-0.0166,0.1586,-0.0186,0.0098,-0.1167,0.0532,-0.0223,-0.0354,0.1686,-0.0232,0.0813,0.0366,-0.2046,0.1851,0.1948,-0.039,-0.017,-0.0368,-0.0533,0.0029,0.0461,0.0156,-0.0126,0.0081,0.1464,-0.0487,-0.0774,-0.1019,0.0001,0.2059,0.1193,-0.0217,0.1388,0.0455,0.0126,0.0855,0.0146,-0.0596,-0.0613,-0.1255,0.2474,0.0986,0.1269,0.1882,0.1232,0.0888,0.0868,0.0868,0.0716,-0.0338,-0.0536,0.1253,0.0232,-0.0989,-0.0436,0.0067,0.0791,0.2211,-0.0856,0.0253,-0.0082,0.1084,-0.29,0.0343,0.0624,0.1075,0.0543,-0.044,-0.0534,-0.0124,-0.2187,-0.113,-0.1648,-0.2449,-0.1632,0.0312,-0.0119,-0.1781,-0.0876,-0.0195,0.0877,0.0697,0.0165,0.1055,0.0709,0.0112,0.0307,-0.0269,-0.0078,0.0967,-0.0709,0.0118,0.0638,-0.0741,-0.0448,0.1473,0.0466,0.1877,0.0768,0.0064,-0.0916,0.0925,-0.406,-0.3607,-0.1965,-0.2712,-0.2112,0.0287,0.008,0.0092,-0.0963,-0.0699,0.0178,-0.1016,0.0099,-0.0411,0.0509,-0.0644,-0.0499,0.0731,0.0009,0.0353,0.0341,-0.1996,0.2484,-0.2412,-0.1157,-0.2171,-0.0302,-0.2038,-0.1088,-0.1382,-0.0383,0.0283,-0.022,-0.051,0.0671,0.0948,0.1361,0.0628,-0.1145,-0.0284,0.0782,0.0461,0.0006,0.0103,-0.0155,0.0534,0.0063,0.0226,-0.0276,0.0243,-0.0521,0.0388,-0.0373,0.0378,0.0263,0.0952,0.0324,0.0388,0.0174,-0.0422,-0.0111,0.0675,-0.0685,-0.107,-0.111,-0.036,-0.0661,-0.1457,-0.0314,0.0142,0.0732,0.024,0.0267,-0.045,-0.0262,-0.0008,0.0458,-0.0013,-0.0393,0.041,0.131,0.1052,0.1355,0.157,-0.0117,-0.0376,-0.0401,0.1606,0.0719,0.1215,0.0011,0.0883,0.0358,0.0127,-0.1122,-0.1501,0.092,0.0712,0.0286,0.0535,0.0841,0.0624,-0.0754,-0.0379,0.1044,-0.0306,-0.0052,0.0124,-0.0745,-0.035,-0.0685,0.0073,0.0201,0.0999,0.0072,0.1375,0.0844,0.0472,0.0867,-0.1375,-0.2226,-0.1429,-0.0978,-0.137,0.0734,0.1012,0.0755,-0.0525,-0.0549,-0.0285,-0.0241,0.0745,0.0582,0.1148,0.0407,0.1521,0.1056,0.0435,0.0526,0.0618,0.1241,-0.0208,0.0491,0.0397,-0.0869,-0.0196,-0.0062,0.1451,0.0386,-0.0162,-0.0007,-0.0243,-0.0038,-0.0981,-0.055,0.0114,0.0467,-0.0028,0.0514,0.0365,0.0597,0.1645,0.0062,0.0235,0.0204,0.0637,0.0567,0.0149,0.0067,0.0912,-0.0477,0.1079,0.0074,0.1448,0.1082,-0.0093,0.1214,0.0765,0.1896,0.0801,-0.095,-0.0994,0.0995,0.0369,0.0602,-0.0849,0.0318,0.016,0.0956,0.1634,0.084,0.0359,0.0351,-0.0983,-0.0033,-0.0159,0.0365,-0.0526,-0.0419,-0.0086,-0.0662,0.0504,0.0693,-0.0151,-0.0256,0.0354,0.0401,0.0854,0.0682,-0.1294,0.0028,-0.0832,0.0043,-0.0707,-0.1491,-0.0998,0.0461,0.0674,0.1532,0.0031,-0.0186,-0.2548,-0.2464,-0.1124,-0.0046,0.0081,0.0007,-0.1302,-0.1241,-0.0932,-0.0706,0.1717,0.012,0.0583,-0.0819,0.1,0.0157,-0.083,-0.0741,0.0049,-0.0768,0.0245,0.0534,-0.094,-0.0197,0.0914,-0.121,-0.0314,-0.0098,0.0465,-0.0947,-0.0645,0.054,-0.0105,-0.0172,0.0147,-0.1484,-0.1087,-0.0858,0.0514,-0.0087,-0.0446,0.0335,0.0207,0.2118,0.2238,-0.1018,-0.0654,-0.1171,0.0647,-0.0536,0.109,0.1172,0.1103,0.1247,-0.0469,0.0705,0.0031,0.0578,-0.1058,0.065,0.1102,0.0376,0.0594,0.0885,-0.0444,0.1164,-0.0387,0.2355,0.0801,0.0066,-0.0297,0.0136,-0.0405,0.0629,-0.0523,0.0897,-0.2072,0.0959,-0.1455,-0.0214,-0.0465,-0.0461,-0.0638,-0.2023,-0.2172,-0.1802,0.1447,0.0888,0.0364,0.035,0.1167,0.0384,0.0688,0.1412,0.0869,0.0125,0.1301,-0.0713,0.037,0.084,0.0839,0.1333,-0.0218,-0.022,0.2317,0.1036,-0.0689,0.0891,0.1864,-0.0941,-0.1331,0.063,-0.0434,-0.0238,-0.0162,-0.1551,-0.1545,0.1407,0.083,0.099,0.0538,-0.1012,-0.0594,-0.0069,-0.0244,0.0018,-0.0723,-0.1965,-0.1331,-0.1194,-0.1636,0.1207,0.1633,0.0976,0.1675,0.088,0.0742,0.1611,0.1001,0.0436,-0.0299,-0.0106,-0.0418,-0.0454,0.101,-0.2697,-0.2423,-0.1292,-0.0894,-0.0129,-0.1516,0.2599,0.167,0.2506,-0.076,-0.1028,-0.1356,-0.0611,-0.0285,-0.1855,-0.0788,-0.2308,-0.056,0.0408,0.0775,0.0061,-0.0106,0.0212,-0.0103,-0.0447,-0.0474,0.0175,-0.0192,-0.0687,0.0817,0.0119,0.1269,0.0782,0.0073,0.0513,-0.263,0.015,-0.2163,-0.0868,-0.0396,0.0159,0.0147,-0.0518,0.003,-0.0414,-0.1435,-0.0771,-0.0985,-0.0611,0.0231,0.0481,0.0115,-0.1291,-0.0551,-0.0666,-0.1169,0.0247,-0.0566,-0.0252,0.0099,0.0285,-0.0233,0.0604,0.0795,-0.0477,-0.0983,0.0123,0.0758,-0.0941,-0.0695,-0.2007,-0.0801,-0.0033,-0.0674,-0.0167,0.0134,-0.1157,-0.1135,-0.0474,-0.0306,-0.0117,-0.1183,0.0946,0.0593,-0.0344,-0.0933,-0.1482,-0.0546,-0.001,0.0397,0.0954,0.0378,-0.018,-0.3126,0.0035,0.0468,0.0103,0.0528,0.1853,0.1259,0.1397,0.1216,0.031,0.0576,0.0848,-0.0216,-0.2067,-0.2002,-0.1218,0.0586,0.14,0.2763,0.0774,0.0742,-0.0866,0.0338,0.0468,-0.2413,-0.2511,-0.0761,-0.0254,-0.0385,0.0321,0.2386,0.0534,0.1447,0.0288,-0.1439,-0.1589,-0.0016,0.0531,-0.0142,-0.018,0.2207,0.0843,0.0419,0.0539,0.2669,0.2267,0.0725,0.2314,-0.0868,0.0644,-0.0268,-0.2283,0.2063,0.1161,0.0367,-0.0187,-0.0849,0.0911,0.0409,0.2673,0.1885,0.0965,0.1529,-0.2683,0.1137,0.0726,-0.0289,0.2422,-0.1151,-0.0776,-0.0677,-0.081,-0.0574,-0.1751,-0.0777,-0.0951,0.0377,0.004,-0.0408,0.042,0.0706,0.0105,0.0608,-0.135,-0.0253,0.0854,0.1544,0.1194,0.0312,0.0635,0.0139,-0.0835,-0.0121,0.0398,-0.1069,-0.03,-0.0217,0.1544,0.0568,0.1238,0.0815,0.1728,0.0919,-0.0114,0.1226,-0.0309,0.0318,0.0283,-0.0223,0.0397,0.0941,-0.0398,0.046,-0.0291,0.0435,0.0627,0.0367,0.085,-0.0279,-0.0215,-0.0576,0.0656,0.0551,0.0359,-0.103,-0.0744,0.0137,0.0231,-0.0939,0.0737,0.1159,-0.0283,-0.0592,-0.1122,0.0625,0.1019,-0.0407,0.0475,0.0385,-0.1,-0.2137,-0.2917,0.0133,0.0738,-0.0408,0.0804,-0.0097,-0.1972,0.0663,-0.3132,0.2545,-0.3168,-0.2999,-0.0759,0.0099,0.0447,-0.0311,-0.0401,-0.0639,-0.0799,-0.122,-0.0281,0.036,0.1067,-0.0786,-0.0938,-0.0457,0.1414,0.1081,0.164,-0.0095,0.0358,0.197,0.0766,-0.0092,0.003,0.0371,0.1047,0.1213,-0.2655,-0.0013,0.1244,-0.2428,-0.2168,-0.0361,0.0543,-0.1283,-0.2125,-0.1259,-0.0494,-0.1317,0.0203,-0.0254,-0.1289,-0.1036,0.0418,-0.1465,-0.0366,-0.0653,-0.0013,-0.2504,-0.1073,0.0818,0.0728,0.0082,0.2728,0.0549,0.1283,0.0868,0.1265,0.2748,0.0693,0.2519,0.1702,-0.0634,0.0993,0.1901,0.1655,0.1948,0.0852,0.0645,0.1286,0.0872,0.0929,0.059,0.074,0.1711,0.1209,-0.0215,-0.0671,0.039,-0.0127,0.0066,-0.0382,0.0553,0.1413,0.0521,0.0327,0.0153,-0.0167,0.1665,0.1845,0.0668,-0.0467,0.1303,0.1824,-0.0311,0.0502,0.0586,0.1451,0.0951,0.0433,0.0278,-0.017,-0.079,-0.0139,-0.1563,0.0649,-0.0931,-0.1286,-0.0271,0.131,-0.0802,0.1457,0.0903,0.0507,0.1581,0.1685,-0.0333,-0.1345,-0.2045,0.0037,0.1209,-0.2453,0.0879,0.0298,-0.1279,0.0913,0.0983,0.1324,-0.0536,-0.0343,-0.1598,-0.1114,0.1815,0.159,-0.1035,-0.1309,-0.0521,-0.1373,-0.0402,0.0542,0.0917,0.0966,0.0526,0.0864,0.1401,0.0716,0.0767,-0.043,-0.0462,-0.0681,-0.0435,-0.2315,0.0795,-0.0626,0.0168,-0.0455,-0.0342,-0.0312,0.015,0.0397,0.0624,-0.0205,0.073,-0.0067,0.032,0.0361,0.0573,0.016,0.0755,-0.017,0.0679,-0.0045,0.038,0.0144,0.0482,-0.1008,-0.0442,0.0168,0.0221,0.0398,0.0537,-0.0069,0.0534,0.0505,0.1056,0.093,-0.1764,-0.023,-0.1207,0.0049,-0.0428,0.1513,0.0792,-0.0246,0.0501,-0.1467,-0.1094,0.1301,0.1224,-0.0682,0.0597,0.046,0.0736,-0.1292,-0.312,0.1681,0.018,0.1009,0.0302,0.0038,0.1115,0.1517,0.141,-0.0605,0.0099,0.0385,-0.0132,0.1463,0.0751,-0.053,-0.0487,-0.0342,-0.0056,-0.0101,0.062,0.1383,0.0135,-0.1301,0.1006,-0.0854,0.117,-0.3628,0.1174,-0.1634,0.0348,0.0781,0.1846,0.1522,0.0338,0.0703,0.0345,-0.0091,-0.0034,-0.0098,0.0529,0.0047,-0.0053,-0.1337,-0.1616,-0.1257,-0.0514,-0.1587,-0.2155,0.054,-0.0012,-0.1704,-0.3633,-0.1561,0.0029,-0.1716,-0.1205,-0.0709,-0.2046,-0.2185,-0.2499,-0.2264,-0.1325,-0.1287,-0.0529,-0.1528,-0.1455,-0.3769,-0.1174,-0.2472,-0.2918,-0.1738,0.1033,0.1275,0.1283,0.1453,0.2544,0.2165,0.1578,0.107,-0.1786,-0.0825,0.2242,0.2014,0.1208,-0.0518,0.0394,0.1547,-0.161,0.0249,0.06,0.0007,0.0427,-0.0126,-0.0043,0.019,0.0992,-0.0671,0.1945,0.1789,-0.0808,-0.0407,-0.0048,0.0075,0.0107,0.1432,-0.07,-0.0865,0.0435,0.0122,-0.1079,0.0788,-0.0133,0.0778,0.1291,-0.0799,-0.085,0.1094,0.0987,-0.0207,0.093,0.048,0.1496,0.0054,-0.1571,0.1545,0.1134,0.0455,0.0304,0.0494,-0.0266,color perception
trm_4c3e05903e4bb,-0.1205,-0.1158,-0.1556,-0.1186,-0.0078,-0.0569,-0.1297,-0.0337,0.0092,-0.0806,-0.013,-0.0377,-0.1424,-0.0999,-0.146,-0.0692,-0.123,-0.1694,-0.0689,-0.107,-0.1124,-0.0094,-0.0676,0.0242,-0.0535,-0.0122,-0.0161,-0.1342,-0.1583,-0.0876,-0.1546,-0.1497,-0.1485,-0.1208,-0.1844,-0.1795,-0.0886,-0.074,-0.1542,-0.0507,-0.1587,-0.1184,-0.0761,0.0585,-0.0902,-0.0937,0.0907,-0.0724,0.0714,-0.1,-0.0375,0.0892,0.0903,0.0875,-0.0274,-0.0719,-0.126,-0.0684,0.0003,-0.0756,-0.05,0.0019,-0.1875,0.098,0.0856,0.1224,-0.2762,-0.3317,-0.1648,-0.0346,0.1107,0.0274,0.204,-0.1485,-0.1046,0.0725,-0.126,0.016,0.0587,-0.0666,-0.0103,0.1081,-0.0633,-0.1705,0.096,0.1053,0.0587,0.0069,-0.0158,-0.1554,-0.1167,-0.016,-0.0238,0.2711,0.1973,0.222,0.1703,0.0538,0.3173,0.165,0.0856,0.0059,0.1422,0.0882,0.1281,-0.2101,-0.2367,0.1885,-0.019,-0.0024,-0.0092,-0.1472,0.1403,0.2181,0.0453,0.0406,-0.1179,0.0786,-0.053,-0.1068,-0.1482,-0.1905,-0.1816,-0.0087,-0.0907,-0.1788,-0.0968,0.0596,0.0943,0.051,-0.1029,-0.1013,-0.0593,-0.3065,-0.0166,-0.2631,-0.0204,-0.1672,-0.0509,-0.0491,-0.1207,-0.1145,0.0497,-0.0458,-0.0492,0.1178,-0.0809,0.0327,-0.1249,0.089,-0.0868,-0.1563,-0.1875,-0.1938,0.181,-0.0189,0.0942,0.0256,0.014,-0.0844,-0.0791,-0.147,-0.2858,-0.2892,-0.0327,0.0142,-0.0501,-0.25,-0.2376,0.0248,-0.115,-0.1964,0.0598,-0.2835,-0.1762,-0.2444,-0.1815,-0.1609,-0.1063,-0.0134,-0.1856,0.0377,-0.1076,0.0549,-0.0999,-0.0799,-0.1475,-0.1396,-0.0922,-0.0525,-0.0362,-0.151,-0.0576,-0.2352,-0.214,-0.2272,-0.2106,-0.1004,-0.0243,-0.0612,-0.0171,0.2868,-0.2084,-0.1913,0.0952,-0.0719,-0.1816,-0.051,-0.0919,-0.0189,-0.2477,-0.1208,0.0194,0.0096,0.05,0.0284,0.0752,-0.17,-0.1179,-0.0122,0.0978,-0.1644,-0.2098,-0.0744,0.1234,0.0126,-0.0703,0.1419,-0.0375,0.253,-0.043,-0.2168,0.1708,-0.1695,-0.1559,0.1303,-0.0436,0.0937,0.0558,-0.0762,0.0055,-0.2277,-0.0676,0.019,-0.0865,-0.1109,-0.1063,-0.164,-0.0345,-0.1591,0.0218,0.0314,-0.0022,0.0972,0.0281,-0.2281,0.0467,-0.0522,0.1584,0.2322,0.1117,0.3087,-0.1316,0.1293,0.2286,0.4056,0.1906,-0.0412,-0.0179,-0.0267,-0.051,-0.064,-0.1537,-0.0254,-0.0251,0.0469,-0.0427,-0.1497,-0.0901,0.0375,0.0716,-0.0944,-0.0676,-0.2756,-0.2082,-0.1257,0.0628,0.0897,-0.1601,-0.1311,-0.1388,-0.1294,-0.052,-0.1085,-0.1316,0.0009,-0.0459,0.1814,-0.0218,0.2354,0.1235,-0.2327,-0.1359,-0.1641,0.0027,0.024,-0.156,-0.0406,-0.0096,0.0016,0.0269,-0.0152,-0.12,0.0993,0.0576,-0.0272,0.1912,0.0198,0.0889,-0.1653,0.0194,0.0171,-0.1167,-0.1401,-0.1226,-0.0798,0.0026,-0.0697,-0.097,-0.1482,0.0541,-0.1259,-0.052,-0.0229,0.0347,0.1463,0.1313,0.0104,-0.0435,-0.1581,-0.135,-0.0638,0.0422,0.0096,0.0596,0.0615,-0.3015,-0.2123,-0.2073,-0.1327,-0.1407,0.0536,-0.0848,-0.0036,-0.0845,-0.0883,-0.0624,-0.1637,-0.1735,-0.1256,0.0016,-0.0179,0.0911,0.0232,0.0275,0.1194,-0.1685,0.3213,0.0381,-0.1858,0.0076,0.1361,-0.0236,0.1737,-0.1744,-0.0143,-0.0987,0.1146,0.1156,0.1532,0.1626,0.0817,-0.0669,0.0889,0.0546,0.1064,-0.1068,-0.0323,0.0595,-0.0335,-0.0054,-0.0332,-0.0642,-0.0729,0.1218,0.0756,-0.07,-0.2115,-0.105,-0.0586,-0.068,0.0338,0.0374,-0.0375,0.0529,0.1276,0.0848,0.0023,-0.1631,-0.0473,-0.024,-0.2326,-0.0731,0.2611,-0.2006,-0.0578,0.2773,0.02,-0.0894,-0.018,0.0215,-0.2669,-0.1746,-0.3738,-0.3394,-0.1238,-0.2149,-0.0629,-0.1578,-0.0884,-0.0665,0.0851,0.0007,-0.0015,-0.0434,0.0754,0.042,0.0627,-0.3406,-0.1657,0.0399,0.0788,-0.0471,0.0757,-0.0982,-0.1144,0.0739,0.1702,-0.1263,0.0384,0.1363,0.0871,-0.1302,-0.0569,0.0788,-0.1916,0.0424,-0.0562,0.0277,-0.0,0.0754,-0.0524,-0.0776,0.0284,-0.1719,-0.1295,0.0567,0.3847,-0.1392,-0.043,0.0351,0.035,0.1697,-0.0536,-0.072,-0.0418,0.0506,0.0435,-0.0326,-0.0514,0.1186,0.0436,0.0417,0.1205,0.143,0.1798,-0.0016,-0.0072,-0.1246,-0.0461,0.066,0.2174,-0.1259,-0.1849,0.1109,-0.0032,-0.0679,-0.0479,0.0541,-0.1278,-0.1074,0.035,-0.0967,-0.1479,-0.1082,-0.1498,0.047,0.0155,-0.0563,0.1445,-0.2105,0.0654,-0.0177,0.0082,0.0685,0.1292,-0.1707,-0.1501,0.1831,-0.1139,-0.0529,-0.0753,0.0535,0.176,0.2381,0.024,0.2069,0.1965,0.0801,0.0997,-0.0861,-0.0388,-0.0882,-0.2928,-0.1332,0.0292,-0.2242,-0.1026,-0.0581,-0.1945,-0.0575,0.0093,0.0484,-0.0385,-0.1067,-0.0298,0.0242,0.0392,0.0098,-0.107,0.095,-0.0517,0.0063,0.0403,-0.0131,-0.1797,0.106,0.0896,0.0424,-0.0504,-0.1044,0.0018,-0.1217,0.0351,-0.0897,0.0458,0.0798,-0.071,0.0095,-0.0386,-0.079,0.0001,-0.1279,0.0015,0.05,0.0449,0.057,0.0909,0.1039,0.1161,0.0328,-0.1511,-0.0278,-0.048,0.1917,0.0663,0.138,0.0809,0.1272,-0.0511,-0.1426,0.0594,0.1813,0.1786,0.0202,-0.0283,-0.2939,-0.061,0.2041,-0.0758,0.023,0.0702,0.0605,0.0678,0.0526,0.0829,-0.0374,-0.1983,-0.1858,0.1333,-0.2129,-0.0705,0.0777,-0.0598,-0.3262,-0.1036,-0.1008,0.0491,-0.0224,-0.2994,-0.0757,-0.2611,0.0661,0.0044,-0.072,0.0626,-0.0842,-0.1832,-0.0428,0.0711,0.0806,0.1018,-0.0837,0.0063,0.095,0.0821,0.0934,-0.0159,-0.1051,0.0341,-0.0906,0.0942,0.0246,0.0023,-0.1129,-0.0489,-0.257,-0.211,0.1925,-0.2828,0.0959,-0.1811,0.2119,-0.1729,-0.0331,-0.0521,0.1204,-0.0711,-0.0516,-0.1039,-0.2372,0.0522,0.1833,0.0091,0.096,0.1283,-0.0802,-0.2343,0.0127,-0.0054,-0.0566,-0.1047,-0.0945,-0.0276,-0.0509,-0.107,0.2272,-0.1534,-0.0028,-0.0662,0.0715,0.0576,0.0817,0.0312,0.1493,-0.1713,-0.1236,0.0404,0.0357,0.0364,0.0674,0.2371,0.215,0.125,0.0329,-0.0543,0.0443,-0.0827,-0.0887,0.0122,0.0803,0.0403,-0.0589,-0.1309,-0.1048,-0.0332,-0.1824,-0.1629,-0.1626,0.0816,0.1097,0.047,-0.0519,0.0848,0.0058,-0.015,-0.0207,0.037,-0.1968,0.0442,0.1303,-0.0974,-0.3689,-0.3665,-0.2536,-0.0181,-0.0123,-0.136,0.0318,-0.0475,0.0073,-0.0395,-0.0715,0.109,0.1352,-0.0163,-0.1476,0.1501,0.167,0.3741,-0.2146,-0.0408,-0.0812,-0.0114,-0.0235,-0.1982,0.1434,0.0691,-0.0639,0.0403,-0.0035,0.0514,-0.2101,-0.3337,-0.2896,-0.2066,0.0473,0.1678,-0.0144,-0.1539,-0.0258,0.0417,0.1127,0.0347,0.0769,0.0102,-0.1199,-0.1035,-0.0451,0.158,0.1267,0.1482,-0.07,-0.0356,0.0415,-0.1052,0.0492,-0.1063,-0.1859,-0.029,-0.2085,-0.1978,-0.1265,0.0996,0.0885,0.0396,0.0015,-0.0752,0.028,0.1444,-0.019,-0.0932,0.0389,-0.0063,0.0613,0.0265,0.1309,-0.0829,0.2232,-0.2295,-0.2295,0.1119,0.1122,0.12,-0.0345,-0.048,0.0928,0.0269,0.0315,0.2088,-0.0125,0.1169,0.1107,0.1497,0.0595,0.0224,0.205,0.191,-0.1365,0.0409,0.1005,-0.2465,-0.2165,-0.0197,-0.1587,-0.0633,-0.3219,-0.1041,-0.219,-0.1663,-0.2725,-0.0178,-0.0422,0.0254,-0.0979,-0.0499,0.041,0.1133,0.1499,0.0424,0.101,0.1408,0.0339,0.1226,0.0658,0.0415,0.1392,0.1532,-0.1367,0.1948,0.0842,-0.0283,-0.0655,-0.1347,-0.068,0.1189,0.1118,-0.3615,-0.1907,-0.0433,0.1024,0.2032,0.1077,0.062,0.0935,0.0946,-0.0528,-0.1112,0.1679,-0.0657,0.0367,-0.2015,0.1758,-0.0888,0.1693,0.2373,0.0644,0.2279,-0.2327,-0.2181,-0.1309,0.2013,-0.0982,-0.1371,-0.1304,0.093,-0.0513,-0.1903,-0.0778,-0.1757,0.1306,-0.0688,0.0211,0.1128,0.0076,0.0761,-0.2116,-0.1191,-0.0469,0.0906,-0.1395,0.0599,0.0281,0.0647,0.1203,0.2437,0.1287,-0.1563,-0.092,-0.1347,-0.0948,-0.1445,-0.0629,0.075,0.1853,0.0477,-0.0221,-0.1434,0.1454,0.2522,0.1214,0.029,-0.0046,-0.0734,-0.1526,-0.0849,-0.0636,0.0065,0.0241,-0.1796,-0.0301,0.0995,0.012,-0.0736,-0.0588,0.0922,-0.1139,-0.0701,-0.0785,-0.173,-0.1674,-0.3143,-0.1654,-0.3358,-0.0573,-0.0581,-0.1245,-0.1658,-0.1474,-0.2077,-0.1722,-0.286,-0.1274,-0.1186,0.0256,0.0486,0.1381,-0.039,0.0553,0.0007,0.0291,0.0762,0.094,0.1294,0.09,-0.0529,0.007,0.0361,0.0099,0.1298,0.1229,0.1278,0.0004,0.1544,-0.0827,0.087,-0.0699,-0.0429,-0.048,0.074,-0.0108,0.0552,-0.208,-0.1168,-0.0984,-0.1312,-0.1066,0.0719,0.1676,0.0774,0.1138,0.1251,0.0688,0.0744,0.0725,-0.0362,0.0248,0.055,-0.0193,-0.0464,-0.0969,-0.1155,-0.076,0.1199,0.0918,-0.1432,-0.0991,-0.1189,-0.2338,-0.135,0.2281,0.0906,0.2192,0.0731,0.0427,-0.1096,-0.0187,0.082,-0.025,-0.0578,-0.0014,0.0144,-0.0598,-0.079,-0.0065,0.0881,-0.1179,-0.0275,-0.1139,0.0536,-0.1589,0.0613,0.1091,0.3023,0.2037,0.1329,0.0753,0.1055,-0.014,0.0023,-0.0356,-0.099,-0.0079,0.0026,0.0614,0.0337,-0.0361,0.0896,-0.024,-0.0841,-0.0189,-0.1957,-0.1969,-0.2069,-0.1186,0.2474,0.0125,0.073,-0.1946,0.223,0.1148,-0.0205,-0.0565,-0.0378,0.0622,-0.0295,0.0717,-0.1416,-0.1242,-0.0309,0.0059,-0.1641,-0.0979,-0.1074,-0.0592,-0.0801,-0.0871,-0.0911,-0.0648,0.0335,-0.0144,-0.0147,0.025,0.0883,-0.1102,0.0804,-0.1313,0.0276,-0.0495,-0.1314,0.3214,0.219,0.3167,0.2475,0.2614,0.0454,0.2697,0.114,-0.219,0.175,0.178,0.1033,0.0902,0.082,-0.0916,-0.026,-0.0855,-0.0174,0.0424,0.0389,0.0878,0.0324,-0.171,0.067,0.0548,0.0122,0.0945,-0.0051,-0.0569,0.1214,0.0409,-0.1099,0.0046,-0.1156,0.1246,0.0184,0.1998,-0.0419,-0.2423,-0.197,-0.1239,-0.0548,0.1087,0.1172,-0.0127,-0.1211,-0.2629,-0.2082,-0.1054,0.1934,-0.1091,0.2004,0.2142,-0.0703,0.0032,-0.0015,0.1687,0.2205,0.156,0.1637,0.0876,0.0317,0.1375,0.1156,-0.1506,-0.2321,0.0871,-0.1136,0.1141,0.0026,-0.086,-0.0356,-0.1646,-0.0726,-0.0472,-0.1189,-0.1469,0.0454,0.1751,-0.0918,-0.004,-0.0156,0.2113,0.0509,0.06,-0.2453,-0.2303,-0.0924,-0.1016,-0.0911,-0.1803,-0.13,-0.0279,-0.0328,0.2966,0.1416,0.1538,0.3072,0.0399,0.124,-0.0197,0.1515,0.063,0.2827,-0.0633,0.2864,0.4178,0.0794,-0.0938,0.3273,0.268,-0.0235,-0.1535,-0.004,-0.2194,-0.0905,-0.3086,-0.0753,0.1501,-0.0842,-0.074,0.0817,-0.0614,0.0057,-0.0717,-0.0772,-0.0498,-0.0979,0.0573,0.0865,-0.0335,0.2745,0.1837,0.2039,0.2432,-0.1638,-0.0204,-0.0919,-0.1351,-0.0746,-0.1032,0.0231,0.1277,-0.194,-0.1298,0.1337,0.0047,-0.0259,0.0977,0.0293,0.0354,-0.0157,0.1801,-0.1007,-0.1125,0.0111,0.1696,0.0679,-0.0313,-0.0225,-0.0225,-0.209,0.0797,0.0335,0.0528,-0.044,0.0565,-0.087,0.2783,-0.3524,-0.3265,0.1399,-0.051,-0.2892,-0.2957,-0.2321,-0.0312,-0.0858,-0.092,-0.0254,0.013,0.196,-0.0244,0.1201,-0.0556,0.129,-0.031,0.1329,0.1023,-0.0482,-0.0716,0.0236,-0.0538,-0.0392,-0.0927,0.0062,0.0671,0.014,0.1537,0.0786,0.1969,0.0106,0.1761,-0.1988,-0.1439,0.0295,-0.156,-0.0643,-0.2109,-0.3005,-0.0139,-0.1204,-0.2602,0.0235,-0.0636,-0.2193,-0.0222,-0.0679,0.0281,-0.171,-0.0252,-0.1432,-0.1702,-0.0849,0.103,-0.0999,0.177,0.1674,0.1221,0.1902,-0.0609,0.0409,-0.0843,-0.1618,-0.1631,0.0154,-0.128,0.0178,-0.1467,-0.0569,0.0415,0.0613,-0.0279,-0.2254,-0.1301,0.015,0.0889,0.0101,-0.0131,-0.087,0.0149,-0.1017,-0.1444,-0.1507,-0.2556,-0.1487,-0.0696,-0.2122,-0.2106,-0.0203,-0.0225,-0.0629,-0.0332,0.0475,-0.1553,-0.1256,0.1106,-0.2378,-0.0084,0.0415,0.0016,-0.1051,-0.1797,0.0208,0.1846,-0.0423,-0.014,-0.0092,-0.0558,0.1916,0.138,0.0135,0.0191,-0.2497,0.0727,-0.0152,0.0211,0.1619,0.0267,0.0364,-0.059,0.0101,0.1632,-0.1236,0.0069,-0.142,-0.0251,-0.1518,-0.1401,-0.0158,0.1235,0.022,-0.1163,-0.1445,0.0175,-0.0523,0.0158,-0.081,-0.173,-0.0248,0.0106,-0.1055,0.0719,-0.0957,-0.0576,-0.0585,-0.1012,-0.0968,-0.0857,-0.0589,-0.0573,0.0102,0.0036,0.1724,-0.048,-0.0205,-0.0576,0.0741,0.0245,-0.0641,-0.2193,0.0869,-0.0623,0.0691,0.0076,0.0569,0.0628,0.0647,0.0846,-0.09,-0.0438,-0.1453,-0.0417,-0.29,-0.0133,-0.2003,-0.0277,-0.1066,-0.0914,-0.0273,-0.134,-0.1035,0.2955,0.1883,0.0571,0.2336,0.2342,0.0859,0.0459,0.1654,-0.0094,-0.0567,-0.0037,0.2766,0.056,0.0481,0.0212,-0.0666,-0.0289,-0.1058,0.0493,0.0289,0.0206,0.1012,0.111,-0.1238,-0.1224,-0.0484,0.1215,0.155,0.0954,-0.2517,-0.0988,0.0066,-0.2269,-0.1538,0.0502,0.1102,0.0152,0.0473,0.0503,0.0243,-0.2119,-0.0565,0.0229,-0.0886,-0.2529,-0.0713,-0.0082,-0.0831,-0.06,0.1462,-0.0393,-0.0327,-0.0399,0.0321,0.1116,0.3097,-0.0566,0.0758,0.0322,-0.0024,-0.1468,-0.0699,0.0587,0.0297,-0.0078,0.1955,0.1067,0.0615,-0.0898,-0.1249,0.1036,0.4856,0.4819,-0.2361,-0.1788,0.0847,-0.078,-0.1208,-0.0369,-0.2287,0.0538,-0.0598,-0.0872,0.0119,0.0251,0.308,0.0018,0.2107,0.0717,0.0241,0.1767,0.4276,-0.0325,-0.0978,0.2781,0.0453,0.0979,0.0743,0.056,-0.0983,0.1654,0.1115,-0.0132,-0.0406,0.0619,0.0042,0.1383,0.1081,-0.0352,0.0067,-0.0132,0.1403,-0.1725,0.003,0.1481,-0.076,-0.0219,-0.0268,0.0159,-0.1575,-0.0541,0.083,-0.0972,0.1306,-0.0651,0.0981,0.1769,-0.0463,-0.0536,0.0368,-0.0188,-0.0146,0.0969,0.143,0.1046,-0.0022,0.2095,0.1292,0.0704,0.3454,-0.1721,-0.136,0.1622,-0.1781,0.0897,0.0839,0.1996,-0.1169,0.0179,0.0126,-0.0285,0.0352,0.0404,-0.0418,0.0579,0.0414,0.0734,0.0253,0.1339,0.3026,0.2974,-0.106,-0.1839,-0.1185,-0.0032,0.1422,0.0592,-0.07,-0.002,0.0493,0.051,0.1215,-0.043,-0.3537,-0.1519,-0.0442,0.1457,-0.0394,0.0199,0.0456,0.1115,0.0914,0.1033,-0.0412,-0.0737,0.0105,0.0261,0.1225,-0.1016,-0.1289,-0.1401,0.0267,-0.0393,-0.0011,0.3437,-0.1203,-0.1146,0.0062,0.2279,0.1551,0.1815,-0.1152,-0.0292,0.021,-0.0009,0.1594,0.1777,0.1897,-0.0607,0.0617,0.0755,0.099,-0.146,0.1447,-0.2936,-0.0747,-0.1006,-0.1895,-0.0539,0.0542,-0.045,0.0181,-0.0832,0.0136,0.0115,0.0445,-0.1298,-0.0212,-0.0149,-0.0037,-0.0162,0.1405,0.2393,0.1798,0.3245,-0.2843,-0.1671,-0.224,-0.0742,0.1056,-0.0848,-0.1635,-0.1126,-0.1679,-0.0737,0.2092,0.0614,0.2246,0.112,0.0272,0.0498,-0.0442,-0.0225,-0.0221,0.0108,-0.245,-0.0341,-0.1744,-0.0565,-0.1035,-0.0387,0.1035,0.2789,0.1625,0.1235,0.0838,-0.1038,-0.3798,-0.1909,-0.2988,-0.2213,0.0056,-0.0305,0.0297,-0.164,-0.238,-0.1724,-0.0663,0.0545,0.0231,-0.0302,-0.1045,-0.0463,-0.0699,-0.2469,-0.1518,-0.139,0.1112,0.028,-0.0408,-0.3397,-0.0195,-0.1396,-0.2174,-0.4041,0.0526,-0.089,-0.1039,-0.0964,-0.0451,-0.0021,-0.0156,-0.1498,-0.1312,-0.1962,0.1917,0.0509,0.2507,0.0215,0.1209,-0.0627,0.1023,0.1715,0.3226,-0.0976,-0.0479,-0.0282,0.1646,-0.2082,-0.245,-0.1839,-0.0974,-0.1002,-0.1929,-0.1698,-0.136,-0.131,-0.0286,0.0154,0.0354,-0.3376,0.0059,0.0101,-0.1209,-0.0689,-0.1091,0.0086,-0.1949,0.1499,0.0409,0.0804,-0.0139,-0.0659,-0.2952,-0.1413,-0.1815,-0.0827,-0.246,-0.1754,0.0569,0.0979,0.0651,-0.0277,-0.0897,0.0078,0.1572,0.2284,0.2387,-0.344,-0.3774,-0.021,0.0872,-0.0345,-0.0573,0.0824,-0.1125,-0.0007,-0.0343,-0.074,-0.1629,-0.0074,-0.1072,-0.1251,0.0027,-0.1492,0.0875,-0.0264,0.1331,0.1499,0.1165,-0.0736,-0.2,-0.2257,-0.1799,-0.1324,-0.3486,-0.1756,0.2245,-0.0707,-0.126,0.1507,0.0922,0.0115,0.1299,0.0272,0.0597,0.2709,0.0267,0.1259,0.0711,0.0147,0.0825,0.0745,0.1897,0.2128,-0.2572,-0.0111,0.0605,0.2374,-0.0322,-0.1101,0.0672,-0.0483,0.0196,0.1134,0.0635,-0.0533,-0.0179,-0.1292,-0.0814,-0.1114,0.0904,-0.1031,0.053,0.1712,0.2629,-0.0303,-0.0093,0.0866,0.1101,0.0356,0.0587,0.0516,0.0159,0.0335,-0.3954,-0.1561,-0.1858,-0.1856,-0.1074,-0.1935,-0.2406,-0.168,-0.0323,-0.0999,-0.2105,-0.1397,0.0923,-0.1376,-0.3739,0.1352,-0.0698,0.0235,0.0499,-0.1245,0.0605,-0.1864,-0.1058,-0.0152,-0.1111,-0.083,0.0546,-0.1419,0.0643,0.1211,0.1116,-0.0033,-0.1592,0.0647,-0.0442,-0.2091,-0.0799,-0.1251,-0.1122,0.126,0.0136,-0.0235,-0.136,-0.122,-0.0338,0.0513,-0.0636,-0.0965,-0.1321,-0.0613,-0.0204,-0.0733,0.0861,-0.1513,-0.0908,0.1246,0.067,0.0257,0.0515,0.0297,-0.1852,-0.0175,-0.0958,-0.1667,0.2304,0.3455,0.2956,-0.0701,0.3889,0.1761,-0.181,-0.1369,0.3409,0.2051,0.0921,0.1118,0.1069,0.1292,-0.1265,-0.1188,-0.0721,-0.0981,0.342,0.2922,0.197,0.0092,0.1101,0.1702,0.3942,0.3861,0.3476,-0.0364,-0.0199,-0.0347,-0.0266,-0.022,0.0213,-0.2388,-0.1129,-0.0669,-0.073,-0.0934,-0.0998,0.1193,0.0093,0.0284,-0.0929,0.0136,0.2103,0.3011,0.0175,0.017,-0.0359,-0.0426,-0.0541,-0.0538,0.0068,-0.1156,-0.0477,-0.0353,-0.2025,-0.3009,-0.2693,0.1044,-0.0334,-0.0111,0.1363,0.0594,0.2522,0.0635,0.1337,0.3091,-0.1203,-0.2007,-0.2307,0.0178,0.1187,-0.0937,0.1479,0.1056,0.176,0.1233,-0.2136,-0.2067,-0.1364,-0.1204,0.1594,-0.2613,-0.1498,0.0322,-0.0651,0.1704,-0.0225,-0.0292,0.1657,0.0752,-0.1545,-0.0366,-0.1732,-0.2052,-0.223,0.0168,-0.0231,-0.074,0.0619,-0.0289,0.0765,0.4156,0.3697,0.1715,0.2753,-0.0692,0.0703,0.109,0.2453,0.2619,0.3622,0.0094,0.067,-0.0063,0.1465,0.0929,0.0087,0.0006,0.0026,0.017,-0.1251,0.0102,-0.0708,0.0301,0.0369,0.0289,0.0641,-0.0077,0.1546,-0.0395,0.091,0.0742,-0.1801,-0.2044,-0.1492,-0.1406,-0.229,0.0895,-0.0978,-0.1176,-0.0382,0.2172,0.0598,-0.3221,-0.0461,-0.0359,-0.1466,0.0222,0.002,0.0531,0.148,0.1288,0.3404,0.318,0.2786,0.0235,0.0165,0.1746,-0.1514,-0.1634,0.0007,-0.0134,-0.0455,-0.0485,-0.017,-0.0813,-0.1453,-0.2221,-0.2723,-0.2569,-0.0838,-0.1,-0.1884,0.0288,-0.0993,0.0224,-0.0125,-0.074,-0.0696,-0.0248,0.2856,-0.0514,-0.0148,-0.1726,0.0573,-0.0559,-0.0575,0.0498,-0.2112,-0.1,0.2359,-0.0745,-0.0746,-0.0651,0.0095,-0.0101,0.0324,-0.0355,-0.0569,-0.0654,0.0044,0.007,-0.2326,0.0364,-0.0196,0.1229,0.0041,-0.2742,-0.138,0.0061,-0.0937,-0.067,-0.0456,-0.1856,-0.0781,0.0804,0.0303,0.0647,-0.4239,-0.1575,-0.1661,-0.325,-0.2354,-0.1679,-0.1606,-0.1606,-0.0968,-0.0734,0.1346,-0.2593,-0.0687,-0.1175,-0.1304,-0.0324,-0.0639,-0.4143,0.1989,-0.215,0.0708,0.0587,0.2975,0.0806,0.0179,-0.2094,-0.0652,-0.0215,-0.0037,-0.0385,0.2222,0.0467,0.1738,0.3559,0.2829,0.0008,0.0508,0.0892,0.0241,0.0011,-0.1667,-0.1519,-0.0874,-0.159,-0.0316,-0.008,-0.0066,0.0867,-0.0375,-0.0745,0.1051,0.0395,-0.0959,0.1303,-0.0287,-0.0587,-0.0045,-0.1269,-0.0153,0.0225,0.2304,-0.1105,0.2549,0.2354,0.072,0.2393,0.2133,-0.0743,0.1659,-0.0121,0.2835,0.1139,0.0233,0.1457,-0.1254,0.0795,0.1408,0.0957,-0.0708,-0.0436,0.0543,-0.0175,-0.0026,-0.0742,-0.1496,-0.0109,-0.0815,0.0266,-0.0552,-0.0956,0.1563,0.0241,0.0342,0.0542,-0.0172,0.0084,0.0397,-0.1167,-0.1374,-0.0153,0.0766,0.1706,0.0146,0.0493,-0.1349,0.0316,0.1399,0.0685,0.1967,0.0931,0.0467,-0.0648,0.0774,-0.091,-0.0276,0.0604,0.0042,-0.0668,-0.1235,-0.0885,-0.1046,-0.0158,0.0579,-0.0994,0.0706,0.0205,0.0626,0.0602,0.0942,0.1446,0.0666,-0.0352,-0.0857,-0.1225,-0.0787,0.0735,0.0352,-0.0558,-0.0588,-0.0358,0.1111,-0.0176,-0.208,-0.1524,-0.204,-0.1811,-0.0418,-0.0156,0.0689,-0.1687,-0.147,-0.1976,-0.0215,-0.098,0.0197,0.0279,-0.0682,0.1264,-0.1534,-0.1567,-0.076,0.0791,-0.0658,-0.048,0.1012,0.0992,-0.198,0.0278,-0.0237,-0.079,0.0498,0.0813,0.0194,0.0375,-0.0965,-0.2186,-0.0647,-0.2275,-0.2695,-0.0222,-0.1473,0.0269,0.0878,0.1745,0.1579,0.1697,-0.1644,-0.2333,0.057,0.2245,0.2835,0.0251,-0.0586,-0.0335,0.0014,-0.0609,0.0599,-0.0985,-0.1555,-0.0685,0.0005,-0.1388,-0.1943,0.1409,0.0039,0.0242,0.1335,-0.0199,0.0802,-0.1262,-0.0946,-0.0697,-0.0327,-0.0676,0.0629,0.2075,0.1271,0.022,-0.0916,-0.0552,-0.1364,-0.0456,-0.064,-0.2868,-0.0439,-0.037,-0.0322,-0.0474,0.033,0.0412,0.0393,-0.0789,0.1033,-0.2555,-0.1404,-0.2087,-0.2202,0.0252,-0.1785,-0.1458,-0.3195,-0.1282,-0.0612,0.2544,-0.2094,-0.0704,-0.045,0.0511,0.1464,0.0886,-0.1475,-0.2217,-0.0823,-0.1133,0.0238,0.1213,-0.0398,-0.0673,-0.0534,0.1028,0.0784,0.0863,0.1632,-0.0143,-0.0364,0.0807,-0.01,0.0337,0.0002,-0.0662,-0.106,0.0532,0.0078,0.1033,0.0282,0.1423,0.152,0.0839,0.0168,-0.0672,-0.2224,-0.1571,-0.0465,0.1968,0.2937,0.1026,-0.0114,-0.003,0.0463,0.3632,0.2034,0.1894,0.1843,-0.249,-0.0283,-0.0365,-0.0164,-0.1147,0.0936,0.0156,0.0302,0.0388,0.0679,0.0729,-0.0945,0.0611,0.1179,-0.1893,0.2498,0.0913,0.0118,0.0215,0.1282,0.0908,0.01,-0.0059,0.0328,0.0914,0.2073,0.2326,0.2663,-0.1147,0.0409,-0.0215,-0.048,-0.2235,-0.4693,-0.4512,0.0201,0.0959,0.1156,-0.0894,0.0438,0.0575,-0.0725,-0.1449,-0.1803,0.0656,-0.0717,0.0012,0.0088,0.0597,0.0032,-0.1988,-0.0738,-0.1893,-0.1336,0.0304,-0.1663,-0.0185,-0.261,-0.1174,-0.0561,-0.0523,0.0042,0.0948,0.0397,-0.0289,-0.1386,0.251,-0.1543,0.1814,0.1942,0.1703,-0.0109,0.0259,-0.042,0.2355,0.2078,-0.2038,-0.1536,-0.0607,-0.0371,-0.1888,-0.1282,-0.1703,-0.2989,-0.1504,-0.0478,-0.1469,0.0687,-0.058,-0.0488,-0.1056,-0.2518,-0.0034,-0.0195,-0.2005,-0.1182,0.0487,-0.1546,-0.2873,0.0985,0.1865,-0.1138,0.0626,0.1205,0.1686,-0.1143,-0.1361,-0.1713,-0.2704,-0.133,-0.11,-0.0035,0.133,0.0375,0.1345,-0.0174,0.2674,0.2879,0.2108,0.161,0.2331,-0.3527,-0.2823,-0.1901,0.0429,0.0052,-0.044,-0.116,0.0096,0.1288,-0.1492,-0.1584,-0.0528,0.1397,-0.164,-0.0083,-0.021,0.0206,0.0962,0.1254,0.009,-0.0155,0.0138,-0.0211,0.0898,0.1595,0.1455,0.0536,0.0115,0.1496,0.2151,0.1853,0.1555,-0.0054,-0.1342,0.0106,-0.022,0.0294,-0.0074,0.0135,0.1889,0.081,0.0471,0.0564,-0.0762,-0.0392,-0.2593,-0.1834,-0.1536,-0.1343,0.3288,-0.0179,0.2244,0.2074,0.1359,-0.0385,-0.0515,0.1934,0.0025,0.2769,0.248,0.1132,0.1877,0.0906,0.0492,-0.11,-0.0876,-0.0596,0.0739,0.1086,0.1652,-0.1031,-0.0001,0.0209,0.0534,-0.0086,-0.052,-0.0716,-0.1286,0.0235,-0.1329,0.0501,-0.1038,0.1066,0.0796,0.1569,0.0959,-0.0691,-0.032,-0.0264,-0.0544,0.1304,0.1743,-0.0206,0.0139,-0.032,0.068,-0.0363,-0.0411,0.0307,0.0886,0.1381,0.0102,-0.1527,-0.1101,-0.1733,-0.1295,0.0738,0.2155,-0.0947,-0.052,-0.1491,-0.2042,-0.2767,-0.176,-0.1472,-0.1413,-0.1303,-0.0895,-0.1372,0.121,-0.154,-0.143,-0.1302,-0.0843,0.004,-0.1253,-0.1231,-0.0033,0.0697,0.0535,-0.0848,0.2975,0.3168,0.1443,0.0131,0.0274,-0.0517,-0.0924,0.0503,-0.023,0.0273,0.2102,0.2025,-0.039,0.0247,0.0612,0.1374,-0.1553,-0.1208,-0.0924,-0.0551,-0.0918,-0.067,-0.0547,-0.0822,0.0334,-0.1851,-0.1228,0.2066,0.0171,-0.3107,-0.0166,0.1404,0.1644,-0.0719,-0.1178,-0.4955,-0.4012,-0.1825,-0.3335,0.1372,-0.148,-0.1205,0.0517,-0.041,-0.0215,-0.1357,-0.0342,0.1445,0.1691,0.2855,0.2108,0.2546,0.0304,0.0637,0.2145,0.0522,0.1095,0.0862,0.064,0.226,0.156,-0.1968,-0.3169,-0.1906,-0.0601,-0.1616,-0.0331,-0.0552,0.0561,0.0171,0.043,0.1487,0.0901,-0.27,-0.0786,-0.2196,-0.0562,-0.2109,-0.3014,0.0093,0.0079,-0.0014,-0.1124,-0.0145,-0.1155,-0.0826,-0.249,-0.0575,-0.2084,-0.0538,-0.0756,-0.0641,-0.0636,-0.1007,0.0389,0.1278,0.0675,-0.1038,-0.1197,-0.1338,-0.0123,0.1357,0.1159,-0.0421,0.321,-0.0085,-0.0445,0.0442,0.117,-0.0607,-0.0552,-0.0189,0.0782,-0.0053,-0.0575,0.1682,0.3573,0.4257,0.0059,0.0201,0.0068,0.1181,-0.0041,0.2571,-0.0096,0.3388,-0.0821,0.1905,0.1761,0.1349,0.0439,0.0082,-0.0121,0.0349,0.066,0.0726,0.0615,0.0266,-0.0495,-0.14,0.1034,0.2365,0.2121,-0.2582,-0.2021,-0.2375,0.0024,-0.2347,-0.0031,-0.0434,0.0874,0.0478,-0.0393,-0.1635,-0.2067,0.0501,0.0031,-0.1373,0.1475,0.3186,0.0707,-0.069,0.1953,0.4928,0.2106,0.1694,0.2379,-0.055,0.0481,0.2448,0.2339,-0.1205,0.2986,0.1142,0.1204,0.0787,0.4826,0.0778,-0.1948,-0.1621,-0.0883,-0.0935,0.0726,-0.1208,0.0023,-0.0727,-0.0841,0.0203,-0.2104,-0.1283,0.073,-0.101,-0.2493,-0.0332,-0.0746,-0.0356,-0.0307,-0.084,-0.1113,-0.1088,-0.0723,-0.0801,-0.2522,-0.1767,0.1722,0.2885,-0.0241,-0.0579,0.0547,0.0448,-0.0802,-0.0995,-0.1397,-0.1608,0.0239,0.1094,-0.1962,-0.2453,-0.136,-0.0643,-0.2214,-0.1854,-0.0123,-0.1268,-0.0668,-0.1504,-0.1314,-0.0681,-0.1199,-0.0641,-0.0226,-0.0283,0.1816,-0.1384,0.0631,0.2311,0.1005,-0.1982,0.0123,-0.1783,-0.2015,-0.1091,-0.0365,-0.0522,0.0657,0.1347,0.143,-0.0567,-0.1384,0.0297,-0.0495,0.0087,0.1349,-0.1958,-0.107,-0.2033,0.0286,0.0497,0.163,0.0192,-0.3112,-0.2633,0.0192,0.0419,-0.0217,0.1356,0.1113,-0.0156,-0.1368,-0.1939,-0.0844,-0.1839,-0.3374,-0.1481,-0.0912,0.1302,-0.0056,0.2451,-0.0272,0.2166,0.0126,0.0764,-0.0002,0.1012,0.185,0.0825,0.0088,-0.0021,-0.0679,0.0941,-0.0166,0.0304,-0.0889,-0.0865,-0.0481,0.0166,-0.0812,-0.0446,-0.0719,-0.072,-0.1988,-0.0564,0.044,0.1145,-0.099,0.0727,0.006,0.0427,-0.0533,-0.0608,0.0501,-0.0681,-0.2049,-0.0952,0.2183,0.1989,0.0148,-0.0626,-0.0441,-0.1698,-0.1099,-0.012,-0.1111,0.1458,0.1178,-0.2469,-0.2362,0.0336,-0.1769,-0.0447,-0.0551,0.2471,0.23,-0.2845,0.0949,-0.1287,-0.0479,-0.0748,-0.2316,-0.2693,-0.1983,0.0394,-0.0262,-0.12,0.0133,-0.1318,-0.0834,0.1937,0.0391,0.0388,-0.0012,0.019,0.0433,-0.1924,-0.0772,0.0489,-0.1727,0.0994,-0.2738,0.242,-0.2198,0.2368,0.1662,0.1531,-0.3107,-0.2743,0.1253,0.2652,0.0491,0.257,0.0717,0.0485,0.1359,0.0072,0.0637,0.0516,0.069,0.0618,0.0538,0.0294,0.0973,-0.0563,0.0994,0.2241,0.4622,0.1914,0.193,0.2735,0.1104,0.1463,0.2107,0.2175,0.2306,0.1202,0.2425,0.2318,0.1578,0.1595,0.2992,0.3557,0.2677,0.2992,0.199,0.2253,-0.2493,-0.0519,-0.2656,-0.1359,-0.0497,-0.3465,-0.2688,-0.1671,0.0702,-0.0353,-0.389,-0.3296,-0.2093,-0.063,-0.0084,-0.2062,0.1147,-0.0335,-0.0763,0.0605,-0.1169,-0.0885,-0.043,-0.1156,-0.1975,0.1194,-0.2702,-0.2814,0.0454,-0.0068,-0.0105,-0.0202,-0.0134,-0.2192,0.2222,0.1882,-0.17,0.2563,0.2681,0.036,0.1146,0.1551,-0.0981,0.4378,0.4433,-0.0868,-0.0701,0.1351,-0.1017,-0.0222,-0.1688,-0.023,0.1388,-0.0795,-0.1031,0.0361,0.0102,-0.0465,-0.0112,updating
trm_557b4a7315f1b,-0.017,0.0022,-0.0587,-0.0402,-0.0111,0.0139,-0.0281,0.0768,0.0518,-0.0109,-0.0109,-0.0498,-0.0696,-0.0633,-0.0602,0.0162,-0.0346,-0.1222,-0.0037,-0.0973,-0.0777,-0.0437,-0.0689,-0.0033,-0.0546,-0.0382,-0.0393,-0.1375,-0.1085,-0.0587,-0.0716,-0.119,-0.0528,-0.0565,-0.1081,-0.1201,-0.0228,-0.0069,-0.0219,0.0023,-0.0541,-0.0136,0.0085,0.0005,-0.0229,-0.0842,-0.0227,-0.0067,0.0468,-0.0548,-0.056,0.0801,-0.0332,0.0852,-0.0827,-0.0571,-0.0403,-0.0415,0.0278,-0.0113,-0.0487,-0.0066,-0.094,0.0645,0.0644,0.1713,-0.1504,-0.2657,-0.1123,-0.0546,0.0852,0.0275,0.0037,-0.0943,0.0101,-0.0182,-0.0231,-0.0364,0.0242,-0.0386,-0.0549,0.0143,-0.0231,-0.0888,0.0789,0.035,0.0892,0.0069,-0.0373,-0.0783,-0.0361,0.0266,0.0249,0.27,0.1621,0.1736,0.0958,0.0301,0.24,0.2546,0.0468,0.031,0.0827,0.2363,0.151,-0.0465,-0.1617,0.097,0.011,0.0767,-0.0138,-0.093,0.0445,0.154,0.002,0.0037,-0.0917,0.1472,-0.052,-0.0153,-0.1299,-0.0972,-0.1426,-0.015,-0.0704,-0.1688,-0.0847,0.0716,0.0584,-0.0092,-0.1603,-0.0747,-0.0093,-0.2118,-0.0168,-0.158,0.0104,-0.1114,-0.0093,-0.0013,-0.046,-0.0574,0.0209,-0.0959,0.0033,0.105,-0.0051,-0.0253,-0.0446,-0.0088,-0.0344,-0.1094,-0.1239,-0.1011,0.0775,0.0142,0.0365,0.0479,-0.0195,-0.044,-0.0425,-0.0764,-0.1965,-0.1364,-0.013,0.089,-0.0563,-0.2012,-0.1913,-0.0967,-0.0409,-0.1309,0.0687,-0.2909,-0.1786,-0.1997,-0.167,-0.2046,-0.1164,-0.0158,-0.0943,0.0481,-0.0493,0.0435,-0.1226,-0.0953,-0.0818,-0.2019,-0.1471,-0.0727,-0.0534,-0.0792,-0.0431,-0.2263,-0.2172,-0.0616,-0.0576,-0.0886,-0.0504,0.1457,0.0366,0.2017,-0.1605,-0.1026,0.0756,-0.0755,-0.2579,0.0397,0.0388,0.0464,-0.1801,-0.1065,0.0158,-0.0239,0.0079,-0.0471,-0.0213,-0.0177,0.0522,0.0047,0.0603,-0.113,-0.1027,-0.0254,0.0867,0.0047,-0.0146,0.0656,-0.1003,0.1024,0.0884,-0.1398,0.0836,-0.0177,-0.0074,0.1071,-0.0796,-0.0179,0.0024,-0.0807,0.0523,-0.1143,0.019,0.0426,-0.0549,-0.0763,-0.0751,-0.0809,-0.0252,-0.1613,-0.0272,0.0348,-0.038,0.0538,-0.0119,-0.1781,0.0565,0.0401,0.0764,0.0344,-0.0074,0.1919,-0.0742,0.0553,0.1423,0.253,0.1138,-0.0256,-0.0323,-0.0345,0.0497,0.0075,-0.1063,-0.0795,0.0029,-0.0202,-0.022,-0.1327,-0.0119,0.0089,0.0261,-0.1305,-0.1256,-0.2615,-0.178,-0.0608,0.0471,0.0431,-0.002,-0.1001,-0.0381,-0.1079,-0.0473,-0.0978,-0.0657,0.0176,-0.0747,0.0902,0.0003,0.1547,0.0268,-0.2138,-0.0272,-0.0919,0.1772,0.2072,-0.0573,-0.0789,0.0338,-0.008,0.0465,-0.0208,0.0388,0.0689,0.063,0.0387,0.1454,0.0232,0.0359,-0.0561,0.0083,-0.0357,-0.0923,-0.1193,-0.0587,-0.0219,0.0302,-0.0151,-0.0551,-0.0118,0.0443,-0.0854,-0.0876,-0.0487,-0.0347,0.1227,0.0688,-0.0709,-0.0574,-0.156,-0.1447,-0.0725,0.1176,0.0431,0.0595,0.0374,-0.1133,-0.0753,-0.0525,-0.0445,-0.0355,0.0656,0.0843,0.0598,0.0275,0.0536,-0.0047,-0.1253,0.0034,-0.0508,-0.0021,-0.0214,0.0046,-0.0155,0.0221,0.0952,-0.053,0.2218,0.0556,-0.1376,-0.0317,0.0672,0.0334,0.0985,-0.0778,-0.007,-0.06,0.0435,-0.0112,0.1046,0.0073,0.1781,0.0116,0.1101,0.0222,0.0865,-0.0719,0.0329,0.0438,-0.008,0.0099,-0.0085,0.104,-0.0499,0.0877,0.1492,0.0765,-0.1015,-0.0176,-0.0096,-0.0054,0.0025,0.0153,-0.0149,0.0294,0.1092,-0.0097,-0.0029,-0.1429,0.0101,0.0558,-0.0979,-0.078,0.1024,-0.1768,-0.1089,0.1201,0.0408,-0.0488,-0.0081,0.0183,-0.0681,-0.0026,-0.1011,-0.0868,0.0119,-0.0939,0.0167,-0.0445,0.0759,-0.0633,0.0308,-0.0228,0.0057,-0.0841,0.0006,0.1254,0.0429,-0.1708,-0.0548,0.0298,0.0792,0.019,0.0623,-0.1347,-0.0767,0.0265,0.0989,-0.1707,-0.0109,0.1047,0.0546,-0.0811,-0.0458,0.0435,-0.1667,-0.0045,-0.0083,0.0165,0.0163,0.0411,0.0235,-0.1103,-0.0003,-0.1268,-0.0062,0.0758,0.1996,-0.0678,0.0035,0.0437,-0.012,0.1639,-0.0271,-0.0941,-0.0142,0.0642,0.1066,-0.022,-0.0038,0.1367,0.0544,0.1594,0.1082,0.0526,0.085,0.0359,0.0457,-0.0463,0.0017,-0.0123,0.1539,-0.037,-0.0724,0.088,-0.0429,-0.1671,0.0371,0.0312,-0.0792,-0.0671,-0.0351,-0.0825,-0.0517,-0.0294,-0.1223,-0.031,-0.1185,-0.0105,0.1114,-0.116,0.1104,-0.0959,-0.0169,0.0436,0.1191,-0.1442,-0.1289,0.202,-0.0707,-0.0407,-0.0681,0.0169,0.1351,0.0839,-0.0079,0.0943,0.0797,0.0578,0.1145,-0.0029,0.0087,0.0083,-0.1399,-0.1653,0.0315,-0.1155,0.0096,-0.0174,-0.0992,-0.0487,0.0045,-0.0116,-0.0133,-0.0975,-0.0219,-0.0094,-0.0187,-0.0263,-0.0979,0.0879,-0.0587,0.0207,0.116,0.0212,-0.1432,0.071,0.0497,-0.0041,-0.0349,-0.0846,0.0764,-0.0857,-0.0101,-0.1052,-0.0385,-0.023,-0.1827,-0.0179,-0.101,-0.0697,-0.0779,-0.0554,-0.0257,0.2192,0.1775,0.0551,0.1105,0.0339,0.0545,-0.0268,-0.0677,-0.0503,-0.0196,0.1239,0.0099,0.2205,0.0437,0.086,-0.0683,-0.0865,0.0881,0.1502,0.097,0.1099,0.0666,-0.1596,-0.0943,0.0965,-0.0226,-0.0261,-0.026,0.0016,-0.0177,0.0521,0.1896,-0.0386,-0.1476,-0.1376,0.0511,-0.1322,-0.0005,0.0212,-0.0088,-0.1601,-0.0746,-0.057,-0.0462,-0.0255,-0.1452,0.0004,-0.1145,0.0981,-0.0265,-0.0942,0.0641,-0.0005,-0.1414,0.0664,0.0601,0.0728,0.1559,-0.0639,0.0229,0.1297,0.1411,0.0748,0.0567,-0.1102,0.0476,-0.0238,0.0666,0.0265,0.1783,-0.0212,-0.014,-0.262,-0.2125,0.1373,-0.1911,0.0315,-0.0775,0.166,-0.0706,-0.0531,-0.0051,0.224,0.0908,-0.0335,-0.0326,-0.1782,0.1501,0.0712,0.168,0.0881,0.0935,0.1243,-0.1648,0.1425,0.0809,0.0297,-0.0481,-0.0228,0.0408,-0.0195,-0.0458,0.1692,-0.1165,-0.0204,-0.0528,0.0556,0.0957,0.0597,-0.0128,0.0358,-0.1085,-0.0486,-0.0047,0.0273,0.0487,-0.0036,0.222,0.2025,0.0591,0.015,-0.0876,0.0602,-0.0986,-0.0319,0.0379,0.0793,0.0403,-0.0402,-0.1161,-0.0923,0.0086,-0.081,-0.0017,-0.0235,0.0156,0.0274,-0.0128,-0.0206,0.0062,-0.0674,-0.0776,0.03,-0.0517,-0.1189,0.0051,0.0436,-0.1033,-0.1975,-0.1868,-0.1394,0.0284,0.0026,-0.0876,-0.0397,0.0671,-0.0572,-0.0578,0.0046,0.0974,0.1404,0.0356,-0.017,0.0192,0.1336,0.1792,-0.23,-0.038,0.0361,0.0204,-0.0455,-0.1821,0.0492,0.0403,-0.0724,-0.013,-0.0606,-0.0185,-0.1894,-0.2863,-0.248,-0.1987,0.0146,0.052,-0.0127,-0.0046,-0.0593,0.0649,0.084,0.0185,0.0902,0.0495,-0.1435,-0.0789,0.0687,0.0819,0.0949,0.0804,-0.0149,-0.0181,0.0398,-0.0595,0.0639,-0.1096,-0.1356,-0.0394,-0.1693,-0.1356,-0.066,0.0626,0.0804,0.054,-0.0076,-0.0395,0.0366,0.0672,0.0329,-0.0712,-0.0121,-0.0249,0.0339,0.053,0.0844,-0.0798,0.1418,-0.2207,-0.2237,0.042,0.0087,-0.0065,-0.0603,-0.0398,0.0482,0.0243,0.0462,0.0895,-0.0206,0.126,0.0745,0.0769,0.0191,0.0041,0.0803,0.0683,0.0236,-0.0051,0.0308,-0.1248,-0.1532,0.1179,-0.0792,-0.0997,-0.2364,-0.0973,-0.1886,-0.1392,-0.2052,-0.0159,-0.0269,-0.08,-0.0449,-0.0205,0.0401,0.1302,0.1022,0.0102,0.057,0.0412,-0.0347,0.1009,0.067,0.0412,0.0857,0.0522,-0.0644,0.1161,0.0459,-0.0151,-0.0564,-0.1021,-0.0371,0.0556,0.1177,-0.2097,-0.1846,-0.017,0.0043,0.0578,0.0504,-0.0296,0.1006,0.1542,0.0549,-0.0214,0.2059,0.0346,-0.0191,-0.1894,0.2533,-0.0289,0.0703,0.1728,-0.001,0.1829,-0.216,-0.1891,-0.032,0.0579,-0.0289,-0.0555,-0.0579,0.0681,-0.0018,-0.0857,-0.0267,-0.1831,0.0691,-0.0019,0.0243,0.0921,-0.0372,0.0415,-0.1115,-0.0767,-0.0146,0.014,-0.0994,0.0334,-0.0693,0.0414,0.0596,0.0237,0.016,-0.1336,-0.0677,-0.0436,-0.0426,-0.0704,-0.0444,0.0416,0.1173,0.0339,-0.0159,-0.0346,0.1042,0.1592,0.0901,0.035,0.0231,-0.0402,0.0814,-0.0242,-0.0409,0.0425,0.0177,-0.0945,0.0099,-0.0092,0.023,0.0012,-0.0347,0.0251,-0.1132,-0.0994,-0.0519,-0.1481,-0.1443,-0.3109,-0.1527,-0.347,-0.1456,-0.1249,-0.1317,-0.1456,-0.2117,-0.194,-0.2344,-0.258,-0.0796,-0.076,0.0538,0.0105,0.0867,0.019,0.0715,0.0783,-0.0134,0.0627,-0.0079,-0.0477,0.003,-0.0032,0.0277,0.1107,-0.0039,0.0594,0.025,0.043,0.0182,0.0197,-0.0897,-0.0327,-0.0598,0.0129,0.0591,0.068,0.0193,0.048,-0.1851,-0.119,-0.0682,-0.131,-0.0997,0.0878,0.0954,0.1075,0.0845,0.0416,-0.021,0.1343,0.0973,0.0148,0.0449,0.0782,-0.0176,-0.006,-0.0836,0.0309,-0.0733,0.0249,-0.0057,-0.0258,-0.0387,-0.1289,-0.1799,-0.1356,0.1381,0.0818,0.179,0.024,-0.0275,-0.0628,-0.0321,0.0041,0.0107,-0.0591,0.0222,0.0072,-0.0078,0.0408,-0.0053,0.0704,-0.0645,-0.0203,-0.0505,0.0263,-0.042,0.0311,0.1764,0.3804,0.1629,0.0801,0.0067,0.1198,-0.0259,-0.0855,0.0088,-0.072,-0.0095,0.0692,0.0763,0.0794,0.0239,0.0931,0.032,-0.0332,0.0822,-0.0725,-0.0859,-0.1358,-0.0422,0.1595,0.0237,0.0331,-0.1357,0.1202,0.0143,-0.0075,-0.0511,-0.0277,-0.0595,-0.0051,0.0506,-0.0777,-0.085,-0.0038,-0.0064,-0.125,-0.0881,-0.0775,-0.0886,-0.1472,-0.0875,-0.0624,-0.0694,0.0038,0.1413,0.0053,0.0459,0.0957,-0.0473,0.1157,-0.131,-0.0724,-0.0723,-0.147,0.0612,0.0525,0.2062,0.1929,0.2176,0.0341,0.1505,0.0517,-0.2174,-0.0453,0.0164,-0.0447,-0.0347,-0.134,-0.148,-0.0539,-0.127,-0.0663,-0.0091,-0.0313,0.1128,0.0318,-0.1358,0.0087,-0.0077,-0.0399,0.0836,0.0591,-0.0756,-0.0252,-0.072,-0.0683,0.0354,-0.149,0.0473,0.0005,0.1238,-0.0282,-0.128,-0.1869,-0.1802,-0.1075,-0.0069,0.0123,0.0997,-0.0406,-0.1073,-0.1572,-0.0592,0.0267,-0.1034,0.0625,0.144,-0.1177,-0.0007,0.0571,0.2775,0.2569,0.2496,0.0649,0.0017,0.0523,0.0873,0.1051,-0.0654,-0.1378,0.0396,-0.1392,0.1425,-0.0293,-0.0519,0.0407,-0.1077,-0.0076,0.0814,-0.1297,0.1036,0.1926,0.0518,-0.1038,-0.0056,-0.0465,0.0592,-0.0089,0.0507,-0.2233,-0.2215,-0.0609,-0.0615,-0.0119,-0.0566,-0.1179,0.0171,-0.0263,0.1638,0.0883,0.1137,0.2475,0.0471,0.0461,-0.1021,0.0459,0.1337,0.2218,-0.073,0.1912,0.3011,0.0803,-0.151,0.2572,0.2273,-0.0633,-0.1847,0.0085,-0.1293,-0.1262,-0.144,-0.0533,0.1998,0.0301,0.0167,0.0893,0.0468,-0.0103,-0.0513,-0.0054,0.0399,-0.1022,0.0422,0.029,-0.0063,0.019,-0.0002,0.041,0.0119,-0.149,0.0152,-0.0629,-0.1018,-0.0385,-0.1028,0.2089,0.0337,-0.1858,-0.1048,0.0753,0.0537,0.0001,0.0909,-0.0061,0.1003,0.0185,0.2206,-0.0605,-0.0716,-0.0066,0.1144,0.0666,-0.0321,0.0517,0.0517,-0.2288,0.0886,0.0802,0.0619,0.0185,-0.0137,0.038,0.2203,-0.2378,-0.2585,0.0236,-0.0462,-0.1923,-0.218,-0.1121,0.0054,-0.0013,-0.0656,-0.0748,0.0337,0.1973,-0.028,-0.0086,-0.0129,0.043,0.0271,0.0072,0.0873,0.0298,-0.0755,0.0403,-0.0806,-0.0578,-0.0775,-0.0179,0.016,-0.0517,0.287,0.1577,0.2637,0.0563,0.2019,-0.2292,-0.2188,-0.0051,-0.1821,-0.0411,-0.1086,-0.0527,0.0565,-0.0741,-0.1493,0.1199,0.0104,-0.1353,0.0035,0.0871,-0.0181,-0.1073,-0.0651,-0.0581,0.0569,-0.0606,0.08,-0.0792,0.0237,0.1042,0.1312,0.1198,0.0178,0.0676,-0.0489,-0.1278,-0.1301,-0.0525,-0.0872,-0.062,-0.172,-0.0769,-0.0307,0.0144,-0.0621,-0.1943,-0.1066,0.0225,0.0032,0.0302,0.0143,-0.1184,0.0159,-0.1059,-0.0817,-0.1516,-0.2312,-0.1326,-0.0109,-0.1056,-0.0979,-0.0254,-0.0272,-0.0685,0.0668,0.1189,-0.0805,-0.0785,0.0746,-0.1242,-0.0009,0.055,0.0182,0.0942,-0.0798,-0.0076,0.1189,-0.0756,0.0964,-0.0311,-0.048,-0.0112,0.0171,-0.0,-0.0137,-0.1875,0.0272,0.0055,-0.0902,0.258,-0.0891,0.0571,0.0724,0.1052,0.1549,-0.0566,-0.0077,-0.1534,-0.0377,-0.0935,-0.1417,-0.0341,0.0986,0.0573,-0.1367,-0.1289,-0.0184,-0.0644,0.0316,-0.0755,-0.0832,-0.0201,0.0572,-0.0297,0.0455,-0.0441,0.0082,-0.0123,-0.0549,-0.0266,0.0011,-0.1208,-0.0031,0.035,0.0035,0.0527,-0.0326,-0.0319,-0.0314,0.0749,0.0098,-0.0112,-0.0778,0.0192,0.0802,0.1808,-0.0279,0.0081,0.0014,0.0552,0.0401,-0.0301,-0.0257,-0.0486,0.0192,-0.2056,0.0131,0.0209,0.068,-0.0451,-0.0176,-0.0585,-0.1003,-0.1493,0.1613,0.0638,0.027,0.1053,0.2665,-0.0277,0.0913,-0.059,0.0129,-0.0583,-0.0614,0.0607,0.1129,0.0893,0.2092,0.1265,0.0673,-0.1226,-0.0004,0.1032,0.1045,0.0759,0.0346,-0.0049,-0.043,0.0018,0.1402,0.0894,0.0211,0.0135,0.0896,0.0567,0.0083,0.0752,0.0375,0.0677,0.0005,0.0064,0.0177,-0.0062,-0.1665,-0.1069,0.0942,0.0261,-0.0398,-0.0951,-0.0256,-0.0452,0.0597,0.0747,-0.0346,-0.0845,-0.0069,0.0178,0.0656,0.2056,-0.0338,0.0177,0.0243,0.0087,-0.0377,-0.0844,0.0926,-0.0231,-0.0251,0.0826,0.0867,0.052,-0.0423,-0.0533,0.0901,0.2975,0.2955,-0.0891,-0.0579,0.1113,-0.0298,-0.0156,-0.0258,-0.1134,0.0534,-0.0618,-0.0763,0.0058,0.0784,0.2384,-0.0524,0.175,0.0073,0.1031,0.1721,0.2137,0.1797,-0.0753,0.1348,0.0509,0.0981,0.0113,0.0311,-0.0517,0.0178,0.0086,0.0324,0.078,-0.0198,-0.0685,-0.0589,-0.0539,-0.1366,0.007,0.0282,0.0702,-0.1019,-0.0029,0.0254,-0.1054,-0.0952,-0.0201,0.0519,-0.0447,0.0103,0.0497,-0.0621,-0.0169,-0.1137,0.0079,0.0502,-0.0006,-0.0234,0.0204,-0.0515,-0.0027,-0.01,0.0713,0.0613,-0.1132,0.0745,0.1069,0.0539,0.0998,-0.217,-0.0843,0.0839,-0.1778,0.1183,0.0504,0.1142,-0.1053,0.0162,-0.0219,-0.0243,0.1011,0.0529,-0.0539,0.0341,0.061,0.0385,-0.0347,0.1113,0.1783,0.12,-0.0444,-0.019,-0.0865,-0.0502,0.0512,0.0103,-0.1103,-0.076,-0.0185,0.0535,0.0979,0.1069,-0.2101,-0.1235,-0.0169,0.0948,0.0177,0.0555,-0.0114,0.0189,-0.0077,-0.0351,-0.0507,-0.0587,-0.024,0.02,0.0466,-0.1246,-0.122,-0.1001,0.0148,-0.0616,-0.0468,0.2031,-0.1754,-0.1101,-0.1112,0.2338,0.1476,0.114,-0.0542,0.0006,-0.0234,-0.0002,0.0998,0.1552,0.0666,-0.0088,-0.0061,0.0108,0.1071,-0.1185,0.1703,-0.1544,-0.0782,-0.1101,-0.0754,0.0036,-0.0051,0.0462,0.1904,-0.0235,0.1128,0.102,0.1328,-0.1102,0.0094,0.0194,0.0105,0.0757,0.1153,0.1527,0.1701,0.2331,-0.2285,-0.1215,-0.2111,-0.0261,0.069,-0.0648,-0.0837,-0.0988,-0.0873,-0.0361,0.059,0.013,0.1647,0.069,0.0845,0.1113,0.0518,-0.0272,0.0133,0.0352,-0.0633,-0.0191,-0.1404,-0.021,-0.1275,-0.0374,0.053,0.104,0.0272,-0.0496,0.0305,0.0422,-0.3148,-0.2046,-0.2105,-0.192,-0.0357,0.0211,0.0469,-0.1519,-0.2037,-0.0705,-0.0276,-0.052,0.0114,0.0344,-0.0,-0.0001,-0.0387,-0.1201,-0.041,-0.0542,0.1022,-0.0011,-0.0237,-0.2869,-0.032,-0.0974,-0.1597,-0.3291,0.0616,-0.1311,0.0292,0.0191,0.0228,0.0074,-0.0434,-0.0958,-0.0846,-0.2409,0.0125,-0.076,0.1557,-0.0521,0.0262,-0.0461,0.0217,0.0778,0.2604,-0.0311,-0.0117,-0.0306,0.1054,-0.1805,-0.2402,-0.1596,-0.0286,-0.054,-0.1104,-0.1833,-0.1124,-0.0606,0.0259,0.0568,0.0571,-0.2209,-0.0354,0.0127,-0.0458,0.0374,0.0268,-0.0561,-0.0317,0.1604,-0.0307,0.0207,-0.0018,-0.1784,-0.1485,-0.0815,-0.1456,-0.0093,-0.2212,-0.1566,0.1042,0.104,0.0366,0.0568,-0.0594,-0.0049,0.0696,0.1058,0.1041,-0.1575,-0.2095,0.0581,0.1044,0.0208,0.0565,0.0926,-0.0642,-0.0672,0.0174,-0.0224,-0.0623,-0.0067,-0.0255,-0.0276,-0.0011,-0.034,0.1259,-0.0201,0.1676,0.1011,0.0255,0.0136,-0.2089,-0.192,-0.1122,-0.121,-0.301,-0.1691,0.0334,-0.0478,-0.0438,0.35,0.2065,0.2334,0.3125,0.192,0.1712,0.241,0.1562,0.1338,0.0995,0.2685,0.2193,0.2584,0.2847,0.1194,-0.2548,0.0112,-0.0061,0.0199,-0.0858,-0.1284,0.0808,-0.0529,0.0038,0.0769,0.0535,-0.0307,-0.0729,0.1215,-0.0579,-0.0564,0.1106,-0.0553,-0.0739,0.0857,0.1001,-0.0859,-0.0924,0.063,0.1153,0.0377,-0.0033,0.0588,-0.0424,-0.0181,-0.3282,-0.1376,-0.1198,-0.1827,-0.1852,-0.1424,-0.2222,-0.1272,-0.0884,-0.1039,0.0283,0.0458,0.2056,0.0055,-0.229,0.1447,0.1067,0.0944,0.0263,-0.0963,0.0729,-0.0878,-0.0767,-0.0485,-0.084,-0.0672,0.0209,-0.0002,0.0321,0.0927,0.0775,0.0695,-0.0944,-0.0457,-0.0272,-0.2768,-0.1711,-0.1678,-0.1524,0.066,-0.0068,-0.0858,0.0636,-0.0374,0.0265,0.1328,-0.1281,-0.0308,-0.0802,-0.0331,-0.0586,-0.0286,0.0358,-0.0619,-0.0602,0.1075,0.0607,-0.0284,0.0293,0.0147,0.0528,0.0241,0.0137,-0.0845,0.1392,0.2065,0.1572,-0.0481,0.1421,0.025,-0.0867,-0.0488,0.0682,0.173,0.0487,0.0572,0.027,0.108,-0.0707,-0.0629,-0.071,-0.0376,0.0867,0.0564,0.0646,-0.002,-0.0076,0.0672,0.1247,0.1192,0.1089,-0.0556,0.0047,0.0027,-0.0098,-0.0178,0.0943,-0.2264,-0.0359,-0.0335,-0.0468,-0.0541,-0.0699,0.0332,0.0424,0.0477,-0.0112,0.0058,0.1311,0.1647,0.117,0.0272,0.1333,-0.0361,-0.0118,0.013,-0.0121,-0.0805,-0.054,0.021,-0.2247,-0.2877,-0.2538,0.0806,0.0776,0.0137,-0.0071,0.0077,0.2035,0.0396,0.0202,0.1114,-0.046,-0.1073,-0.1486,0.1496,0.0582,-0.0545,0.0717,0.0366,0.1421,0.1867,-0.0593,-0.0491,-0.0464,-0.0327,0.2588,0.0547,0.0898,-0.0131,-0.0611,0.0473,0.0517,-0.0394,0.1732,0.0873,-0.145,-0.0411,-0.123,-0.1529,-0.1357,0.0846,0.0005,-0.0307,0.0909,-0.0003,0.0117,0.3426,0.2783,0.1393,0.1606,-0.0512,0.1258,0.0391,0.2498,0.2362,0.2546,-0.0137,0.0438,0.0101,0.1246,0.0719,0.1303,0.1236,0.0187,0.0272,-0.092,-0.0252,-0.0291,0.0999,-0.0015,0.0318,0.0047,0.0399,0.1035,0.026,0.0176,-0.0231,-0.1829,-0.1157,-0.1196,-0.0697,-0.153,0.0553,-0.0644,-0.079,-0.0058,0.172,0.1485,-0.1692,0.0799,-0.0139,-0.169,-0.0304,0.0345,-0.0101,0.0598,0.0274,0.1233,0.2553,0.2348,0.0413,0.0486,0.2073,-0.0752,0.012,0.0763,-0.0215,0.0285,0.0687,-0.0133,-0.0351,-0.1717,-0.206,-0.27,-0.258,-0.0737,-0.1226,-0.1739,-0.0252,0.0023,0.134,0.005,0.0535,0.0412,-0.0548,0.1215,-0.1146,0.0344,-0.0861,-0.0743,-0.1727,-0.028,-0.0297,-0.0656,0.0226,0.2614,-0.0606,-0.0638,-0.0208,0.0101,0.0131,0.0555,-0.0014,-0.0185,-0.02,-0.0077,-0.0016,-0.1849,0.0247,-0.0141,0.0794,0.0111,-0.2717,-0.1009,0.0319,-0.115,-0.0273,-0.0128,-0.0849,-0.08,0.0921,0.0646,0.0641,-0.3154,-0.1464,-0.0677,-0.262,-0.1648,-0.0846,-0.1432,-0.1432,-0.0908,-0.048,0.116,-0.1493,-0.0167,0.0532,0.0257,-0.0224,-0.0792,-0.2183,0.1156,0.0084,0.0608,-0.0414,0.238,0.0475,-0.0217,-0.1184,-0.023,-0.0047,0.0487,0.0025,0.1691,0.1158,0.2448,0.3261,0.2419,0.0228,0.028,0.2039,0.1332,-0.0065,-0.011,-0.0597,-0.0632,-0.0892,-0.0073,-0.0288,-0.0146,0.0398,-0.0079,-0.0494,0.1027,-0.0087,-0.0787,0.0592,-0.0383,-0.0944,0.0226,-0.1313,-0.079,0.0666,0.1741,-0.0793,0.3569,0.3313,0.1189,0.3196,0.2556,-0.0493,0.0396,-0.0682,0.0443,-0.004,0.0022,0.0992,-0.0112,0.056,0.0576,0.0636,-0.0121,-0.0496,-0.0001,-0.0212,-0.0012,0.1755,-0.1315,0.2327,0.1052,0.1767,0.0837,0.1328,-0.0268,0.0269,-0.0009,-0.054,0.0959,-0.0166,0.0096,-0.081,-0.0806,0.0055,0.0692,0.0928,0.0017,-0.0126,-0.0987,0.0324,-0.0005,-0.1031,0.1087,0.0556,0.0087,0.0013,0.0925,0.0085,0.0689,0.1195,-0.0562,-0.0727,-0.0982,-0.069,-0.0335,0.0534,0.0364,-0.0287,0.0836,0.1189,0.0095,0.0218,0.0612,0.0817,0.0496,0.0184,-0.0431,0.0254,0.0256,0.0959,0.0614,-0.0405,-0.0404,-0.0576,0.0843,0.012,-0.1509,-0.107,-0.1404,-0.097,-0.0179,-0.0002,0.0573,-0.1449,-0.1064,-0.163,0.0137,-0.065,-0.0173,0.0031,0.1418,0.0586,-0.12,-0.1211,0.005,-0.0421,0.0018,-0.0592,0.0379,0.1009,-0.0354,0.0096,-0.0089,-0.0178,0.0339,0.0495,0.0767,0.0751,-0.0048,-0.1841,0.021,-0.1339,-0.1276,-0.0231,-0.0804,0.0455,0.1054,0.1573,0.14,0.1189,-0.0657,-0.1954,-0.0371,0.0648,0.0856,0.0547,0.0131,0.0016,0.0313,-0.0771,-0.0477,-0.1041,-0.1302,-0.0064,0.0561,-0.0818,-0.0839,-0.0745,-0.0748,0.0004,-0.0163,-0.0512,-0.0106,-0.1243,0.0306,0.0587,-0.0061,0.0343,0.0778,0.1392,0.1498,0.009,-0.0388,-0.0268,-0.0554,-0.0605,-0.0205,-0.2341,-0.068,-0.0457,0.0218,-0.0726,-0.0009,-0.0154,0.0536,-0.022,-0.0001,-0.1496,-0.0894,-0.1801,-0.1057,0.0544,-0.1574,-0.1033,-0.2106,-0.0969,0.1023,0.1801,-0.096,-0.0445,0.0017,-0.0065,-0.0019,-0.0176,-0.098,-0.1616,-0.0703,-0.0796,-0.0183,0.089,0.0587,-0.0184,-0.0349,0.0416,0.0527,0.0147,0.0546,-0.0607,-0.0018,0.0921,-0.0209,-0.0194,-0.1028,-0.1038,-0.0471,0.1374,0.0429,0.0645,-0.0267,0.0615,0.0861,0.1756,0.0168,-0.0472,-0.133,-0.0621,-0.0284,0.1886,0.1417,0.0512,-0.0665,0.0173,0.0488,0.2457,0.0954,0.1143,0.1441,-0.1914,-0.0192,-0.017,-0.0308,-0.1375,0.0656,0.1079,0.1215,0.0202,0.069,0.0382,-0.0565,0.0494,0.0959,-0.1317,0.1442,0.0085,-0.0178,-0.0316,0.0889,-0.006,0.0088,-0.0367,0.0617,0.2129,0.1974,0.1554,0.1802,-0.045,0.0791,-0.0593,-0.0084,-0.0637,-0.233,-0.23,0.0331,0.0816,0.0891,-0.0553,0.0526,-0.0261,-0.0763,-0.0703,-0.0991,0.0504,-0.0743,0.0339,-0.0017,0.0433,-0.0007,-0.1049,-0.0132,-0.1056,-0.0383,0.1071,-0.1634,-0.0057,-0.1936,-0.0632,0.0094,-0.0116,0.0094,0.0236,0.0151,0.0454,-0.1274,0.1286,-0.0766,0.1993,0.1185,0.1003,-0.035,-0.0715,0.1532,0.1728,0.1595,-0.1577,-0.0727,0.0377,-0.0568,-0.1657,-0.083,0.0086,-0.1668,-0.0979,-0.0117,-0.1373,0.0392,-0.0689,-0.0125,-0.0365,-0.145,-0.1079,-0.0953,-0.1569,-0.0775,0.0324,-0.1013,-0.2104,-0.0331,0.1112,-0.0624,0.0448,-0.0168,0.0374,0.1325,0.1152,-0.1085,-0.1086,-0.0991,-0.0199,0.0712,0.07,0.0064,0.0671,0.0021,0.1844,0.0534,0.0988,0.0748,0.0506,-0.1929,-0.2316,-0.1145,-0.1286,-0.0717,-0.0661,-0.1187,-0.1069,0.0091,0.0861,0.0312,0.0292,-0.0057,-0.057,0.2241,0.1841,0.1096,0.0227,0.0516,0.1393,-0.1245,-0.0452,-0.1264,0.0703,0.1381,0.1664,0.0398,0.0215,0.1928,0.1828,0.2274,0.0892,0.0023,-0.1156,0.055,0.0096,0.0137,0.0618,0.07,0.199,0.0674,0.0157,0.0338,-0.0935,-0.0075,-0.1487,-0.0903,-0.106,0.0027,0.1429,-0.0511,0.0557,0.1456,0.0867,-0.0954,-0.1039,0.1116,0.0682,0.1893,0.2015,0.0488,0.0979,0.0641,0.0316,-0.0646,-0.065,0.1218,0.0819,-0.0302,0.0538,0.0483,0.0263,0.0516,0.1634,-0.0125,-0.0268,-0.0534,-0.0415,0.0841,0.0886,0.0512,-0.0978,0.0091,0.0188,0.166,0.0978,-0.0156,0.0162,0.0951,0.0165,0.0814,0.1579,0.0413,0.0805,0.0847,0.0536,-0.005,-0.0687,0.0382,-0.0308,0.1509,0.0571,0.0006,-0.0663,-0.0844,-0.0337,0.0712,0.3634,-0.0219,-0.041,-0.0518,-0.1308,-0.3044,-0.1869,-0.1485,-0.157,-0.1185,-0.1387,-0.1107,0.0318,0.1513,0.1132,0.1281,-0.0591,0.0036,-0.1116,-0.0508,-0.0349,0.0066,0.0025,0.0679,0.1786,0.2096,0.061,0.0201,0.1081,-0.0736,-0.1205,0.0199,-0.0346,-0.0594,0.0895,0.0281,-0.032,-0.0203,-0.0084,0.1155,-0.1234,-0.1393,-0.1125,-0.1011,-0.057,-0.0493,0.0717,-0.0866,0.1097,-0.0334,0.0667,0.1507,-0.0694,-0.1316,0.0155,0.0888,0.1286,-0.0455,-0.1014,-0.2719,-0.2067,-0.0899,-0.1915,0.0417,-0.1766,-0.1237,0.0101,-0.0485,0.1406,0.1033,0.0452,0.0001,0.0763,0.1887,0.1683,0.1953,0.1551,0.184,0.1712,0.0151,0.0095,0.0162,0.0029,0.0582,0.0337,-0.0572,-0.1847,-0.1674,0.0539,-0.0453,-0.0591,0.073,-0.0063,-0.0648,0.0166,0.1122,0.0391,-0.2231,-0.0779,-0.2332,-0.1274,-0.1269,-0.1008,0.0318,-0.071,0.0179,-0.0433,0.0591,0.0898,-0.0069,-0.1544,0.0516,-0.1112,-0.0527,-0.0723,-0.1198,-0.0606,-0.0881,0.0005,0.0903,0.0875,-0.0603,-0.0486,-0.0206,-0.0059,0.0439,0.0772,-0.0117,0.2021,-0.0374,-0.0809,0.0084,0.0979,-0.0165,-0.0562,-0.0696,0.0859,0.0122,-0.0753,0.0413,0.2089,0.2269,0.043,-0.0539,0.0261,0.0733,0.0568,0.1959,0.0218,0.2853,-0.102,0.377,0.3785,0.0636,-0.007,0.0167,0.0739,0.0722,0.157,0.1641,0.035,0.0609,-0.08,-0.0968,0.1392,0.1951,0.1666,-0.1772,-0.1189,-0.1613,-0.0207,-0.093,-0.0671,-0.0689,0.0822,0.038,-0.0271,-0.1337,-0.1643,0.1192,-0.0638,-0.116,0.2553,0.2627,0.0997,-0.0667,0.1384,0.3737,0.1514,0.0313,0.1744,-0.0045,0.0912,0.1277,0.1824,-0.0569,0.175,0.0767,0.1202,0.02,0.3546,0.0841,-0.1333,-0.0724,-0.0125,-0.2134,-0.0911,-0.1335,-0.0573,-0.0787,-0.1561,-0.0283,-0.2472,-0.1737,-0.0355,-0.1351,-0.2656,-0.0694,-0.0638,0.0371,-0.0215,-0.0355,-0.0382,-0.0427,-0.0524,-0.0702,-0.2476,-0.185,0.0605,0.1201,-0.0022,0.0233,0.0294,-0.0167,-0.073,-0.1226,0.047,0.0844,-0.0335,0.0427,-0.1562,-0.208,-0.062,-0.0045,-0.1674,-0.1779,0.0425,-0.0206,-0.0303,-0.0803,-0.1258,-0.0969,-0.0211,0.0999,0.0327,0.0554,0.2038,-0.0248,0.0897,0.1685,0.0928,-0.1085,0.0735,-0.1607,-0.1724,-0.0946,0.0162,0.0111,-0.041,0.0706,0.0173,-0.0143,-0.1332,0.1129,-0.0019,0.0308,0.1333,-0.11,-0.1172,-0.1907,0.0258,-0.0273,0.1254,0.1169,-0.2475,-0.2645,0.1151,0.1315,-0.0099,0.0601,0.0337,-0.0263,-0.0951,-0.1577,-0.04,-0.0854,-0.1905,-0.0907,-0.0482,0.1891,0.0803,0.1955,0.0729,0.1713,-0.0029,0.0447,0.007,0.0423,0.0475,0.0478,0.0215,-0.028,-0.0202,0.0819,-0.0284,0.0396,-0.0472,-0.0408,-0.0036,-0.0056,-0.0413,0.0264,-0.0274,-0.0708,-0.1677,0.0006,0.0718,-0.0281,-0.0009,0.0029,-0.0018,-0.0031,-0.0597,-0.0791,0.0137,-0.0703,-0.1179,-0.0812,0.2218,0.1717,0.0911,0.0052,0.0662,-0.047,-0.0942,-0.0594,-0.0445,0.1281,0.0584,-0.103,-0.1646,0.0779,-0.1294,-0.0164,-0.0406,-0.018,-0.0015,-0.2857,0.0308,-0.1334,-0.0298,0.0111,-0.1749,-0.202,-0.0818,0.0511,0.0172,0.0059,-0.0176,-0.1129,0.0376,0.0712,-0.0072,0.0063,0.0162,-0.0191,-0.0269,-0.1687,-0.0584,-0.0062,-0.1068,0.0149,-0.1917,0.2577,-0.126,-0.0032,0.0926,0.059,-0.2428,-0.1927,0.0514,0.0823,0.0488,0.1063,0.0772,0.0433,0.113,-0.056,0.0156,0.0244,0.0322,-0.0138,-0.065,-0.1868,-0.0578,-0.0494,0.1253,0.0399,0.1452,0.0661,0.0565,0.014,-0.0546,0.0119,0.0228,0.1118,0.0398,0.0053,0.0959,0.0268,0.0471,0.0036,0.1131,0.2633,0.0962,0.1388,0.1863,0.1045,-0.1075,-0.0242,-0.1938,-0.0298,-0.0913,-0.2304,-0.182,-0.0986,0.2651,0.0954,-0.3023,-0.2843,-0.1022,-0.0178,0.0152,-0.1851,0.0468,-0.0375,-0.0496,0.0739,-0.0565,-0.024,0.0253,-0.1232,-0.1516,0.0842,-0.265,-0.2664,0.0654,0.052,0.0082,-0.0248,-0.0215,-0.1222,0.147,0.1719,-0.1186,0.0703,0.076,0.0255,0.0194,0.0005,-0.0505,0.255,0.2594,-0.0574,-0.0869,0.0075,-0.1317,-0.0543,-0.0985,-0.0033,0.1204,-0.0738,-0.0829,0.0044,0.0356,-0.0046,0.0168,response execution
trm_4a3fd79d0af66,0.1092,0.1302,0.0966,0.1844,0.0062,0.0561,0.0776,0.1036,0.0707,0.1035,0.0079,-0.0182,0.1019,0.0513,0.1256,0.0909,0.0782,0.1439,0.0962,0.0017,0.0443,-0.0322,-0.0042,-0.0296,-0.0261,-0.0617,-0.0591,0.1087,0.138,0.0484,0.0982,0.1092,0.1207,0.0768,0.1311,0.0951,0.0198,0.073,0.1654,0.0514,0.1069,0.1342,0.065,-0.0915,0.1166,0.0661,-0.2434,0.0908,-0.0183,0.1146,0.0481,-0.0364,-0.0496,0.0456,0.0713,0.0543,0.0844,0.0074,-0.016,0.0129,-0.0482,-0.0624,0.1567,-0.0831,0.0341,-0.0684,0.2132,0.212,0.1438,-0.0501,-0.0447,-0.0354,-0.1449,0.0461,0.2086,-0.081,0.1279,-0.0788,-0.0007,-0.0211,-0.0513,-0.0759,0.0643,0.1203,-0.0012,-0.0546,0.0411,-0.0368,-0.0093,0.1233,0.0685,0.0372,0.0133,-0.1199,-0.1964,-0.1564,-0.1437,-0.0317,-0.1983,-0.0292,-0.0904,-0.0109,-0.0688,-0.0202,-0.0797,0.1543,0.132,-0.1779,0.0454,0.0902,0.0123,0.1101,-0.0769,-0.1537,-0.0229,-0.0042,0.0977,-0.0255,0.0423,0.0899,0.0952,0.1723,0.1135,0.0228,0.1024,0.1027,0.1189,-0.0399,-0.0696,-0.0765,-0.0006,0.0697,-0.0017,0.1575,0.012,0.1879,0.0193,0.1008,0.0447,0.0139,0.1131,0.1196,-0.0391,0.0185,0.0692,-0.0187,0.0886,-0.0067,0.0999,-0.1021,0.0858,0.0736,0.1453,0.1521,-0.1412,-0.0182,-0.0583,-0.0162,-0.0195,0.0419,0.0948,0.0644,0.2059,0.1842,-0.0004,0.0189,-0.0015,0.141,0.1343,-0.0199,0.0012,0.1098,-0.0875,0.0723,0.0691,0.101,0.0631,0.0737,0.0296,0.033,0.1187,-0.1019,0.0662,0.0466,0.0252,0.0282,0.0381,-0.0204,-0.0168,0.0952,0.0905,0.019,-0.031,0.1652,0.1474,0.2933,0.2677,-0.0139,0.0325,0.168,0.056,-0.158,0.1375,0.1328,0.088,0.0186,0.0296,0.0806,0.0896,0.0267,0.1281,0.0272,-0.0051,-0.0501,-0.0667,-0.0397,-0.1545,0.1573,0.1382,-0.0473,-0.1196,0.0831,0.1035,0.0626,-0.0378,-0.0425,0.1153,-0.1571,-0.0145,-0.0515,0.04,0.0721,-0.1879,0.1409,0.136,-0.0433,-0.0168,-0.0059,-0.0216,0.0587,0.0034,0.1573,0.0829,-0.0008,0.0935,0.0756,0.0728,0.1545,0.0701,0.0736,-0.0364,-0.0421,0.0208,-0.0382,-0.0284,0.1509,0.0358,0.1288,-0.1532,-0.3261,-0.0815,-0.2498,0.1094,-0.0963,-0.1604,-0.2477,-0.0479,0.0327,-0.0678,0.0167,0.0911,0.0053,0.0836,-0.0544,0.0209,-0.1578,0.0405,0.0682,0.0835,-0.0369,-0.1093,-0.0133,-0.0273,0.141,0.113,0.0593,-0.0364,-0.0951,0.111,0.0881,0.1025,0.0467,0.0033,0.0413,0.0738,-0.0136,-0.0222,-0.0114,0.0628,-0.0564,-0.084,0.1505,0.1195,0.0469,0.0976,0.0928,0.1239,-0.0076,0.0061,0.0363,0.0274,0.0174,0.1854,-0.025,-0.0286,0.0975,-0.0696,-0.0581,-0.046,0.1559,0.0206,-0.0558,0.1175,0.1321,0.0883,0.0904,0.0011,0.0395,0.0774,0.1063,-0.0142,0.0587,-0.0302,-0.0286,-0.0416,-0.1051,-0.0148,0.0165,-0.0983,0.1523,0.1319,-0.102,-0.0256,0.0072,-0.0883,-0.0348,0.2063,0.1728,0.1292,0.089,0.0528,-0.1511,0.0598,0.0207,0.0386,0.0604,0.0611,0.1033,0.1208,0.112,-0.0123,0.0617,0.0666,0.0373,0.0267,-0.0637,0.1208,-0.0529,-0.0533,0.136,-0.0084,-0.054,0.0181,-0.1225,0.148,0.0405,0.1107,-0.1052,-0.2399,-0.1406,-0.2921,0.0157,0.1536,0.0526,-0.0022,-0.0214,0.0798,0.0314,-0.0043,0.053,0.055,0.0425,0.0611,0.0295,-0.0976,-0.0282,0.0818,0.1451,0.1043,0.0973,0.0758,-0.0411,-0.0064,0.0187,-0.0796,-0.0119,-0.0795,-0.0044,0.0855,0.0219,0.009,0.1523,0.0364,-0.2192,0.0546,0.03,-0.1825,0.0991,0.1567,0.0833,-0.0054,0.2406,0.1532,0.3897,0.3481,0.1681,0.1604,0.0917,0.1493,0.1756,0.0039,-0.0683,-0.0061,0.0303,-0.027,-0.0664,0.0033,-0.0283,0.2495,0.1705,-0.1034,-0.0536,-0.026,-0.0494,-0.042,0.0651,-0.0392,-0.1121,0.1148,0.17,0.124,-0.0379,0.1059,0.1055,0.0261,0.1306,-0.0609,0.1158,0.1009,0.0031,-0.0245,0.0941,0.0334,-0.0667,0.0881,0.1303,0.0065,-0.3091,0.0935,0.0303,-0.0097,-0.0693,-0.0196,0.0076,0.0075,0.0729,-0.0352,-0.0364,0.0117,0.0549,-0.0484,-0.0197,0.0533,-0.0199,-0.0567,-0.1037,0.0458,0.0114,0.0969,0.0474,-0.1631,-0.0545,0.1328,0.1495,-0.0882,-0.091,0.0866,0.036,-0.0423,0.1423,0.1327,-0.0174,0.0493,0.1276,0.1093,0.1098,-0.0082,-0.0427,0.0506,-0.1069,0.1685,0.0136,0.0268,0.0022,-0.1083,-0.0042,0.0834,0.0641,-0.1031,0.053,0.0955,0.0343,-0.1081,0.0024,-0.1057,-0.0421,-0.1152,-0.1424,-0.0765,-0.0315,0.0927,0.0491,0.0827,0.2113,0.0013,-0.0182,0.1192,0.1267,0.0495,0.095,0.0072,-0.0518,-0.0366,0.0316,0.0783,-0.0126,0.0274,-0.0409,-0.0379,-0.0236,-0.0793,0.0435,0.074,0.0415,0.0223,0.0996,-0.1092,-0.0305,-0.0891,0.0324,0.0509,0.0343,0.0759,-0.0727,0.0481,-0.1004,-0.1384,-0.0247,-0.0028,0.05,0.0706,0.0085,0.0944,-0.0408,-0.0042,0.0134,-0.0797,-0.0017,-0.1102,-0.0715,-0.0106,0.1105,0.0109,0.0528,-0.0483,-0.0019,0.1209,-0.0041,-0.0413,0.0522,0.0912,0.0674,0.0027,-0.0071,0.0982,0.0646,0.2082,0.0298,-0.1237,0.0475,-0.0355,-0.0954,-0.0691,-0.111,-0.061,-0.0228,-0.0128,0.1343,0.136,0.0277,0.1453,0.0592,-0.0249,0.0891,0.2341,0.0431,0.0722,-0.0212,-0.0263,0.2144,0.1033,0.2045,-0.05,-0.0167,-0.0008,-0.053,0.1618,0.1027,0.1295,-0.0016,-0.0431,-0.0227,0.0799,0.0535,0.1429,0.0063,-0.0067,0.0665,0.0371,0.0869,0.0849,-0.0676,0.0066,0.0725,0.1325,0.0226,0.1835,0.1242,-0.0523,0.1403,0.0839,0.1504,-0.1035,0.0766,0.0294,0.054,-0.0049,0.1184,0.045,0.1245,0.1326,-0.0346,-0.2066,0.076,-0.0509,-0.0638,0.122,0.0864,0.062,0.0536,0.0674,0.0576,0.0538,0.0401,0.0521,0.1123,-0.2154,0.0539,-0.0618,0.0401,-0.0003,-0.0588,-0.0686,-0.0581,-0.2057,0.1665,0.0945,-0.0282,0.0077,-0.0045,-0.0693,-0.0852,-0.0592,-0.1064,-0.1596,0.0671,-0.0355,0.0281,0.0849,0.0675,0.0294,0.0314,0.0204,0.0664,0.0585,0.0943,0.1204,0.1015,0.0753,-0.0273,-0.124,0.0474,0.1072,-0.0726,0.0359,0.0088,0.057,-0.0628,0.0731,-0.0443,-0.1578,0.0348,0.2508,0.2509,0.1685,0.0575,0.0378,0.1091,-0.0011,0.055,-0.1131,-0.0108,0.0368,-0.0576,-0.0444,-0.0135,0.1207,-0.0802,-0.0752,-0.1088,0.1091,0.0184,0.1096,0.0023,-0.0153,0.0774,-0.0809,-0.0829,0.0227,-0.0172,0.0032,-0.1412,0.165,0.2189,0.1821,0.128,-0.09,-0.2318,-0.0252,0.0919,0.0099,-0.0567,-0.042,-0.1108,-0.0346,-0.0206,0.0445,0.0942,0.0523,-0.0817,-0.0872,-0.1703,0.0083,0.0351,-0.0202,0.0889,-0.0578,0.0389,0.0908,0.0439,0.1337,0.1209,0.0844,-0.0658,-0.0495,0.0047,0.0311,0.0183,0.0153,-0.1048,0.0026,0.141,-0.1125,-0.0124,-0.0367,-0.0107,-0.0513,0.0664,-0.0458,0.1619,0.1587,-0.047,-0.1344,-0.2158,0.0013,-0.0374,-0.0485,0.0054,0.0062,-0.2759,-0.0655,-0.0383,-0.1273,-0.1577,-0.063,0.0198,-0.2014,-0.1992,0.1317,-0.0054,-0.0524,0.2161,0.1201,0.106,0.1007,-0.0831,0.24,0.0823,0.1307,0.0687,0.1424,-0.073,0.0062,-0.1797,0.0633,0.0413,0.0609,-0.0071,-0.0816,-0.0246,-0.0444,-0.1027,-0.0671,0.0147,-0.0072,0.0358,-0.1036,-0.1481,0.0834,-0.124,-0.0475,-0.0024,0.0462,0.0888,0.0617,-0.0637,0.154,0.2439,0.1347,0.0228,-0.0972,-0.0966,0.0456,0.0092,-0.0253,-0.0044,0.1221,0.1184,-0.0039,0.1347,-0.047,0.1454,-0.0301,0.076,-0.1149,0.1139,0.0699,0.0987,0.1848,0.1607,0.1014,-0.2311,0.1039,0.1104,0.0944,-0.091,-0.0036,0.1661,0.0629,0.1225,-0.0043,0.0554,-0.1063,-0.0389,-0.0396,-0.1499,0.1883,0.077,0.0554,-0.0697,0.115,-0.0198,-0.1952,-0.0553,-0.0836,-0.4192,-0.1056,0.0492,0.0742,0.1101,0.0961,0.0437,0.0384,-0.0175,-0.1248,-0.078,-0.0466,0.0986,-0.0577,-0.174,-0.0164,0.0368,0.0721,0.0259,0.1432,0.0493,0.0388,-0.0526,-0.0207,0.0771,0.013,-0.1908,-0.045,0.122,0.0112,-0.0735,-0.0051,0.0064,0.0527,0.1079,0.1141,0.1193,0.1336,0.1096,-0.0612,-0.0374,0.0196,0.101,-0.0102,0.0961,-0.0167,0.096,0.0637,0.056,-0.007,-0.0686,-0.0704,0.04,-0.0201,0.0407,-0.0825,-0.1216,-0.0999,-0.1803,-0.0904,0.0581,0.0399,0.013,0.013,-0.0912,-0.1044,-0.1278,0.0192,-0.0562,-0.0537,-0.1654,0.0073,0.0583,0.0327,-0.0915,0.0366,-0.1032,0.1452,0.0752,0.0764,0.0727,0.0496,-0.0286,-0.0813,-0.0069,-0.0855,-0.1778,-0.184,0.0975,0.0498,0.0088,0.0382,-0.0114,0.0039,0.021,0.0539,0.1362,0.0491,-0.113,-0.1034,0.1208,0.108,0.0455,0.1854,0.0756,-0.136,-0.0794,-0.0729,-0.1206,-0.1013,0.0637,-0.0093,-0.0789,0.0253,-0.0056,0.0337,-0.0315,0.0343,-0.0005,-0.0054,-0.0115,0.1143,-0.0184,0.1058,-0.0425,0.146,-0.0153,-0.0912,-0.0938,0.1065,0.0212,0.0494,0.1063,0.0183,0.0402,0.0865,0.0911,-0.0106,0.0231,-0.0535,0.0813,0.0489,0.0334,0.0063,0.0264,0.0392,0.0606,0.1466,0.1117,0.1164,-0.1568,-0.0118,-0.1054,0.1282,-0.2321,-0.164,0.0242,-0.0083,0.0065,-0.0536,0.0373,-0.1221,0.1098,0.1238,0.0111,0.0572,0.121,0.0198,0.0392,-0.1112,-0.1177,0.0365,0.0188,0.0274,-0.0471,0.0136,-0.0352,-0.0252,-0.0171,0.0969,0.0421,0.0325,-0.0954,0.0033,0.0136,-0.5355,-0.3791,-0.3239,-0.1595,-0.171,-0.1114,-0.3244,-0.2422,0.1464,-0.3901,-0.3598,-0.2806,-0.221,-0.3301,-0.1218,-0.1358,-0.0863,-0.0086,-0.0396,-0.0034,-0.0461,-0.0216,0.076,-0.0985,-0.1188,-0.021,-0.0948,0.064,0.0914,-0.158,-0.0634,0.0789,0.0482,0.056,-0.0723,-0.0558,-0.1724,0.0619,0.1365,0.0255,-0.0563,-0.0656,-0.1473,-0.1552,0.0515,0.0743,0.1542,0.0954,0.0771,-0.3621,0.0725,-0.2918,-0.2259,0.0555,-0.0595,0.0432,-0.0314,-0.0594,-0.0162,-0.2264,-0.1258,0.0627,-0.0065,-0.0009,0.0458,0.127,-0.0323,0.0562,-0.0315,-0.0214,0.0773,0.041,0.1363,0.0356,0.0303,0.0066,0.1769,0.0124,-0.207,-0.018,-0.0024,0.0551,-0.1264,-0.0822,-0.0242,0.1571,0.1647,0.0448,0.1017,0.0356,0.0996,0.0277,0.0634,0.054,0.0026,-0.0038,-0.028,-0.1739,0.0395,0.0699,0.0848,-0.0492,0.0505,-0.0344,0.1093,-0.0306,-0.1588,0.0242,0.1197,-0.0937,-0.0784,0.0896,0.1167,-0.0459,0.1941,0.0703,0.2296,0.0274,-0.0638,0.093,0.0873,-0.0381,0.0822,-0.0257,0.0852,0.0182,0.0721,0.0746,0.0928,-0.1227,0.0165,-0.478,-0.364,-0.3272,-0.4189,0.1065,0.0318,0.1053,0.1033,0.1358,-0.0115,0.0961,-0.2529,0.0778,0.0874,-0.0827,-0.0711,0.0491,-0.0702,-0.0492,-0.0093,-0.0043,-0.0572,0.1029,0.1041,0.0892,-0.1622,0.0153,-0.0064,0.0606,0.0606,0.1432,-0.0025,0.0304,-0.0044,0.0439,-0.0781,0.058,-0.2331,0.2433,0.2261,-0.0652,0.0286,0.1797,0.1797,0.1799,0.0217,0.0396,0.0512,-0.0118,0.0292,-0.1202,-0.0459,-0.1241,0.067,-0.094,0.0108,-0.0293,-0.0424,0.0502,0.0765,0.0625,0.054,0.0325,0.0336,-0.0242,-0.0775,-0.0557,-0.0477,-0.0269,-0.0574,0.0175,-0.1396,0.0173,-0.0112,0.0066,0.1164,-0.0534,0.1604,0.2868,0.0563,0.0905,0.2121,0.0389,0.0765,0.1618,0.002,0.0778,-0.0353,0.1604,-0.0005,0.0799,0.2019,0.0093,-0.0089,0.0312,-0.3288,-0.1196,-0.0666,-0.0754,-0.0014,-0.0615,0.0332,0.0904,0.085,-0.0023,0.0773,0.0096,0.0619,-0.0146,-0.0676,-0.0334,-0.0253,0.073,0.0974,0.047,-0.0227,0.012,0.0563,-0.0063,-0.0826,0.0157,0.0854,0.0199,0.0962,0.0984,0.0126,0.1402,0.1703,-0.0198,-0.0296,-0.1195,-0.0581,0.0468,0.121,0.1038,-0.033,0.1074,-0.0066,0.0067,0.0263,0.1074,0.155,-0.0112,-0.1351,-0.0733,0.015,-0.0426,0.0316,-0.2432,-0.0241,-0.0427,-0.0307,0.184,-0.13,0.0084,-0.1934,-0.0653,-0.2151,-0.0255,0.0912,0.0565,-0.1582,0.052,-0.0673,0.0636,0.0459,0.1336,0.0721,0.0365,-0.0594,0.0646,0.0087,0.1017,-0.0051,-0.0155,0.0374,-0.0151,0.1299,0.0073,0.0272,0.0858,-0.0449,0.0425,0.074,0.0622,0.1005,0.0934,0.0833,0.0506,0.0553,-0.0305,-0.0252,-0.0803,0.0546,0.0407,0.0251,-0.0043,-0.0073,0.0624,0.1883,-0.0696,0.0999,0.0077,-0.0046,-0.0639,-0.0625,-0.0282,-0.0504,0.0712,0.0318,0.0697,0.039,0.1828,-0.0082,0.1295,0.0319,-0.0398,0.0525,0.0639,0.1064,0.0897,-0.059,-0.0277,0.0459,-0.3523,0.0672,-0.0137,-0.0122,-0.2427,0.0056,0.0371,-0.105,-0.2322,0.0834,0.0296,0.148,0.1432,0.1006,0.0232,-0.0344,0.0269,0.0916,-0.1347,-0.2028,0.0552,0.0624,0.02,0.0049,-0.0484,-0.0717,0.2427,0.1368,0.0439,0.2159,0.19,-0.0801,-0.1315,-0.0458,0.0116,-0.0947,-0.0389,0.1783,0.0803,0.0953,0.094,0.1816,0.0458,0.065,0.074,0.1297,-0.1416,-0.0165,0.0038,-0.0317,-0.0296,-0.1362,-0.0941,0.0477,-0.071,0.0183,0.0583,0.0823,0.0294,-0.0578,-0.0091,-0.0001,-0.1454,-0.0671,-0.0508,0.0607,0.0824,0.0543,-0.29,-0.2751,0.1575,0.1431,-0.0188,0.077,0.0686,0.0508,0.171,-0.0205,0.0019,0.0278,-0.0125,0.0388,-0.149,0.0968,-0.0613,-0.0683,0.0656,-0.0128,-0.2587,0.0665,0.0687,-0.267,-0.0789,-0.031,-0.1075,-0.0682,0.0668,-0.0766,-0.0323,0.0582,0.0366,-0.0043,-0.0554,-0.0733,-0.0929,0.0457,0.0225,0.048,-0.1404,0.1309,-0.0536,-0.1556,0.0375,0.0298,-0.0477,0.0038,0.12,0.0293,-0.0668,0.0225,-0.0234,0.1057,-0.0434,-0.0881,0.0436,0.0291,-0.05,-0.0859,-0.0268,-0.1669,-0.1079,-0.1654,-0.0504,-0.1365,0.0324,-0.0123,-0.4797,0.1039,0.163,0.0829,0.0522,-0.0325,-0.0783,-0.0864,0.0402,-0.0108,-0.0257,0.0278,0.0057,0.0074,0.0471,0.0037,0.0182,-0.023,-0.0868,-0.1315,-0.2153,-0.2356,0.0411,0.1112,0.0867,0.0374,-0.0685,-0.0576,-0.0253,-0.1258,-0.0954,0.0414,-0.0928,0.049,0.1915,0.1071,-0.0529,-0.0611,-0.0083,-0.0806,-0.0383,-0.2891,-0.2338,-0.0241,0.0158,0.1201,-0.0054,-0.022,-0.0688,0.0669,0.1016,0.1359,-0.0598,-0.0022,-0.0171,-0.0893,0.0411,0.0206,-0.0846,-0.039,-0.0001,-0.1483,-0.0296,-0.0163,-0.0661,-0.0518,-0.1223,-0.1599,-0.2164,0.0279,-0.034,-0.0379,-0.0178,0.1022,-0.0095,0.188,0.0958,0.0295,0.1061,0.0008,-0.1168,0.1034,0.0519,0.0657,0.0223,0.0166,0.0359,0.0215,0.0722,0.0102,0.0067,0.0971,0.0114,-0.1415,-0.0165,-0.038,0.1991,0.1296,0.1439,0.0198,0.0481,0.1272,0.0819,0.0099,0.116,0.0517,-0.1005,0.0104,-0.0974,-0.0575,-0.0176,-0.0419,0.0087,-0.0296,-0.0369,0.0533,0.1898,-0.0165,0.1118,0.0613,0.0364,-0.0262,-0.0713,-0.2804,-0.1845,-0.0784,-0.0439,0.1169,0.2654,0.1312,0.1917,0.1234,-0.021,0.0152,-0.0405,0.0882,0.1472,0.1801,0.082,-0.0115,-0.0558,0.0463,0.0632,0.0133,0.0099,0.1615,0.1001,0.0758,-0.0409,-0.0111,0.0189,0.2218,0.1367,0.1334,0.1169,0.2853,-0.0467,-0.0297,0.0475,0.0874,0.0751,0.0673,0.0062,0.1739,0.0344,0.0577,-0.0165,-0.1081,-0.0225,-0.0238,-0.0684,0.1476,0.0474,0.0141,-0.0679,0.0671,0.0459,0.0664,-0.1338,0.1204,0.1304,0.0924,0.0778,0.063,0.144,0.0697,0.0756,0.0517,0.0734,0.0395,0.0408,0.223,-0.0202,0.092,0.1149,0.1017,0.0902,0.0209,0.1519,0.1079,-0.0012,-0.2289,0.0135,-0.016,0.2072,0.0985,0.1132,0.0737,0.1713,0.1036,0.005,-0.1166,-0.1143,0.0475,0.0837,-0.0208,-0.2042,-0.2027,-0.1699,0.2442,0.2449,0.067,-0.0424,-0.006,0.1294,0.0039,0.0291,-0.0452,0.058,0.0969,0.0666,-0.0027,0.0746,0.1105,0.0051,0.1128,0.046,0.0175,0.0929,-0.1346,-0.1629,0.0942,0.1233,0.1331,0.1512,0.0777,0.1967,0.1047,-0.4262,0.0911,0.118,0.0006,0.0144,0.0609,0.0151,0.0289,0.0045,-0.0508,0.0599,-0.0406,-0.0009,0.1101,0.0071,-0.0009,-0.124,-0.2971,0.1824,-0.0288,-0.0949,-0.3873,0.0004,0.0051,-0.0454,-0.0057,0.0093,0.0076,-0.1684,-0.0076,-0.0629,0.1262,0.1018,0.1285,0.0303,0.0828,-0.0889,-0.1671,-0.1813,-0.0885,-0.1055,-0.0725,-0.1477,-0.1108,-0.0654,0.0057,-0.0252,-0.0497,0.2385,0.0979,0.1764,0.0969,0.001,0.1509,0.1,0.067,-0.0139,0.0512,0.2058,0.0814,0.0675,0.0964,0.2472,-0.0342,0.1787,0.0388,-0.0433,0.1024,-0.0155,0.1596,0.077,0.0358,0.0882,0.0637,-0.0151,0.1206,-0.1051,-0.0677,-0.0978,-0.0027,0.1176,-0.0143,0.0187,-0.0146,-0.0858,-0.0121,0.0325,-0.0558,0.0044,0.0407,0.1765,0.0774,0.0323,0.0324,-0.065,0.027,0.1164,0.1131,0.0134,0.0761,-0.1022,0.1367,0.0349,-0.0148,0.0007,-0.0023,-0.0175,-0.0814,0.2281,0.0084,0.1272,0.1204,-0.0771,-0.1363,-0.1494,0.0362,-0.4632,-0.3221,0.181,0.1158,-0.4728,-0.2034,-0.0492,-0.1634,-0.1895,-0.1467,0.1527,0.1477,0.0865,0.1049,-0.5762,-0.4908,-0.3585,-0.0968,-0.1892,-0.2736,-0.5016,-0.4986,-0.4378,-0.0297,-0.0047,0.0656,-0.0366,0.0421,-0.0016,0.1395,0.0678,0.0007,0.0307,0.1325,0.1059,-0.099,0.0339,-0.0019,0.0559,-0.1054,-0.0732,-0.1178,0.0391,0.0446,0.1211,0.0042,-0.0157,0.0192,0.079,0.0742,0.0654,-0.0,0.1143,0.2024,0.1855,0.017,0.0902,0.0162,-0.2291,-0.0276,-0.1416,-0.086,-0.0813,-0.2464,-0.0097,0.1882,0.2157,0.031,-0.063,0.0145,-0.1513,-0.1146,-0.1521,-0.0375,0.1325,0.1283,0.0953,0.0852,-0.0341,0.2501,0.1964,-0.0134,0.0296,-0.0862,0.0606,-0.0208,-0.0525,0.0199,-0.0526,-0.0757,0.0074,0.0972,0.1398,0.0016,-0.0409,0.0629,0.0821,0.0932,-0.0654,-0.1236,-0.0992,-0.0182,-0.1609,0.053,0.0118,-0.0725,-0.0284,-0.1583,-0.1098,-0.0618,-0.0462,0.0078,-0.1242,-0.1389,0.087,0.0954,0.0569,0.0446,0.0626,-0.0382,-0.0036,0.0395,-0.0024,-0.0417,-0.0692,-0.0125,-0.1659,0.0035,-0.1798,-0.1884,0.1355,0.15,0.0898,0.1415,0.1826,-0.1522,-0.0113,0.0629,0.0843,-0.1613,0.024,0.1898,0.1034,-0.0655,0.0432,-0.0514,-0.0467,-0.1272,-0.1635,-0.2999,-0.4414,-0.1202,0.0033,0.0707,0.0131,-0.0464,0.118,0.1234,0.0781,-0.0268,0.0602,-0.0457,0.0319,0.0854,0.027,0.148,0.1682,0.1161,0.0792,0.0162,0.0771,0.1547,0.1066,0.0325,0.0087,0.0572,0.0686,0.0592,-0.1203,-0.1161,-0.0402,0.0401,-0.1783,-0.1243,0.0795,-0.15,0.1809,0.119,-0.0327,0.024,0.0282,0.0142,-0.0108,-0.0284,-0.0129,0.077,0.044,0.0129,-0.0006,-0.0473,0.1004,-0.0959,-0.0274,-0.0789,-0.0262,0.1451,0.1123,0.0559,0.0767,0.0946,0.0692,0.0938,0.0055,-0.0441,0.0379,-0.0687,0.2368,0.1152,0.1457,0.1984,0.1718,0.14,0.1018,0.1018,0.0326,0.0306,-0.0446,0.1889,0.0062,0.0999,0.099,-0.0086,-0.0137,0.3021,-0.1168,0.1647,0.0057,-0.0192,-0.1312,-0.0956,-0.0102,0.1151,0.1276,-0.0322,-0.0783,0.0214,-0.1001,-0.0253,0.0277,-0.0729,-0.0424,-0.0032,-0.0208,0.0345,0.0583,0.0168,0.1457,0.1177,0.048,0.0938,0.0303,0.0293,0.0233,-0.0428,0.0289,0.0144,-0.0513,-0.1578,0.0295,-0.1415,-0.0628,0.2618,0.086,0.2937,0.0375,0.1206,0.0451,0.0669,-0.0716,-0.0765,0.0064,-0.0814,-0.0649,-0.0493,-0.1624,-0.0512,-0.3447,-0.1848,0.0028,-0.1105,0.129,-0.0647,-0.0446,-0.0766,-0.0088,0.0452,-0.0381,0.0394,0.0074,0.0802,0.075,0.0886,0.0925,0.029,0.024,0.1523,-0.3814,-0.0043,-0.0765,-0.1055,0.0339,-0.0393,0.0244,0.0171,0.1599,0.0946,-0.0951,-0.0799,0.0848,0.0436,0.0602,-0.0123,-0.0538,-0.1597,-0.0042,0.0125,-0.0251,0.0683,-0.0992,0.1096,0.0191,-0.0084,0.0189,0.0204,0.0497,0.1045,0.0576,0.0385,-0.0328,0.1105,-0.1245,0.0235,-0.1641,-0.0075,-0.0163,-0.0914,-0.0051,0.0926,0.0569,0.099,0.0694,0.0148,-0.0637,0.0227,0.0785,-0.0175,-0.0834,-0.0305,0.1277,0.1045,0.1739,0.1392,-0.0599,0.0161,0.0005,0.1058,0.0733,0.0882,0.0516,0.0978,-0.0091,-0.0223,0.1092,-0.1515,0.076,0.0664,0.0663,-0.0095,0.1368,0.0286,-0.1105,-0.0501,0.196,-0.0643,-0.0324,0.0817,-0.099,-0.0986,-0.0104,-0.0493,0.0726,0.0958,0.0803,0.1498,0.1554,-0.0176,0.1333,-0.0351,-0.0427,-0.0831,-0.0803,-0.0985,0.1191,0.0856,-0.021,-0.1339,-0.2297,-0.0268,0.0334,0.0049,0.0215,0.1199,0.0217,0.1151,0.0953,0.0756,0.0567,0.0802,0.1632,-0.2099,0.0051,-0.0032,-0.2301,-0.0283,-0.0612,0.1293,0.0128,0.0112,-0.0752,0.0897,0.0288,-0.0038,-0.0052,0.0594,0.062,0.0643,0.1153,0.0194,0.0422,0.1905,0.0206,0.0192,0.028,0.0335,-0.0303,-0.0066,-0.0175,0.0724,-0.1408,0.1755,0.0882,0.1062,0.1609,0.0022,0.1539,0.105,0.254,0.1309,0.0791,-0.0564,0.1726,0.0233,0.0879,-0.0791,-0.0658,-0.066,0.1281,0.1467,0.076,-0.0042,-0.0564,-0.0895,0.0595,0.012,0.063,-0.0688,-0.0637,-0.037,-0.1351,0.0008,0.0701,-0.0339,-0.0116,0.0211,-0.0641,0.003,0.0427,0.0347,0.0228,-0.1511,0.0191,-0.1646,-0.1412,0.0326,0.0019,-0.0152,0.1674,0.0532,0.0178,-0.147,-0.2244,-0.1026,-0.0571,-0.0135,0.0062,-0.1341,-0.1487,-0.0837,-0.0742,0.1779,0.0377,0.055,-0.1531,0.0248,-0.0295,0.0118,0.0248,-0.0471,-0.0158,-0.0845,0.0469,-0.0861,0.0046,0.1122,-0.1129,-0.1238,-0.0454,0.0063,-0.0931,-0.1396,-0.0277,-0.0658,-0.0475,0.0913,-0.0441,-0.1328,-0.1288,-0.0231,0.0204,-0.1391,0.0441,0.126,0.3124,0.3031,-0.0552,-0.0709,-0.056,-0.0126,-0.0088,0.0526,0.0961,0.0456,0.0949,-0.0628,0.0059,0.0205,0.0479,-0.0639,0.0036,0.1523,0.009,0.1321,0.1454,0.003,0.0341,-0.0265,0.2264,0.1091,-0.0105,-0.0049,0.0233,-0.1069,0.033,0.125,0.092,-0.2105,0.1254,-0.0564,0.0072,0.0089,-0.0161,-0.1256,0.1243,-0.1806,-0.1816,0.0807,0.0717,0.0863,-0.0401,0.0713,0.1135,0.1342,0.1907,0.0669,-0.0095,0.0291,-0.0692,0.0105,0.0271,0.1098,0.1608,-0.1959,-0.1706,0.1629,0.0507,0.0523,0.0795,0.1792,-0.2638,-0.1399,0.104,-0.0245,-0.1373,-0.0569,0.1512,0.1615,0.1665,0.2222,0.0829,0.096,-0.0602,-0.0475,-0.0406,-0.0447,0.0594,-0.0503,-0.4129,-0.202,-0.1071,-0.3733,0.2503,0.1883,0.115,-0.0135,0.0182,0.0353,0.0898,-0.0163,-0.0333,0.169,0.1512,0.0419,-0.2939,0.0931,0.0405,0.0334,-0.0684,-0.0989,-0.1457,0.0359,0.1,0.097,0.0787,-0.0261,-0.103,-0.0704,-0.0688,-0.0243,-0.0076,-0.0433,-0.0523,-0.0277,0.0121,0.1133,-0.0067,-0.0035,-0.0117,0.0079,-0.0061,-0.0297,-0.0023,-0.0203,-0.0206,0.0035,0.0246,0.1769,0.1364,0.0604,0.1601,-0.3509,-0.0306,-0.2681,-0.09,-0.0462,-0.0465,-0.0608,-0.0833,0.0251,-0.1099,-0.1805,-0.0659,-0.0598,-0.0573,-0.0436,0.0708,0.0438,0.1241,-0.0118,-0.2923,-0.1746,0.0698,0.0098,-0.0031,0.0673,-0.0238,-0.0543,0.0831,0.0957,0.0044,0.1486,-0.0707,0.0636,-0.1184,-0.0893,-0.1239,-0.0043,0.0286,0.0128,0.0172,0.0282,-0.0784,-0.1654,0.0045,-0.0418,0.081,-0.1327,0.088,0.1234,0.0353,-0.1432,-0.0587,0.0139,0.1544,0.0505,0.1067,0.0902,-0.0092,0.0069,0.0356,-0.0107,0.0948,0.1188,0.0895,0.0649,0.0942,0.044,0.0564,0.0016,0.0561,0.0106,0.1514,0.158,0.1366,0.0572,-0.0092,0.0785,0.0881,-0.0985,-0.1569,-0.0351,0.0624,-0.2639,-0.2858,-0.1529,0.0331,-0.086,-0.0441,0.0716,-0.0117,0.0401,-0.0509,-0.1924,-0.2463,0.0071,-0.0169,-0.1196,-0.0523,0.0909,0.0279,0.0001,-0.006,0.076,0.06,0.0452,0.1022,-0.0013,0.1589,0.1371,-0.1134,-0.0262,0.199,0.0021,-0.0706,-0.1109,0.0402,0.0789,0.3231,0.2849,0.1241,0.2044,-0.2664,0.0339,0.0468,-0.082,0.0097,0.0695,0.1029,0.039,-0.3095,-0.1506,-0.3016,-0.1336,-0.0813,0.1189,0.0915,-0.0342,0.0279,-0.0127,0.0024,0.0331,-0.2847,-0.1723,0.1021,0.209,0.0769,0.1195,0.158,0.0477,0.0784,-0.0748,-0.0754,-0.0339,0.0144,0.0111,0.1546,-0.0099,0.1058,-0.005,0.1577,0.1711,0.0106,-0.1268,0.0677,0.0381,0.0521,0.1305,0.0821,0.1583,0.074,0.103,0.056,0.0167,-0.0157,0.0297,0.0599,-0.0382,0.0071,-0.0061,0.1117,0.0651,0.1337,-0.0327,-0.0979,-0.0346,0.0706,-0.1118,0.0952,0.0729,-0.0976,-0.0448,-0.0302,-0.0007,-0.0047,0.0237,0.0389,-0.0182,-0.1824,-0.2763,-0.2565,-0.0442,-0.1261,-0.0032,-0.0983,0.1084,-0.1442,0.0131,-0.1835,-0.0246,0.028,0.0476,-0.0753,0.0319,0.0213,0.0035,-0.0278,0.0549,0.0472,-0.0805,-0.0682,-0.0003,0.1041,-0.0752,-0.0729,-0.0473,0.166,0.1198,0.1733,0.0112,0.1385,0.117,-0.011,-0.0142,-0.0196,0.024,0.1062,0.106,-0.0403,-0.0375,0.118,0.0214,-0.206,-0.0356,0.0535,-0.1332,-0.1313,-0.0864,-0.0435,-0.1015,0.1086,0.0372,-0.2495,-0.0486,0.0748,-0.1934,-0.024,0.0132,-0.0558,-0.1649,-0.0655,0.1112,0.1182,0.101,-0.0791,-0.1786,0.0462,-0.0877,0.0139,0.0122,0.022,0.0715,-0.0252,-0.2041,0.0658,0.1086,-0.0816,0.0282,0.1089,-0.0073,0.0503,0.0729,0.0752,0.0832,0.0796,0.1656,0.1139,-0.0833,-0.19,0.0542,0.0403,0.0495,-0.0476,0.0056,0.0879,0.1154,0.1705,-0.0542,-0.0336,0.1528,0.1495,0.0856,0.0464,0.083,0.1339,0.003,0.1234,0.0792,0.1619,0.0273,-0.0002,0.0893,0.0421,-0.01,0.052,-0.0707,0.0803,-0.0214,-0.1101,-0.0909,0.1415,0.0185,0.1043,0.1223,0.063,0.043,0.0453,-0.0546,-0.1142,-0.1717,0.0327,0.0746,-0.0633,0.0513,0.0408,-0.1071,0.1625,0.0645,0.1306,-0.0744,-0.0444,-0.1154,0.0377,0.2111,0.1588,0.0607,0.0395,-0.0154,-0.1262,-0.1488,-0.0074,0.0843,0.0924,0.0794,0.1433,0.2558,0.1075,0.1065,-0.008,0.0332,-0.0378,0.0108,-0.1224,0.0165,-0.0297,-0.0058,-0.087,-0.1195,-0.0442,0.0091,-0.0343,0.1107,0.0233,0.0943,0.0712,0.0444,0.0199,0.0475,0.029,0.1138,0.0842,0.0673,0.0275,0.0692,0.0349,0.0097,-0.1699,0.0099,-0.129,-0.0478,-0.0653,0.0011,-0.0717,0.0047,0.0653,0.1333,0.0532,-0.1397,-0.0272,-0.0182,0.0865,0.0806,0.1233,0.0756,-0.0238,0.0434,-0.0589,-0.1204,0.1885,0.1344,0.0012,0.1158,0.0647,0.0388,-0.5017,-0.3958,0.1066,-0.0751,0.0541,0.0021,0.0634,0.1448,0.1778,0.1334,-0.0658,0.0234,0.0948,0.0103,0.1394,0.0631,-0.1512,-0.0069,-0.0604,0.0191,-0.0044,-0.0265,0.1305,0.0093,-0.1334,0.1252,-0.0457,0.1496,-0.1353,0.1668,-0.4121,0.0324,0.0043,0.1791,0.1655,-0.0097,-0.0524,0.0396,-0.0694,0.0064,-0.0763,0.044,-0.0563,-0.0761,-0.1526,-0.1282,-0.2138,-0.173,-0.2685,-0.3253,0.0606,-0.0659,-0.3806,-0.6502,-0.2596,-0.2315,-0.5155,-0.3117,-0.2814,-0.3872,-0.2109,-0.3464,-0.2885,-0.1955,-0.3318,-0.2051,-0.3292,-0.285,-0.3295,-0.2617,-0.2833,-0.1352,-0.2102,0.1743,0.1449,0.147,0.0946,0.0287,0.1968,0.2064,0.0763,0.0474,0.0604,0.2224,0.1896,0.1366,-0.0007,-0.0002,0.1356,-0.1877,0.0152,0.1265,0.0411,0.1169,0.0907,0.1029,0.0249,0.1172,-0.0839,0.1721,0.193,-0.0928,0.0356,0.0812,-0.0227,-0.0268,0.1032,-0.0093,-0.0172,0.0938,-0.136,-0.2939,0.0536,-0.104,-0.0999,0.1094,-0.0683,-0.069,0.0205,0.077,-0.1497,0.0037,-0.0387,0.1092,0.0337,-0.1625,0.0566,0.0791,0.0188,0.0295,0.0655,0.0507,response inhibition
trm_557b495cdde57,0.0264,0.0248,0.0156,0.0058,-0.0171,-0.0116,-0.0081,0.0095,0.0034,0.0202,-0.003,0.0091,0.0122,0.0162,0.0271,0.0224,0.0154,-0.0092,-0.0417,-0.004,0.0268,0.0034,-0.0045,-0.0068,-0.0003,-0.0049,-0.0056,0.009,0.0105,0.011,0.0044,-0.0185,-0.002,-0.0053,-0.0016,-0.008,-0.0178,-0.0144,0.0356,-0.0055,-0.0235,0.0298,-0.0009,-0.0085,0.0005,0.017,-0.0102,0.0174,0.0055,-0.014,0.0174,0.0104,0.0059,0.0035,0.0035,-0.0024,0.0119,0.0101,-0.0096,0.0097,0.0032,-0.0012,0.0064,0.0059,0.015,0.007,0.0215,0.0213,0.0151,-0.0147,-0.0281,-0.0126,-0.0288,-0.0057,0.0273,0.0043,0.0174,-0.0127,0.0057,-0.0075,-0.0109,0.0037,-0.0094,0.0033,-0.002,0.0001,0.0113,-0.0035,0.0067,0.0185,-0.0013,0.0031,-0.044,0.021,0.0163,0.0178,-0.0005,0.0265,0.012,-0.0034,0.0155,-0.0145,-0.0062,0.005,0.0077,-0.014,0.0185,-0.0227,0.0092,0.0191,-0.0044,0.0069,0.0011,0.0092,0.0034,-0.0261,0.0028,0.023,0.0156,0.0012,0.0052,0.008,-0.0037,-0.0007,0.0002,0.0052,-0.03,-0.0005,-0.0353,-0.0228,-0.0121,0.0024,0.0038,-0.0366,-0.0009,0.0117,0.0019,-0.0007,-0.0023,0.024,0.0062,-0.0019,-0.0216,-0.0114,0.0055,0.0068,0.0141,0.0054,0.0146,-0.0262,0.0063,-0.0017,-0.0256,-0.018,0.0002,-0.008,-0.013,0.0191,-0.0176,-0.0205,0.0229,0.0071,0.004,0.0117,-0.0048,-0.0094,-0.0032,0.014,0.0135,0.0069,-0.0311,0.0058,-0.0162,-0.0339,-0.0011,-0.0076,-0.0132,-0.0323,-0.0085,0.0056,0.0081,-0.0302,-0.0057,-0.0013,0.0079,-0.0004,-0.0055,-0.0151,0.0059,0.0168,0.0149,-0.0018,0.0004,0.0216,0.0213,0.0275,0.0245,0.0076,-0.0009,0.0114,0.0047,0.0122,0.0053,0.0153,0.0053,0.0044,-0.0127,0.0155,0.0086,-0.009,-0.009,-0.0141,-0.0058,-0.0204,-0.0043,0.0013,-0.0148,0.009,0.0259,0.0059,-0.01,-0.0037,-0.0196,-0.0028,0.0035,-0.0131,0.0088,-0.0129,-0.0186,-0.0014,0.0055,0.0037,-0.0287,0.0008,0.0001,0.0062,-0.0202,-0.0115,0.0104,0.0193,-0.0133,0.0202,0.0101,0.0029,-0.0041,0.0076,-0.0191,0.007,0.0189,0.0058,0.0087,-0.0082,-0.0095,-0.0286,0.007,0.0077,0.0076,0.0072,0.0146,0.001,0.01,0.0129,0.0062,0.0188,0.0071,-0.0146,-0.0087,0.0048,-0.0376,0.015,0.0138,0.0261,0.0045,-0.0031,0.0135,0.0001,0.0035,0.0124,0.0194,-0.0229,-0.0015,-0.0126,-0.0209,-0.0082,-0.0059,0.0046,0.0102,-0.0018,0.0229,0.0092,-0.0127,-0.0045,0.0094,-0.0126,-0.0048,-0.0205,0.0138,0.0117,0.0051,0.0196,0.0067,-0.0175,-0.0087,-0.0062,0.0095,0.0085,0.0068,0.0218,0.0233,0.0173,-0.0113,-0.0024,0.02,0.0048,-0.0257,0.019,0.0126,-0.0021,0.0036,0.0082,-0.0082,-0.0047,0.0011,0.0014,0.0023,0.0267,0.0035,0.013,-0.0161,-0.0103,0.0034,-0.0199,-0.0041,-0.0093,-0.0091,-0.0029,-0.0257,-0.0024,0.0003,-0.0001,-0.0034,-0.0137,0.0179,0.0008,0.0208,0.0047,0.0096,0.0125,0.005,-0.0043,0.0144,-0.0006,0.0066,0.0119,-0.0033,0.0079,-0.0027,0.0027,0.0141,-0.0003,-0.0044,0.0036,0.0081,0.0136,-0.0023,-0.0035,0.0224,0.0256,-0.0138,0.023,-0.0028,0.0122,-0.0161,-0.0106,-0.0065,0.01,0.0198,0.0072,-0.0226,-0.0124,-0.0311,0.0224,0.0091,-0.01,0.0106,0.0033,0.0041,0.0055,0.0159,-0.0012,-0.0023,0.0136,0.0152,0.0173,0.0087,0.0044,0.004,0.0099,0.0186,0.005,-0.0033,-0.0146,0.0191,0.0151,0.011,-0.0035,0.0071,0.0221,-0.025,0.0052,0.0203,-0.0009,0.011,0.0096,-0.0072,0.0041,-0.0142,0.014,0.0088,0.0232,0.003,0.0111,0.0087,0.0354,0.0251,0.0117,0.0216,-0.0081,0.0049,-0.0162,0.03,-0.018,0.026,-0.0099,-0.0429,-0.0205,0.0029,-0.0072,0.014,0.0166,-0.0273,-0.0087,-0.0153,-0.0148,0.0064,0.0062,-0.0116,0.0007,0.016,0.0247,0.0296,0.0119,0.0135,0.0146,-0.0056,0.0041,0.0076,0.011,0.0272,-0.0266,-0.0009,0.004,0.0004,-0.0325,0.0129,-0.0091,-0.0239,-0.0247,0.0113,-0.0092,0.0006,0.0065,0.0238,-0.0044,-0.0258,0.0028,0.0067,-0.0009,-0.004,0.0217,0.0174,0.0206,0.0169,0.0191,-0.01,-0.0218,0.0102,-0.0081,0.0001,-0.0054,-0.0416,-0.0341,-0.009,-0.0221,-0.0311,0.0066,0.0061,0.0099,-0.0118,0.0068,0.0042,0.018,0.0157,0.0164,0.0006,0.0059,0.0069,-0.015,-0.0186,-0.0084,0.0059,-0.0265,0.0069,-0.0004,-0.0014,0.0065,-0.0036,-0.01,0.0096,0.002,-0.0028,0.0084,-0.0137,0.0286,-0.0086,0.001,-0.0012,-0.0158,-0.012,0.006,-0.0026,0.0227,-0.0056,0.0046,-0.0221,0.0022,0.0204,0.0074,0.0006,-0.0106,-0.0284,0.0065,0.0144,0.008,-0.0112,-0.0005,0.0096,0.0033,0.0013,-0.0113,-0.0104,-0.0154,-0.004,-0.0035,0.0184,0.0097,-0.0309,-0.0017,-0.0489,0.0273,0.0025,0.0091,0.0113,0.0134,0.0052,-0.0368,-0.0239,-0.0136,-0.0129,-0.0052,-0.0038,-0.0047,-0.0228,0.0056,-0.0073,-0.0054,-0.0049,0.0044,0.0087,0.0071,-0.0122,0.0226,0.0043,0.016,0.0083,-0.0066,0.0216,-0.0008,-0.0098,0.0038,-0.0125,0.0106,-0.0027,0.0187,0.0114,0.0109,0.0107,-0.003,0.019,-0.002,-0.0019,-0.012,0.0042,-0.0205,0.0073,-0.0055,0.0101,0.0245,0.023,0.013,0.0166,0.0184,0.0046,0.0083,0.0186,0.0063,0.0283,0.0053,0.0024,0.0263,-0.0005,0.0161,-0.0321,0.0076,0.0109,-0.0147,0.0169,0.013,0.0126,0.0076,-0.0093,0.0018,0.0068,0.0217,0.0294,-0.0025,0.0079,0.0099,0.0106,0.0037,0.0151,-0.0059,0.0114,0.0066,-0.0029,0.0109,0.011,0.004,-0.0019,0.0129,-0.0155,0.0128,0.0095,0.0024,-0.0171,0.0024,0.0223,0.0045,-0.0053,-0.0044,0.0095,-0.0061,-0.0152,0.0114,0.0081,0.0093,0.0003,0.0132,0.0046,-0.0027,-0.0349,-0.0007,-0.022,0.0034,0.002,0.014,-0.0451,0.0206,0.0084,-0.0041,-0.008,-0.0121,0.0077,0.0194,-0.0012,0.0202,0.0108,0.0049,0.0109,0.0187,0.0082,0.006,-0.004,0.0069,-0.0238,0.0047,-0.0023,0.0301,0.0018,0.0228,-0.0093,-0.0028,0.0139,-0.0207,0.0139,-0.0162,0.0258,0.0202,0.008,-0.0248,-0.0013,-0.005,-0.0025,-0.0188,-0.0197,0.0046,-0.0187,-0.0114,-0.0074,0.0105,-0.0432,0.0159,0.0111,0.0122,0.0113,0.0185,0.0162,0.0044,0.0067,0.003,-0.0172,0.0126,-0.005,-0.0037,-0.0098,0.0173,0.0223,0.0045,0.0176,-0.0011,0.0123,-0.0042,0.0038,-0.0069,-0.0196,0.0115,0.0157,-0.0074,0.0085,-0.0148,-0.0186,-0.0524,-0.016,-0.0035,-0.0142,-0.0208,0.0105,-0.0284,-0.0273,0.0079,0.0094,0.0128,-0.0042,-0.0053,-0.0243,0.0033,0.0068,0.0229,0.0007,0.0045,0.0029,0.002,0.0071,-0.0002,0.0035,0.0128,-0.0305,-0.0253,0.0096,0.0022,0.0192,0.0087,-0.0149,0.0225,-0.0032,-0.0015,-0.0106,-0.0043,-0.0173,0.0087,0.003,-0.0097,-0.0261,-0.0293,-0.0027,0.0048,0.0062,0.0242,0.009,0.007,0.0078,-0.022,-0.0258,-0.0371,0.0052,-0.0176,0.0046,0.0154,0.0297,-0.0204,-0.0092,0.0204,-0.0398,-0.0211,0.0189,-0.0305,-0.0064,-0.0206,-0.009,0.005,-0.0082,0.0018,0.0152,-0.0144,-0.0005,-0.0408,-0.0014,0.0077,-0.0188,-0.0037,-0.0015,-0.0129,-0.0178,-0.0181,0.0016,0.0075,0.0143,-0.0015,0.0155,-0.0082,-0.0028,0.0145,0.0138,0.0164,0.0022,0.0179,0.018,-0.0116,0.0064,0.0062,0.0076,-0.0101,-0.0077,0.0024,0.011,0.0053,0.0308,0.0129,0.0167,-0.0111,0.0079,-0.0099,0.0045,-0.0111,0.015,-0.0034,0.0031,0.002,0.0151,0.0043,0.0042,0.0076,0.022,0.0056,0.0048,0.0121,-0.0099,0.0159,0.015,0.0079,0.006,0.0039,-0.0054,0.0067,0.0148,0.0071,0.0101,0.0149,-0.0052,-0.0081,0.0159,0.0089,0.0025,0.0102,0.0126,-0.0154,0.0128,0.0021,-0.0067,0.0074,-0.0417,-0.0056,-0.0509,-0.0068,-0.0321,-0.0721,-0.0097,0.0087,-0.0062,0.0028,0.0232,-0.0194,0.0178,0.0055,0.0057,-0.042,-0.0302,-0.0021,-0.002,0.0027,0.0163,-0.0034,0.0116,0.0016,0.0169,-0.006,0.0087,-0.0171,-0.0131,-0.0008,-0.0159,-0.0187,0.0202,-0.007,0.0116,-0.0345,0.0047,-0.0142,0.0018,0.0096,0.0101,-0.0162,-0.0062,-0.0201,-0.0295,0.0078,-0.0161,-0.0079,-0.0282,0.0055,-0.0141,-0.0377,0.001,0.0061,-0.0046,0.0188,-0.0124,0.0049,0.0109,-0.0283,-0.0174,0.0128,-0.0033,-0.0063,-0.026,0.0002,0.027,-0.0013,-0.0002,-0.009,0.0053,0.0214,0.0094,-0.022,-0.0099,0.0049,0.0076,0.0024,0.0243,0.0149,0.013,-0.0168,0.0186,0.0128,-0.0176,0.002,-0.0055,-0.0012,0.0138,-0.0017,0.0108,-0.0657,-0.0304,0.0217,0.0117,0.0012,0.0215,-0.0028,-0.01,0.0069,0.0153,0.0056,-0.0085,-0.0243,-0.0254,0.0176,0.0013,-0.0048,-0.0203,-0.0096,0.0195,0.0142,0.0085,-0.0523,0.0079,0.0143,-0.0073,-0.0057,0.0172,-0.0006,-0.0007,-0.0324,-0.0263,-0.0003,-0.0053,0.0171,0.008,0.0054,0.0023,-0.0017,0.007,-0.0301,0.0115,-0.0027,0.0196,0.0049,0.0045,0.0174,0.017,-0.0253,-0.0071,0.0127,0.0257,-0.0129,-0.0045,0.0067,0.0078,-0.0031,0.0056,0.0041,-0.003,0.0006,0.0017,0.0033,0.018,-0.0237,-0.0159,-0.0488,0.0003,-0.0193,-0.0036,-0.0168,0.0001,0.0142,-0.031,0.0036,-0.0158,0.0168,0.0019,-0.0336,0.011,0.0049,0.0007,-0.004,-0.0004,-0.0246,-0.0051,-0.0027,0.0031,0.0163,0.014,-0.0008,-0.0136,-0.0055,0.0204,0.0125,-0.0267,0.0107,-0.0146,-0.0064,-0.0547,-0.0395,-0.0175,0.0102,-0.0117,-0.0126,-0.01,-0.0124,0.0176,-0.0469,-0.0144,-0.0061,-0.0415,-0.0479,-0.0212,-0.0055,-0.0295,0.0115,0.0024,-0.0015,0.0109,-0.0171,0.0072,0.0301,0.0277,-0.004,-0.0031,0.0108,-0.0084,0.0009,0.0093,0.0134,-0.0041,0.0185,0.0007,-0.0008,0.02,0.0175,0.0228,-0.0355,-0.0177,-0.0202,-0.0087,0.0058,-0.008,-0.0048,-0.0039,-0.0169,-0.0147,-0.0122,0.0209,-0.0242,-0.0172,-0.0086,0.0218,0.0104,0.0072,0.011,0.0062,-0.0003,-0.0208,0.0066,0.0037,0.0006,0.0035,0.0077,0.0108,0.0164,-0.0261,-0.01,0.0061,0.0177,0.0268,0.0089,-0.0079,-0.0014,0.0224,0.0048,-0.0012,0.0028,0.0041,0.0049,0.0053,0.0162,0.0029,0.0201,0.0213,-0.0177,0.0066,-0.0039,0.0002,-0.0149,0.0171,0.0153,0.027,0.0088,0.0154,-0.0002,-0.0033,0.0093,0.0284,-0.0075,0.0074,0.0277,0.01,-0.0017,-0.0096,-0.0103,0.0069,0.0007,-0.0067,-0.002,0.0128,0.0178,-0.0092,0.0027,-0.0036,-0.0064,-0.0191,-0.0126,0.0028,0.0159,0.0099,0.0134,0.0055,-0.0175,-0.0109,0.0089,0.0206,-0.0133,0.005,-0.0359,-0.0258,-0.0135,-0.0299,0.0265,-0.0011,-0.0018,-0.0004,0.0188,-0.0251,0.0089,-0.0309,-0.0094,-0.0102,-0.0107,-0.0186,-0.003,-0.0301,-0.016,-0.0071,0.0028,-0.0144,-0.0076,-0.0246,-0.0137,-0.0071,0.0044,-0.0033,-0.0313,-0.0313,0.0143,0.0168,0.0201,-0.0071,-0.0047,-0.0126,0.0142,-0.0039,0.0131,0.0168,0.0144,-0.0167,0.0203,0.0177,-0.0018,-0.0129,0.0156,-0.0284,0.0008,-0.0075,0.0126,-0.0035,-0.003,0.0139,-0.0033,0.0112,-0.0013,0.007,0.0088,-0.0026,0.0099,0.0228,0.0067,0.003,-0.0149,0.0036,0.0032,-0.0009,0.0156,-0.0081,0.0134,-0.0161,-0.0288,-0.0166,-0.0198,0.0021,-0.0116,0.0039,-0.0104,0.0033,-0.0292,0.0019,0.0067,-0.0267,0.0036,-0.009,0.0166,-0.0341,0.0182,0.0236,0.0123,0.0232,-0.0051,0.0152,-0.0083,-0.0069,0.0118,0.0286,0.0244,-0.0221,-0.0094,-0.0055,0.0062,0.0044,-0.0046,-0.0137,0.0061,0.0066,-0.0175,0.0105,0.0052,0.0169,0.0169,-0.0025,-0.0001,0.0039,0.0109,-0.0109,-0.0027,0.0066,-0.008,-0.0145,-0.0018,-0.0009,-0.0132,-0.0028,0.0026,0.0059,-0.008,-0.0089,-0.007,0.0156,0.0089,0.0068,0.004,-0.0035,-0.0021,-0.0179,-0.0059,0.0067,0.0033,-0.0241,-0.0007,-0.0273,0.0117,-0.0029,0.0018,0.019,-0.0208,-0.0002,-0.0034,0.0119,-0.0048,0.004,-0.0121,-0.0168,-0.0094,-0.0102,0.0142,0.0002,0.0235,0.0112,0.0015,0.0111,-0.0216,-0.0088,0.0018,0.0072,-0.014,0.0115,0.0011,-0.0064,0.0169,-0.0228,-0.0136,0.0056,-0.0187,-0.0067,-0.0115,0.0127,-0.0074,0.0047,-0.0169,0.0162,-0.0142,0.0022,-0.0013,-0.0146,0.0224,-0.0218,0.0031,-0.0067,0.009,0.0024,0.0147,-0.0002,-0.0029,-0.0004,-0.0237,-0.0233,-0.0382,0.0197,0.0137,0.0061,-0.0249,0.0167,0.0141,0.0029,0.0202,-0.0047,-0.0037,0.0084,-0.004,-0.0,0.0019,-0.0177,-0.0385,-0.0028,-0.0073,0.0046,0.0189,0.0222,0.0139,0.0043,-0.026,0.0193,-0.0035,0.0115,-0.0109,-0.007,0.0124,0.0017,-0.014,0.0261,0.0167,-0.0014,0.0005,0.016,0.0042,0.0053,0.0202,0.0215,0.0079,-0.0014,0.0214,-0.0035,0.0062,-0.0187,-0.0153,-0.0058,0.0067,0.0138,-0.0028,0.0137,0.0041,-0.0139,0.0012,-0.0239,0.0032,-0.0223,-0.0181,0.0135,0.0104,0.0077,-0.0014,0.0267,0.0147,-0.0159,0.0016,-0.0061,-0.0103,0.0116,-0.0142,-0.0247,-0.0244,-0.0312,0.0209,-0.0051,-0.0265,0.0173,0.0204,-0.001,-0.0257,-0.0275,0.0019,-0.022,-0.0026,0.0032,-0.0002,-0.0141,-0.0036,0.0017,0.0055,0.0085,-0.0079,0.0065,-0.0026,0.0211,0.008,-0.0218,0.0244,0.0068,0.0183,-0.0041,0.0135,0.0215,0.0004,0.0055,-0.0128,0.016,-0.0175,0.0133,-0.0109,0.0109,0.009,0.0049,0.0244,-0.0137,-0.0001,-0.009,0.007,-0.0103,0.0095,0.0041,-0.011,-0.0167,-0.0154,-0.0206,0.0107,-0.0003,0.012,-0.0128,-0.0405,0.0105,0.0135,0.0001,0.0021,0.0125,-0.0098,-0.0099,-0.0063,-0.0082,-0.0215,0.0193,0.0013,0.0134,0.0069,-0.0011,0.0264,0.0115,0.0113,0.003,-0.0128,-0.0508,0.0133,-0.0271,-0.0256,0.0158,0.0257,0.0102,-0.0171,-0.0031,0.0199,0.0022,0.0184,0.0161,0.0306,0.0097,0.0139,0.0048,0.0222,0.0005,0.0106,0.0103,-0.0024,0.0083,0.0164,0.0044,-0.0117,-0.0032,-0.0002,0.0053,-0.0091,-0.01,0.0206,-0.0094,0.0075,0.0058,-0.023,0.0065,-0.0018,-0.01,0.0054,0.0098,-0.0042,-0.0115,0.028,0.0076,-0.0049,-0.0236,0.011,-0.0488,-0.0524,0.0077,0.0129,0.0201,-0.0109,0.0115,-0.0263,0.0067,0.0209,0.0088,-0.0036,0.0099,-0.0081,0.0169,0.0246,0.0057,-0.0185,0.0111,0.0086,-0.0015,-0.0193,0.0129,0.0017,0.0095,0.0023,0.0152,0.0042,0.0009,-0.0094,-0.0051,0.0284,0.0055,-0.0155,-0.0025,0.0077,-0.0183,-0.0003,-0.0109,-0.0121,-0.0109,0.0063,-0.0212,-0.0075,-0.0088,0.0203,-0.0119,0.0089,0.0009,0.0074,0.0036,0.0184,-0.0044,0.0101,-0.0072,-0.0036,0.0019,-0.0135,0.0101,0.008,0.0013,0.0193,-0.0051,-0.0002,-0.0043,-0.012,-0.0059,0.0078,-0.0089,0.0068,0.0081,0.0117,-0.0089,0.0099,0.0201,0.0373,-0.0029,-0.0089,-0.007,-0.0042,-0.0262,-0.0002,-0.0607,-0.0277,-0.0049,-0.0203,0.0147,0.0168,0.0126,0.0123,0.0101,0.0124,-0.0021,0.0045,0.0089,-0.0141,0.0094,-0.0023,0.0146,-0.0047,0.0168,0.0143,-0.0435,-0.0127,0.0213,0.0005,0.007,0.0077,-0.0039,-0.0147,0.0177,0.0207,0.0042,-0.0006,0.0207,0.0051,-0.0046,0.0082,0.0059,-0.0134,0.0114,0.0216,-0.01,-0.0182,-0.0085,0.007,0.0002,0.0186,-0.0159,-0.0065,0.005,0.0043,-0.0041,0.0022,-0.008,-0.0109,0.0171,-0.0174,-0.0091,0.0073,-0.0039,0.0113,0.0056,0.0111,-0.0221,-0.0046,-0.0019,0.0079,-0.0289,-0.0175,-0.0087,-0.0314,0.0149,0.0149,0.0019,0.008,0.0141,0.0087,0.017,0.0128,-0.0112,0.0067,0.0119,0.0072,0.0117,0.0019,0.0123,0.0167,0.0135,-0.0024,0.0142,0.0131,-0.0105,0.0158,0.0106,0.0008,-0.0407,-0.0129,0.0084,0.0181,0.0046,0.0021,0.0111,0.0108,-0.0305,0.016,0.0138,0.0047,0.0086,-0.0019,0.0177,0.0036,-0.001,0.0039,0.0133,-0.0051,0.0004,0.0294,0.013,-0.0011,0.0084,-0.0157,-0.0331,0.0106,0.0167,0.0018,-0.0134,-0.015,0.0155,-0.0012,0.0138,0.0063,0.0115,0.0102,0.0158,0.0121,0.0197,-0.01,0.0056,-0.028,0.0193,0.0179,0.0127,0.0126,-0.0069,0.0095,0.01,-0.0151,-0.0352,0.0114,-0.0001,0.0047,-0.0135,-0.0007,0.029,-0.0001,-0.0277,-0.0266,0.0208,0.0039,0.0058,0.0113,0.0056,-0.015,-0.0009,-0.0266,-0.006,-0.0075,-0.0042,0.0043,0.0029,-0.0196,-0.0109,0.0134,0.0114,0.0014,-0.0066,0.0138,0.0107,-0.0119,0.0041,-0.0067,-0.0069,-0.0286,0.0116,0.0245,0.0247,0.0278,0.0127,0.0138,0.0082,0.0052,0.0226,-0.0089,0.0218,0.0214,0.0174,-0.0066,-0.0089,0.0096,-0.016,0.0156,0.0054,0.0147,-0.0103,-0.0161,-0.0129,0.009,-0.0104,-0.0096,-0.0233,-0.0447,-0.0142,-0.0111,-0.0159,-0.0112,-0.0117,0.0104,0.0128,-0.0094,0.0013,-0.0136,0.0052,0.0276,0.0182,0.0045,0.0116,-0.0226,0.0146,0.0049,0.0022,-0.0078,0.0169,0.0023,0.0091,0.0224,-0.0068,0.004,0.0028,-0.005,0.0002,-0.0059,0.0083,-0.0338,-0.0331,0.0181,0.0054,-0.0206,0.0112,0.0055,-0.0061,0.0069,0.0087,0.0041,0.0053,0.0143,0.0019,-0.0496,-0.0558,-0.0207,-0.0569,-0.0171,-0.0304,-0.0473,-0.0473,-0.0274,0.0121,0.002,0.004,0.0021,0.0208,0.0039,-0.0038,0.0151,0.0099,0.0055,-0.0198,-0.024,-0.0246,0.0085,0.0071,-0.0197,-0.0433,0.0038,0.0012,0.0192,0.0106,0.0227,0.0107,0.0088,0.0106,-0.011,0.0165,0.0079,-0.0136,0.0044,0.0048,0.0032,0.0078,0.0238,0.0123,-0.0094,-0.0142,0.013,-0.0057,0.0027,-0.0173,-0.0006,0.0132,-0.0088,0.0019,0.0007,0.0121,0.0143,0.0135,0.0141,-0.0015,-0.0004,0.0046,-0.0037,-0.0056,0.0185,0.014,0.0121,-0.011,-0.0186,-0.0061,-0.0313,-0.0176,-0.0255,0.0151,-0.0012,0.0001,0.0097,-0.0099,0.01,-0.0128,-0.002,-0.0027,0.005,0.01,0.0084,0.019,0.0287,0.0124,-0.0105,0.005,0.0328,-0.006,0.0092,-0.0102,0.0025,-0.0057,0.0011,0.0209,-0.0054,-0.0089,-0.0107,-0.0126,0.0145,0.0106,0.0183,-0.0099,-0.0098,0.0113,-0.006,-0.0092,0.0106,-0.0286,0.0054,-0.0162,-0.0175,-0.0082,0.0003,0.0093,-0.0196,0.0087,0.0146,-0.0084,-0.0096,-0.0099,0.0038,-0.0015,-0.0054,0.0152,-0.0122,-0.0257,0.0176,0.0037,0.0018,-0.019,-0.0027,-0.0233,-0.0284,0.0067,0.0063,0.0107,0.0054,0.0071,-0.0001,0.0023,-0.0068,-0.0047,-0.0011,0.0003,0.0109,0.0096,0.0156,0.0133,0.0133,0.0011,0.0009,0.0096,0.0177,-0.0008,0.0182,0.0055,-0.0212,0.0174,0.0278,0.0085,0.0024,-0.0184,-0.0019,0.0005,-0.0425,-0.0338,0.0163,-0.0056,0.0038,0.016,-0.0029,0.0075,0.0141,-0.0021,0.0003,-0.0252,0.015,0.0204,0.0044,0.0128,0.0075,0.0027,-0.0188,0.0162,0.009,0.0017,-0.0163,0.0144,-0.0034,0.0148,-0.0152,-0.0079,0.0139,-0.0049,-0.0226,-0.0027,-0.0037,0.0027,0.0114,0.0191,0.0136,-0.0175,0.0249,0.0153,0.0089,0.0089,0.0156,0.009,0.0073,0.0195,-0.0034,0.018,0.0076,0.0231,0.0113,0.0272,0.0091,0.0065,0.0152,-0.0167,0.0123,0.0021,0.0099,-0.0252,0.0334,0.01,-0.0241,0.0117,0.0104,0.0136,0.0339,0.0226,0.0182,-0.008,-0.0223,0.0193,0.0177,-0.0113,0.0158,0.015,-0.0129,-0.0044,-0.0017,-0.0023,-0.0118,-0.0026,-0.0126,0.0149,0.0181,0.0109,0.0099,-0.0011,0.0008,0.018,0.0126,0.0176,-0.0199,0.0262,0.0117,-0.0079,0.0128,0.0201,0.0014,0.0088,-0.0015,-0.005,-0.0323,-0.0246,-0.0089,0.0052,-0.0336,0.0045,0.0235,0.0009,-0.0059,0.0141,-0.0147,-0.0046,0.0051,0.0027,-0.0055,0.0056,0.0098,0.0108,0.016,-0.0128,0.0066,0.006,-0.0256,0.0261,-0.0235,-0.0074,-0.0278,0.0153,-0.0288,0.0111,0.0161,0.015,-0.0278,-0.0017,0.0112,0.0104,0.0075,-0.0005,-0.0087,-0.0019,0.0239,0.0005,0.0117,-0.0172,0.0039,0.0021,-0.0077,-0.0034,0.0136,0.0023,0.0164,0.0357,0.021,-0.0038,0.0024,-0.0188,-0.0147,0.0212,-0.0095,0.001,-0.0072,-0.0109,0.0207,0.0226,-0.0245,0.0163,0.0174,0.0164,0.0127,-0.0075,-0.0242,0.0061,0.0166,-0.0002,0.0024,0.0037,-0.0086,-0.0075,0.0063,-0.0111,-0.0195,-0.003,-0.0017,-0.0018,-0.0024,-0.006,0.0253,0.0002,-0.0026,0.0084,0.0122,0.0008,0.0062,0.0149,0.0049,-0.0189,0.0185,0.0083,0.0199,0.0054,-0.0163,0.0006,0.0048,0.0004,0.0115,-0.0192,0.0022,0.0176,0.0137,0.0159,0.0006,0.0156,-0.0016,0.0031,0.0034,0.0277,0.0234,0.0101,0.0122,-0.0031,-0.0003,-0.0052,-0.0235,-0.0123,0.0006,-0.0244,0.0018,0.0017,0.0064,0.0106,0.004,0.0173,-0.0195,0.0089,0.0039,-0.003,0.0115,0.0154,-0.038,0.0107,-0.0062,-0.0016,-0.017,0.0103,-0.0024,0.0093,0.0081,0.0044,-0.0011,0.0028,0.0071,0.0061,-0.005,0.0044,-0.0139,0.0139,0.0146,-0.0205,-0.0156,-0.0112,0.0238,0.0067,0.0055,-0.0071,0.0075,0.021,-0.0101,0.016,0.0056,0.0018,0.0057,0.0192,-0.0063,-0.0045,0.0195,-0.0024,0.0062,0.0016,0.0055,-0.0061,-0.0095,0.0095,0.022,0.0154,0.017,0.0091,-0.005,0.0095,0.0111,0.007,-0.0002,-0.0003,-0.0174,0.0137,0.0209,-0.0143,0.0062,0.003,-0.0004,0.0072,-0.0027,0.0099,0.0127,0.0277,-0.0082,-0.0005,0.0,-0.004,-0.0046,-0.0081,0.0069,-0.012,0.0035,-0.0281,-0.0228,0.007,-0.0079,-0.0147,-0.005,-0.0119,0.0176,-0.005,-0.0178,-0.0121,0.0103,-0.0122,-0.0353,0.0139,-0.0056,0.0256,0.0165,-0.0089,0.0226,0.0046,-0.0214,-0.0139,0.0079,-0.0108,-0.0274,0.0135,0.0234,0.0084,0.0009,-0.0348,-0.0063,0.0077,-0.0156,0.0206,-0.0103,0.0241,0.0187,0.0013,-0.0064,-0.0351,-0.0248,0.008,-0.0004,0.0202,0.0163,0.0146,-0.0092,0.009,0.0041,-0.0176,-0.0012,0.0084,0.0151,-0.0006,-0.003,-0.0031,-0.006,-0.004,-0.0103,0.0221,-0.0163,0.0053,-0.0001,0.008,0.0144,0.0126,0.0004,0.006,0.0034,0.0136,-0.0192,0.0159,0.0089,0.0083,0.0086,0.0228,-0.0032,-0.0139,-0.0111,0.0233,-0.019,0.0025,-0.0132,-0.0177,0.0208,-0.0037,-0.0176,-0.0388,0.0114,0.001,-0.0283,-0.0109,-0.001,0.021,0.0332,0.0005,0.0005,-0.0132,-0.0141,0.0084,0.0127,0.0217,0.0183,-0.0062,-0.0024,-0.0032,-0.0,0.0314,0.0198,0.0018,-0.0214,-0.0004,0.0149,-0.0072,-0.0074,-0.0011,0.0134,0.0145,0.0202,0.0206,0.0139,0.0089,0.0168,-0.0147,0.0209,-0.0196,-0.0097,0.0166,-0.0304,0.0112,-0.0031,-0.02,0.0059,0.0143,-0.0187,-0.0026,0.0109,0.0075,0.0069,0.0027,-0.0056,0.0205,-0.0058,0.0092,-0.019,-0.0293,0.0095,-0.0012,-0.0056,-0.0059,-0.0219,0.0269,0.0071,-0.0065,-0.0008,0.0024,0.0029,-0.0097,-0.01,0.0139,-0.0006,-0.0072,0.0201,-0.0086,-0.0001,-0.0107,-0.0217,0.0184,-0.0013,0.0004,-0.0025,-0.0052,0.0021,0.0072,-0.0104,0.0081,0.0191,0.0065,-0.0043,-0.0213,0.0129,-0.0412,-0.0236,-0.0207,0.024,-0.019,0.0019,-0.0027,-0.0098,0.023,-0.0294,-0.0233,-0.0271,-0.0124,0.0136,0.0041,-0.0133,0.009,0.0126,0.0114,-0.0182,0.0158,0.0023,0.0087,-0.0016,-0.0068,0.0075,-0.0106,-0.0299,-0.0022,0.02,0.0095,0.001,0.0104,0.0024,0.0055,0.0121,-0.0099,-0.0096,-0.0124,0.0003,-0.0078,0.0003,-0.0201,0.0094,0.0039,0.0322,0.0098,0.0218,-0.0079,-0.0046,-0.0061,0.003,0.0204,0.0177,0.0018,0.0003,0.0181,0.0267,0.0212,-0.009,-0.029,0.0167,0.0156,-0.0064,0.0092,-0.0043,-0.0205,0.0083,-0.0137,0.0054,0.0147,0.0069,0.0021,0.0163,-0.0229,0.0024,0.0125,-0.0024,0.0011,-0.0218,0.0015,0.013,0.0159,0.0059,0.0089,0.0112,-0.015,0.0081,0.0081,-0.0156,-0.0246,-0.0232,-0.0174,-0.0069,-0.0017,0.0131,-0.0192,-0.0009,0.0146,-0.0262,-0.0077,-0.0128,0.0084,0.0072,0.0007,0.0182,-0.0168,0.0028,0.0104,0.019,0.002,0.0046,0.004,-0.0308,-0.0293,0.0188,-0.0066,0.0108,0.0127,0.0029,0.0361,0.0125,0.0048,0.0088,0.0082,-0.0038,-0.0012,0.0095,0.0202,-0.0553,0.0002,-0.0094,0.0102,0.0268,0.0142,0.0074,0.0059,-0.0025,-0.0165,0.0257,0.0041,-0.0119,-0.0225,0.0029,0.0167,-0.0023,0.0076,-0.0064,-0.0009,0.0144,-0.0135,-0.0166,0.0338,-0.0042,0.0114,-0.0099,-0.0334,0.016,-0.0149,0.0123,0.0088,-0.0199,0.0056,-0.0012,-0.0132,0.0078,0.0013,0.0171,-0.0126,0.0068,0.0015,0.0051,0.0142,0.0135,0.0206,0.0204,-0.0443,-0.0099,-0.0067,0.0109,0.0093,0.0046,0.022,0.0022,-0.0048,-0.0036,-0.0078,0.003,0.0161,0.0146,0.0043,-0.0161,-0.0354,-0.0157,0.0032,0.0267,-0.0046,0.006,0.0025,-0.0011,-0.0024,0.01,-0.0001,0.0104,-0.007,-0.0188,0.0265,0.0049,-0.002,0.0144,0.0107,-0.0023,-0.0068,0.0157,-0.0131,0.0236,0.0155,0.0144,-0.0101,-0.0248,-0.0032,-0.0177,-0.0157,0.0018,0.0212,0.0074,-0.0026,-0.0148,-0.0124,0.0219,0.0102,-0.0064,0.006,-0.0192,0.0057,0.0114,0.0053,-0.0003,0.015,0.0224,0.0125,0.0012,0.0011,-0.0004,-0.0107,0.0065,0.0198,0.0141,0.0029,0.0096,-0.0208,0.0073,-0.0099,0.0073,0.0149,0.008,0.0146,-0.0189,-0.0043,-0.0042,0.0169,-0.0354,-0.0249,-0.0034,-0.016,0.0157,-0.0028,0.0201,-0.0105,0.0131,0.0167,-0.0277,-0.009,0.0074,0.0107,-0.0051,0.0141,-0.0079,-0.0034,0.0086,0.0096,0.0003,-0.0036,0.0232,0.0107,-0.0097,-0.0056,-0.0181,-0.0021,0.0248,0.0339,-0.0078,0.0114,-0.0009,0.0148,0.0089,0.0005,0.0014,0.0114,0.0106,-0.0056,-0.0114,0.014,-0.0055,0.0191,-0.013,0.0268,0.0212,-0.0066,-0.0016,0.0289,0.0214,-0.0156,0.0058,0.0177,0.0188,0.018,0.0059,0.0056,0.0191,0.0245,0.0142,0.0109,0.0142,0.0029,0.017,-0.01,-0.0136,-0.0275,-0.0069,0.0097,-0.0056,-0.0079,0.0137,0.0098,0.0166,0.0189,0.0079,-0.0101,0.0016,0.0075,0.0277,0.0149,-0.0011,0.023,0.0233,0.0027,-0.0086,-0.0363,0.01,-0.0143,0.007,0.0067,0.003,0.0121,-0.0069,0.0067,0.0101,0.0172,0.0203,0.0146,-0.0156,-0.018,0.0102,-0.0131,0.007,0.0027,-0.0307,-0.0136,-0.0318,0.0035,0.0003,0.0029,-0.0173,0.0181,0.0004,0.0019,-0.0075,0.0104,0.0002,0.017,0.0049,-0.0027,0.0009,-0.0166,0.009,0.0032,-0.0401,0.0115,-0.0084,-0.0175,-0.0224,0.0004,-0.0038,-0.0029,0.0128,0.0045,-0.0188,0.0034,0.0141,0.0065,-0.0003,0.0089,-0.0073,-0.0114,0.0092,-0.0303,0.0131,0.0137,0.0051,0.008,-0.0001,0.009,-0.0764,-0.0483,0.0008,0.0114,-0.0149,0.0169,0.0088,-0.0066,0.0166,0.0111,-0.0161,-0.0137,0.0144,-0.0033,-0.0132,-0.0037,-0.0073,0.0193,0.0124,0.003,0.0148,-0.022,-0.0058,-0.0172,-0.0132,-0.0115,0.0123,0.017,0.0041,-0.0005,-0.036,-0.0149,-0.0076,0.002,0.0044,-0.0103,0.0003,0.0123,0.0062,0.0089,0.0116,-0.002,-0.0062,0.0034,-0.0059,-0.019,-0.0182,-0.0086,-0.0281,-0.04,0.0242,-0.0101,-0.0322,-0.0392,-0.0008,-0.0427,-0.065,-0.0357,-0.0332,-0.0198,-0.0035,-0.0241,-0.0201,-0.009,-0.0558,-0.0076,-0.0261,0.0008,-0.0193,-0.0344,-0.004,-0.0034,0.0124,-0.0006,-0.009,0.0006,0.0192,-0.0052,0.0012,0.0066,0.0105,0.0252,0.0147,0.0186,0.0039,0.0219,0.008,0.0023,0.0037,0.0013,0.0033,0.0064,0.0159,0.0148,0.0208,0.016,0.0058,0.0192,-0.0145,-0.0003,0.013,-0.0124,0.0046,0.0039,-0.0043,-0.0047,0.0237,0.0082,0.0056,-0.0058,-0.0009,0.0024,0.0045,-0.0043,-0.0028,0.0152,0.0136,0.0137,-0.0069,0.0147,0.0093,-0.01,0.0018,-0.0098,-0.0035,-0.026,-0.0328,-0.0321,-0.0176,-0.0073,-0.0022,0.0206,potential monetary reward
trm_557b4abe521af,0.1274,0.1123,0.1451,0.1599,0.0497,0.0559,0.1018,0.0765,0.038,0.1103,0.0375,0.0469,0.1064,0.0583,0.1283,0.0768,0.1175,0.1436,0.0892,0.007,0.1006,0.0201,0.0274,-0.0466,0.0424,0.0191,0.0198,0.1117,0.1592,0.0802,0.0802,0.1148,0.1136,0.1152,0.1033,0.113,0.0619,0.0752,0.1178,0.039,0.0997,0.0959,0.0583,-0.0511,0.1028,0.0672,-0.136,0.0851,-0.0201,0.1053,0.0479,-0.0148,-0.0227,0.02,0.0528,0.1006,0.1069,0.0272,-0.0291,0.0334,0.0223,-0.0154,0.126,-0.1178,0.0317,-0.0376,0.2114,0.2361,0.114,-0.0055,-0.0339,0.0229,-0.1535,0.0762,0.1191,-0.0921,0.0921,0.0205,-0.0526,0.0055,-0.0432,-0.0612,0.0195,0.1328,-0.0354,-0.0515,0.0109,-0.0088,0.0079,0.1359,0.0974,0.0774,-0.0017,-0.0968,-0.1307,-0.0953,-0.1401,-0.0127,-0.1819,-0.0537,-0.0474,-0.0207,-0.0707,-0.0085,-0.0514,0.1349,0.1222,-0.2045,0.0219,0.0292,0.0001,0.108,-0.1157,-0.1533,-0.0298,-0.0458,0.1237,-0.0418,0.0152,0.0842,0.0957,0.1571,0.111,0.0253,0.0835,0.1084,0.0694,-0.0643,-0.0759,-0.0643,-0.0016,0.0732,-0.0195,0.1793,0.0138,0.1772,0.0376,0.0861,0.0024,0.0203,0.1118,0.1335,-0.0391,0.033,0.0461,-0.0187,0.1309,0.0032,0.0669,-0.0827,0.0609,0.0971,0.1214,0.1557,-0.182,0.0473,-0.0559,-0.0051,0.0336,0.0794,0.0813,0.0821,0.2122,0.2168,-0.0001,-0.0514,0.0197,0.1215,0.1152,-0.0265,0.0593,0.1287,-0.0243,0.1192,0.0913,0.1201,0.0871,0.1133,0.0601,0.057,0.0919,-0.0894,0.069,0.0035,0.1,0.0687,0.0513,0.0107,0.0003,0.0614,0.0499,0.0802,0.0378,0.1676,0.1468,0.1972,0.1924,0.0213,0.0008,0.1102,0.0761,-0.1386,0.1109,0.1018,0.0126,0.0416,0.0183,0.0834,0.0871,0.0202,0.1269,0.0505,-0.0177,-0.0165,-0.0702,-0.0368,-0.1094,0.122,0.1771,-0.0384,-0.1058,0.0885,0.1082,0.0599,-0.0096,-0.0232,0.0648,-0.1455,0.0054,-0.1739,0.0693,0.083,-0.1589,0.158,0.151,-0.0816,0.0121,-0.0767,-0.0193,0.0578,0.0353,0.1687,0.0757,0.001,0.1087,0.0521,0.0514,0.1118,0.0472,0.0667,-0.0449,-0.056,0.0147,-0.0636,0.0088,0.1509,-0.0093,0.0855,-0.158,-0.2368,-0.0188,-0.2332,0.1384,-0.1395,-0.1788,-0.2928,-0.1185,0.0149,-0.0506,-0.02,0.0494,0.0482,0.0631,-0.0467,0.0471,-0.1024,0.0566,0.0739,0.0903,-0.0157,-0.0796,0.016,0.0086,0.1212,0.0932,0.0913,-0.0999,-0.1032,0.1074,0.1066,0.0928,0.0824,0.0361,0.0648,0.1153,0.042,-0.0014,-0.0619,0.0485,-0.0941,-0.0575,0.1559,0.0954,0.0921,0.1049,0.0983,0.1032,0.0439,-0.0136,-0.0208,0.019,-0.0017,0.1556,-0.0725,-0.0527,0.0567,-0.1172,-0.0505,-0.0509,0.1469,0.0156,-0.0328,0.0671,0.1087,0.072,0.0808,0.0052,-0.0141,0.0962,0.1278,-0.0215,0.1182,0.0326,-0.0201,-0.0236,-0.0499,-0.1019,0.0396,-0.0167,0.1225,0.1177,-0.0285,-0.0,0.0505,-0.0897,-0.026,0.2168,0.1609,0.1546,0.0835,0.0863,-0.0665,0.0805,0.0292,0.0327,0.0886,0.072,0.1051,0.1473,0.0935,-0.016,0.0355,0.0317,0.0707,0.0642,-0.0495,0.1334,-0.1723,-0.0564,0.1339,-0.0013,-0.0765,0.0132,-0.1038,0.1567,0.0593,0.0882,-0.1111,-0.2497,-0.1991,-0.2701,0.0447,0.1368,0.0348,-0.0161,-0.0779,0.0919,0.0266,-0.0234,0.065,0.0523,0.0478,0.1096,0.0357,0.0215,0.0717,0.0883,0.1502,0.0877,0.0772,0.0614,-0.0207,-0.0039,0.0359,-0.0317,-0.0669,-0.1326,0.0031,0.1005,0.0452,0.0531,0.1189,0.0438,-0.3126,0.096,0.0061,-0.3079,0.0243,0.0891,0.0483,-0.0008,0.2075,0.1389,0.2914,0.2414,0.1176,0.155,0.1152,0.1522,0.1445,0.0239,-0.0663,0.0193,0.0503,-0.0155,-0.0504,-0.0583,-0.0154,0.2663,0.138,-0.0062,-0.0777,0.0504,-0.0841,0.0354,0.0971,-0.0593,-0.1113,0.0666,0.0539,0.0121,-0.0742,0.0975,0.0775,0.0342,0.0969,-0.0685,0.0586,-0.0029,-0.0311,-0.0406,0.0672,0.0271,-0.0889,0.1027,0.1104,-0.0328,-0.3386,0.1096,0.0018,-0.0007,-0.0075,-0.0426,0.0055,0.0117,0.0333,-0.0201,-0.0398,0.0233,0.0444,-0.058,0.0147,0.0105,-0.0574,-0.0641,-0.1241,-0.0014,0.0457,0.0619,0.0365,-0.0885,-0.0555,0.0932,0.1225,-0.0747,-0.0784,0.0754,0.0797,-0.0482,0.1218,0.1142,-0.0675,0.0865,0.122,0.107,0.0509,-0.0762,-0.0803,0.0229,-0.0911,0.2002,0.0105,0.0243,-0.0095,-0.0596,-0.0535,0.1601,0.1489,-0.0745,0.1018,0.093,0.0799,-0.0577,-0.0427,-0.1461,-0.0446,-0.1118,-0.1644,-0.0622,-0.097,0.0538,0.0059,0.0875,0.1869,0.0492,-0.0414,0.127,0.0964,0.035,0.1142,0.0161,-0.0404,-0.0204,0.0027,0.0726,0.0214,-0.0002,-0.079,-0.0167,0.0544,-0.0755,0.0007,0.0221,0.0174,0.0274,0.0944,-0.0839,-0.0395,-0.1061,0.0349,0.0391,-0.0086,0.0593,-0.0173,0.0288,-0.0748,-0.0871,-0.0238,0.0069,0.0509,0.1017,0.0128,0.1736,0.0202,0.0367,0.0408,-0.0708,-0.0331,-0.0836,-0.0697,-0.0295,0.1039,0.0096,0.0647,-0.012,-0.0059,0.0639,-0.0187,-0.0428,0.0767,0.094,0.0084,-0.076,-0.0789,0.093,0.0834,0.2199,0.0199,-0.157,0.0328,-0.0713,-0.0637,-0.0491,-0.0489,-0.0306,0.0166,-0.02,0.1394,0.1339,-0.0188,0.2008,0.0331,-0.0574,0.0233,0.2238,0.0518,0.0631,-0.054,-0.0252,0.1927,0.1113,0.2056,-0.0509,-0.0268,0.0385,-0.0338,0.1053,0.1054,0.0788,-0.0383,-0.0223,0.0264,0.0115,-0.0123,0.0519,-0.0546,-0.0213,0.0667,0.0608,0.0642,0.0729,-0.0548,-0.0197,0.0959,0.0948,0.0301,0.1413,0.1084,-0.0569,0.151,0.0397,0.0874,-0.1246,0.0712,0.0176,0.0672,0.0308,0.0835,0.0434,0.079,0.1208,0.03,-0.1076,0.0515,-0.0376,-0.0877,0.1265,0.1095,0.0669,0.0897,0.055,0.0584,0.0443,0.0337,0.0414,0.0944,-0.1656,0.095,-0.019,0.0397,-0.0186,-0.0744,-0.0533,-0.0339,-0.1303,0.1484,0.0794,-0.0571,-0.0201,0.0157,0.0273,-0.128,-0.0879,-0.0672,-0.0449,0.0075,-0.0645,0.0181,0.0636,-0.0003,-0.0004,0.0284,0.0407,0.0967,0.0785,0.0762,0.081,0.044,0.0769,-0.0407,-0.1299,-0.0373,0.0559,-0.1063,-0.0194,-0.0156,0.0608,-0.0361,0.0978,-0.028,-0.0865,0.0741,0.1906,0.1991,0.0982,0.0302,0.0655,0.1283,-0.0401,0.0246,-0.0822,0.0068,0.0838,-0.0014,-0.038,-0.0511,0.1529,-0.1213,-0.133,-0.2239,0.0956,0.0313,0.1,-0.0379,-0.0148,0.1513,-0.0937,-0.1185,0.0366,0.0136,-0.0288,-0.0195,0.1615,0.2276,0.1948,0.153,-0.0518,-0.1936,0.0187,0.1127,0.0231,-0.0033,-0.0364,-0.0711,-0.0323,0.0126,0.0345,0.0852,0.0848,-0.0822,-0.0882,-0.1453,0.0469,0.0368,-0.0297,0.0689,-0.0185,0.066,0.1154,0.0092,0.1284,0.0982,0.0679,-0.1237,-0.1251,-0.0836,0.0106,0.0505,-0.0161,-0.1209,0.0408,0.0823,-0.0723,-0.0214,-0.0354,-0.0364,-0.1164,0.0246,-0.1465,0.1698,0.1715,-0.0794,-0.1525,-0.1389,0.0012,-0.0278,-0.0557,0.0148,-0.0134,-0.1342,0.0097,-0.0567,-0.089,-0.1553,-0.0588,0.0203,-0.1672,-0.1549,0.0956,-0.0486,-0.1037,0.1945,0.1053,0.0666,0.0996,-0.0765,0.2371,0.1109,0.1595,0.1072,0.1668,-0.0525,0.0093,-0.1177,0.0737,0.1074,0.0057,-0.0569,-0.1078,-0.0599,-0.0975,-0.1125,-0.0437,-0.0246,0.0007,-0.0253,-0.0912,-0.1462,0.0558,-0.0951,-0.0628,0.0134,0.0612,0.0818,0.0418,-0.0808,0.0629,0.1908,0.1363,0.0218,-0.084,-0.1474,-0.0397,-0.0378,-0.0531,0.0097,0.1007,0.113,-0.0252,0.0607,-0.0462,0.1253,0.0142,0.0825,-0.0907,0.0108,0.0122,0.0023,0.1619,0.1328,0.0795,-0.1638,0.0811,0.0784,0.0993,-0.0641,0.0092,0.1515,0.0563,0.1236,-0.0681,0.0691,-0.0878,-0.0666,-0.0186,-0.0798,0.1765,0.0725,0.0368,-0.0975,0.1172,0.0075,-0.0723,-0.0016,-0.0756,-0.2692,-0.0572,0.0438,0.0989,0.0583,0.063,0.0844,0.0035,-0.0586,-0.1377,-0.0332,-0.0439,0.1152,-0.1044,-0.2129,-0.0112,0.0172,0.0285,0.0338,0.1635,0.083,0.0769,0.043,-0.0388,0.1107,0.0269,-0.1526,-0.0092,0.0992,0.059,-0.0729,0.0318,0.0584,0.0521,0.1591,0.1644,0.1551,0.1305,0.1359,-0.0321,-0.017,0.0302,0.1245,0.0366,0.0992,0.0248,0.1226,0.0699,0.0507,-0.0171,-0.0999,-0.0932,0.0188,-0.0499,0.0255,-0.0483,-0.0853,-0.1171,-0.1711,-0.094,0.0384,0.0357,0.0035,-0.0334,-0.1393,-0.112,-0.0775,-0.0197,-0.1328,-0.0541,-0.1283,0.0022,0.03,0.02,-0.0715,0.0513,-0.0576,0.1566,0.066,0.0784,0.053,0.0415,-0.0359,-0.0327,0.0001,-0.1228,-0.1455,-0.1392,0.0569,0.0096,-0.0038,0.0291,-0.0133,0.0077,0.0402,0.0956,0.1267,0.0427,-0.0925,-0.0835,0.1036,0.1398,0.0562,0.1731,0.0735,-0.153,-0.0707,-0.1142,-0.0805,-0.0925,0.0633,-0.0092,-0.0663,-0.0022,0.0114,0.0047,-0.0275,0.0312,0.0576,0.0283,-0.0449,0.1032,0.0093,0.0511,-0.0349,0.1481,0.013,-0.0303,-0.0806,0.0054,-0.0628,-0.0048,0.0456,0.0089,0.0073,0.0048,0.0718,-0.0032,-0.0102,-0.0282,0.0521,0.0743,-0.0152,0.0198,0.01,0.0939,0.0597,0.1368,0.0981,0.0833,-0.1831,0.0029,-0.0294,0.1184,-0.1851,-0.1279,0.0164,-0.0041,0.0129,-0.0684,0.0126,-0.0595,0.1202,0.085,0.0006,0.0478,0.106,0.014,0.0509,-0.0682,-0.0545,0.0545,-0.0143,0.069,-0.0518,0.0628,-0.0216,-0.0505,-0.0754,0.0977,0.0249,0.0563,-0.0039,0.0227,0.0438,-0.3692,-0.2518,-0.1603,-0.0776,-0.1087,0.0121,-0.1426,-0.1273,0.1518,-0.379,-0.3595,-0.2818,-0.1931,-0.3043,-0.072,-0.1109,-0.036,-0.0369,-0.1004,-0.012,-0.1152,-0.0421,0.126,-0.0705,-0.055,-0.0384,-0.0837,0.017,0.0509,-0.2166,-0.1085,0.1084,0.0083,0.0958,-0.0975,-0.0297,-0.1489,0.0562,0.1368,0.0762,-0.0184,-0.0454,-0.1349,-0.1749,0.0943,0.0892,0.1137,0.0641,0.076,-0.3628,0.1186,-0.1161,-0.1337,0.069,-0.0624,0.0604,0.0264,-0.0207,0.0193,-0.1242,-0.0582,0.0202,-0.0351,-0.0594,0.1114,0.1503,-0.0238,0.0584,-0.0267,0.009,0.0981,0.0546,0.0856,0.0175,0.0388,0.0328,0.1367,0.0609,-0.2448,0.0154,-0.004,0.0176,-0.1964,-0.0407,-0.0287,0.1694,0.164,-0.0275,0.1078,0.1124,0.1175,0.0697,-0.0084,0.0284,-0.0788,-0.0741,-0.0535,-0.1282,0.0221,-0.0019,0.0406,-0.0931,0.0157,-0.0996,0.069,-0.108,-0.2238,0.0198,0.0777,-0.1727,-0.1201,0.047,0.0844,0.0009,0.1583,0.0904,0.1993,0.0303,-0.0452,0.0758,0.0153,-0.0372,0.0617,-0.0147,0.0926,0.0281,0.0298,0.0739,0.0781,-0.0845,0.0321,-0.4768,-0.3594,-0.3266,-0.4159,0.0807,0.0586,0.088,0.0868,0.1154,0.0558,0.1007,-0.158,0.0771,0.1149,-0.1232,-0.0291,0.0246,-0.146,-0.0537,-0.012,-0.0116,-0.0859,0.1003,0.1095,0.046,-0.1355,-0.0313,-0.0,0.0942,0.0942,0.1809,-0.0606,-0.0047,-0.0021,0.0833,-0.0682,0.0385,-0.1643,0.2696,0.2496,-0.1296,0.0136,0.2146,0.218,0.221,0.0877,0.0729,0.0212,0.0201,-0.0012,-0.0759,-0.0487,-0.1412,0.0603,-0.1142,0.0716,-0.0446,-0.1081,0.0327,0.0227,0.0319,0.0153,-0.0163,0.037,-0.0109,-0.0386,-0.0456,0.0074,0.0528,-0.027,0.0215,-0.0611,0.0476,0.0435,0.0258,0.1093,0.0328,0.1519,0.2944,0.0207,0.0718,0.1892,0.07,0.0909,0.1505,0.0012,0.1036,0.0033,0.1429,0.0076,0.1008,0.1445,0.0132,-0.0268,0.0573,-0.2513,-0.1032,-0.0119,-0.057,0.0328,-0.0178,0.0107,0.0973,0.0958,-0.0026,0.0643,-0.0139,0.1022,0.002,-0.0499,-0.0252,-0.0359,0.1414,0.102,0.0102,-0.0264,0.0128,0.0251,0.0182,-0.0256,0.0182,0.0834,0.0407,0.1313,0.1222,-0.0038,0.1675,0.1744,0.0163,0.0117,-0.014,0.0335,0.0178,0.1272,0.124,-0.0275,0.1297,-0.0153,-0.0093,0.0611,0.1403,0.1278,-0.0882,-0.1132,-0.0888,-0.0459,-0.0108,0.011,-0.2588,-0.0449,-0.0152,-0.0053,0.1651,-0.1067,0.013,-0.0819,-0.0296,-0.1661,-0.0246,0.1082,0.0594,-0.0985,0.0933,0.0029,0.0965,0.0246,0.0886,0.0377,-0.0154,-0.0608,0.0135,0.0947,0.0876,-0.0515,-0.0292,0.0261,-0.0182,0.1401,-0.0383,-0.0067,0.068,-0.0705,0.0565,0.0807,0.0242,0.0964,0.0911,0.1023,0.0328,0.0668,-0.0133,0.0177,-0.1167,0.0382,0.0274,0.0617,0.0236,0.0127,0.0184,0.1545,-0.0767,0.1301,0.0656,-0.0224,-0.0981,-0.0784,-0.0015,-0.0261,0.0677,0.0163,0.0745,0.0513,0.1674,0.0191,0.1509,0.0336,0.0028,0.0359,0.0436,0.0681,0.065,-0.1378,-0.0906,0.0117,-0.3291,-0.0397,-0.0714,-0.0284,-0.2246,0.0154,0.0543,-0.0593,-0.2157,0.0512,-0.0086,0.0755,0.1078,0.069,0.0801,-0.0689,0.0736,0.0705,-0.0805,-0.1457,0.0602,0.0806,0.0223,-0.0134,-0.0418,-0.0598,0.2114,0.1089,0.018,0.2141,0.1603,-0.1249,-0.0513,-0.048,-0.0564,-0.0852,-0.0443,0.1843,0.0699,0.0416,0.0594,0.1864,0.044,0.0455,0.0664,0.083,-0.1183,0.0109,0.0211,-0.0215,0.0059,-0.1087,-0.1718,0.0775,-0.0392,0.0297,0.0386,0.1083,0.0429,-0.0489,0.0251,-0.0075,-0.156,-0.0126,0.0033,0.0758,0.0918,0.0085,-0.3246,-0.3087,0.1364,0.1281,-0.0208,0.0528,0.0974,0.0489,0.1439,-0.0446,0.0134,-0.0047,0.0128,-0.0287,-0.1405,0.064,-0.0616,-0.1107,0.0355,-0.0517,-0.2972,0.0997,0.06,-0.2899,-0.0432,-0.0309,-0.1157,-0.108,0.0709,-0.1731,-0.1088,0.0882,0.0253,-0.0563,-0.0175,-0.1499,-0.0715,-0.0046,0.0029,0.0487,-0.1258,0.1292,-0.007,-0.1864,-0.0051,0.0052,0.0141,0.0006,0.1376,0.0327,-0.0911,0.0657,-0.0782,0.0777,-0.0852,-0.1731,0.0406,0.0075,0.0011,-0.0553,-0.0036,-0.1016,-0.0707,-0.1067,-0.0233,-0.1661,0.0134,-0.0429,-0.4188,0.1059,0.0779,0.0197,0.0367,-0.0315,-0.0709,-0.1199,0.0604,0.0159,-0.0345,0.0415,-0.0008,0.0108,0.0422,0.0097,-0.0234,-0.0414,-0.0923,-0.1156,-0.297,-0.2978,0.0848,0.1179,0.0536,0.0317,-0.1319,-0.1153,0.0026,-0.0411,-0.0814,-0.0126,-0.0747,0.1067,0.1831,0.1015,-0.021,-0.1261,0.0482,-0.039,-0.0476,-0.1483,-0.0957,-0.0459,-0.0041,0.0807,0.0063,-0.0189,-0.0719,0.0883,0.0949,0.1209,-0.0943,0.0406,0.0131,-0.1688,0.0564,0.0476,-0.0673,-0.0608,-0.0438,-0.0668,0.036,0.0124,-0.0418,0.008,-0.0912,-0.1015,-0.1311,0.0563,-0.0536,-0.0724,-0.0134,0.1243,-0.0038,0.1811,0.0778,0.0466,0.1009,0.0304,-0.0926,0.1248,0.0789,0.0705,0.0708,0.0567,0.0596,0.0982,-0.0082,0.0251,0.0274,0.0543,0.0134,-0.1179,-0.0013,-0.081,0.2029,0.1365,0.1681,0.0173,-0.0317,0.0848,0.0746,0.0189,0.1206,0.0555,-0.1546,-0.0234,-0.1405,-0.093,-0.0092,-0.0472,0.0314,0.0117,0.0382,0.0352,0.1871,0.0566,0.1066,0.0995,0.0591,-0.0125,-0.0727,-0.3258,-0.2492,-0.0926,-0.0928,0.0892,0.288,0.1645,0.2241,0.1531,-0.0074,0.033,0.0215,0.0573,0.1734,0.1452,0.0568,-0.0584,-0.05,0.0515,0.0395,0.0329,0.0977,0.1782,0.1107,0.0513,-0.0827,0.0131,0.004,0.1735,0.0577,0.0912,0.101,0.2139,-0.0139,0.0076,0.0519,0.0623,0.0595,0.0644,0.0151,0.1723,0.0953,0.0511,-0.1002,-0.1124,-0.0948,-0.0822,-0.0516,0.0558,-0.049,-0.0219,-0.1425,0.1131,0.0558,0.0162,-0.0913,0.117,0.1243,0.0659,0.0936,0.0655,0.1151,0.1052,0.1122,0.0366,0.0366,-0.042,-0.0309,0.2464,-0.0294,0.041,0.0809,0.053,0.0984,0.0052,0.1081,0.0191,-0.0013,-0.1614,-0.002,0.0108,0.1506,0.0907,0.0849,0.0897,0.1304,0.1047,-0.0217,-0.0661,-0.0521,-0.0176,0.1026,-0.0289,-0.1145,-0.1853,-0.1438,0.1875,0.2089,0.0806,-0.0703,-0.0178,0.0995,-0.0462,0.0533,-0.0582,0.0118,0.0832,0.072,0.0253,0.0765,0.1021,0.0055,0.0958,0.0183,0.0588,-0.0058,-0.0467,-0.1036,0.0952,0.1198,0.1159,0.1403,0.1032,0.227,0.1202,-0.2366,0.068,0.0889,0.0263,0.0184,0.0851,0.0109,0.0541,0.0757,-0.1442,0.0515,-0.0099,-0.0086,0.0795,0.0527,0.0829,-0.0205,-0.1145,0.1406,0.073,-0.0275,-0.1891,-0.0197,0.0362,-0.0618,0.0173,0.0026,-0.0031,-0.1033,-0.0212,-0.0306,0.1254,0.1105,0.1287,0.0383,0.0992,-0.0561,-0.1815,-0.2438,-0.0368,-0.0531,-0.0879,-0.0936,-0.0367,-0.065,-0.0227,-0.0013,-0.0516,0.2187,0.1027,0.1326,0.082,-0.0342,0.1011,0.1126,0.065,-0.0185,0.0555,0.196,0.0851,-0.0319,0.1052,0.2009,-0.0474,0.0964,0.0152,-0.0598,0.1201,-0.0196,0.1382,0.0721,-0.0141,0.0954,0.0886,-0.0396,0.1213,-0.0569,-0.0457,-0.0437,0.0258,0.092,-0.0423,-0.0102,0.0427,-0.0615,0.0334,0.0449,-0.0733,-0.0015,0.035,0.1617,0.1022,0.0314,0.0275,0.0055,0.014,0.0925,0.085,0.0853,0.0795,-0.0875,0.1077,0.0611,-0.0289,-0.0232,0.002,-0.0617,-0.0278,0.1816,0.1052,0.1533,0.1303,-0.1197,-0.2104,-0.2348,0.0623,-0.4091,-0.2478,0.1579,0.1,-0.4419,-0.1171,-0.0588,-0.1116,-0.1648,-0.0954,0.1277,0.1238,0.0832,0.136,-0.458,-0.3492,-0.2757,-0.0597,-0.1277,-0.2494,-0.467,-0.461,-0.4214,-0.0521,0.0074,0.0577,0.003,0.0686,0.0006,0.1123,0.0509,0.042,0.0103,0.0932,0.0866,-0.1378,0.0326,0.0301,0.1086,-0.0607,-0.1008,-0.1539,0.0223,0.014,0.096,0.0122,0.0235,0.0027,0.05,0.0755,0.0565,0.0144,0.1206,0.1861,0.1707,0.0206,0.0693,-0.0311,-0.159,-0.0467,-0.1371,-0.0636,-0.0555,-0.3405,0.0714,0.1553,0.1804,0.038,-0.0781,-0.0047,-0.1679,-0.0402,-0.123,-0.029,0.1545,0.1541,0.0872,0.0786,-0.023,0.2095,0.1512,-0.0342,-0.0089,-0.1869,0.0942,-0.0082,-0.0904,0.0142,0.0365,-0.0161,0.0732,0.1332,0.1338,0.0423,0.0264,0.0828,0.0296,0.0862,-0.1168,-0.1939,-0.1802,-0.0256,-0.1646,0.0443,-0.0264,-0.0807,-0.0969,-0.172,-0.1622,-0.0344,-0.047,0.0251,-0.0723,-0.0837,0.0766,0.0743,0.0382,0.014,0.0407,-0.0331,0.0413,0.0112,0.0539,-0.0603,-0.0489,-0.0372,-0.0691,0.0087,-0.1553,-0.1443,0.111,0.1559,0.1347,0.1204,0.1803,-0.1008,0.0254,0.0598,0.0413,-0.1762,-0.0025,0.1794,0.0775,-0.0152,0.0305,-0.018,-0.0381,-0.0601,-0.1511,-0.2007,-0.3993,-0.1181,-0.0848,0.0435,0.0495,-0.0567,0.1221,0.1089,0.0784,0.0106,0.0796,0.029,0.042,0.0878,0.0592,0.1265,0.1721,0.1407,0.0765,0.1005,0.1443,0.0487,0.073,-0.0084,0.0157,0.0146,0.0556,0.0757,-0.206,-0.0569,-0.0505,0.0939,-0.1418,-0.1185,0.0666,-0.0787,0.1412,0.0873,-0.0347,0.0433,0.0526,0.0241,-0.0332,-0.0894,-0.0162,0.0733,0.0571,-0.0368,-0.0022,-0.0426,0.1213,-0.042,0.0128,-0.0348,-0.0296,0.158,0.1183,0.0676,0.0759,0.0713,0.0425,0.0807,0.0002,-0.0597,-0.0293,-0.0148,0.235,0.1379,0.1295,0.1537,0.1479,0.1164,0.154,0.154,0.0328,0.0353,-0.0574,0.1778,-0.0081,0.088,0.0835,-0.0455,-0.0562,0.2165,-0.1453,0.1334,-0.0309,-0.0357,-0.1539,-0.073,-0.0129,0.1261,0.0887,-0.0162,-0.0673,-0.0096,-0.1253,-0.0386,-0.0023,-0.1342,-0.1043,-0.0266,-0.0366,0.0221,0.037,0.0091,0.0942,0.0566,0.0508,0.0825,0.0699,0.0541,0.0532,-0.0302,0.025,0.0318,-0.0223,-0.1229,0.0091,-0.1542,-0.0493,0.1321,0.0562,0.1695,0.073,0.0792,-0.046,0.0688,-0.0278,-0.0134,0.0396,-0.0882,-0.1046,0.0414,-0.1487,-0.0239,-0.318,-0.1092,-0.0011,-0.0748,0.1024,-0.056,-0.0995,-0.0811,0.0396,0.0138,-0.0657,0.0031,0.0027,0.1142,0.0923,0.0929,0.0727,0.0539,0.0311,0.1381,-0.1984,-0.0007,-0.105,-0.1653,-0.0077,-0.0344,-0.0096,0.0825,0.1105,0.0639,-0.0926,-0.0916,-0.0061,0.0053,0.1124,-0.011,-0.098,-0.1021,-0.1239,-0.013,-0.0311,0.0634,-0.0772,0.0674,-0.0383,-0.0247,0.0294,0.0489,0.0481,0.0697,0.0819,0.0318,0.0002,0.0907,-0.0549,-0.0012,-0.1201,0.0029,-0.0689,-0.0621,-0.0032,0.0766,0.0873,0.0815,0.0562,0.008,-0.0347,-0.0232,0.0141,0.0118,-0.1315,0.011,0.1307,0.0798,0.1645,0.1159,-0.014,0.0253,-0.0194,0.0972,0.0738,0.127,0.0198,0.0871,-0.0275,-0.0187,0.1311,-0.1249,0.0746,0.0813,0.052,-0.0272,0.1175,-0.0132,-0.0361,-0.0053,0.1437,-0.1078,0.0151,0.0699,-0.1097,-0.0661,-0.0132,-0.0693,0.0941,0.089,0.0953,0.1704,0.1795,0.0988,0.1072,0.0401,0.0073,-0.1211,-0.1142,-0.0962,0.1361,0.1572,-0.0875,-0.2354,-0.3234,-0.0735,0.0376,0.0079,0.0547,0.0951,-0.0254,0.0842,0.0783,0.0828,0.0172,0.0817,0.1761,-0.241,-0.0314,-0.0343,-0.2037,-0.0668,-0.0769,0.0866,0.0523,0.086,0.0495,0.0984,-0.0072,-0.0521,-0.0498,-0.0038,0.0534,0.0357,0.0843,0.0023,0.0522,0.1358,0.0005,0.0212,0.022,0.0051,-0.0145,0.011,-0.015,0.0625,-0.0873,0.208,0.1061,0.1438,0.1742,-0.0337,0.1449,0.1132,0.2334,0.103,0.0919,-0.0722,0.175,0.0144,0.0536,-0.0436,-0.0635,-0.057,0.1115,0.147,0.0353,0.0139,-0.0739,-0.09,0.0652,-0.0045,0.0213,-0.0882,-0.0259,-0.0366,-0.0875,0.0162,0.0785,-0.0049,0.0259,-0.0077,-0.0451,-0.0057,0.0637,0.0344,0.011,-0.1646,0.0338,-0.187,-0.1876,0.0772,-0.0094,0.0349,0.1449,0.0992,0.0251,-0.1599,-0.2429,-0.1046,-0.046,-0.0259,-0.01,-0.1404,-0.1428,-0.1355,-0.0972,0.1403,0.0628,0.0795,-0.0536,0.0554,0.009,0.0515,0.0117,-0.0655,-0.0169,-0.0563,0.0798,-0.101,-0.0074,0.1596,-0.1808,-0.0876,-0.0311,-0.0344,-0.0833,-0.1266,-0.0233,-0.0271,-0.0301,0.0239,-0.056,-0.2095,-0.1668,-0.0117,0.0182,-0.1124,0.0289,0.1632,0.3119,0.3017,-0.0218,-0.0588,-0.0204,0.0528,-0.0099,-0.0526,0.0395,0.0633,0.103,-0.0884,0.045,-0.0082,0.0137,-0.0412,0.009,0.1391,0.0347,0.1358,0.1027,0.046,0.052,-0.0002,0.2305,0.0595,0.0049,0.0694,0.0034,-0.0834,0.0114,0.1395,0.0856,-0.2062,0.1049,-0.1157,-0.038,-0.0696,-0.0111,-0.0576,0.1049,-0.0944,-0.0698,0.0795,0.036,0.0067,-0.0347,0.0917,0.1056,0.1103,0.1883,0.0741,0.0289,0.0147,-0.0819,0.0111,0.095,0.1365,0.2153,-0.0709,-0.0828,0.1504,0.0361,0.0402,0.1085,0.1688,-0.23,-0.0855,0.0754,-0.0088,-0.1167,-0.0793,0.1276,0.1237,0.1484,0.1772,0.1046,0.0997,-0.0681,-0.0347,-0.0447,-0.0435,0.0657,-0.0616,-0.3708,-0.1953,-0.1518,-0.3191,0.2269,0.1324,0.1244,-0.0867,0.0097,0.0195,0.0651,-0.0277,-0.0693,0.1643,0.1133,0.0305,-0.2018,0.0824,0.0651,0.0772,-0.0071,-0.0966,-0.1574,0.0476,0.0668,0.0524,0.0544,-0.0455,-0.1009,-0.0901,-0.0539,-0.0562,0.0345,-0.0194,-0.0539,-0.0654,-0.0173,0.1203,0.0016,0.0313,-0.0048,0.0013,0.0422,-0.1247,-0.0779,-0.0173,-0.0218,0.0835,0.0392,0.1904,0.1569,0.063,0.1483,-0.3248,0.0146,-0.2667,-0.1242,-0.0681,0.0241,0.0147,-0.1048,0.0366,-0.1192,-0.1537,-0.0685,-0.1166,-0.0237,-0.0173,0.0847,0.0867,0.1137,0.0157,-0.127,-0.1569,0.111,-0.0034,-0.0459,-0.0021,0.0155,-0.0048,0.0247,0.0875,0.0122,0.148,-0.0646,0.0445,-0.1846,-0.0659,-0.0492,-0.0404,0.0279,0.0133,0.0356,0.0608,-0.0978,-0.1523,0.0358,-0.0152,0.0529,-0.044,0.0417,0.0846,0.0318,-0.0998,-0.0887,-0.0013,0.1647,0.099,0.1138,0.1008,-0.0243,-0.0288,0.0782,0.0519,0.0812,0.1226,0.0998,0.0696,0.071,0.0849,0.0532,0.0096,0.1086,-0.0551,0.1437,0.1378,0.1173,0.0529,-0.0222,0.0862,0.1064,-0.053,-0.0398,-0.0683,0.0756,-0.2131,-0.2342,-0.0881,0.0598,-0.049,0.0499,0.0551,-0.0601,0.0128,-0.0751,-0.1973,-0.2158,0.0026,-0.0475,-0.0638,-0.0626,0.1095,0.0595,0.0354,0.0449,0.0782,0.0777,0.0219,0.1009,-0.0171,0.1719,0.1422,-0.0962,-0.0299,0.1916,-0.0129,-0.0659,-0.117,0.0633,0.0904,0.3202,0.2722,0.1488,0.2199,-0.1873,0.0592,0.0353,-0.0351,0.027,0.0738,0.1532,0.0528,-0.2429,-0.1426,-0.2493,-0.1377,-0.1059,0.0381,0.0142,-0.0825,-0.0653,-0.0585,-0.0058,0.0072,-0.2315,-0.1366,0.1115,0.2321,0.1211,0.1298,0.1574,-0.0201,0.1112,-0.0836,-0.0601,-0.0439,-0.0742,-0.0618,0.1989,0.0371,0.1683,0.0182,0.1466,0.1847,0.0276,-0.0649,0.0369,0.0199,0.0695,0.1645,0.0749,0.15,0.0709,0.1365,0.0726,-0.0089,-0.0377,0.036,0.075,-0.0407,-0.0163,-0.0012,0.0971,0.0883,0.0827,-0.0086,-0.1082,-0.0349,0.0724,-0.1843,0.0424,0.0373,-0.0345,-0.0401,-0.0365,0.0243,0.0076,-0.0018,-0.0284,0.0071,-0.197,-0.2604,-0.3014,-0.0008,-0.0604,-0.0146,-0.0636,0.0508,-0.1113,0.0646,-0.1885,0.0298,0.0106,0.0148,-0.1018,-0.0115,0.025,-0.0276,-0.0655,0.0107,0.0009,-0.0489,-0.0728,0.0516,0.12,-0.055,-0.0961,-0.0994,0.1905,0.1195,0.1864,0.0197,0.1317,0.0651,0.0109,-0.0579,0.0075,0.0618,0.1401,0.1342,-0.0119,-0.0469,0.1158,0.056,-0.1909,-0.0372,0.0699,-0.1048,-0.2489,-0.0855,-0.0886,-0.1872,0.0829,0.0006,-0.2426,-0.092,0.0482,-0.2303,-0.0209,-0.064,-0.071,-0.2569,-0.0631,0.125,0.1513,0.1108,-0.0289,-0.1842,0.0406,-0.084,0.0481,0.0159,0.035,0.0877,0.0004,-0.1278,0.0413,0.1327,-0.0342,0.0526,0.0729,0.0033,0.0521,0.0451,0.0463,0.0899,0.0541,0.1813,0.1173,-0.1382,-0.231,0.0006,0.0594,-0.0463,-0.0506,0.0411,0.1003,0.1395,0.1963,-0.0898,-0.0471,0.0972,0.126,0.1015,0.0388,0.1226,0.0746,0.0186,0.0822,0.0522,0.1324,0.0867,0.0412,0.1105,0.0328,0.0059,0.035,-0.1314,0.0891,-0.0011,-0.1586,0.0075,0.1245,0.047,0.1075,0.17,0.0984,0.0773,0.098,-0.0577,-0.0527,-0.094,0.0757,0.1551,-0.0216,0.0493,0.0383,-0.0246,0.165,0.0923,0.1386,-0.0607,-0.0314,-0.0998,0.0491,0.2017,0.1766,0.0735,0.0616,0.01,-0.0366,-0.1014,0.052,0.1171,0.0911,0.0887,0.1182,0.2464,0.1129,0.087,-0.0585,-0.023,-0.0897,0.0209,-0.1371,-0.0016,-0.0462,0.0137,-0.0962,-0.1496,-0.0889,-0.0394,-0.0253,0.1028,-0.0044,0.0818,0.0218,0.0636,0.044,-0.0013,-0.0009,0.0919,0.0701,0.0562,0.022,0.0908,0.0307,0.0148,-0.2115,0.0477,-0.1205,-0.0447,-0.0598,-0.0117,-0.0252,-0.0235,0.0493,0.144,0.0223,-0.1616,-0.0482,0.0451,0.0459,0.066,0.1047,0.0898,0.0244,0.0811,-0.0677,-0.0838,0.1776,0.1465,0.0326,0.1048,0.0968,0.0589,-0.2641,-0.1986,0.1176,-0.0291,0.0903,0.0571,0.09,0.0916,0.1824,0.1441,-0.0633,0.0176,0.095,-0.0038,0.1265,0.0193,-0.1681,0.0294,0.0004,0.0096,-0.0337,-0.0328,0.137,0.0195,-0.1277,0.1188,-0.0725,0.1181,-0.0937,0.1489,-0.4138,-0.0265,-0.0443,0.1666,0.1433,-0.0298,-0.101,-0.0106,-0.0812,-0.0338,0.0544,-0.0172,-0.0625,0.026,-0.0212,-0.0303,-0.0949,-0.1725,-0.1701,-0.2394,0.0218,-0.0281,-0.2124,-0.518,-0.204,-0.2158,-0.3406,-0.1869,-0.2016,-0.2669,-0.1508,-0.1929,-0.2109,-0.2048,-0.2748,-0.0942,-0.2842,-0.3876,-0.2719,-0.2692,-0.1881,-0.0798,-0.1728,0.1729,0.1039,0.1301,0.0904,0.0019,0.2472,0.2111,0.1147,0.0622,0.1017,0.2492,0.2172,0.138,0.0289,-0.0287,0.1295,-0.1182,0.0291,0.0823,0.0046,0.0695,0.0737,0.0985,0.0519,0.1398,-0.1169,0.197,0.2101,-0.0519,0.0342,0.0479,0.0074,0.0106,0.1314,-0.0764,-0.0854,0.1096,-0.2481,-0.3544,-0.0423,-0.1727,-0.1997,0.0946,-0.1692,-0.1699,0.0548,0.0568,-0.1728,0.0057,-0.0452,0.1387,0.0261,-0.1691,0.083,0.1046,0.0383,-0.0387,0.0069,0.0566,spatial selective attention
trm_5159beaf80413,0.0268,0.0451,0.0143,-0.0127,-0.0105,0.0094,0.0494,0.0796,0.1247,-0.0184,-0.038,-0.0395,0.0243,0.0085,-0.035,-0.011,-0.0002,-0.0811,0.0734,-0.101,-0.0517,-0.0291,-0.0054,-0.0145,0.0022,-0.0147,-0.0019,-0.0592,-0.0046,0.0006,-0.0203,-0.0672,0.0159,-0.0031,-0.0518,-0.0142,-0.0109,-0.0137,-0.0236,-0.0491,-0.016,0.0395,0.0759,-0.0275,-0.0057,-0.0221,-0.1041,0.0201,0.023,-0.0259,0.0011,0.0672,0.048,0.0212,-0.0078,-0.0057,0.0201,-0.0412,-0.0594,-0.0528,-0.0147,-0.046,-0.0873,0.0291,-0.0114,0.0513,-0.0446,-0.0997,-0.0053,0.0418,0.0124,-0.0114,-0.0421,-0.0762,-0.0017,-0.0256,0.0624,-0.0592,0.0152,0.0623,-0.0282,-0.0553,0.0412,-0.1227,0.0157,0.033,0.0081,0.041,-0.0362,0.1466,0.055,0.1762,0.0109,0.1918,0.0831,0.1976,0.036,0.062,0.1778,0.1814,-0.0086,0.005,0.0724,0.1562,0.0533,0.0043,-0.0685,-0.0509,0.0098,0.0309,-0.0447,-0.0887,-0.0151,0.018,-0.0285,-0.0473,-0.0563,0.2099,-0.036,0.0472,-0.109,-0.0438,-0.1057,-0.0063,-0.0606,-0.0591,-0.0768,0.0305,0.0158,0.0495,-0.0817,0.002,0.0292,-0.0232,-0.0424,-0.0697,0.0465,-0.0392,0.0088,0.0013,-0.0206,0.0198,-0.0382,-0.0451,-0.0426,0.0584,0.0476,-0.0762,-0.0324,-0.0847,-0.0306,-0.0819,-0.0168,-0.0933,-0.0413,0.0411,-0.0135,0.0092,-0.0614,-0.0219,0.0259,-0.0493,-0.1018,-0.0189,0.0348,0.002,-0.056,-0.0579,-0.0605,-0.032,-0.0051,-0.1156,0.0194,-0.1203,-0.0579,-0.0636,-0.0587,-0.1087,-0.0566,0.0384,-0.0133,-0.0122,0.0139,0.0494,0.0446,-0.0264,0.0788,-0.1002,-0.1279,-0.0537,-0.0699,-0.0891,0.0026,-0.0864,-0.0937,-0.0372,-0.0737,-0.0802,-0.058,0.1392,0.115,0.1571,-0.0695,-0.0159,-0.0499,0.0443,-0.0786,-0.0282,-0.0507,-0.036,-0.105,-0.0385,0.2154,-0.0268,-0.0972,-0.0546,-0.0009,0.0756,0.1823,-0.0607,0.0189,-0.0367,-0.0021,0.0277,0.0165,0.0251,-0.0119,0.1003,-0.0582,-0.0576,0.1553,-0.0938,0.0121,0.0059,0.0143,0.2512,-0.0963,-0.0545,-0.0239,-0.0185,0.0244,-0.0174,0.0511,0.0191,-0.0678,-0.0328,-0.0722,-0.0505,0.0927,-0.1453,-0.0143,0.0275,0.0065,-0.0035,0.0142,-0.046,0.0499,0.0977,-0.0503,-0.0544,-0.0121,-0.0374,-0.0432,-0.0044,-0.01,-0.0203,-0.048,-0.0841,-0.0247,-0.0466,0.0097,0.1524,-0.0479,-0.0429,0.1235,-0.0116,0.1531,0.0691,0.1902,0.0279,0.0456,-0.0863,-0.0903,-0.1201,-0.1338,0.0415,-0.0289,-0.0371,0.0247,0.0076,-0.0403,-0.0622,0.0028,-0.1087,-0.0012,-0.0309,-0.0904,0.056,-0.0157,0.0315,0.0568,-0.1757,-0.0262,-0.0137,0.1202,0.1388,0.0389,-0.0036,0.1008,-0.0421,-0.0162,-0.0399,-0.0847,-0.1281,-0.0362,0.0295,-0.0269,0.0493,-0.0618,-0.0805,-0.035,-0.0014,-0.0545,-0.064,0.0067,0.0081,-0.0526,-0.0061,0.0292,-0.0093,-0.0689,-0.0588,-0.1399,-0.0588,-0.0796,0.0781,0.0859,-0.0988,-0.0922,-0.071,-0.0616,-0.0667,0.0731,0.0537,-0.0133,0.0328,0.028,0.0272,0.0162,0.0252,0.0351,0.0815,0.0981,0.0888,-0.0002,0.0443,-0.0069,-0.0119,0.0217,0.0471,-0.0047,-0.03,0.1259,0.1065,0.1458,0.0683,0.0534,0.0191,0.0081,-0.0079,-0.0383,-0.0115,-0.015,0.0439,-0.0671,0.0793,-0.019,-0.0009,-0.0785,0.0111,-0.0469,0.1217,-0.0731,-0.0595,0.0104,0.0374,-0.0247,0.0275,0.0083,0.0128,0.1135,0.0325,0.0676,-0.0496,0.0158,0.1394,0.188,-0.0051,0.1277,0.0128,-0.0337,0.0536,-0.0086,-0.0497,0.0338,-0.0469,-0.0393,-0.0705,-0.0138,-0.0029,0.0144,-0.0095,-0.0611,-0.0355,-0.0528,-0.0891,-0.0233,-0.1202,-0.138,-0.009,0.0063,0.0328,0.0353,-0.0545,-0.063,0.0592,-0.0075,0.0863,-0.0141,0.0745,0.0157,0.0626,0.0408,0.0045,-0.0833,-0.0207,0.0709,0.0462,0.0242,0.0251,0.0055,0.1247,-0.0065,0.0657,-0.0276,0.0901,-0.0021,0.139,-0.146,-0.0801,-0.0483,0.0365,-0.0477,-0.0026,-0.0172,-0.0796,-0.0026,-0.0085,-0.0494,-0.0301,-0.0603,0.0263,-0.0079,-0.0497,-0.0307,-0.0185,0.0185,-0.0856,0.0802,0.0494,0.0454,0.0226,0.0852,0.005,-0.0148,-0.0112,0.1313,0.0118,0.0132,-0.0373,0.1409,0.1013,0.16,0.0513,0.02,-0.0165,0.046,0.0295,-0.1089,0.0608,0.0068,0.1092,-0.0173,-0.0037,0.0029,-0.0219,-0.0065,0.0452,-0.0397,-0.096,-0.095,-0.0619,-0.0043,0.0291,0.0362,0.0072,-0.0195,-0.0201,-0.0091,0.0916,-0.0059,0.0533,-0.0109,-0.0221,-0.0492,-0.03,-0.1043,-0.0797,0.121,-0.0601,0.0166,-0.0075,-0.0701,-0.0426,-0.0225,-0.0289,-0.0334,0.0608,0.0608,-0.0041,0.0825,0.0416,0.0646,-0.0343,-0.0939,-0.007,-0.052,0.0311,-0.0414,-0.0005,-0.0225,-0.0322,-0.0351,0.0379,-0.0229,0.0016,-0.0707,0.0035,-0.0294,-0.0342,0.1098,-0.0536,-0.034,0.2284,0.0475,-0.067,-0.0009,-0.0215,-0.0535,0.084,-0.0911,-0.0763,-0.0215,-0.0279,-0.028,0.0772,-0.0615,-0.1301,-0.0205,-0.0128,-0.0746,-0.0932,0.0357,0.0029,0.2288,0.1781,0.0595,0.0876,0.0083,-0.0118,-0.0087,-0.0919,-0.068,0.038,0.0158,-0.0059,0.1291,-0.0575,0.0768,0.0333,-0.0154,0.0,0.0584,-0.0123,0.0747,0.0396,-0.0482,-0.071,0.1228,-0.0288,0.0484,0.0015,-0.0606,-0.0321,0.0466,0.2145,0.0015,-0.0156,-0.0079,-0.0334,-0.0163,0.0381,-0.0268,-0.0286,-0.0646,-0.0529,-0.0264,-0.0302,-0.0197,-0.0232,0.0092,-0.0056,0.0814,-0.0343,0.0247,0.0631,-0.0314,-0.0108,0.0472,0.0067,0.0283,0.1249,-0.0271,-0.0502,-0.013,0.1053,-0.026,0.0832,-0.063,0.1385,0.0254,0.0831,0.0934,0.1798,-0.0541,-0.0115,-0.1331,-0.1327,0.0679,-0.0988,0.019,-0.0121,0.051,-0.101,-0.0408,0.0979,0.146,0.0531,0.0017,0.0096,-0.1474,0.2553,-0.021,0.1717,0.1021,0.0551,0.1578,-0.0172,0.2303,0.0751,0.044,-0.0072,0.034,0.1152,-0.0037,-0.0156,0.1671,-0.0611,-0.0781,-0.0329,-0.0602,0.0167,-0.0242,-0.0174,0.0241,-0.0274,0.0652,-0.0558,-0.0238,0.0783,-0.0812,-0.046,0.0132,-0.0984,-0.0334,-0.1325,-0.047,-0.0061,0.0089,-0.057,-0.0102,-0.0596,0.0267,-0.0588,-0.0151,0.0476,-0.0005,-0.0268,0.0048,0.019,-0.0612,-0.1552,-0.1691,0.0338,-0.1827,-0.0648,0.009,-0.0282,-0.0746,-0.0139,0.0406,-0.0013,-0.0886,-0.0766,-0.091,0.0009,-0.0278,-0.0391,-0.0452,0.0737,-0.0438,-0.0204,0.0117,-0.0525,0.0354,0.0158,0.018,0.024,-0.0115,-0.0066,-0.0628,-0.0044,0.0272,-0.0098,-0.0727,-0.0433,-0.0369,0.013,-0.0504,0.0302,-0.0569,0.0392,-0.0619,-0.1471,-0.123,-0.0825,-0.006,-0.0815,-0.0072,0.1108,-0.012,0.0954,0.0211,-0.0105,-0.0233,0.0181,-0.0065,-0.0039,0.1468,0.0001,0.011,-0.0114,0.1145,-0.0083,0.0302,-0.0447,0.0095,-0.0378,-0.0757,-0.0325,-0.0413,-0.0419,-0.084,0.0045,-0.0635,0.0013,0.013,-0.0158,0.0052,-0.0685,0.0868,0.0054,-0.0826,0.0123,0.058,0.0596,0.0178,-0.0658,-0.0211,-0.0942,-0.0808,-0.0025,-0.081,-0.0507,-0.0167,-0.0197,-0.0285,0.0065,0.0214,0.0217,-0.0106,0.1068,-0.009,0.0052,0.0087,0.0297,0.0251,0.0149,0.0919,0.0713,0.0167,-0.0008,-0.0885,0.1124,-0.031,-0.0406,-0.1287,-0.05,-0.0713,-0.058,-0.0821,-0.057,-0.0645,-0.0547,-0.0209,0.0112,-0.0726,0.1213,0.0131,-0.0286,0.0233,-0.0762,0.0026,-0.0353,0.0232,-0.0349,-0.0245,-0.0354,-0.0431,0.0735,0.0204,0.0124,-0.033,0.0285,-0.0233,-0.0483,-0.0072,-0.0899,-0.0888,-0.0016,-0.0463,-0.0251,0.0028,-0.0446,0.1238,0.1301,-0.0171,-0.0595,0.0543,-0.0824,-0.0077,-0.0652,0.2014,-0.089,0.0352,-0.0346,-0.0575,-0.0213,-0.1127,-0.1096,-0.0497,-0.0037,-0.0193,-0.0218,-0.0246,-0.0383,-0.0214,-0.0755,-0.0883,-0.0594,0.0118,0.0286,0.0124,0.0538,-0.042,0.0093,-0.0199,-0.0473,-0.0152,0.0358,-0.0371,0.0037,-0.11,-0.0458,-0.0236,-0.1123,0.0046,-0.0293,-0.057,-0.1231,-0.0633,-0.0217,-0.0439,0.0281,0.0134,0.0238,-0.028,-0.0005,-0.0009,0.0247,0.0923,0.0547,-0.0013,-0.0321,0.162,0.0663,0.0504,0.0367,-0.0152,-0.0385,0.0391,-0.0047,0.0189,0.0215,-0.0045,-0.0334,0.0262,-0.0083,0.0009,-0.0546,-0.0525,-0.134,-0.0594,-0.1345,-0.0716,-0.075,-0.0657,-0.0295,-0.0959,-0.0479,-0.11,-0.0701,0.0478,0.0541,0.0951,-0.0245,-0.0129,0.0073,-0.0101,0.0316,-0.0477,0.0088,-0.1177,-0.0862,-0.0459,0.048,0.0205,0.0549,0.0191,0.0034,-0.0242,0.0023,0.0134,0.0524,-0.0233,-0.088,-0.0034,0.0264,0.0518,-0.084,-0.0539,-0.074,-0.0123,-0.0649,-0.0844,-0.1286,-0.0934,0.0081,0.0091,0.1278,0.0384,-0.0634,-0.0534,-0.0249,-0.0234,0.0472,0.0069,0.0029,0.0112,0.0117,-0.021,0.0987,-0.0166,-0.0638,-0.0835,0.0479,0.0689,-0.0878,-0.0748,-0.0943,0.0312,0.0879,0.0461,-0.044,-0.0532,-0.1473,-0.0643,-0.0611,0.0345,0.0285,0.0676,-0.0011,0.0042,0.134,0.091,-0.0778,-0.0338,0.0147,-0.0237,-0.0243,0.0708,0.1135,0.1435,0.2603,-0.0097,-0.0263,-0.0269,-0.0141,-0.0386,-0.0826,-0.0445,-0.0272,0.0537,0.0429,0.0401,0.0354,-0.0061,-0.0171,0.014,0.0011,0.078,-0.0153,0.0098,-0.0628,-0.0083,0.0319,-0.0151,0.0209,-0.0781,0.0307,-0.0048,-0.0155,-0.0544,-0.0742,-0.0683,-0.0421,0.0607,-0.0311,-0.0478,0.0007,0.0016,-0.096,-0.0622,0.0088,-0.0437,-0.0489,-0.0714,-0.0222,-0.0748,0.0212,0.1225,0.0288,0.0127,0.0722,-0.0029,0.0692,-0.1043,-0.0572,-0.0113,-0.0649,-0.1044,-0.0649,0.0797,0.116,0.1139,0.0774,0.0661,-0.0659,-0.0884,-0.1604,-0.1335,-0.1279,-0.1,-0.2063,-0.094,-0.007,-0.0569,-0.1099,-0.0344,-0.0219,0.0338,0.0131,-0.0528,0.0992,0.052,-0.0053,0.0596,-0.0349,-0.0305,-0.0421,-0.0542,-0.061,0.0304,-0.0466,-0.0448,-0.0122,-0.0108,-0.0408,-0.0602,-0.1453,-0.1015,-0.0998,-0.075,-0.0364,0.1496,0.0171,0.0106,-0.0608,0.009,-0.1399,-0.0312,-0.013,0.0944,-0.0708,0.0418,0.1642,0.2824,0.2251,0.2045,-0.0022,-0.0455,-0.029,-0.0108,0.0155,-0.0008,-0.0771,0.084,-0.0022,0.1642,-0.008,-0.0111,0.07,-0.0376,-0.0229,0.0579,-0.0197,0.1196,0.1684,-0.0241,-0.072,-0.0258,-0.025,-0.0034,0.0557,0.0554,-0.104,-0.0878,-0.0489,0.0344,0.1097,0.0471,-0.091,0.0746,-0.0643,0.1036,0.0084,0.0667,0.1372,0.0639,0.0981,-0.0944,-0.0201,0.1366,0.001,0.0184,-0.0079,0.0513,-0.0356,-0.0519,-0.0116,-0.0041,-0.0398,0.0151,0.0059,-0.0606,-0.0517,-0.0481,-0.0062,0.0782,0.0299,0.0454,0.1444,0.0234,0.0135,0.012,0.0747,0.0517,-0.0754,-0.014,-0.0191,-0.0145,-0.1512,-0.1359,-0.094,-0.1344,-0.1032,-0.072,-0.108,-0.0753,-0.0872,-0.0025,0.1391,-0.0459,-0.0891,-0.1237,0.0263,0.1032,-0.0241,0.0054,-0.0115,0.056,0.0521,0.1788,-0.1295,-0.1118,0.0521,0.0678,-0.0141,-0.0565,0.0673,0.0673,-0.0573,-0.0429,0.0046,-0.0328,0.0416,-0.0909,0.0368,0.1499,-0.0947,-0.0886,-0.0143,-0.0379,-0.0305,-0.0352,0.0256,-0.0165,0.0356,-0.0642,-0.0552,0.0443,0.148,0.0695,0.0556,0.0198,-0.0053,0.0341,0.0545,0.0699,0.0722,-0.0407,-0.0182,-0.0313,-0.0425,-0.0845,0.1202,0.0566,-0.0514,0.2392,0.1436,0.2218,0.0098,0.12,-0.0848,-0.0551,-0.0123,-0.1012,0.0856,-0.0584,0.0418,0.0466,-0.0552,-0.071,0.181,0.0212,-0.049,-0.0448,0.1495,-0.0198,0.0573,0.0349,-0.0443,0.1605,-0.051,0.0327,-0.0312,-0.092,0.1605,0.1988,0.1609,0.0359,0.0098,-0.037,0.0757,0.0634,-0.0031,-0.054,-0.0012,-0.1442,0.053,-0.0363,-0.0131,-0.0407,-0.0919,-0.1246,0.0249,0.022,0.0826,-0.0317,-0.008,0.0001,-0.0371,0.009,-0.127,-0.1376,-0.0771,-0.0071,-0.0589,-0.0518,-0.015,-0.0162,-0.0193,-0.0045,0.0872,-0.0255,-0.0428,0.0562,-0.0611,-0.0068,0.0821,0.0956,0.1185,-0.0104,-0.0138,0.0306,-0.1204,-0.0296,0.0039,-0.0404,-0.107,0.045,0.0009,0.0144,-0.0863,-0.029,-0.0127,-0.0424,0.1861,-0.1423,0.0007,0.1253,0.0479,0.102,-0.0495,0.0044,-0.0577,-0.0183,-0.0453,-0.0885,-0.0915,-0.0209,0.0778,-0.093,-0.0982,-0.0318,-0.0765,0.0014,-0.0365,-0.0242,-0.0177,-0.0356,0.0008,0.0252,0.0308,0.0298,-0.054,-0.1075,-0.1032,-0.0861,-0.0607,-0.0206,0.0334,-0.0098,0.0332,0.0345,-0.0276,-0.0667,0.0231,0.0759,-0.0039,-0.0114,0.0567,0.1312,0.1792,-0.0423,-0.0596,-0.0896,0.0808,-0.0038,0.0327,-0.0464,-0.0648,-0.0187,-0.1266,0.0317,0.0938,0.0208,-0.0081,0.0378,-0.0317,-0.0179,-0.0625,0.1331,0.095,0.0111,-0.1083,0.2256,-0.0413,0.0502,-0.0847,-0.0164,-0.019,-0.1238,-0.0826,-0.0012,0.0315,0.0162,0.1008,0.0013,-0.0438,0.0077,0.0798,0.0692,0.149,0.0559,-0.0387,-0.0855,-0.0382,0.0745,0.0053,-0.0437,0.1628,0.1667,0.1048,0.1794,0.1886,-0.0773,0.016,-0.0144,-0.0266,0.0994,0.0278,-0.0427,-0.0701,0.0527,0.0518,0.1385,-0.0679,-0.0215,-0.0237,0.0629,-0.0285,0.0106,-0.0508,-0.0127,-0.0477,0.0337,-0.0131,-0.0314,-0.0833,0.0362,0.0131,0.0382,-0.0319,0.0567,0.033,-0.0136,0.0855,0.0162,0.0597,0.0178,-0.0371,0.0355,0.0556,0.0495,-0.0093,-0.0225,0.0305,0.0786,0.1029,-0.0134,-0.0198,-0.0173,-0.0303,-0.0422,-0.0303,0.0621,0.1343,-0.0491,0.0699,0.0282,0.0038,0.081,-0.01,0.1958,-0.0061,-0.0779,0.0016,0.0504,0.0164,0.0311,0.0211,-0.0683,-0.0475,-0.0218,0.02,-0.0784,-0.0493,-0.114,-0.0689,-0.1354,-0.0571,-0.0524,0.0813,-0.0949,-0.0375,-0.0772,-0.0579,-0.0502,-0.0339,0.064,-0.0264,-0.0464,0.0081,-0.033,0.1146,0.0259,-0.0203,0.0505,-0.0144,-0.0277,0.0149,-0.0893,0.025,-0.0161,0.0581,0.0058,-0.0743,-0.0463,0.0104,0.0539,-0.128,-0.1008,-0.0862,-0.0347,-0.034,0.1071,0.0992,0.1363,-0.0278,-0.057,-0.0071,0.0005,0.0382,-0.0633,-0.0857,0.0326,0.0526,0.0496,-0.0262,0.0974,0.0516,-0.004,-0.0013,0.0362,-0.0186,-0.0773,0.1084,0.0368,-0.1629,-0.0287,0.0059,0.0019,-0.0097,0.1441,-0.0336,-0.0747,-0.055,-0.0399,0.0371,0.0768,-0.0151,-0.0734,-0.0651,0.0569,-0.0529,-0.0323,-0.0364,0.0053,0.0507,0.0553,0.0535,0.11,0.0361,-0.012,-0.0296,0.0396,-0.0822,-0.0982,-0.0756,0.147,0.0708,-0.022,-0.0228,0.0333,0.162,0.0814,0.0486,0.0516,-0.0072,-0.0194,-0.0449,-0.0801,0.0696,-0.0139,0.0485,-0.0633,-0.095,-0.1002,-0.0133,-0.0267,-0.0505,-0.0101,0.2185,-0.0466,0.0575,0.0417,0.1289,0.0424,0.0044,0.0371,0.0303,0.106,0.0051,-0.0153,-0.0103,0.0475,-0.0837,-0.0627,-0.0843,0.0334,-0.072,-0.1806,-0.0558,-0.0607,0.0258,-0.0553,-0.061,-0.0385,0.0407,0.0115,-0.0093,0.1494,0.0569,-0.0162,0.0278,0.1269,0.0995,-0.0457,-0.1238,-0.0706,-0.0364,-0.0687,0.016,-0.0613,-0.1067,-0.0368,0.0074,0.1538,-0.1009,-0.0533,-0.0568,-0.0369,-0.0433,0.0345,0.0057,-0.0889,-0.0703,0.005,0.0367,-0.0045,-0.0011,0.0718,-0.021,-0.0027,-0.0014,-0.0173,0.056,-0.0451,-0.0187,-0.0004,-0.006,-0.1802,-0.0385,-0.0153,-0.1378,-0.1522,-0.0064,-0.103,0.0432,-0.0204,-0.008,-0.0237,0.0111,-0.0082,0.0759,-0.1331,-0.1337,-0.0731,0.0305,-0.0992,-0.0376,-0.0998,-0.0709,-0.0146,0.0581,0.0271,-0.0038,-0.0418,0.027,-0.0729,-0.0775,-0.0922,0.0489,-0.0871,-0.0669,-0.1154,-0.046,0.0058,-0.0003,-0.0316,-0.0575,-0.0961,-0.0909,-0.0242,-0.0468,0.085,-0.0382,-0.0133,0.0053,0.0219,0.015,-0.05,0.0265,-0.0581,-0.0526,-0.0169,-0.0769,0.0501,-0.1083,-0.0893,0.0073,0.1507,0.1029,-0.0039,-0.0483,-0.0119,0.0327,-0.019,0.0326,-0.0688,-0.0779,0.1138,0.0769,0.0634,0.0602,-0.0267,-0.0373,-0.0788,0.0661,-0.019,-0.0084,0.0332,-0.0043,-0.1282,-0.1016,-0.1009,0.083,-0.0099,-0.0036,0.1272,0.0365,0.0611,-0.1194,-0.0556,-0.0606,-0.0627,-0.0755,-0.0369,-0.0368,-0.1118,-0.0716,0.3633,0.267,0.29,0.2456,0.1222,0.1341,0.0567,0.1623,0.0594,0.0762,0.2899,0.2197,0.2982,0.2787,0.0384,-0.1343,-0.0051,0.001,-0.0204,-0.0356,-0.1008,0.0291,-0.0593,-0.0085,0.1228,0.0773,-0.0324,-0.0358,0.1293,0.0829,0.1046,0.1769,0.0127,-0.018,0.2141,0.0934,-0.0222,-0.0196,-0.0577,-0.0955,0.0371,-0.0442,-0.0619,-0.0791,-0.0193,-0.1772,-0.036,-0.0327,-0.0754,-0.1108,-0.062,-0.1272,-0.0766,-0.0677,-0.0439,0.0711,0.1201,0.0936,0.055,-0.0902,0.12,0.0624,0.0606,-0.0355,0.0313,0.1428,-0.0239,-0.0646,-0.0939,-0.0086,-0.0844,0.0127,0.1158,0.0859,-0.0102,0.0713,0.0874,-0.0351,-0.0802,-0.083,-0.1262,-0.0745,-0.0679,-0.0485,0.0107,-0.0305,-0.0951,0.1622,-0.03,0.0434,0.0372,-0.0325,0.092,0.0436,-0.0479,-0.0376,0.0278,0.0109,-0.0298,-0.0527,0.026,0.0288,0.0208,-0.0635,-0.0249,0.1353,-0.0629,-0.0994,-0.1229,-0.0137,0.0159,-0.0037,0.0168,0.0015,-0.0626,0.0061,-0.0673,-0.0453,0.1332,-0.0291,-0.0056,-0.0343,0.1128,-0.0888,-0.0864,-0.0314,0.0255,-0.1704,-0.1228,-0.1198,-0.0208,-0.1161,-0.0998,-0.0661,-0.064,-0.0553,-0.043,0.0134,0.0322,-0.0083,0.0416,0.0224,-0.15,-0.006,-0.0248,-0.0808,-0.0261,-0.0303,-0.0433,0.0057,0.0131,0.086,-0.0546,0.0351,-0.0414,0.1858,0.1449,0.2884,-0.0291,0.0062,-0.0511,-0.0309,0.0218,-0.1258,0.2469,-0.1106,-0.1562,-0.1496,0.1194,0.1537,0.015,-0.1167,-0.009,-0.0064,0.0372,-0.0756,0.0393,-0.0014,-0.1202,-0.1692,0.2355,-0.0473,-0.0674,-0.0158,-0.002,0.1107,0.3403,0.0092,0.0165,0.0264,0.0232,0.23,0.1858,0.1944,-0.0004,-0.0737,-0.0756,0.0673,0.0449,-0.0112,-0.0043,-0.1189,-0.1014,-0.0946,-0.0256,0.0006,0.0559,-0.0535,0.0038,0.0012,0.0395,-0.0524,0.1375,0.0875,0.0117,0.0301,-0.0748,0.0831,-0.0124,0.1673,0.1107,0.0359,-0.0355,0.0149,0.0564,0.0721,-0.0131,0.0918,0.0902,0.1783,0.1449,-0.0091,0.0224,-0.0343,0.0193,-0.037,0.0518,-0.0313,0.0167,0.082,0.104,-0.017,0.0068,-0.1101,-0.0675,-0.0818,-0.0317,-0.0824,0.0194,-0.0396,0.0317,0.0191,0.0887,0.1259,-0.0838,0.0786,0.0591,-0.1187,0.0076,0.0194,0.0221,-0.0052,0.0678,-0.075,0.1087,0.002,0.0255,0.0094,0.0928,-0.0434,-0.0298,0.0451,-0.0031,-0.0105,0.0336,0.092,-0.004,-0.1177,-0.085,-0.0865,-0.0982,0.002,-0.0342,0.0034,-0.0475,-0.0159,0.0603,0.0353,0.0319,0.0834,0.0854,0.1531,-0.1021,0.0802,-0.0355,-0.0496,-0.126,0.2104,-0.051,0.001,0.015,0.1433,0.1071,0.1,0.0265,-0.0117,0.0337,0.0292,0.039,0.0208,-0.0338,0.0033,-0.0225,-0.0312,-0.004,-0.0478,0.0202,-0.0509,-0.0504,-0.0897,0.0046,-0.026,-0.0219,-0.0267,-0.0549,-0.0049,0.142,0.0459,0.0876,-0.16,-0.0015,0.0153,-0.1364,-0.1284,-0.0798,-0.0547,-0.0547,-0.0172,0.0408,0.049,-0.009,-0.0089,0.2381,0.1996,0.0147,-0.0439,-0.1078,0.0272,0.2033,-0.0079,-0.0047,0.0872,0.0583,0.0201,-0.057,0.0023,0.024,0.0194,0.0079,0.0549,0.1109,0.1937,0.166,0.0766,-0.0675,0.0285,0.31,0.2271,0.0157,-0.0678,-0.0595,-0.0453,-0.0892,-0.06,-0.0663,-0.0523,0.0603,-0.0116,-0.051,0.0933,-0.0765,-0.1024,0.0425,-0.0638,-0.142,-0.0246,-0.1577,-0.0416,0.0124,0.0723,-0.1189,0.3731,0.3643,0.2403,0.1249,0.0888,0.0071,-0.0836,-0.0409,-0.0941,-0.0704,0.0228,0.118,0.0829,0.0166,-0.0252,0.0128,0.1141,-0.0902,-0.0116,-0.0003,-0.0308,0.3206,0.0721,0.3178,0.2487,0.185,0.1097,0.2853,-0.0909,0.0539,-0.0527,-0.0895,0.0374,-0.0341,-0.0586,-0.0705,-0.1076,-0.0343,0.0627,-0.0449,-0.0631,-0.0613,0.0158,0.0051,-0.1197,-0.0533,-0.0005,-0.0213,0.004,0.1041,0.1451,0.0435,0.159,0.392,-0.0278,0.005,-0.036,-0.0053,0.0455,0.0892,-0.0074,-0.023,0.0408,0.2582,0.0552,-0.0439,-0.0251,0.0537,0.0726,-0.0248,0.0178,0.0104,0.0223,0.0373,-0.0831,0.0556,-0.0286,0.0108,0.1593,-0.011,-0.0804,-0.0683,-0.0506,-0.0672,0.0464,0.0114,-0.0183,-0.0816,0.019,-0.0603,0.018,-0.0915,0.0345,-0.0178,0.1571,-0.0513,-0.0414,0.0059,0.0362,-0.0812,0.0325,-0.062,0.0429,0.09,0.0065,-0.0443,0.0481,0.0454,-0.0345,-0.0369,0.0115,-0.0315,0.0159,-0.0495,0.0065,-0.0161,-0.0224,-0.0234,-0.0599,0.0306,0.0973,-0.0155,-0.0193,-0.0054,-0.0568,-0.1375,-0.0216,-0.0328,0.0609,-0.0417,0.0454,-0.0837,-0.0657,-0.0415,-0.0943,-0.0033,-0.0079,-0.0333,-0.0314,-0.006,-0.0956,-0.1362,-0.1044,-0.0134,-0.1055,-0.0366,-0.0448,-0.0997,0.0044,0.0101,-0.0095,0.0729,0.0831,0.0735,0.0444,0.0252,0.0294,0.0048,-0.0185,-0.0674,-0.0338,-0.0976,0.0237,0.0679,0.0011,-0.0828,-0.028,-0.0267,-0.0234,0.0213,-0.0091,-0.0149,-0.0079,-0.057,-0.0552,0.0527,-0.0579,-0.0751,-0.0807,-0.049,0.1007,0.1243,-0.0561,-0.1092,-0.0029,-0.0012,-0.056,-0.0982,-0.0568,-0.0248,-0.0595,-0.0814,-0.0682,-0.0423,0.0189,0.025,-0.0026,-0.0073,-0.0213,0.0271,-0.008,-0.0487,0.0228,-0.0273,0.0335,-0.0402,-0.1195,-0.095,-0.0239,0.1649,-0.006,-0.0037,-0.0298,0.135,0.0759,0.0975,-0.0062,-0.07,-0.0268,0.0557,-0.0468,0.1815,0.0895,0.0649,-0.0185,-0.0817,-0.0073,0.0165,-0.0624,0.0182,-0.0506,-0.1422,-0.0324,-0.0137,-0.0031,-0.0629,0.0311,0.0445,0.1417,-0.0025,0.0518,-0.0511,0.0149,-0.0213,0.0035,-0.0117,-0.0019,-0.0008,-0.0102,-0.0144,0.0036,-0.0691,-0.0806,0.0362,-0.0482,0.008,0.0913,-0.0337,-0.0235,-0.0801,0.042,-0.0983,-0.0403,0.0329,-0.0435,-0.0707,0.1038,0.0121,0.0869,-0.0116,0.0043,-0.0935,-0.1074,-0.0946,-0.0875,-0.0519,0.0028,0.092,-0.1015,0.0087,0.0601,-0.1723,-0.0928,-0.0566,-0.148,0.1579,-0.0479,-0.0284,-0.1546,-0.1117,-0.0347,0.1152,0.0255,-0.041,-0.0038,0.0019,-0.1096,-0.0321,-0.0249,-0.0061,-0.0239,0.0235,0.0273,-0.0323,0.3344,0.0727,0.0884,-0.0635,-0.0996,0.002,-0.0774,-0.1559,0.0177,0.2699,-0.0427,-0.0333,-0.0192,-0.1195,0.0267,-0.0438,-0.0192,0.0015,-0.0098,-0.1184,-0.1106,-0.0998,-0.0051,0.0757,-0.0358,-0.0525,-0.0974,0.0113,0.0654,-0.0006,-0.0487,0.0505,0.2831,0.2942,-0.0274,0.0309,0.0154,-0.0024,0.0519,0.0613,0.0042,-0.0739,-0.0512,0.0227,-0.0848,-0.0209,0.0078,-0.0647,-0.0608,-0.1093,-0.025,-0.0261,-0.0478,0.027,-0.0557,-0.001,0.0125,0.1241,0.0872,0.0372,-0.0845,-0.0645,0.3463,0.2797,0.2236,0.02,-0.0656,0.2412,-0.0155,0.0072,0.039,0.0135,0.0354,0.0948,0.0217,-0.0093,0.215,0.1195,0.2367,0.0359,-0.0008,-0.0533,-0.0424,0.0722,0.0393,0.0203,0.0012,0.032,-0.0282,-0.0211,0.039,-0.0403,-0.0411,-0.0531,-0.0113,-0.0507,0.0553,-0.0848,-0.0363,-0.013,0.0074,0.0821,-0.0161,-0.0329,0.021,0.1151,-0.069,0.0154,0.1023,0.1226,0.0018,0.024,-0.0266,0.0074,0.2577,0.147,-0.0558,0.0378,0.0478,0.0333,0.1152,-0.0009,-0.0734,-0.0159,0.0408,-0.0254,0.0801,0.3101,0.1565,-0.0633,0.0359,0.0511,0.0927,0.0433,-0.0054,0.0654,0.104,0.0081,0.0399,0.0923,0.1149,0.0213,0.1103,0.0639,-0.0261,-0.0418,0.0102,-0.1166,0.1071,0.0893,0.0722,-0.0587,-0.0313,0.02,0.0147,0.3141,-0.0366,-0.0114,-0.0618,-0.0644,-0.2046,-0.0976,-0.1038,-0.1248,-0.1008,-0.079,0.0016,-0.0632,0.3801,0.3054,0.3233,-0.0137,0.1244,0.074,-0.061,-0.0274,-0.0548,-0.0082,0.2837,-0.005,0.0018,-0.051,0.0412,0.0509,0.0289,0.0881,0.1287,0.1169,-0.0818,0.0182,-0.0335,-0.0377,-0.0663,0.0107,0.0134,0.0346,-0.1071,-0.0769,-0.0617,0.2396,0.1429,0.4141,0.0673,0.034,0.0046,0.0728,0.0891,0.0945,-0.0586,-0.026,-0.0232,0.0462,-0.0212,0.0081,-0.0587,-0.0998,-0.0424,-0.0087,0.0094,-0.0307,-0.0391,-0.0276,0.1086,0.175,0.2361,0.0463,-0.0462,0.0326,0.033,-0.033,0.0185,0.0022,0.0137,0.0214,-0.0498,-0.1054,-0.0281,-0.0184,0.0698,0.0376,-0.0249,-0.0685,-0.0645,-0.0497,-0.1178,-0.0656,0.1255,0.0175,-0.0131,-0.0153,-0.0254,-0.021,-0.0117,0.0022,-0.0723,-0.0195,-0.0127,0.0284,0.0442,0.0048,0.05,-0.0022,0.0196,0.1036,0.0288,-0.1123,0.1159,-0.0703,0.0558,-0.0954,-0.107,-0.0332,0.0352,0.0002,0.001,0.0376,-0.0553,-0.0391,-0.0044,0.078,0.001,0.0997,0.0273,0.0292,-0.0694,-0.0907,-0.0445,0.1193,-0.0171,-0.0673,-0.0685,0.0582,-0.0058,-0.0184,-0.0115,0.0398,-0.0003,-0.0119,0.0036,-0.024,0.1185,0.011,0.088,0.0907,0.1174,0.0692,0.2912,0.3051,0.0016,0.0106,0.0519,0.0569,0.0728,0.2156,0.1962,0.0651,-0.0547,0.0345,-0.0787,-0.0222,-0.0065,0.0033,-0.0192,-0.0295,-0.0947,-0.0071,0.063,0.0526,-0.0778,0.011,0.0158,-0.017,-0.0105,-0.0322,0.2779,-0.0191,-0.0852,0.2236,0.0379,0.0192,0.0096,-0.0271,-0.0096,0.0496,0.0208,-0.0105,0.0248,-0.0145,-0.0268,-0.0264,-0.0389,-0.0158,-0.0086,0.0189,-0.0388,0.1319,0.0067,0.0476,0.086,0.0889,-0.0223,-0.0503,-0.0434,0.0089,0.0356,0.0374,0.0506,-0.0964,-0.0496,-0.055,-0.0721,-0.0377,-0.0306,0.1,0.0538,-0.0224,-0.0309,-0.0353,-0.0641,0.0027,-0.0899,-0.0912,-0.0798,-0.0028,-0.0097,0.0634,0.0269,-0.0966,-0.0381,0.0183,-0.0602,0.0086,0.0551,-0.0519,-0.0224,-0.1003,-0.1155,0.0317,0.031,-0.0437,-0.0898,0.0664,-0.0253,-0.0411,-0.0079,-0.1018,-0.0651,0.0572,0.0249,0.0736,0.1214,0.0094,-0.0144,0.0207,0.0076,0.0879,-0.0415,0.0927,-0.0888,-0.0547,0.0181,0.0746,0.0964,-0.0716,0.0544,0.0269,0.012,-0.0328,0.2081,-0.0635,-0.0282,0.0858,0.0475,-0.0456,-0.0199,0.0123,0.0035,0.0865,0.1716,-0.098,-0.0936,0.1102,0.1327,-0.0285,0.0802,-0.0873,-0.0718,-0.0909,-0.0552,-0.0189,-0.0479,-0.0235,-0.0371,0.028,-0.0558,-0.0337,-0.0649,0.0369,0.0704,-0.0511,-0.0306,0.0667,-0.0168,-0.0254,-0.0225,0.0228,0.0005,0.0021,0.0191,-0.0775,-0.0181,-0.0086,0.0362,-0.093,-0.0351,0.0054,0.0085,-0.0397,-0.0733,-0.0613,0.0018,0.0041,-0.0557,0.0734,0.0348,-0.0289,-0.0038,-0.0164,-0.0563,-0.035,-0.0705,-0.005,-0.0655,0.0456,-0.0455,0.122,-0.006,0.1064,-0.015,-0.1045,0.0703,0.0248,0.0674,0.0567,-0.0351,-0.0196,0.0652,-0.0653,0.0397,0.0009,-0.1266,-0.0175,-0.112,-0.0847,-0.0212,-0.0425,0.0448,-0.1655,-0.0842,0.0081,0.0391,-0.0773,0.0343,-0.0171,-0.0566,-0.0105,-0.0441,-0.0109,-0.0187,-0.0387,0.0064,-0.014,-0.044,-0.06,-0.0752,-0.0752,-0.0412,-0.0788,0.3511,-0.159,-0.1263,0.0382,-0.0389,-0.1773,-0.1619,0.0766,0.0515,0.0814,0.0421,0.1036,-0.0172,0.0009,-0.13,-0.0593,0.0045,-0.0041,-0.0297,-0.0623,-0.1023,-0.0785,0.0241,-0.0976,-0.1065,-0.0796,-0.0243,-0.0068,-0.1067,-0.0931,-0.088,-0.0583,0.0285,-0.0091,-0.0057,-0.0257,-0.115,-0.0226,-0.0279,-0.0651,0.1208,0.0185,-0.0067,0.1139,-0.0318,-0.0457,-0.004,-0.1705,0.2907,0.0529,-0.0878,-0.0315,-0.0711,0.1848,0.1428,-0.0665,-0.0657,-0.0093,0.0929,-0.0606,-0.1313,0.027,-0.0214,-0.0024,0.0211,0.0265,0.056,0.0131,-0.0564,-0.0146,-0.0306,-0.0873,-0.0783,0.0608,0.0327,0.026,-0.0128,-0.0031,-0.0263,0.0228,0.0244,-0.041,0.0105,-0.0648,-0.0502,-0.0317,0.0438,-0.0267,0.0144,0.018,-0.0946,-0.1044,-0.0086,-0.1186,-0.0568,0.0045,0.0028,0.031,-0.0627,-0.059,-0.0293,-0.0101,-0.045,0.0822,animacy perception
trm_557b4855a12b4,0.0423,-0.0017,0.0241,-0.0405,-0.0003,-0.0104,0.0105,-0.0001,0.0089,0.0134,0.0322,0.019,0.001,0.0077,0.0256,0.0291,0.0285,-0.0,0.0036,0.0286,0.0636,0.0183,0.0281,-0.0032,0.0485,0.0622,0.0599,-0.0375,-0.0088,0.021,0.0291,0.0216,0.0107,0.0066,-0.0036,-0.0041,0.0298,-0.0043,0.0005,0.0127,-0.0115,-0.0048,0.0081,0.0342,-0.0019,-0.0184,0.0863,0.0084,0.0433,0.0001,0.0072,-0.0398,-0.0586,0.0006,-0.0701,0.0004,-0.048,0.0177,0.0245,0.0332,0.0455,0.0193,-0.0036,-0.006,-0.0137,0.0091,0.0108,0.024,-0.0003,0.02,0.019,-0.0026,-0.0208,0.0122,-0.045,-0.0482,0.0186,0.0576,-0.0109,0.0019,-0.0113,0.0119,-0.0137,-0.0298,-0.0417,0.0234,-0.0051,-0.006,0.0121,-0.1209,0.0064,-0.0337,-0.0184,0.0615,0.0963,0.0624,0.048,0.0344,0.0108,-0.015,0.0221,0.0003,-0.0134,-0.005,0.0467,0.0016,0.0061,0.0233,-0.029,-0.0283,0.0291,-0.0054,0.0021,-0.0122,-0.0082,-0.0153,0.0156,0.0159,0.0113,-0.0026,0.0386,-0.0094,0.0315,-0.0093,-0.0495,0.0361,-0.001,0.0181,0.022,-0.0541,-0.0131,0.0066,0.0093,-0.0394,-0.0082,-0.0011,0.0177,0.0059,-0.0106,-0.0109,0.0194,0.0019,0.0134,-0.0173,0.0059,-0.0443,-0.0153,0.0251,0.0048,-0.018,-0.0068,0.05,0.0016,0.0311,0.0246,0.0065,0.017,0.056,0.0228,0.0104,0.0025,0.0247,0.0256,0.0122,0.0238,-0.0449,0.0265,0.0099,0.0085,-0.0548,0.0329,0.0492,0.0405,0.0072,-0.01,0.0091,-0.0029,0.0095,-0.0,0.0069,-0.0306,0.0347,0.0083,-0.0122,-0.0129,0.0004,0.0068,0.0012,-0.0114,-0.0267,-0.037,0.0064,0.0325,0.0238,0.0281,-0.0466,-0.0357,0.0343,-0.0008,-0.0669,-0.032,0.0438,0.0057,-0.021,0.0094,-0.0517,-0.0227,-0.0024,-0.025,-0.029,-0.005,0.0344,-0.0561,0.0139,0.0001,0.0066,-0.0038,-0.0207,-0.0318,0.0314,0.0523,0.0057,-0.0018,-0.0169,0.0049,0.0456,-0.0219,0.0126,-0.0333,0.0262,0.0211,0.0042,0.0616,0.0138,0.0103,-0.0386,0.0166,-0.0092,-0.0282,-0.055,0.0313,-0.0066,-0.0064,0.014,-0.0298,-0.0325,0.0008,-0.0053,-0.0128,-0.007,-0.0058,0.0087,-0.0397,-0.0082,-0.008,0.0076,-0.0308,-0.0399,0.0555,0.0704,0.0309,0.0997,0.0121,0.0497,0.0771,0.0637,0.019,-0.017,0.0257,0.0103,-0.0064,-0.0173,-0.0011,0.0056,-0.0677,-0.043,-0.1455,-0.1538,-0.0739,-0.0683,-0.0331,0.0229,0.0199,-0.012,-0.0094,0.0044,0.0074,0.0079,-0.0113,-0.0229,0.0169,0.0042,0.0074,-0.0066,0.0071,0.0368,0.013,-0.0297,0.0175,0.0208,-0.0398,0.0001,-0.0192,0.0379,-0.0195,-0.0149,0.0251,-0.046,-0.0759,0.001,-0.0305,-0.0381,-0.0191,-0.0264,-0.0022,-0.0213,0.0274,-0.0005,0.0105,-0.0266,0.001,0.018,-0.0354,-0.0229,-0.0007,-0.0232,0.0173,-0.0054,-0.0063,0.007,-0.0514,-0.0269,0.078,0.0128,0.0441,-0.0006,-0.0619,-0.0378,0.0562,0.0019,-0.0099,0.0462,0.0143,-0.0045,0.0234,-0.013,-0.0097,-0.0093,0.0063,-0.0184,0.0188,0.1013,0.0086,0.0071,0.0079,0.0036,-0.0373,-0.0062,-0.0363,-0.0066,0.035,0.011,-0.1373,-0.0198,-0.034,0.0247,-0.0182,0.0059,0.0326,0.0257,-0.0074,0.0254,0.0092,0.032,0.0391,-0.0225,-0.0223,0.0217,0.0417,0.0084,0.0244,0.0018,-0.0328,-0.0138,-0.0026,-0.0174,0.0071,0.0038,0.0138,-0.0016,-0.0398,-0.0372,0.0154,0.0013,0.0303,0.0141,0.016,0.0034,-0.0195,-0.021,-0.0268,-0.0005,0.0039,0.0184,0.0102,-0.0133,0.004,0.0525,0.0072,0.0162,0.0351,0.0374,-0.0065,0.007,0.0159,-0.0488,-0.0078,-0.0215,-0.0391,-0.0105,0.0069,-0.0148,-0.0105,-0.025,-0.0321,-0.0252,0.0265,0.0192,-0.0335,-0.015,0.0255,0.0012,-0.0087,-0.0288,-0.0039,0.0261,-0.0442,-0.0238,-0.0012,-0.0071,0.0545,-0.0062,0.06,0.0094,0.0167,0.0086,-0.0008,0.0036,0.0354,-0.0211,-0.0034,0.0015,-0.0183,-0.0132,-0.0336,0.005,-0.046,0.007,-0.059,0.0193,0.0443,0.0075,-0.0207,0.0287,0.0217,-0.0307,0.0254,0.089,0.0162,-0.0457,-0.0095,-0.0103,-0.0412,-0.0484,-0.0117,-0.0099,0.0311,-0.0157,0.0043,0.0237,-0.012,-0.0218,-0.0195,0.0052,-0.0166,-0.0277,0.0082,0.0016,0.0242,0.013,0.0288,-0.0696,-0.0292,-0.0438,0.0168,0.0162,-0.1481,0.0337,0.0182,-0.0164,-0.0179,-0.0022,0.0003,0.0155,0.0094,-0.0441,-0.0434,-0.0508,-0.0258,0.0294,-0.0073,-0.0251,-0.0452,0.0211,0.0576,0.0084,0.003,-0.0096,-0.0127,-0.0056,-0.0332,-0.0079,0.0524,-0.0043,-0.0339,0.0286,-0.0077,0.0291,-0.0018,0.0195,-0.0416,-0.0409,-0.0102,0.0142,0.0388,-0.0046,0.0304,-0.0149,-0.0019,0.0209,0.002,0.0078,-0.0437,-0.0392,0.0081,0.0397,0.0108,-0.0077,-0.0204,0.0789,0.0195,0.0204,-0.0404,-0.0397,0.0255,-0.0067,0.0092,-0.0146,0.019,-0.0343,0.0268,-0.0101,0.0162,0.005,-0.0271,-0.0534,0.0217,-0.0504,-0.0294,-0.0512,0.0106,-0.0219,0.008,0.0318,0.0273,0.0012,0.0173,-0.0357,-0.0084,-0.0121,-0.0465,0.0142,0.0243,0.0201,-0.0475,0.0114,0.009,-0.0071,-0.004,-0.0086,0.017,-0.0076,0.0037,-0.0276,-0.0349,-0.0071,0.0187,-0.0016,-0.0218,-0.0387,-0.0167,0.0151,0.0468,0.0167,0.0436,0.0392,-0.0328,0.0292,0.0257,-0.0333,-0.011,-0.0157,0.0249,-0.0348,-0.0033,0.0025,-0.0068,-0.0309,-0.0091,-0.0112,-0.0173,0.0036,0.0208,0.0036,0.0064,-0.0141,-0.0354,0.004,-0.0248,0.007,-0.0046,-0.0149,0.0144,0.0025,-0.0002,0.0227,0.0059,-0.0295,-0.0036,-0.0725,-0.0296,0.0146,0.0311,0.01,0.0096,-0.0076,-0.0192,-0.0171,0.0423,0.0366,-0.0158,-0.0236,0.0348,0.0347,-0.0084,0.0065,0.0062,-0.0247,0.0049,-0.0073,-0.0056,0.0093,0.0361,-0.0079,0.0241,0.0042,-0.0205,0.0514,-0.0201,-0.0196,-0.02,0.0107,0.0117,-0.043,-0.0027,0.0032,-0.014,0.0032,0.0249,0.0122,0.017,0.0001,0.0232,0.023,0.0161,0.0023,-0.0123,-0.007,-0.0003,-0.0194,0.0251,0.0478,0.0151,0.0238,0.1127,-0.0041,0.0069,-0.0193,-0.0009,-0.0055,-0.0289,-0.0125,-0.0079,0.029,0.0004,-0.001,-0.0034,0.0277,0.0217,-0.017,0.0387,-0.062,-0.0079,-0.0314,-0.0234,-0.0476,0.0208,-0.0642,0.0277,-0.0014,-0.0098,-0.0674,0.0102,0.0094,0.0124,0.0094,0.0066,0.0146,-0.0078,-0.0011,0.0341,-0.0052,0.0169,0.0259,0.0093,0.0045,-0.0146,0.01,0.0054,-0.0477,0.0103,-0.017,0.0036,0.0371,0.0266,0.0389,-0.0071,-0.0098,0.0158,-0.0072,0.0041,0.0339,-0.0018,0.0267,0.0148,0.0256,0.0463,0.045,0.0098,-0.0356,-0.0314,-0.0128,-0.0045,0.0158,-0.015,0.049,0.0031,-0.0241,0.0372,-0.0224,0.0175,0.0419,-0.0001,0.0079,0.0166,-0.0333,0.0017,-0.0119,0.0245,-0.0042,0.0158,0.0002,0.0131,0.0383,-0.0004,-0.0415,-0.0208,0.0219,0.019,0.0185,-0.0002,-0.0287,0.0206,-0.0181,0.0264,-0.0108,0.0123,-0.0343,-0.0219,0.0269,0.0221,0.0402,0.0265,0.082,0.0155,-0.0252,-0.009,-0.0188,0.044,0.1278,0.0417,-0.0145,0.0052,0.0181,-0.0022,-0.0078,0.0401,0.0375,-0.0376,-0.0651,-0.0502,0.008,0.0122,-0.0099,0.0185,0.0385,0.0023,0.0144,0.0221,0.0199,0.0171,0.039,0.026,0.0726,0.0195,0.0154,-0.0117,-0.0575,-0.006,0.0145,-0.039,0.0264,-0.0156,0.0005,0.0059,-0.0074,0.0334,0.0362,0.0021,0.01,-0.0101,0.0187,0.0289,-0.0103,-0.0181,0.0374,-0.0071,0.02,-0.0486,0.0072,-0.0051,-0.0452,-0.0882,-0.0435,-0.0499,-0.0164,-0.0002,-0.0261,0.0273,-0.0193,0.0391,0.0021,0.0286,-0.0084,0.0178,-0.0128,-0.0188,0.0021,-0.0627,-0.0432,0.0121,0.1035,0.0101,0.0137,-0.0332,0.0052,0.017,0.0198,0.0021,0.0094,-0.0492,0.0089,0.0144,-0.022,0.0076,0.055,0.0157,-0.0207,0.0043,-0.0391,0.0241,-0.0008,0.0784,0.0389,0.0402,0.1126,0.0431,0.0276,0.0141,-0.0201,0.0282,0.0331,0.0005,-0.02,-0.0068,0.0101,0.0101,-0.0231,0.0247,-0.0061,-0.0134,-0.0297,-0.0445,0.0315,-0.0378,0.0094,-0.006,0.0415,0.0107,-0.005,-0.0358,-0.018,0.0228,0.006,0.0306,0.0018,-0.0119,0.0224,0.0398,0.0173,0.017,-0.0217,-0.0408,-0.0087,0.028,0.0067,0.0072,-0.0309,0.0147,-0.0261,-0.0183,-0.0179,0.0132,0.0113,-0.0155,0.0281,0.0262,-0.0144,0.0251,0.0044,0.0154,0.0271,0.0212,0.0214,-0.0144,0.0165,-0.0246,0.015,-0.0263,-0.0139,-0.0182,0.0319,0.0175,-0.1102,0.0123,0.0467,-0.018,-0.0272,-0.0037,0.0527,-0.0205,0.0439,0.0091,0.0063,0.0113,0.009,0.0118,-0.0187,-0.0308,0.0034,-0.0134,0.0291,0.0592,-0.0194,-0.0241,0.0106,-0.0403,0.0175,-0.0075,0.0368,0.0137,-0.024,0.0145,-0.0178,-0.0174,-0.006,-0.0278,-0.0394,-0.0609,-0.0147,-0.0155,-0.0013,-0.0118,0.0047,0.0243,0.0121,0.0009,0.009,0.0195,0.0211,-0.0321,-0.001,-0.0023,-0.0042,0.0123,0.0264,-0.0079,0.0194,-0.0373,0.0078,-0.0114,0.0416,0.0382,0.0376,-0.0297,-0.034,0.014,-0.0207,0.0131,-0.0015,-0.0109,-0.0255,0.0052,-0.0018,-0.0108,-0.0664,0.0243,-0.0147,0.0075,0.0132,0.017,0.0079,-0.0424,0.0167,-0.0052,-0.0354,0.0144,0.0264,-0.0265,0.0552,0.0403,-0.0143,0.0126,-0.0109,-0.0502,-0.0301,0.025,0.0071,-0.0192,-0.0167,-0.0508,-0.0344,0.0206,-0.0347,0.0379,0.0195,-0.0311,-0.0034,-0.0232,-0.0088,0.0293,-0.0017,-0.0017,-0.0288,-0.0066,-0.001,0.0022,0.0326,-0.024,-0.0258,0.156,0.0893,0.1,0.0467,0.0697,0.0316,0.0871,0.0929,0.0272,0.0513,0.0419,0.0312,0.0471,0.0544,0.0289,0.0469,0.0332,-0.0098,-0.0254,-0.0161,-0.0177,0.0564,0.0415,-0.0045,0.0161,-0.0102,0.0147,-0.0083,-0.0414,0.0085,0.0055,0.0152,0.0037,0.0248,-0.009,0.0198,0.0422,0.0101,0.0325,-0.0029,0.0239,0.026,0.0401,-0.0302,-0.0147,0.0036,0.007,0.016,-0.0179,0.0433,0.0127,0.1204,0.0823,-0.0056,0.0096,-0.0122,0.0212,0.0308,0.0193,0.0891,0.003,-0.0067,0.0085,0.0123,0.0469,0.0243,-0.0339,-0.0106,0.0008,-0.0052,-0.015,0.0169,-0.0106,-0.0159,0.0452,0.0181,-0.0054,0.0243,-0.0129,0.0313,0.0326,0.0106,-0.0734,0.0232,0.0046,0.0331,0.0225,-0.0471,-0.016,0.0065,-0.0012,0.0438,-0.0163,-0.0073,-0.0785,-0.0401,-0.0448,0.0477,-0.0323,-0.1238,-0.027,0.0024,-0.0758,0.0187,-0.0883,-0.0062,0.0348,0.0174,-0.1567,0.0215,0.0156,0.0039,-0.0679,0.0132,0.0051,-0.0074,0.0202,0.0241,-0.0309,-0.0203,-0.0352,-0.0579,-0.0249,-0.0418,-0.0025,-0.0321,-0.0411,-0.0066,-0.0332,0.0258,-0.0133,0.0519,0.0432,0.0736,0.0371,0.025,-0.0184,-0.0231,-0.0174,0.0079,0.0272,-0.0159,0.0925,-0.0112,0.0469,-0.0267,-0.025,0.0246,0.0019,-0.0072,0.009,0.0091,-0.0036,0.047,0.0321,-0.0569,0.0292,0.0032,0.0256,0.0005,0.0005,-0.0052,0.0195,-0.0043,0.0298,0.0042,0.0332,0.0306,0.0622,0.0294,0.0281,-0.0274,-0.0536,0.0149,0.0055,-0.0095,-0.004,0.0049,0.0066,-0.0014,-0.028,0.0795,-0.0123,-0.0916,-0.0296,-0.0282,0.032,-0.1008,-0.0234,-0.0135,-0.0149,-0.0195,-0.056,-0.0011,0.0333,-0.1296,-0.023,0.0107,0.0525,0.025,-0.0077,0.0062,0.0591,0.0323,0.0305,0.004,0.0015,0.0575,-0.023,-0.0001,-0.0371,0.0336,0.0,-0.0103,0.003,0.0043,-0.0047,-0.0038,0.0303,-0.1308,-0.0806,-0.0028,-0.0446,0.026,0.0013,0.028,0.1235,-0.035,0.0113,-0.0195,-0.0162,0.0056,-0.0275,-0.1444,-0.1419,0.0386,0.0108,-0.0707,0.0311,-0.0302,0.0004,0.0193,-0.0044,0.0154,-0.0142,-0.0064,-0.0836,-0.0207,-0.0313,-0.0316,0.0576,-0.0161,-0.0102,0.0242,0.0122,0.0104,-0.0015,0.0266,0.014,0.0483,0.052,0.0693,0.0868,0.0075,0.0151,0.0157,-0.0629,0.0037,-0.0025,-0.0067,-0.0024,0.0012,-0.0431,-0.0095,0.0102,-0.0068,-0.013,0.0286,-0.0184,0.0114,-0.1038,0.0024,-0.0217,-0.0036,0.0336,0.0095,0.0514,0.047,0.1244,0.0087,0.0273,0.0222,0.042,0.0225,0.0317,0.0185,-0.0003,0.0144,0.0163,-0.013,0.0422,-0.0148,0.0281,-0.0159,-0.0459,0.0261,0.0022,-0.0331,-0.0157,-0.0133,0.0198,0.0382,0.0198,0.0176,0.0209,0.0031,0.0061,-0.0259,-0.0292,-0.0148,-0.0059,0.0016,-0.0192,-0.0163,0.0062,-0.0196,0.0144,0.0046,-0.0246,-0.0233,-0.0527,-0.0126,-0.0034,0.0063,0.0154,-0.0017,0.018,0.0537,-0.0038,-0.0282,-0.0378,0.0245,-0.0307,0.0103,0.0164,0.0119,-0.0031,0.0439,-0.0253,-0.0115,-0.0338,-0.0347,-0.0823,-0.1256,-0.0696,0.0326,0.0204,-0.0193,0.0351,0.0173,-0.0085,0.003,0.0185,0.0195,0.0079,-0.0056,-0.0056,-0.0073,0.0159,-0.0434,-0.0068,0.0342,-0.0142,-0.0028,0.0182,0.0369,-0.0099,0.0162,0.0072,0.0309,0.0055,-0.0564,-0.033,-0.0363,-0.0482,-0.052,0.017,0.0455,-0.0221,-0.0307,-0.0407,-0.0027,0.0013,0.0333,-0.025,0.0056,-0.0225,0.0426,-0.0019,0.0258,-0.0416,0.0232,0.0144,-0.0222,-0.0088,-0.0165,0.0234,0.0058,0.0298,-0.0194,0.0246,0.0088,0.0136,0.0205,0.0054,-0.0194,-0.0169,-0.0054,0.0216,0.0292,0.0227,-0.0025,0.0194,0.0839,0.0798,-0.0104,0.0249,0.029,-0.001,0.027,-0.0115,-0.0222,-0.0103,0.0049,-0.0111,0.0042,-0.0496,-0.0134,-0.043,0.0044,-0.0088,-0.0246,0.0084,0.0674,0.0079,-0.0156,0.055,0.0086,0.0023,0.016,-0.0242,-0.0089,0.0223,-0.0066,-0.0104,0.0031,-0.0319,0.0174,-0.0701,-0.0655,-0.0302,0.0151,-0.0126,0.0066,-0.0227,0.0041,0.0155,-0.0019,-0.0356,0.0211,0.0003,0.0084,0.0005,-0.0329,0.016,-0.1562,-0.1457,-0.0994,-0.0879,0.0245,-0.0001,0.0034,0.0068,0.0215,0.0498,-0.0028,0.0418,-0.0163,0.0746,0.006,-0.0009,0.1582,-0.0111,0.001,-0.0068,-0.0361,-0.0297,-0.0824,-0.0949,0.012,-0.0167,0.0075,0.0073,-0.012,0.0071,0.0051,-0.036,-0.0361,-0.0268,-0.0158,-0.0134,-0.0112,-0.0147,-0.0313,-0.0017,-0.0064,-0.0027,-0.1041,-0.0447,0.0139,0.0336,-0.0297,-0.0242,-0.0121,0.0198,0.0103,0.0172,0.0432,-0.0233,0.0153,-0.0052,0.0133,0.0778,0.0462,-0.1426,0.0227,-0.0316,-0.0236,-0.0006,-0.017,-0.1594,-0.1377,-0.1808,-0.0119,0.0211,0.0114,-0.0068,-0.0011,0.0144,0.0055,0.0274,0.0161,0.0363,0.0455,0.0179,-0.0035,0.0104,0.0114,0.088,0.0663,0.0129,0.02,-0.0081,-0.0067,0.0316,-0.0305,-0.0198,-0.0386,0.0089,0.0233,0.0481,-0.0083,0.0075,0.0116,0.0134,-0.0037,-0.011,0.0034,0.0372,-0.0201,-0.0133,-0.0373,-0.0186,-0.0053,0.0269,0.0123,0.0036,0.0098,0.0283,0.0164,-0.0005,-0.0161,-0.0165,0.0283,0.0133,-0.0292,0.0118,-0.0274,-0.0469,0.0233,-0.0143,0.0354,0.0169,0.0166,0.052,0.0295,0.0029,-0.0603,0.017,0.0225,0.0105,-0.0089,0.0379,-0.0042,0.0517,0.0132,0.0012,-0.0281,-0.0018,0.0303,-0.0066,0.0219,0.025,0.0377,-0.0042,0.037,0.0198,0.0224,-0.0159,-0.0318,-0.1288,0.0104,0.0159,0.031,0.0262,0.0429,0.0117,-0.0186,0.0197,-0.0123,-0.008,0.0283,-0.0028,-0.0215,-0.039,0.0006,-0.0279,0.0384,0.0195,0.0111,0.0005,0.0087,0.0104,-0.0105,-0.0118,0.0162,-0.011,-0.0082,0.0058,-0.0192,0.0167,0.0153,-0.0244,-0.0209,-0.0289,0.0103,0.0088,-0.0026,0.0164,0.0453,-0.0336,-0.0268,0.0018,0.0088,-0.0148,0.0291,0.0306,-0.0028,-0.0248,-0.0232,0.0318,0.0264,0.0167,-0.0007,-0.0216,0.0039,-0.0845,-0.0251,-0.0706,0.0118,-0.047,-0.0075,0.0905,-0.0725,-0.0796,-0.0185,-0.0084,0.0081,-0.0069,-0.03,-0.0343,0.0243,0.0704,0.0786,-0.0075,-0.021,-0.0103,0.0256,0.0046,-0.045,0.0076,0.0247,-0.0393,-0.0068,-0.0554,-0.0155,-0.0085,0.0192,0.0135,-0.0148,-0.0058,-0.019,-0.0207,-0.0197,-0.0178,-0.0076,0.0037,-0.0595,0.0176,-0.0404,0.0843,0.0799,-0.0035,-0.01,-0.0069,-0.0334,-0.0417,0.0353,0.0178,0.1823,-0.0219,-0.0211,0.015,0.0219,-0.0047,0.0191,0.0194,0.0406,-0.0177,-0.0025,-0.0166,0.0129,0.0034,0.0147,0.0238,0.0546,0.1358,-0.013,-0.0025,0.0356,0.1987,-0.0856,0.0144,-0.0096,-0.0203,-0.0028,0.0002,0.0296,0.0007,0.0124,-0.01,-0.1094,-0.1089,-0.0743,0.0359,-0.0098,-0.0283,-0.0606,0.006,-0.0249,0.0205,0.0577,0.0809,0.0238,-0.0266,0.0074,0.0052,0.0074,-0.0072,-0.0212,0.0095,0.0205,-0.0016,0.0231,0.0158,-0.0222,-0.0128,-0.031,0.0073,-0.0142,-0.0334,0.0269,0.0147,-0.0121,0.0074,0.0384,-0.0114,-0.0441,-0.0033,-0.0204,-0.0256,0.0056,0.0118,0.0136,0.0261,0.0739,0.0353,0.0534,0.0062,0.0025,-0.0002,-0.0153,0.0277,0.0315,0.0037,-0.0261,-0.0184,0.022,-0.0075,-0.0483,0.0113,-0.0014,0.0004,-0.0847,0.0128,-0.0405,0.0062,-0.0099,0.0085,-0.0226,-0.0385,-0.0002,-0.0308,-0.0678,-0.0672,-0.0107,-0.0057,-0.0412,-0.0108,-0.027,-0.0301,0.0216,0.059,0.0389,-0.0009,0.0939,0.0796,0.0117,-0.0321,0.0924,0.1007,-0.0022,0.0964,0.061,0.0537,-0.0149,-0.0152,-0.0253,-0.0125,0.185,0.1417,0.0996,0.0443,0.0688,0.0726,0.1052,0.095,0.0624,0.0402,-0.0152,-0.0028,0.0177,0.0045,-0.0199,-0.0116,0.0002,0.0423,-0.0043,-0.0094,0.0125,-0.02,-0.0363,-0.0044,0.0223,0.0401,0.0167,0.0031,-0.0671,-0.0487,-0.0532,-0.0031,0.023,0.0216,-0.0282,-0.0058,-0.026,-0.0236,-0.0076,-0.0159,-0.0158,-0.0372,-0.0572,-0.0006,0.0876,0.0173,0.0274,0.0269,-0.0056,-0.0249,0.0276,-0.0485,-0.0187,-0.0251,-0.0104,-0.0366,-0.0033,0.0466,0.0342,-0.0394,0.0096,0.0058,-0.0182,-0.0131,-0.025,-0.0343,-0.0526,-0.0222,-0.0209,-0.0379,0.0005,-0.0339,-0.0449,-0.0183,0.0493,0.0229,0.0428,-0.0082,-0.0195,0.0448,0.0241,0.0003,-0.0214,-0.0127,0.0118,0.0709,0.044,0.0624,0.0266,-0.0146,0.0326,0.0264,0.0207,0.0417,0.032,0.0629,0.0267,0.0284,0.0642,0.074,0.0044,0.002,-0.0862,-0.0487,-0.0015,-0.0239,0.025,-0.0018,-0.0258,0.0004,0.0353,0.033,0.0486,-0.035,0.0593,0.0398,-0.0338,-0.0224,-0.0112,-0.0104,-0.0061,0.0381,0.0153,-0.0149,-0.0083,0.0049,-0.0209,0.0365,-0.006,-0.0029,0.0342,0.0303,0.008,0.0073,0.0095,0.0284,0.0768,0.0198,0.0144,-0.0085,-0.0269,0.0224,0.0117,0.001,0.0195,0.0502,-0.0025,0.054,-0.0193,0.0017,0.0236,-0.0106,0.0028,0.0098,-0.0239,0.0417,0.0001,-0.034,-0.0255,-0.0224,-0.0092,-0.0083,-0.0305,-0.1211,-0.1046,0.0442,0.0092,0.0106,-0.0057,-0.0008,-0.0877,0.0382,0.0049,0.0027,0.0243,-0.0904,-0.0989,-0.0065,-0.0205,-0.0103,-0.0105,-0.0406,0.0081,-0.0134,0.0018,-0.0276,-0.0308,0.0212,0.0495,0.0386,0.0097,-0.0156,0.0329,-0.0049,-0.0073,-0.0224,-0.0095,0.0207,0.0359,-0.0036,-0.0147,0.0247,0.0112,0.0031,-0.0156,0.0085,-0.0091,0.0005,0.0179,0.0179,-0.0077,-0.0062,-0.014,0.002,-0.0,0.0161,0.0071,-0.0308,-0.0355,0.0108,-0.0338,-0.0476,-0.0224,-0.0972,0.0515,-0.0711,-0.0524,0.0112,-0.0102,0.0237,0.0656,-0.033,0.0305,0.0117,0.0026,-0.0067,-0.0027,-0.03,-0.001,-0.0242,-0.0098,-0.0017,0.0564,0.0107,0.0144,-0.0164,0.0078,-0.0076,-0.0139,-0.0116,0.0051,-0.0106,0.016,0.0103,-0.0168,0.007,0.0105,-0.0227,-0.0119,-0.0241,0.0096,-0.0105,0.0047,-0.0037,0.0377,0.0351,-0.0034,0.0435,0.0367,0.0293,-0.0322,0.0101,0.0288,0.0264,-0.019,-0.0042,-0.046,0.0089,-0.0314,0.0272,0.0383,-0.0269,0.0184,-0.0267,0.0009,-0.0086,-0.1274,-0.0053,-0.0329,0.0216,0.0072,-0.0124,0.1224,0.0266,0.0019,-0.0087,0.0294,0.0098,-0.0395,0.0311,-0.0182,-0.0309,-0.0117,-0.0051,-0.0217,-0.0281,0.0307,-0.0068,-0.012,-0.0054,-0.054,-0.01,-0.0418,-0.0236,-0.0303,-0.0213,-0.0239,-0.0769,0.0106,0.0101,0.0072,-0.0047,0.0153,0.0064,-0.0197,-0.0355,0.0088,-0.0018,0.0087,0.032,0.0059,0.0215,-0.0115,0.0161,-0.0077,0.018,0.015,-0.0083,0.0316,-0.0181,-0.0107,0.017,-0.0788,-0.0366,0.0151,-0.016,-0.0112,-0.0141,0.0094,0.0011,-0.0024,-0.0205,0.0242,0.0163,-0.0454,-0.0319,-0.0364,0.0032,0.0157,0.0793,-0.0377,0.0033,0.0112,-0.0176,-0.0166,-0.0484,0.0373,0.002,-0.0303,0.0217,-0.0009,-0.0073,0.0524,0.0087,0.0055,0.0321,0.0262,-0.0436,-0.0068,-0.0258,-0.0345,0.0064,0.0073,0.0619,0.051,0.0303,0.0216,0.0076,-0.0208,0.0134,-0.0877,-0.0464,-0.0787,0.0094,0.0046,0.0143,0.0317,-0.0679,-0.0232,-0.0556,-0.002,0.0323,-0.0247,0.0047,-0.0002,-0.0067,-0.002,-0.0132,0.0213,-0.0286,-0.0581,-0.0189,0.0199,0.0144,0.0265,-0.0303,-0.0165,-0.0372,-0.0184,-0.0488,-0.0217,-0.0016,-0.0427,0.0182,0.0079,0.0007,-0.0283,-0.0071,-0.0198,-0.0303,-0.0137,-0.0081,-0.0244,0.0052,0.0005,0.027,0.0176,0.0242,0.0203,-0.044,-0.0213,-0.0256,-0.0434,-0.0365,0.0097,-0.0436,0.0145,-0.002,-0.01,0.0022,0.0029,0.0281,0.0011,-0.0141,-0.0114,0.0311,-0.0256,0.0489,0.0074,-0.0004,-0.0351,0.021,0.0167,-0.0207,0.0105,-0.0253,-0.0098,0.0165,-0.0098,0.0077,0.0041,-0.0177,-0.0095,-0.023,0.0174,0.0147,-0.0211,-0.0472,-0.0061,0.0076,-0.0243,0.0113,-0.0081,0.0392,0.0165,-0.0113,0.0013,0.0093,0.0041,0.0254,0.0003,-0.0094,0.0377,-0.0218,0.0468,-0.0214,-0.0365,-0.0079,0.0933,-0.0039,0.0055,-0.0097,-0.0248,-0.0121,0.01,-0.0024,-0.0159,0.0258,0.018,0.0003,0.016,-0.0117,0.0032,0.0095,0.0048,0.0086,-0.013,0.005,0.0205,-0.0213,-0.003,-0.0199,-0.0032,-0.021,-0.024,0.0739,0.005,0.0313,0.0275,0.0256,0.0067,0.0255,0.0274,-0.0226,0.0175,-0.0354,-0.0189,0.0376,0.0348,0.0228,-0.0116,-0.0161,-0.0039,0.0307,-0.0155,-0.0126,-0.0034,-0.0105,-0.0179,-0.0045,-0.0213,0.0311,-0.001,-0.0179,0.0193,-0.0052,-0.0135,-0.0264,-0.0198,-0.0151,-0.0049,0.0614,-0.002,0.0189,0.0146,-0.0072,-0.0106,0.0388,-0.0124,0.0739,0.0532,0.0158,0.0028,-0.0101,0.0185,0.0375,-0.0018,-0.0673,0.008,0.01,0.0412,0.0237,0.0229,0.0417,0.0051,-0.0386,-0.0007,0.0655,0.0595,-0.0253,-0.0012,0.0095,-0.0131,0.0046,0.0499,0.0585,-0.015,0.0092,0.0261,-0.0478,-0.0239,-0.0274,0.0023,0.0076,0.0155,-0.0186,0.0288,-0.0097,-0.0141,0.0086,0.0162,-0.0176,0.062,0.0515,-0.0196,0.0678,0.0078,0.0069,0.0079,-0.1255,-0.056,-0.0239,-0.0402,-0.0612,-0.052,-0.0269,-0.0197,0.0094,0.0495,0.0032,0.009,0.0229,-0.0113,0.0379,0.0045,-0.0002,-0.1701,-0.1246,-0.1703,-0.0104,0.0258,0.0119,0.0152,-0.0183,0.0231,-0.015,0.0101,-0.0244,-0.0254,0.0127,0.0235,-0.0163,-0.0216,0.0155,0.0203,-0.0088,-0.0156,0.0004,0.0382,-0.0204,0.0301,0.0305,0.0066,0.0172,-0.0056,0.0926,0.0158,0.0515,-0.0169,-0.0488,0.0042,0.0229,0.0061,-0.0082,0.0304,0.0297,-0.0398,-0.0179,-0.0072,-0.0204,0.0126,0.0022,-0.017,0.0181,0.0598,0.0168,-0.0447,-0.0409,-0.0024,-0.0349,0.0285,0.0213,-0.0597,-0.0004,0.0231,-0.0202,-0.053,-0.0081,-0.0074,0.0054,0.0343,-0.0081,0.0049,-0.0034,-0.0053,0.0073,0.0246,0.0389,-0.0287,0.0358,-0.0576,0.0385,-0.0308,-0.0398,0.0143,0.0975,-0.0062,-0.0296,-0.0255,-0.0061,-0.0011,0.0019,0.0107,0.0076,0.0102,-0.0038,0.0431,0.0324,0.009,0.0249,0.0043,-0.0114,0.007,-0.012,0.0144,-0.0074,-0.0061,-0.0076,-0.0283,0.0208,-0.1096,-0.1347,0.001,0.0144,0.0813,-0.032,-0.0645,0.1023,0.1044,0.0472,0.0008,0.0218,0.0428,-0.1134,-0.0932,-0.0651,-0.02,-0.0017,0.0308,0.0239,-0.0051,0.0176,0.0073,-0.0898,0.0249,0.0046,0.0217,-0.1608,-0.1213,-0.0906,-0.1281,0.0336,0.0121,-0.0095,0.0259,-0.1585,0.01,0.0141,0.0382,0.0302,-0.0056,0.0078,0.011,0.0268,0.0002,-0.0146,0.1097,0.0014,-0.0198,0.0393,-0.1317,-0.0241,-0.01,0.0068,0.0392,0.0044,0.0136,0.0221,0.004,-0.0497,-0.0543,-0.0085,-0.0336,-0.0414,-0.0306,-0.0299,0.0221,-0.0079,-0.0291,-0.0061,0.0203,-0.0114,-0.0106,0.0231,0.004,0.0085,-0.0225,0.0422,0.021,0.0197,0.0324,0.009,0.0324,-0.0392,-0.0386,-0.0148,-0.0152,-0.0599,-0.0128,0.0217,-0.0285,-0.0253,-0.0272,-0.0025,-0.0637,0.0197,0.0002,-0.0231,0.0201,-0.0321,-0.0179,-0.0045,0.01,-0.017,-0.0023,-0.0008,-0.0033,0.0209,-0.0244,-0.036,0.006,-0.0205,-0.0421,-0.0191,0.0315,0.0124,0.0255,0.0386,-0.0108,0.0013,-0.0316,0.0215,0.0195,0.012,0.0699,-0.0302,-0.0334,-0.0317,-0.0845,0.0284,0.0205,-0.0628,0.056,-0.1236,0.0019,-0.0074,-0.0059,-0.027,-0.0061,0.012,-0.0229,-0.0526,-0.0479,0.0463,0.0081,-0.0044,0.0111,0.0164,0.0182,0.0354,-0.0069,0.0011,0.0113,-0.0022,0.0158,-0.1656,0.0221,-0.0196,-0.0346,-0.0293,0.0192,0.0435,0.0357,0.0005,-0.0263,-0.0023,0.0707,-0.0099,-0.0053,0.06,-0.0022,-0.0029,-0.027,0.0215,-0.0557,0.0157,0.038,0.045,0.0406,0.0332,-0.0058,0.0158,-0.0197,-0.0019,0.0385,0.0073,-0.0048,-0.0031,-0.0906,-0.026,-0.0139,-0.035,-0.0552,-0.1525,-0.0235,-0.035,-0.0287,0.0734,-0.0142,-0.0192,-0.0784,-0.0989,-0.0399,-0.0099,-0.0304,0.0063,0.0011,0.0314,0.0171,0.0236,0.0232,-0.0147,-0.0103,-0.0379,0.0425,-0.0139,-0.0072,-0.0001,-0.0069,-0.0103,-0.0346,-0.041,-0.0388,-0.0148,-0.0274,0.0098,-0.006,0.0394,-0.013,0.0264,-0.0123,-0.0022,-0.0192,-0.001,0.0002,-0.0075,0.0293,0.0149,-0.0463,0.0249,0.0052,0.0177,-0.0096,0.0055,-0.0288,-0.0154,-0.0327,0.0294,-0.0075,-0.0673,-0.0866,0.0308,-0.0091,0.0195,0.0255,0.0313,0.0255,0.0034,0.0022,0.0503,-0.0164,-0.0066,0.0061,-0.0073,0.0053,0.0424,0.0063,0.0001,0.0063,0.0031,0.0024,0.0498,0.0102,0.0174,0.0383,0.0264,0.0096,0.0012,-0.0085,0.0064,0.0176,-0.0001,0.0054,0.0139,0.0014,0.0041,0.0255,0.0073,-0.0201,0.0129,0.0086,-0.0157,0.0284,-0.0213,-0.0009,-0.0287,-0.0335,-0.0273,0.0277,0.005,0.0267,0.0054,0.0063,-0.039,-0.0168,0.0099,0.0114,-0.0096,-0.013,-0.0166,-0.0018,0.0392,0.0146,-0.0061,-0.0151,-0.0147,0.0187,-0.0092,0.0098,-0.0406,-0.0357,0.027,0.0205,0.0202,-0.0279,-0.0243,-0.0259,-0.0027,0.0004,0.0119,-0.0221,-0.0059,0.0085,0.0099,0.0067,-0.0082,0.0012,0.0129,0.1408,0.1865,-0.0048,0.0116,-0.0018,0.0369,0.0095,-0.0119,0.0104,-0.0313,-0.0163,-0.0198,0.0008,0.0152,-0.0267,-0.0191,0.0023,-0.014,0.037,0.0304,0.0033,-0.0352,0.0052,0.0491,0.0335,-0.0185,-0.003,-0.0104,0.0315,-0.0093,0.0573,-0.0317,-0.0214,-0.0004,0.0002,-0.1132,-0.0771,-0.029,-0.0249,-0.0695,0.0122,-0.0666,0.021,0.024,0.0614,0.0631,0.0748,0.0274,0.0984,0.1003,-0.0347,0.0565,0.0932,0.1553,0.0743,-0.0242,0.1272,0.1035,0.0632,0.1437,0.0547,0.1553,0.0942,0.0556,0.08,-0.0086,0.0628,-0.0273,0.0715,0.0039,0.0866,0.0845,0.0918,-0.0156,-0.035,0.0119,-0.1197,-0.1357,0.0271,0.0094,0.012,-0.0026,-0.0175,0.0287,0.035,-0.0116,0.0379,-0.0194,-0.0037,0.0439,0.0134,-0.0434,-0.038,-0.0245,-0.0029,0.0246,0.0479,0.0446,-0.0014,0.0346,0.0361,0.0278,0.0093,-0.0181,0.0472,0.0502,-0.0072,0.024,0.0224,0.0004,-0.1109,-0.0261,-0.04,-0.0896,-0.118,-0.0456,-0.0065,-0.0095,0.0037,-0.0021,-0.0414,0.0293,0.0036,-0.0095,-0.0223,0.0532,0.0181,0.0254,-0.0073,-0.0039,0.0111,-0.0148,emotional self-evaluation
trm_4a3fd79d0b4a9,-0.1143,-0.1291,-0.1317,-0.1061,0.0114,-0.0262,-0.0929,-0.0146,-0.004,-0.1038,-0.0293,-0.0192,-0.1369,-0.1082,-0.151,-0.075,-0.1077,-0.1473,-0.063,-0.1009,-0.0974,0.0096,-0.0686,0.0223,-0.0533,-0.0146,-0.0171,-0.1554,-0.1831,-0.0905,-0.1338,-0.1197,-0.1454,-0.1053,-0.1757,-0.1444,-0.0585,-0.0524,-0.1406,-0.0313,-0.1369,-0.1424,-0.0656,0.053,-0.0974,-0.1373,0.1562,-0.0679,0.0657,-0.1051,-0.0446,0.0483,0.044,0.0629,-0.0564,-0.0832,-0.109,-0.0401,0.0188,-0.045,-0.0063,0.0579,-0.1971,0.1048,0.0419,0.1361,-0.2574,-0.3102,-0.1564,-0.0248,0.0945,0.0582,0.1512,-0.1201,-0.1131,0.0083,-0.1463,0.0465,0.0471,-0.0558,0.0028,0.1203,-0.0809,-0.1435,0.0832,0.1091,0.0298,0.0124,-0.0109,-0.1769,-0.1081,-0.0167,0.0051,0.2566,0.2104,0.2026,0.1728,0.033,0.3033,0.1759,0.0666,0.0297,0.1438,0.1354,0.1372,-0.1555,-0.255,0.1645,-0.0133,-0.0291,0.0255,-0.1254,0.1227,0.216,0.0425,-0.0083,-0.1247,0.1162,-0.0341,-0.0654,-0.1371,-0.1997,-0.1742,-0.0196,-0.1076,-0.2049,-0.1088,0.0813,0.1159,0.0695,-0.1155,-0.0798,-0.0236,-0.2995,-0.0135,-0.2605,-0.0053,-0.1631,-0.0606,-0.0208,-0.1227,-0.1271,0.0259,-0.0554,-0.0518,0.11,-0.0732,0.031,-0.0991,0.073,-0.069,-0.1321,-0.1728,-0.1844,0.161,0.0116,0.0976,0.0355,0.0341,-0.0478,-0.0716,-0.1139,-0.2684,-0.2583,-0.021,0.0162,-0.0226,-0.2693,-0.2605,-0.0305,-0.0454,-0.1725,0.0931,-0.2847,-0.1776,-0.2323,-0.1781,-0.1684,-0.118,-0.0484,-0.1976,0.1038,-0.0738,0.0471,-0.1013,-0.0666,-0.114,-0.1399,-0.0895,-0.1332,-0.121,-0.1065,-0.0505,-0.2377,-0.2176,-0.2336,-0.203,-0.076,-0.0571,-0.0579,0.0156,0.3176,-0.2249,-0.1982,0.0782,-0.0863,-0.226,-0.0145,-0.0415,0.0166,-0.209,-0.0935,-0.0122,0.0271,0.0566,0.021,0.1235,-0.1591,-0.0846,0.0189,0.1433,-0.1506,-0.1826,-0.0498,0.1127,0.0254,-0.0801,0.1419,-0.0433,0.2421,0.0059,-0.1872,0.2161,-0.142,-0.1279,0.0977,-0.0793,0.0335,0.0515,-0.1111,0.0485,-0.2276,-0.0611,0.0072,-0.0906,-0.1258,-0.0902,-0.1638,-0.0552,-0.1523,0.0149,0.0506,-0.0253,0.0782,0.0276,-0.2369,0.0259,-0.0604,0.1365,0.2646,0.0937,0.3417,-0.1453,0.134,0.2615,0.4214,0.1809,-0.0275,0.007,-0.0693,-0.0643,-0.0335,-0.2081,-0.0483,-0.039,0.0563,-0.055,-0.1371,-0.0807,0.0423,0.0651,-0.1235,-0.0951,-0.3257,-0.2599,-0.1157,0.0378,0.0615,-0.1299,-0.1619,-0.0924,-0.1158,-0.016,-0.0775,-0.1198,0.0348,-0.0124,0.1181,-0.0224,0.1882,0.0641,-0.2095,-0.1259,-0.1317,0.0208,0.0438,-0.1361,-0.0491,0.0213,-0.0234,0.0078,0.0043,-0.1095,0.1007,0.0811,-0.0278,0.1972,0.0235,0.0952,-0.1793,-0.005,0.027,-0.1501,-0.214,-0.0893,-0.0751,0.0027,-0.0567,-0.0726,-0.1071,0.0482,-0.1134,-0.0017,0.0084,0.0486,0.1643,0.059,-0.0082,-0.058,-0.1649,-0.1408,0.0103,0.0714,0.0111,0.0954,0.072,-0.2445,-0.1754,-0.1605,-0.0975,-0.1255,0.0979,-0.0121,0.0161,-0.0483,-0.0276,-0.0308,-0.1795,-0.1431,-0.1128,-0.0066,-0.0294,-0.0088,0.0171,0.0,0.1283,-0.1584,0.3108,0.0293,-0.1793,-0.0261,0.1091,-0.0051,0.1738,-0.1599,-0.0441,-0.1208,0.1096,0.1261,0.1774,0.1629,0.0934,-0.0554,0.1035,0.0407,0.0963,-0.1194,-0.0197,0.0575,-0.0288,0.0061,-0.0366,-0.0022,-0.0763,0.1264,0.0829,-0.0317,-0.1788,-0.0915,-0.0523,-0.0647,0.0213,0.0209,-0.0192,0.0841,0.1199,0.046,0.0108,-0.1391,-0.0289,-0.0135,-0.2073,-0.0733,0.2134,-0.1737,-0.0747,0.253,0.0319,-0.0904,-0.0257,0.0288,-0.2448,-0.1387,-0.3807,-0.3483,-0.1233,-0.2117,-0.0546,-0.1501,-0.0946,-0.054,0.0516,-0.0286,-0.0319,-0.01,0.0684,0.0404,0.0275,-0.3018,-0.1576,0.0375,0.1023,-0.0027,0.0618,-0.0673,-0.1037,0.0484,0.1839,-0.167,-0.036,0.0727,0.0973,-0.1395,-0.0813,0.0504,-0.2105,0.0228,-0.0784,-0.0233,-0.0038,0.0786,-0.0794,-0.0867,0.0185,-0.1699,-0.1295,0.0656,0.4088,-0.1009,-0.026,0.0602,0.0571,0.1268,-0.0579,-0.1215,-0.0624,0.0547,0.0497,-0.0105,-0.0289,0.1501,0.0576,0.0368,0.0932,0.1283,0.1714,-0.003,0.04,-0.0898,-0.0318,0.0908,0.1939,-0.1457,-0.19,0.1241,0.0068,-0.1838,-0.0129,0.0362,-0.1057,-0.0936,0.0178,-0.0528,-0.1404,-0.1121,-0.1605,-0.0129,-0.0617,-0.0481,0.1765,-0.2047,0.0886,-0.0929,0.0484,0.116,0.1024,-0.1446,-0.1295,0.1975,-0.0956,-0.0887,-0.0825,0.1011,0.1518,0.1927,0.0555,0.1944,0.1928,0.076,0.1022,-0.0903,-0.0432,-0.0878,-0.3077,-0.1342,0.0049,-0.2181,-0.1284,-0.0499,-0.1825,-0.0726,0.0014,0.0195,-0.0393,-0.0936,-0.0383,0.0149,0.0464,0.0162,-0.0471,0.1139,-0.0635,-0.0566,0.0392,-0.0196,-0.1941,0.1166,0.0641,0.077,-0.0529,-0.1148,0.0178,-0.1618,0.0604,-0.1184,0.0486,0.1125,-0.1037,-0.0267,-0.0746,-0.1218,-0.0378,-0.0916,0.011,0.1276,0.0834,0.064,0.0671,0.0802,0.074,-0.0011,-0.1327,-0.0403,-0.0261,0.154,0.0428,0.1335,0.0544,0.1256,-0.047,-0.1298,0.0462,0.1553,0.1343,0.0034,-0.0172,-0.2772,-0.0796,0.1807,-0.0575,0.0295,0.0682,0.0874,0.0599,0.0833,0.1272,-0.0469,-0.1889,-0.1793,0.1035,-0.2009,-0.0564,0.0609,-0.0573,-0.2918,-0.0832,-0.0868,0.0278,0.0106,-0.2968,-0.0823,-0.2477,0.0926,0.0011,-0.0499,0.0947,-0.0931,-0.1781,-0.046,0.0569,0.1089,0.1179,-0.1095,-0.0045,0.0824,0.0864,0.0923,-0.0219,-0.0832,-0.0272,-0.0726,0.1337,0.0334,0.0492,-0.1195,-0.0486,-0.312,-0.2019,0.1979,-0.3048,0.0589,-0.2118,0.2633,-0.1921,-0.054,-0.055,0.116,-0.042,-0.0376,-0.1164,-0.2228,0.1144,0.2047,0.0435,0.0927,0.1331,-0.0571,-0.1773,0.0364,-0.0004,-0.0423,-0.102,-0.0803,-0.0273,-0.0715,-0.0988,0.2547,-0.1344,0.0192,-0.0626,0.0542,0.0988,0.0908,0.0343,0.1754,-0.2103,-0.0979,0.03,0.0373,0.0371,0.0519,0.2417,0.2018,0.1282,0.1104,-0.0446,0.0733,-0.0666,-0.093,-0.0015,0.0594,0.0182,-0.0583,-0.1478,-0.0951,-0.0506,-0.1831,-0.1387,-0.129,0.0541,0.1123,0.0508,-0.004,0.0298,0.0031,-0.0517,-0.0163,0.0352,-0.1512,0.0327,0.1234,-0.1192,-0.3994,-0.3912,-0.2929,-0.0167,-0.0664,-0.1462,0.0018,-0.046,0.0616,-0.0502,-0.0433,0.144,0.1423,0.0019,-0.1141,0.1432,0.1555,0.2966,-0.2332,-0.0295,-0.0895,0.0106,-0.0118,-0.1881,0.1144,0.0794,-0.0454,0.038,0.0057,0.0578,-0.2076,-0.3169,-0.2806,-0.2009,0.0526,0.2124,-0.013,-0.1196,-0.0648,0.0786,0.1038,0.0919,0.0691,0.0303,-0.147,-0.1021,-0.0042,0.1552,0.1321,0.1751,-0.0459,-0.0204,0.0363,-0.0841,0.0972,-0.1177,-0.1775,-0.0388,-0.209,-0.184,-0.1032,0.0939,0.0972,0.0363,0.0026,-0.0468,0.0452,0.1479,-0.0149,-0.1288,0.044,-0.027,0.0266,0.0235,0.1227,-0.1223,0.1811,-0.2448,-0.2432,0.1459,0.1319,0.1919,-0.0433,-0.0293,0.0801,0.0233,0.0366,0.2873,0.027,0.1169,0.1192,0.1816,0.0564,0.0202,0.2376,0.2288,-0.0943,0.0219,0.0673,-0.2486,-0.2354,0.0052,-0.1276,-0.0451,-0.3107,-0.111,-0.2082,-0.1446,-0.2641,0.028,-0.0023,0.0523,-0.1097,-0.0354,0.0163,0.107,0.1478,0.0227,0.0743,0.1735,0.0274,0.0697,0.0595,0.0229,0.1437,0.1694,-0.1468,0.1839,0.0684,-0.0042,-0.0856,-0.1437,-0.0826,0.1175,0.0869,-0.3985,-0.2131,-0.0383,0.0857,0.1627,0.0405,0.0315,0.0592,0.0888,-0.01,-0.097,0.1877,-0.0685,0.0438,-0.231,0.2138,-0.0701,0.145,0.187,0.035,0.1893,-0.2769,-0.2638,-0.1111,0.2716,-0.091,-0.1132,-0.1188,0.1045,0.0056,-0.1654,-0.0533,-0.1953,0.0784,-0.0574,0.031,0.1041,-0.0038,0.1265,-0.2252,-0.1297,-0.0421,0.0516,-0.1484,0.0442,0.1119,0.085,0.1532,0.3222,0.1757,-0.1241,-0.104,-0.1081,-0.0972,-0.0862,-0.0572,0.0475,0.1756,0.0982,0.0081,-0.107,0.1472,0.2466,0.1288,0.0035,-0.0219,-0.0915,-0.1187,-0.0528,-0.0511,0.0327,0.0365,-0.1598,-0.0083,0.1027,0.0212,-0.0909,-0.0365,0.0589,-0.083,-0.0556,-0.0744,-0.1732,-0.1677,-0.3389,-0.2155,-0.3521,-0.0367,-0.0676,-0.1298,-0.1825,-0.1651,-0.2318,-0.1811,-0.291,-0.1555,-0.1604,0.0316,0.0624,0.1295,-0.0312,0.0757,0.0489,0.0403,0.113,0.1218,0.1342,0.0904,-0.0531,0.0196,0.0704,-0.0444,0.0878,0.0846,0.1199,-0.0184,0.0797,-0.0423,0.0942,-0.0769,-0.0433,-0.0256,0.1096,-0.0075,0.1,-0.2173,-0.1073,-0.0768,-0.1849,-0.1339,0.0832,0.1263,0.0836,0.1076,0.1518,0.0975,0.081,0.0632,0.0048,-0.017,0.0607,-0.0159,-0.0187,-0.0837,-0.1101,-0.0679,0.1078,0.076,-0.1235,-0.1055,-0.1079,-0.246,-0.1629,0.1897,0.1049,0.1695,0.0951,0.0551,-0.1331,-0.0512,0.0644,-0.0311,-0.0566,-0.0267,0.0052,-0.0734,-0.0204,0.0116,0.0623,-0.1193,-0.0323,-0.1248,0.0482,-0.1451,0.0515,0.1696,0.3374,0.1503,0.1024,0.0412,0.0745,0.0015,-0.0463,-0.0481,-0.1083,-0.0128,0.0133,0.0839,0.0114,-0.0289,0.0762,0.0279,-0.0642,0.0113,-0.1739,-0.185,-0.2252,-0.1422,0.2392,0.0458,0.1006,-0.1778,0.2621,0.1164,-0.0134,-0.0472,-0.0204,0.0186,-0.037,0.1279,-0.1162,-0.1285,-0.0179,-0.0149,-0.1773,-0.0933,-0.0888,-0.0552,-0.0894,-0.095,-0.0865,-0.1016,0.0139,0.0294,-0.0166,0.0449,0.0484,-0.1162,0.0788,-0.1104,0.0198,-0.0435,-0.1211,0.395,0.3006,0.3929,0.283,0.2995,0.1007,0.3506,0.1709,-0.2215,0.1645,0.1638,0.0882,0.0996,0.0854,-0.1047,-0.0143,-0.0861,-0.0469,0.0358,-0.0026,0.085,0.0148,-0.1651,0.0718,0.0659,0.0088,0.0906,-0.0253,-0.1272,0.0626,0.0003,-0.1194,-0.0036,-0.1204,0.121,0.0522,0.2267,-0.0224,-0.2376,-0.187,-0.1105,-0.0364,0.1397,0.1078,0.0314,-0.1044,-0.2667,-0.1853,-0.099,0.1732,-0.1306,0.2853,0.2828,-0.0989,0.0131,0.0047,0.2069,0.2482,0.1727,0.2114,0.1254,0.0227,0.1052,0.1097,-0.0815,-0.2222,0.0364,-0.1154,0.1427,-0.0161,-0.0856,-0.0197,-0.1534,-0.0691,0.0115,-0.0886,-0.1023,0.0757,0.1266,-0.0818,-0.0054,-0.0398,0.1574,0.0568,0.0727,-0.2342,-0.2337,-0.1207,-0.103,-0.0406,-0.145,-0.1077,-0.035,-0.0377,0.2008,0.1127,0.1293,0.341,-0.0134,0.0057,-0.0564,0.1435,0.0418,0.2678,-0.1276,0.2607,0.4148,0.0913,-0.1695,0.3456,0.2802,-0.0578,-0.2005,0.0198,-0.2062,-0.0845,-0.3237,-0.0644,0.2045,-0.0835,-0.0822,0.0786,-0.0638,-0.0201,-0.0913,-0.0775,-0.0425,-0.0943,0.0179,0.102,-0.0266,0.2659,0.1596,0.2264,0.2277,-0.1618,0.0192,-0.0765,-0.103,-0.0727,-0.0676,0.0426,0.1906,-0.1964,-0.1039,0.115,0.0714,-0.0063,0.1168,0.0289,0.0494,-0.0076,0.1693,-0.0855,-0.0983,-0.0445,0.1199,0.0668,-0.0368,-0.0039,-0.0039,-0.2385,0.1019,0.0353,0.0691,-0.013,0.0727,-0.0558,0.2966,-0.3487,-0.3309,0.0837,-0.0545,-0.2682,-0.2765,-0.2191,-0.0545,-0.0562,-0.0734,-0.0,0.0118,0.2382,-0.0507,0.0396,-0.0664,0.0876,-0.0213,0.0515,0.0423,-0.05,-0.0952,0.0101,-0.1054,-0.0828,-0.0921,-0.0131,0.074,-0.0149,0.2116,0.1017,0.2243,0.0397,0.2286,-0.1718,-0.1051,0.0221,-0.1722,-0.0017,-0.2133,-0.2739,0.0374,-0.099,-0.2597,0.043,-0.0423,-0.2346,-0.0024,-0.0422,0.0326,-0.207,-0.0675,-0.1058,-0.1393,-0.0591,0.0781,-0.065,0.262,0.1401,0.1502,0.1506,0.0031,0.0801,-0.0637,-0.1488,-0.1476,0.0083,-0.136,-0.0152,-0.1356,-0.0455,0.0482,0.0488,-0.0338,-0.2038,-0.1415,0.0127,0.0239,0.0168,0.0022,-0.0584,0.051,-0.0873,-0.1549,-0.1461,-0.2467,-0.1294,-0.0601,-0.1728,-0.1843,-0.0029,-0.0008,-0.0007,0.0495,0.0147,-0.1462,-0.1385,0.076,-0.2083,0.0361,0.017,0.0171,-0.0641,-0.1949,0.0004,0.1799,-0.0388,-0.0086,0.0145,-0.0548,0.1783,0.0474,-0.0104,-0.0255,-0.2572,0.0869,-0.0034,0.0474,0.2129,0.048,0.0251,-0.09,0.0092,0.1865,-0.0874,0.0173,-0.1304,-0.0529,-0.1711,-0.1549,-0.0529,0.1401,-0.0015,-0.0958,-0.1857,0.0091,-0.0519,0.0147,-0.0587,-0.1619,-0.0148,0.0236,-0.0858,0.0884,-0.0597,-0.0422,-0.0614,-0.0895,-0.0697,-0.0639,-0.0833,-0.0601,0.006,-0.0066,0.1547,-0.066,-0.0175,-0.0214,0.0942,0.0432,-0.0763,-0.2336,0.0974,-0.0474,0.0994,0.0116,0.0504,0.0509,0.0862,0.0791,-0.0976,-0.0767,-0.108,-0.0347,-0.2889,0.0255,-0.1286,0.0113,-0.0594,-0.0542,-0.0569,-0.1519,-0.1455,0.1582,0.0685,-0.0038,0.248,0.1573,0.0475,0.0886,0.102,0.0004,-0.055,0.022,0.2512,0.0184,0.0413,0.0284,-0.0431,-0.0394,-0.1171,0.0374,0.0289,0.0183,0.1093,0.1249,-0.0948,-0.0857,-0.0436,0.0974,0.1432,0.0761,-0.2116,-0.0802,-0.0108,-0.177,-0.1164,0.0407,0.1432,0.0442,0.0353,0.0528,0.0124,-0.2279,-0.0592,0.0104,-0.0707,-0.2101,-0.1265,-0.0405,-0.1563,-0.0668,0.1526,-0.0557,-0.0429,-0.0292,0.0502,0.1488,0.3067,-0.0228,0.0669,0.0187,-0.0073,-0.1077,-0.0888,0.0728,0.031,0.0023,0.1855,0.1311,0.0765,-0.0819,-0.1101,0.0493,0.5193,0.5179,-0.2275,-0.1896,0.11,-0.0908,-0.0782,-0.0455,-0.2033,0.0674,-0.068,-0.0899,-0.0223,0.0228,0.2827,-0.0495,0.2174,0.062,0.0242,0.1194,0.4638,0.034,-0.0898,0.3054,0.0371,0.0961,0.0634,0.0303,-0.0883,0.137,0.0622,-0.0258,-0.0057,-0.0028,-0.013,0.0634,0.0571,-0.1054,-0.0796,-0.0724,0.1393,-0.1483,0.0359,0.1246,-0.1171,-0.0917,-0.0142,0.0177,-0.1415,-0.0289,0.0653,-0.0873,-0.0025,-0.1491,0.0398,0.0967,-0.0537,-0.0705,0.0401,-0.0041,0.0092,0.1466,0.1584,0.1431,-0.0047,0.1727,0.0764,0.0503,0.3839,-0.1638,-0.1865,0.1089,-0.2251,0.0933,0.0695,0.1451,-0.0782,0.0554,0.0136,-0.019,0.0458,0.0761,-0.0342,0.0587,0.0472,0.064,0.0428,0.1465,0.2811,0.2745,-0.0573,-0.1214,-0.1298,-0.0044,0.0458,0.0157,-0.0639,0.0127,0.0424,0.0185,0.1092,-0.0006,-0.3148,-0.1296,-0.0329,0.1339,0.0245,0.0951,0.0564,0.2179,0.1751,-0.0114,-0.0301,-0.1057,0.0102,0.0251,0.1095,-0.1414,-0.1684,-0.1784,0.0282,-0.0425,0.0014,0.3202,-0.1566,-0.1212,0.0073,0.2191,0.1106,0.1761,-0.0385,0.0043,0.0299,0.0257,0.1584,0.2437,0.2453,-0.021,0.0605,0.0499,0.092,-0.1413,0.1242,-0.2661,-0.0664,-0.0856,-0.162,-0.0157,0.0701,-0.0296,0.0734,-0.0668,0.0882,0.0818,0.1002,-0.0769,-0.0116,-0.0405,-0.0249,-0.0115,0.1186,0.258,0.1858,0.285,-0.2687,-0.1638,-0.2177,-0.0569,0.0877,-0.0519,-0.1462,-0.1119,-0.1673,-0.0921,0.1715,0.0373,0.2136,0.1262,0.031,0.0896,-0.0115,-0.0008,0.0078,0.0159,-0.2295,-0.0361,-0.1583,-0.067,-0.1099,-0.0114,0.1071,0.2968,0.1584,0.0845,0.0859,-0.1012,-0.3852,-0.216,-0.2746,-0.2046,0.0215,-0.0461,0.0552,-0.1771,-0.2263,-0.1677,-0.0916,-0.0359,-0.0079,-0.0085,-0.0496,0.0049,-0.0256,-0.2098,-0.1354,-0.1062,0.1244,0.0172,-0.0113,-0.3753,-0.0617,-0.1589,-0.1745,-0.4631,0.0485,-0.0943,-0.0448,-0.078,-0.0403,-0.047,-0.0078,-0.1393,-0.0794,-0.2459,0.1237,0.0367,0.2188,0.0241,0.1077,-0.1404,0.0744,0.1138,0.316,-0.0885,-0.052,-0.062,0.1858,-0.2799,-0.3162,-0.2505,-0.0689,-0.0776,-0.1753,-0.1617,-0.1097,-0.1049,-0.0305,0.017,0.0277,-0.2892,0.0072,-0.0117,-0.1012,-0.0853,-0.0897,-0.0779,-0.1812,0.0966,-0.0242,0.1489,-0.0391,-0.165,-0.3051,-0.1494,-0.2016,-0.0737,-0.3254,-0.2444,0.0371,0.1146,0.0745,-0.0127,-0.0756,-0.0092,0.1946,0.2469,0.2156,-0.3681,-0.3978,0.0067,0.1156,-0.0181,-0.0489,0.0841,-0.1202,-0.0026,-0.0318,-0.0897,-0.131,0.0211,-0.0968,-0.0869,0.0301,-0.1176,0.0609,-0.0172,0.108,0.1648,0.1427,-0.0784,-0.1834,-0.2785,-0.1976,-0.1393,-0.3273,-0.1822,0.2635,-0.0548,-0.1039,0.1927,0.1024,0.0636,0.1657,0.0537,0.0892,0.2243,0.0601,0.122,0.0782,0.0317,0.1171,0.1277,0.2504,0.266,-0.3003,0.0092,0.056,0.2965,-0.0899,-0.1088,0.0708,-0.0701,0.0213,0.0893,0.1286,-0.0266,-0.0134,-0.0907,-0.0928,-0.1097,0.0887,-0.0822,0.0267,0.1303,0.1889,-0.0279,-0.0148,0.0772,0.175,0.095,0.0554,0.0531,0.0113,0.051,-0.3961,-0.1718,-0.2006,-0.2127,-0.132,-0.1885,-0.212,-0.135,-0.0111,-0.1155,-0.1719,-0.0921,0.0433,-0.1492,-0.4132,0.1328,-0.0946,0.0033,0.0444,-0.1445,0.0478,-0.1647,-0.1253,-0.0455,-0.104,-0.0769,0.0448,-0.1284,0.0725,0.1504,0.1385,0.0317,-0.1529,0.0275,-0.0446,-0.2077,-0.0534,-0.1418,-0.1004,0.1204,0.0243,-0.0248,-0.1032,-0.1454,-0.0327,0.0451,-0.0599,-0.0902,-0.141,-0.0907,-0.0174,-0.0579,0.1023,-0.1677,-0.0818,0.067,-0.0142,-0.0511,0.0344,0.0237,-0.1645,-0.0197,-0.0669,-0.1404,0.237,0.3486,0.31,-0.0682,0.4115,0.2021,-0.1869,-0.1086,0.3502,0.2268,0.0549,0.1216,0.0976,0.1125,-0.1096,-0.1019,-0.0892,-0.0931,0.438,0.3849,0.2423,0.0615,0.1674,0.1809,0.4024,0.39,0.3326,-0.0167,-0.0168,-0.0218,-0.008,-0.0254,0.0435,-0.2285,-0.1021,-0.0153,-0.064,-0.1404,-0.1296,0.1292,0.0038,0.0419,-0.0466,0.0694,0.2013,0.2835,0.0239,-0.0493,-0.0252,-0.0092,-0.0456,-0.027,-0.0112,-0.1095,-0.0389,-0.0058,-0.1987,-0.2803,-0.2483,0.1065,-0.0406,0.0131,0.211,0.0503,0.2524,0.1194,0.1155,0.2487,-0.0546,-0.181,-0.2264,0.042,0.0983,-0.0804,0.1516,0.0845,0.1785,0.1064,-0.1646,-0.1588,-0.0994,-0.0857,0.1815,-0.2202,-0.1046,0.0326,-0.0523,0.1137,-0.0039,-0.0199,0.1555,0.0501,-0.1197,-0.0048,-0.1553,-0.1922,-0.2161,0.0344,0.0086,-0.0356,0.0764,-0.0156,0.1069,0.4093,0.3727,0.1456,0.2813,-0.1397,0.0721,0.1099,0.2333,0.2791,0.3455,0.0535,0.0769,-0.0097,0.1985,0.1641,0.0389,0.0288,-0.0706,-0.0493,-0.1026,0.0112,-0.0435,0.036,0.0461,0.0254,0.062,-0.0034,0.1783,-0.0535,0.08,0.0829,-0.217,-0.1888,-0.145,-0.1418,-0.2076,0.1318,-0.066,-0.1011,-0.0363,0.233,0.0488,-0.3394,-0.0165,0.0013,-0.2076,0.0127,-0.0012,0.0407,0.155,0.1527,0.3972,0.3043,0.2561,0.0252,0.0028,0.1858,-0.1258,-0.148,0.0151,0.0011,-0.0149,0.0382,-0.0711,-0.0929,-0.1926,-0.2827,-0.2938,-0.2511,-0.1226,-0.0963,-0.1781,-0.0285,-0.0782,0.0489,0.008,-0.0609,-0.0415,-0.0646,0.183,-0.0379,-0.0026,-0.1074,0.0381,-0.0737,-0.0379,0.0471,-0.185,-0.0961,0.2683,-0.0786,-0.0843,-0.0248,0.0214,0.0217,0.0282,-0.0347,-0.0387,-0.054,-0.0088,0.019,-0.1911,0.0685,-0.0094,0.1466,0.0314,-0.2913,-0.119,-0.0018,-0.1011,-0.0453,-0.035,-0.1528,-0.0437,0.0793,0.0095,0.1182,-0.4083,-0.1794,-0.1587,-0.3128,-0.2265,-0.1587,-0.1615,-0.1615,-0.0918,-0.0621,0.1198,-0.2409,-0.0584,-0.0665,-0.0877,-0.0991,-0.0779,-0.4612,0.1267,-0.1475,0.048,-0.0614,0.3424,-0.0021,-0.0633,-0.1827,-0.0947,0.0166,0.0507,-0.0488,0.267,0.0819,0.1639,0.3095,0.2476,-0.0056,0.0429,0.0852,0.0198,-0.0008,-0.1792,-0.196,-0.0552,-0.1305,-0.0237,0.0005,0.0129,0.08,-0.033,-0.0679,0.1002,0.0735,-0.0829,0.1217,-0.0305,-0.1346,-0.0294,-0.1931,-0.0202,-0.0212,0.1633,-0.1285,0.2823,0.2598,0.0575,0.2666,0.2414,-0.0469,0.1601,-0.0116,0.2738,0.1101,0.0008,0.1777,-0.116,0.0853,0.0918,0.0713,-0.0297,-0.0599,0.0471,-0.0317,0.0074,0.0167,-0.1386,0.0452,-0.0183,0.0723,-0.012,-0.0383,0.256,0.0459,0.048,0.023,0.0104,-0.0014,0.0318,-0.0995,-0.1314,-0.0412,0.1284,0.1565,0.0065,0.0335,-0.101,0.0499,0.097,0.0704,0.1154,0.0493,0.0147,-0.0385,0.1028,-0.0919,-0.0169,0.0391,-0.0251,-0.0788,-0.1089,-0.113,-0.0948,0.0105,0.0409,-0.1053,0.0802,0.0322,0.0669,0.05,0.0833,0.1463,0.0508,-0.0472,-0.0745,-0.1173,-0.085,0.0743,0.0501,-0.0502,-0.0542,-0.0318,0.05,-0.0901,-0.1892,-0.1362,-0.1921,-0.182,-0.0098,-0.0116,0.0518,-0.1727,-0.1502,-0.1728,-0.0317,-0.0911,0.0127,0.0377,-0.0246,0.1583,-0.156,-0.1484,-0.0374,0.0089,-0.0849,-0.0882,0.1183,0.0893,-0.1758,0.0592,-0.0047,-0.0656,0.0805,0.0727,0.0286,0.0817,-0.0479,-0.2202,-0.0367,-0.2209,-0.2467,-0.0152,-0.1186,0.0883,0.1223,0.1955,0.1804,0.1913,-0.1637,-0.2189,-0.0201,0.1485,0.2082,0.0275,-0.0327,-0.031,0.0171,-0.1291,0.0168,-0.15,-0.1498,-0.0285,0.0098,-0.1165,-0.1618,0.0775,-0.0279,0.012,0.1096,-0.0274,0.0271,-0.1744,-0.0232,-0.0363,0.0063,-0.0586,0.033,0.153,0.1038,-0.0372,-0.0852,-0.0593,-0.1132,-0.0333,-0.0575,-0.3429,-0.0496,-0.0447,-0.006,-0.0384,0.0117,0.019,0.0413,-0.0968,0.0842,-0.2261,-0.1216,-0.2012,-0.1858,0.0058,-0.2263,-0.1564,-0.3444,-0.1379,-0.0278,0.2089,-0.185,-0.037,-0.0616,0.0829,0.0939,0.0754,-0.1513,-0.2275,-0.0993,-0.0862,0.011,0.117,-0.0553,-0.0591,-0.0818,0.1052,0.0929,0.0576,0.1556,-0.0192,-0.0304,0.082,-0.036,0.0081,-0.0291,-0.0795,-0.0954,0.0503,0.0365,0.1193,0.0062,0.1055,0.1251,0.0854,0.0161,-0.0641,-0.225,-0.1273,-0.026,0.2143,0.2533,0.1043,-0.0282,-0.0058,0.0332,0.3476,0.194,0.1857,0.2061,-0.2658,-0.0193,-0.0541,0.0405,-0.1153,0.0719,0.0845,0.0293,0.0441,0.0993,0.0854,-0.0751,0.1024,0.0954,-0.1621,0.2366,0.0949,0.0143,0.0107,0.0797,0.0568,0.0095,-0.0339,0.0771,0.0665,0.1978,0.2325,0.2805,-0.0739,0.0537,0.0015,-0.0432,-0.2072,-0.4544,-0.4391,0.0342,0.1141,0.1349,-0.0563,0.0466,-0.0375,-0.1305,-0.1444,-0.1841,0.065,-0.079,-0.0065,-0.0059,0.0857,-0.0306,-0.1649,-0.0335,-0.1538,-0.1072,0.0403,-0.1771,0.0068,-0.2593,-0.0937,-0.0558,-0.0386,0.0076,0.0956,0.0056,-0.022,-0.1286,0.2886,-0.1604,0.1686,0.1969,0.1705,0.0062,0.0464,-0.0062,0.2899,0.2698,-0.1809,-0.1304,-0.0597,-0.0161,-0.1638,-0.1383,-0.1702,-0.3002,-0.1353,0.0189,-0.1324,0.0716,-0.0617,-0.0275,-0.1219,-0.2275,0.0441,0.0085,-0.2211,-0.1223,0.0314,-0.1242,-0.271,0.0768,0.207,-0.117,0.0798,0.1358,0.1153,-0.057,-0.0863,-0.2103,-0.2761,-0.1343,-0.0889,0.0424,0.1123,0.0385,0.0947,-0.0151,0.2411,0.3121,0.266,0.1224,0.2283,-0.3686,-0.3345,-0.171,-0.0936,-0.0602,-0.0889,-0.1923,-0.0437,0.046,-0.108,-0.1192,-0.0566,0.1562,-0.1465,0.0517,0.0396,0.0901,0.1298,0.1411,0.0154,-0.1511,-0.0772,-0.1416,0.0664,0.1625,0.2033,0.0546,0.0258,0.1493,0.2013,0.2017,0.1516,-0.0071,-0.1374,0.0256,-0.0116,0.0207,0.0246,0.0423,0.1685,0.0689,0.0706,0.0522,-0.0638,-0.0351,-0.2526,-0.1791,-0.1379,-0.1163,0.4046,0.0093,0.2196,0.1784,0.1262,-0.0549,-0.0541,0.208,0.0201,0.2947,0.283,0.0937,0.1786,0.1011,0.0503,-0.1028,-0.0666,-0.0057,0.0736,0.176,0.1265,-0.0624,0.0047,0.0317,0.0249,0.023,0.0192,-0.0963,-0.1145,0.0041,-0.0874,0.0363,-0.0879,0.0882,0.0741,0.1787,0.0855,-0.0326,-0.0476,0.0222,-0.0313,0.1745,0.2348,0.0124,0.0873,-0.0116,0.0933,-0.0659,-0.0964,0.0153,0.0989,0.1526,0.0129,-0.1129,-0.0914,-0.1475,-0.1039,0.0762,0.2116,-0.0902,-0.0225,-0.1237,-0.1792,-0.3264,-0.2191,-0.1975,-0.1948,-0.1425,-0.1173,-0.109,0.1294,-0.0616,-0.0773,-0.0651,-0.0758,-0.0047,-0.1426,-0.1029,0.0577,0.1527,0.071,-0.0787,0.3714,0.3628,0.197,-0.0104,0.0848,-0.042,-0.1451,0.0047,-0.0579,-0.0042,0.2014,0.196,-0.0211,0.0095,0.0518,0.136,-0.1613,-0.1459,-0.1061,-0.0802,-0.1458,-0.1006,-0.0579,-0.1245,0.0797,-0.1574,-0.1074,0.2373,-0.0464,-0.287,-0.0047,0.1726,0.1904,-0.083,-0.1272,-0.4981,-0.3923,-0.1873,-0.3516,0.1392,-0.1307,-0.1164,0.0567,-0.0687,0.0367,-0.0266,0.0387,0.1958,0.1594,0.3441,0.2179,0.2625,0.0025,0.0304,0.1899,0.0082,0.0799,0.0563,0.0289,0.2562,0.1902,-0.1788,-0.2828,-0.1696,-0.0323,-0.1187,-0.0793,-0.0258,0.0383,0.0299,-0.0036,0.1348,0.0786,-0.2551,-0.0501,-0.2014,-0.0586,-0.2106,-0.2711,0.0148,-0.0543,-0.0131,-0.1057,-0.0222,-0.0818,-0.0988,-0.2218,-0.0491,-0.1915,-0.0587,-0.085,-0.0856,-0.0629,-0.1154,0.0378,0.0867,0.0706,-0.0982,-0.1024,-0.1629,-0.001,0.1212,0.108,-0.085,0.302,-0.0602,-0.1046,0.052,0.1105,-0.0331,-0.0277,-0.0565,0.0624,-0.0367,-0.0713,0.1756,0.3439,0.4572,-0.0574,-0.0406,0.0205,0.083,-0.004,0.2599,-0.0492,0.3987,-0.1379,0.2024,0.1834,0.1041,-0.0084,-0.0194,0.0256,0.0399,0.0066,0.0238,0.1219,0.0333,-0.0418,-0.1234,0.1316,0.2363,0.2033,-0.2412,-0.2098,-0.2155,0.014,-0.1947,-0.1357,-0.0248,0.06,0.0373,-0.0518,-0.167,-0.1984,0.1251,-0.0178,-0.1397,0.1536,0.361,0.0769,-0.0946,0.2377,0.4693,0.2024,0.109,0.2166,-0.0743,0.0376,0.2617,0.2387,-0.1368,0.2874,0.1265,0.1019,0.0879,0.4306,0.0964,-0.155,-0.1406,-0.0752,-0.1821,-0.009,-0.1522,-0.0067,-0.1323,-0.1563,-0.057,-0.2499,-0.1243,0.0925,-0.1501,-0.2634,-0.1102,-0.0843,-0.0618,-0.1091,-0.1619,-0.1772,-0.1622,-0.0922,-0.0849,-0.2634,-0.1897,0.1505,0.2619,-0.0393,-0.0367,0.0317,0.0356,-0.0742,-0.1169,-0.106,-0.1304,0.0085,0.0734,-0.2571,-0.3282,-0.0924,-0.0256,-0.1745,-0.2461,0.0131,-0.1017,-0.1145,-0.2019,-0.1192,-0.0808,-0.1008,0.0067,-0.0001,-0.036,0.1879,-0.1146,0.0866,0.2441,0.1141,-0.1949,0.0752,-0.247,-0.1938,-0.1171,-0.0291,-0.0327,0.0411,0.1324,0.1289,-0.0349,-0.1338,0.0995,-0.1218,0.0138,0.1981,-0.1914,-0.1154,-0.2047,0.0513,0.0519,0.1558,0.0317,-0.3142,-0.2699,0.0725,0.0951,0.0084,0.1714,0.1412,-0.0238,-0.1305,-0.1716,-0.0731,-0.1774,-0.3161,-0.1316,-0.1134,0.1734,0.0289,0.2332,-0.0122,0.2055,-0.0066,0.0524,0.0264,0.0984,0.1347,0.0446,-0.0109,-0.0045,-0.0876,0.0895,-0.0154,0.0057,-0.0616,-0.0615,-0.0365,0.0094,-0.0681,-0.0417,-0.0916,-0.0791,-0.2193,-0.0024,0.0213,0.0586,-0.029,0.0846,0.0098,0.0329,-0.0576,-0.0437,0.0165,-0.0619,-0.1848,-0.1025,0.2719,0.1822,0.0471,-0.0597,-0.0435,-0.1449,-0.0945,-0.0164,-0.0811,0.1168,0.1265,-0.2442,-0.2053,0.0478,-0.1731,-0.0553,-0.039,0.3635,0.2739,-0.3008,0.0757,-0.1028,-0.0366,-0.0715,-0.205,-0.2296,-0.1889,0.0679,-0.0073,-0.1061,-0.0054,-0.1315,-0.0212,0.1907,0.0219,0.038,0.0178,-0.0263,0.059,-0.2071,-0.0508,0.0649,-0.1659,0.0843,-0.2694,0.2385,-0.1906,0.26,0.1337,0.1252,-0.3016,-0.266,0.0263,0.1923,0.0067,0.1852,-0.0196,0.055,0.1135,0.0231,0.0571,0.0749,0.0724,0.0575,0.0603,0.0358,0.1032,-0.1049,0.1559,0.3091,0.5472,0.2409,0.2113,0.3812,0.179,0.2109,0.3005,0.2448,0.2612,0.1476,0.2604,0.2806,0.207,0.2111,0.2307,0.3892,0.251,0.3391,0.2579,0.277,-0.2111,-0.0892,-0.251,-0.1376,-0.0859,-0.3175,-0.2617,-0.1559,0.0936,-0.0033,-0.3702,-0.3101,-0.1865,-0.0563,-0.0092,-0.2007,0.1013,-0.0582,-0.1027,0.0083,-0.1293,-0.0747,-0.0297,-0.0825,-0.1843,0.1268,-0.2718,-0.2896,0.0971,-0.0118,-0.0273,-0.0077,0.0011,-0.1814,0.2151,0.2012,-0.1716,0.1399,0.2116,0.0145,0.0584,0.0457,-0.1066,0.3852,0.3894,-0.0857,-0.0973,0.0708,-0.0852,-0.011,-0.1569,-0.0495,0.1334,-0.0826,-0.1155,0.0458,0.0073,-0.0464,-0.033,visual object recognition
trm_568427366401c,-0.0943,-0.0774,-0.1087,-0.1551,-0.0691,-0.0684,-0.0786,-0.1006,-0.0431,-0.0556,0.0234,-0.0142,-0.091,-0.0351,-0.1007,-0.0548,-0.0899,-0.1157,-0.087,0.0323,-0.042,0.0104,-0.0366,0.0522,-0.0181,0.0021,-0.0003,-0.067,-0.1017,-0.0558,-0.0778,-0.0972,-0.0813,-0.0756,-0.0747,-0.1023,-0.0688,-0.0769,-0.11,-0.0671,-0.0804,-0.04,-0.0369,0.08,-0.0699,-0.007,0.1212,-0.0595,0.0147,-0.0868,-0.0204,0.0499,0.055,0.0074,-0.0255,-0.0496,-0.0808,0.008,0.0365,-0.0277,-0.0044,-0.0323,-0.1029,0.0564,0.0102,0.0193,-0.165,-0.1857,-0.1041,0.0035,0.0561,-0.0205,0.204,-0.0349,-0.1176,0.1501,-0.1161,0.0034,0.0286,-0.0185,0.047,0.0528,-0.0039,-0.0838,0.0143,0.0122,-0.0072,-0.0473,0.0285,-0.1651,-0.0888,-0.0778,-0.0128,0.0769,0.1327,0.0983,0.1071,0.0145,0.0933,-0.0167,0.0502,-0.0004,0.0415,-0.0636,0.0747,-0.127,-0.0607,0.2189,-0.0179,-0.0556,-0.0347,-0.0877,0.0783,0.1276,0.0162,0.0827,-0.0742,-0.0386,-0.0011,-0.0822,-0.0591,-0.0921,-0.0667,0.0053,-0.0529,-0.0396,-0.0251,-0.0176,0.0296,0.0145,0.0401,-0.0885,-0.0019,-0.122,-0.0055,-0.1201,-0.0279,-0.0715,-0.0048,-0.0693,-0.0817,-0.1036,0.0797,-0.0139,0.0098,-0.0009,-0.103,0.0209,-0.0818,0.105,-0.0516,-0.0767,-0.1449,-0.0791,0.1471,-0.0422,0.024,0.0118,-0.035,-0.0886,-0.0503,-0.0796,-0.1491,-0.1531,-0.0163,0.0242,-0.0289,-0.0599,-0.0511,0.069,-0.0859,-0.0977,-0.0309,-0.0339,-0.0253,-0.0674,-0.0419,-0.0363,-0.0055,-0.0547,-0.0425,0.0409,-0.0896,-0.0155,-0.0672,-0.0532,-0.1006,0.0067,0.0287,0.004,0.0289,-0.0034,0.0147,-0.128,-0.1082,-0.1552,-0.1622,0.0545,0.086,-0.1028,-0.1036,0.0388,-0.0287,-0.0933,-0.0455,-0.0458,0.0435,-0.1075,-0.0804,-0.0211,-0.0903,-0.0371,0.0151,-0.0355,0.0922,0.0548,0.0745,-0.1222,-0.2051,0.0331,0.0633,-0.0608,-0.1035,-0.0641,0.0192,0.0145,-0.0331,0.1164,0.0223,0.1144,-0.1469,-0.0686,0.0791,-0.1489,-0.1506,0.0117,0.0527,0.0768,0.0102,0.0204,-0.0408,-0.1038,-0.0744,0.0011,-0.0538,-0.0261,-0.0201,-0.101,-0.0611,-0.0205,0.0649,0.0549,0.0031,0.0566,-0.0017,-0.0759,0.0225,-0.0807,0.1874,0.1912,0.0257,0.1392,-0.0798,0.0757,0.0526,0.1895,0.067,0.0171,0.037,0.0521,-0.0406,-0.035,0.0147,0.0637,-0.0413,0.044,-0.1206,-0.1426,-0.1313,-0.0403,0.0373,0.0374,0.0397,-0.0305,0.0132,-0.0822,0.0901,0.1125,-0.1072,-0.0794,-0.1002,-0.0409,-0.0749,-0.0444,-0.0532,-0.0671,0.0251,0.0645,-0.051,0.0971,0.0846,-0.1028,-0.1043,-0.1047,-0.1175,-0.1159,-0.1236,-0.0155,-0.0376,0.0206,-0.0099,-0.0145,-0.1113,0.0846,0.0578,-0.0493,0.1081,0.0264,0.0447,-0.0738,0.0137,0.0028,-0.067,-0.0603,-0.0883,-0.0563,0.017,-0.0084,-0.1011,-0.1358,0.0348,-0.0672,-0.0221,0.0075,-0.003,0.0621,0.0671,0.0288,0.0769,-0.0886,-0.0829,-0.0295,-0.0227,-0.0237,0.0716,0.0183,-0.2249,-0.1666,-0.1489,-0.1148,-0.0598,0.0723,-0.1471,-0.057,-0.0595,-0.1251,-0.096,-0.0475,-0.1119,-0.0903,0.0251,0.0178,-0.0142,-0.0848,-0.0433,-0.0097,-0.1348,0.1106,0.0402,-0.1288,0.0376,0.0501,-0.0207,0.0487,-0.0886,-0.0272,-0.074,0.1019,0.2275,0.0918,0.2582,-0.0446,-0.0958,-0.0486,-0.0117,0.0405,-0.0779,-0.0073,0.0106,-0.0655,-0.0788,-0.025,-0.1517,-0.0268,0.0549,-0.0245,-0.1161,-0.1458,-0.1154,-0.1022,-0.0364,0.0358,0.0147,-0.0493,-0.0023,0.0039,0.1469,0.0213,-0.0947,-0.0071,-0.0096,-0.1066,-0.0243,0.2901,-0.046,0.0399,0.2603,-0.0369,-0.0829,-0.0306,0.0171,-0.2085,-0.137,-0.2392,-0.1967,-0.1135,-0.1286,-0.0877,-0.1031,-0.1439,-0.0139,0.0659,0.0287,-0.0059,0.0303,0.0589,0.0265,0.0325,-0.2204,-0.1126,0.0825,0.0153,-0.0552,0.0689,-0.0289,-0.0982,0.0259,0.0615,0.0001,-0.0101,-0.0059,0.0486,-0.0839,-0.0368,0.0073,-0.0531,0.0486,-0.0399,-0.0023,0.0441,0.0293,-0.0215,-0.0667,0.054,-0.0313,-0.092,0.0306,0.2782,-0.1098,-0.0599,-0.0336,-0.0085,0.0538,0.0317,0.044,-0.0303,-0.0249,0.0395,-0.0385,-0.048,-0.0185,-0.0559,-0.0562,0.0361,0.0127,0.0565,-0.0222,-0.0759,-0.068,-0.0372,0.1026,0.0129,-0.0997,-0.1353,0.0448,0.0648,0.0036,-0.1079,0.0376,-0.0858,-0.0719,0.0427,-0.0949,-0.1267,-0.069,-0.0657,0.1228,0.1559,-0.0276,0.0002,-0.1256,-0.0488,0.0659,-0.0459,0.0529,0.0605,-0.0507,-0.0542,0.03,-0.0657,-0.0494,-0.0603,0.0607,0.0119,0.1309,0.0238,0.1006,0.1022,0.0448,0.0473,-0.0715,-0.0016,-0.1193,-0.1224,0.0079,0.0834,-0.058,-0.0751,0.0024,-0.0777,0.0123,0.0678,0.0313,-0.0504,-0.0707,-0.0201,-0.0001,0.0651,0.0188,-0.0615,0.0634,0.0022,0.0194,-0.0526,-0.0218,-0.0666,0.0891,0.0193,0.0507,-0.0449,0.0276,0.0038,0.0338,0.024,-0.0111,0.0576,0.054,0.0547,0.0063,0.0209,-0.0204,0.066,-0.1879,-0.0208,-0.1737,-0.1274,0.0313,0.0305,0.1148,0.1273,0.0744,-0.0455,0.037,-0.0753,0.062,0.0445,-0.0904,0.0295,-0.0106,-0.0576,-0.0713,0.0035,0.0657,0.0928,-0.0791,-0.0663,-0.1749,-0.0209,0.1136,-0.0746,0.0435,0.0465,0.0249,0.0328,0.0201,-0.1008,0.0299,-0.1317,-0.1288,0.0479,-0.1394,-0.0707,0.0371,-0.0349,-0.1852,-0.0196,-0.0472,0.0151,0.0359,-0.1588,-0.0816,-0.1512,-0.0134,0.0123,-0.0671,-0.0418,-0.0806,-0.0558,-0.0513,0.0088,-0.0012,-0.0451,0.0181,0.0073,-0.0477,-0.0253,0.0151,-0.0822,-0.0287,-0.0068,-0.0641,0.0179,-0.0186,-0.1753,-0.0643,-0.0074,-0.1066,-0.0778,0.0149,-0.0943,-0.0338,-0.0647,-0.0029,-0.0163,-0.0071,-0.0969,-0.05,-0.0959,-0.0376,-0.0692,-0.0756,-0.1249,0.1031,-0.123,-0.0077,0.0444,-0.1289,-0.1304,-0.1052,-0.0555,-0.097,-0.0448,-0.0493,-0.057,-0.0252,-0.0856,0.0731,-0.0427,0.0168,-0.0066,0.0178,0.0142,0.075,0.0291,0.0874,-0.1012,-0.074,0.0756,0.01,-0.0459,0.0968,0.0762,0.0761,0.0886,-0.0308,0.0083,0.023,-0.0589,-0.0575,0.0014,0.0379,0.0306,0.0106,-0.0531,-0.0484,-0.06,-0.0398,-0.0613,-0.1055,0.0526,0.0975,0.0047,-0.0902,0.125,0.0358,0.067,-0.023,0.0325,-0.0978,0.028,0.0981,-0.024,-0.1239,-0.1382,-0.0476,-0.0335,0.0188,-0.0834,0.0741,-0.0244,-0.0058,0.0239,-0.0821,0.0002,0.0249,-0.0017,-0.123,0.0481,0.0931,0.2113,-0.0309,-0.0195,-0.08,-0.0093,0.0402,-0.0763,0.0903,0.044,-0.0315,-0.0074,-0.0081,0.069,-0.0992,-0.1406,-0.1089,-0.0955,0.0481,0.1469,0.0052,-0.1054,0.0235,-0.048,0.0318,0.0226,0.0613,0.0026,0.0074,-0.0659,-0.1212,0.0925,0.0322,0.0866,-0.0798,-0.0478,0.0057,-0.0726,0.0385,-0.0487,-0.0644,-0.0024,-0.0883,-0.0605,-0.0603,0.1096,0.0958,0.0548,-0.0404,-0.0277,0.0015,0.1164,-0.0305,-0.0421,0.0939,0.0275,0.038,0.0162,0.0752,0.0073,0.1316,-0.1182,-0.1249,-0.0026,0.1509,0.0595,0.0513,0.0281,0.084,0.0236,-0.0084,0.0281,-0.0458,0.0322,0.0852,0.1048,0.0591,-0.022,0.1167,0.077,-0.1034,0.007,0.0791,-0.1461,-0.0506,-0.0937,-0.0856,0.0556,-0.1626,-0.0624,-0.1072,-0.0748,-0.0945,0.0252,-0.0172,0.0883,-0.028,-0.0568,0.0336,0.0367,0.0981,0.0568,0.1192,0.0568,0.0398,0.0541,0.0185,0.0346,0.0611,0.0693,-0.0402,0.092,0.0856,-0.0566,-0.0335,-0.0514,-0.033,0.074,-0.0518,-0.1154,-0.1,-0.0319,0.0715,0.1175,0.0201,0.0557,0.0606,-0.0477,-0.1002,-0.0764,-0.0509,-0.0719,0.034,-0.0866,-0.1058,-0.0365,0.1048,0.0039,0.0,0.0013,-0.0957,-0.0647,-0.0355,0.0591,-0.0549,-0.0666,-0.0776,0.0403,-0.0406,-0.1227,-0.0286,-0.0917,0.0589,-0.0835,0.0432,0.0264,0.0639,0.0318,-0.1394,-0.0513,-0.0442,0.0796,-0.0801,-0.0182,0.0362,0.0182,0.0447,0.1803,-0.0091,-0.0398,-0.0746,-0.0456,-0.0407,-0.1313,0.0129,0.0522,0.1245,-0.0202,0.0387,-0.0999,0.059,0.1546,-0.0214,-0.0158,-0.0532,0.0154,-0.1663,-0.1191,-0.0844,-0.0245,0.0563,-0.0496,-0.0613,0.1098,0.0205,-0.1003,-0.0278,0.0674,-0.0208,-0.0157,-0.0535,-0.0783,-0.0835,-0.0618,-0.0593,-0.062,0.0196,0.0237,-0.0251,-0.0923,-0.0179,-0.0459,0.0246,-0.0777,-0.0395,-0.0119,-0.0164,0.0716,0.058,-0.015,0.0308,-0.0956,0.009,0.0649,0.1044,0.1944,0.1189,-0.0329,-0.0737,-0.041,0.056,0.142,0.1388,0.0744,0.0399,0.1204,0.0466,0.1254,-0.0014,0.0048,-0.0133,0.0739,0.0037,0.04,-0.1204,-0.0011,-0.0638,0.0685,0.0698,0.0122,0.0652,-0.0208,0.1025,0.1047,0.1052,-0.0819,-0.0129,-0.0181,0.001,0.0105,0.0047,-0.0669,-0.0915,-0.1201,-0.0807,0.1072,0.1062,-0.1258,-0.1035,-0.0231,-0.1166,-0.0427,0.1465,0.0218,0.1505,0.0653,0.0857,0.0277,0.0545,0.0778,0.0418,-0.0058,0.0154,0.0192,-0.022,-0.1028,-0.034,0.0828,-0.0977,0.0212,-0.0591,0.0363,-0.1524,-0.0266,-0.0572,-0.0187,0.0071,0.0591,-0.011,-0.0453,-0.0213,0.0374,0.0207,-0.0034,0.0443,0.0057,0.013,-0.0362,-0.076,-0.0056,-0.0688,-0.0283,-0.0768,-0.005,-0.0958,-0.0148,-0.0368,0.1617,-0.0456,-0.0229,-0.1046,0.1468,0.1284,-0.0074,0.0298,0.0001,0.0881,-0.0089,-0.0045,-0.0904,-0.0671,-0.0169,-0.0062,-0.0276,0.0159,-0.0298,0.0964,0.083,-0.0,-0.0251,0.0025,0.0371,-0.1298,-0.0015,0.0262,0.0615,-0.0827,-0.0363,-0.0387,0.052,-0.0324,0.0139,0.2926,0.1576,0.0769,0.0044,0.0213,-0.0612,0.0585,0.1142,-0.1152,0.4054,0.3855,0.2852,0.1783,0.3301,0.1124,0.0872,0.0674,0.0767,0.0815,0.0121,0.0495,0.0117,-0.0663,0.0559,0.055,0.0342,0.0831,0.0061,0.0006,0.2608,0.1424,-0.0418,-0.0314,-0.0555,0.0655,-0.0332,0.0735,-0.0311,-0.0723,0.002,0.0427,0.0541,0.0598,0.1837,-0.1436,-0.0645,-0.1012,-0.0542,-0.0661,0.3935,-0.033,0.0338,0.015,-0.0074,0.0438,-0.0668,-0.1278,-0.0742,-0.0805,0.0545,-0.0192,-0.0117,0.0445,0.0218,-0.1265,-0.1172,0.06,-0.0255,-0.0323,0.0133,-0.0919,-0.0466,-0.0911,-0.0035,-0.0382,0.0019,-0.1785,-0.1019,0.2582,0.0617,0.0208,-0.0297,0.1753,-0.0079,0.0041,-0.1424,-0.1253,0.0282,-0.09,-0.1435,-0.1441,-0.0328,-0.0217,-0.0094,0.0845,0.0401,0.05,0.0305,0.0165,0.0431,0.0049,0.0757,-0.0303,0.0765,-0.0111,0.0898,0.1468,-0.0286,-0.0084,0.0805,0.0636,-0.0473,-0.0426,0.033,-0.1203,-0.0736,-0.1214,-0.0278,-0.0163,-0.0527,-0.086,0.0259,-0.0449,0.0471,-0.045,-0.056,-0.0456,-0.0465,-0.0378,0.0695,-0.0193,0.4894,0.3897,0.2936,0.4358,-0.0512,-0.0726,-0.0645,-0.0763,-0.0862,-0.0457,-0.1164,0.0792,-0.0402,-0.0517,0.0604,-0.0654,-0.0029,0.1068,0.0567,-0.0299,-0.036,0.0267,-0.0354,-0.0165,0.0053,0.1641,0.0425,-0.0128,-0.1119,-0.1119,-0.092,0.0477,0.0103,0.0053,-0.0958,0.0279,-0.0284,0.0843,-0.1779,-0.1584,0.1265,-0.0172,-0.1519,-0.146,-0.1761,-0.0236,-0.0683,-0.0427,-0.0355,-0.0374,-0.0206,0.0663,0.1577,-0.0067,0.1252,-0.0075,0.0493,0.1264,-0.0218,0.0,-0.0206,0.0165,0.0431,-0.0269,-0.0484,0.0302,0.0851,-0.0955,-0.0706,-0.0497,-0.029,-0.0132,-0.015,-0.0458,-0.0047,-0.084,-0.0736,-0.1188,-0.2286,-0.0644,-0.049,-0.1686,-0.1018,-0.0863,-0.1035,0.0196,-0.0856,0.0356,-0.1139,0.0078,-0.0839,-0.1576,-0.0112,0.0276,-0.0526,0.1215,0.0992,-0.0004,0.0869,-0.0849,-0.0308,-0.013,-0.1451,-0.1432,0.0358,-0.0572,0.0037,-0.0508,-0.0173,0.0252,0.0481,0.0355,-0.068,-0.0437,-0.0483,0.0513,-0.0489,-0.0372,-0.0157,0.0268,-0.0169,-0.0408,0.0682,-0.006,-0.0686,-0.0114,-0.1338,-0.1317,-0.0223,-0.0231,0.0147,-0.0078,0.0068,-0.1038,-0.0781,0.0228,-0.0878,-0.0077,0.0162,-0.0873,-0.1954,-0.137,0.0518,0.082,0.1076,0.0295,-0.0003,0.0015,0.247,0.0665,0.0477,0.0347,-0.1177,0.0888,-0.0081,0.0869,-0.0453,0.19,0.0212,-0.0597,-0.0336,0.0826,-0.0958,0.0005,-0.0481,0.0073,-0.058,-0.0183,0.0719,0.0122,-0.033,-0.0585,-0.0034,0.0287,0.0399,-0.0183,0.0102,-0.1212,0.0302,0.0473,-0.0912,0.0097,-0.0986,-0.0828,-0.0354,-0.0633,-0.0568,-0.0664,-0.0118,-0.0177,0.0163,-0.0043,0.0789,0.0074,-0.0101,-0.0549,-0.0287,-0.0315,-0.009,-0.1504,0.0059,-0.1358,-0.1248,0.002,0.0775,0.1079,-0.0171,0.029,-0.0513,-0.0014,-0.0421,-0.0374,-0.1149,-0.0403,-0.1915,-0.0612,-0.0276,-0.0651,-0.0561,-0.0693,-0.034,0.1934,0.1282,0.0284,0.3174,0.0366,0.0844,-0.0336,0.3087,0.002,-0.0585,0.0848,0.1765,-0.0321,0.0047,-0.1184,-0.1552,-0.0609,-0.0272,0.0591,-0.0427,-0.0846,0.0355,0.1309,-0.0473,-0.0471,-0.0092,0.0007,0.0258,0.0849,-0.2021,-0.0904,-0.0275,-0.2117,-0.1819,0.1257,0.0436,0.0277,-0.0096,0.0182,0.0436,-0.1297,-0.0622,-0.079,-0.0633,-0.1914,-0.0199,-0.0543,0.005,-0.0885,0.1218,0.0025,0.0165,0.023,0.0132,0.0946,0.093,-0.1012,0.054,-0.0319,-0.0264,-0.0868,-0.0028,0.0241,-0.0205,0.0113,0.1471,-0.0074,-0.0266,-0.057,-0.0861,-0.0099,0.1969,0.1814,-0.1142,-0.0969,-0.0454,-0.0366,-0.1062,-0.0301,-0.1388,0.03,0.0082,-0.0096,0.0506,-0.0153,0.1268,-0.026,0.0611,0.0854,-0.0328,0.0678,0.1645,-0.1951,-0.0514,0.2132,0.0758,0.0314,0.1032,0.1036,-0.0429,0.1191,0.1023,-0.0042,-0.0765,0.0986,0.0664,0.1661,0.1169,0.0637,0.0544,0.0357,0.0808,-0.0575,0.0027,0.1613,0.009,0.094,0.0191,0.0241,-0.1276,-0.0189,0.0893,-0.0434,0.1123,-0.0226,0.0944,0.1736,-0.0024,0.0357,0.0211,0.0648,-0.002,0.04,-0.0275,0.0363,0.0413,0.1857,0.0195,0.0148,0.3843,-0.0784,-0.0349,0.0283,0.0194,0.0133,0.1081,0.1044,-0.1135,-0.0456,0.0254,-0.0517,-0.0174,0.0055,-0.0108,-0.03,-0.0008,0.0242,0.0475,0.1017,0.2043,0.2317,-0.0706,-0.1498,-0.0414,0.0122,0.144,0.1105,0.0669,0.0596,0.1102,0.0174,0.0621,-0.1618,-0.1668,-0.0921,0.0443,0.0968,-0.0909,-0.0594,0.0064,0.0539,0.0097,0.0831,-0.0132,-0.0245,0.0191,0.0365,0.0253,-0.087,-0.0895,-0.144,0.0642,-0.0225,-0.0132,0.1172,0.058,0.0718,0.0906,0.038,0.0733,0.1408,-0.083,-0.0194,-0.0181,-0.0492,0.0673,0.055,0.1353,-0.0938,0.0351,0.1039,-0.0144,-0.0759,0.0324,-0.139,-0.0672,-0.0548,-0.099,-0.0215,0.0821,-0.094,-0.1897,-0.0509,-0.1072,-0.0878,-0.1697,-0.1635,-0.0422,-0.0131,-0.005,-0.0945,-0.0013,0.0899,-0.0079,0.0831,-0.1378,-0.0624,-0.1014,-0.014,0.0217,-0.0955,-0.0491,0.0034,-0.1073,-0.0196,0.1377,0.0404,0.1199,0.0401,0.0069,-0.0256,-0.0152,-0.0231,-0.0098,-0.0838,-0.1853,-0.0008,-0.1091,-0.0322,-0.0317,0.0006,0.0551,0.2729,0.2429,0.1069,0.0491,-0.0429,-0.1913,-0.0832,-0.1708,-0.1222,-0.0129,-0.0387,-0.018,-0.0313,-0.1188,-0.1618,-0.0532,0.1189,0.0521,-0.0592,-0.1002,-0.0575,-0.0892,-0.1548,-0.1317,-0.0612,0.0526,0.0003,-0.0488,-0.0686,-0.0305,-0.0647,-0.09,-0.1315,0.0061,0.106,-0.0875,-0.0624,-0.0646,-0.0187,-0.0333,-0.1199,-0.1472,0.0363,0.1694,0.1579,0.0515,0.0651,0.1173,0.004,0.0418,0.0669,0.1067,-0.0796,-0.0308,0.0054,0.0799,-0.0254,-0.0801,0.004,-0.0874,-0.028,-0.063,-0.0551,-0.084,-0.0564,-0.031,0.0055,0.016,-0.1918,0.0336,-0.0346,-0.0629,-0.0125,-0.078,0.069,-0.0673,-0.0039,0.0735,0.1181,0.0123,0.0781,-0.1223,-0.0595,-0.0394,-0.1082,-0.0642,-0.0393,0.0518,0.0454,0.0397,-0.0816,-0.0547,0.0609,0.052,0.1139,0.1201,-0.137,-0.142,-0.0966,0.0007,-0.001,-0.0943,0.0347,-0.0005,0.0371,-0.0391,-0.0398,-0.0628,-0.0469,-0.0574,-0.0827,-0.0092,-0.0632,-0.0363,-0.0495,-0.0551,0.0228,0.032,-0.0706,-0.0901,-0.0524,-0.1095,-0.0483,-0.156,-0.0436,0.2011,-0.0611,-0.0838,-0.1444,-0.0535,-0.2021,-0.093,-0.0726,-0.0975,0.0974,-0.117,-0.0105,-0.0315,-0.1523,-0.1323,-0.1699,-0.0749,0.0766,-0.1073,-0.0248,0.0016,0.1035,0.0486,0.0749,0.0284,0.0022,0.0155,-0.0325,0.0519,0.0275,0.0714,-0.154,-0.1374,-0.1587,-0.1003,-0.0691,0.0801,0.1667,0.2233,0.0694,0.0412,0.0523,0.1438,0.0112,0.0539,-0.037,0.0537,0.0394,-0.1459,-0.0601,-0.1224,-0.023,0.0244,-0.0781,-0.0913,-0.0656,-0.0289,0.0149,-0.2049,-0.1544,0.0093,-0.0622,-0.123,0.0043,-0.0934,-0.0263,0.0323,-0.0855,0.0126,-0.139,-0.0389,0.0375,-0.073,-0.0562,0.0272,-0.1206,0.0441,0.0354,0.0134,-0.0856,-0.0657,0.0992,0.0212,0.0175,0.0665,0.0239,-0.0351,0.0498,0.0093,-0.0217,-0.1635,-0.03,-0.0322,-0.0338,-0.0076,-0.0201,-0.0961,-0.0434,-0.0207,-0.0764,0.0114,-0.0565,-0.049,0.0497,0.089,0.0626,0.096,0.0764,-0.1597,0.0011,-0.0921,-0.0821,0.0621,0.125,0.1383,-0.0311,0.3938,0.257,-0.1303,-0.1144,0.4519,0.1067,0.1061,0.1174,0.1757,0.1292,-0.0843,-0.0805,-0.0924,-0.1136,0.3678,0.2409,0.2351,0.0273,0.1077,0.2404,0.4176,0.4275,0.4054,-0.0129,0.0166,-0.0743,-0.0154,-0.0569,-0.0179,-0.0793,-0.0562,-0.0672,-0.0219,-0.0302,-0.0236,0.0951,-0.0566,-0.0249,-0.1519,-0.0063,0.0845,0.1176,-0.0671,-0.0,-0.1166,-0.0565,0.0029,-0.037,-0.0214,-0.0472,-0.0314,-0.0284,-0.0695,-0.1358,-0.1265,-0.0698,-0.0705,-0.0147,0.1464,0.0651,0.1059,-0.023,0.0756,0.3074,-0.1069,-0.1337,-0.1034,-0.0984,0.1034,0.0317,0.1219,0.0793,0.0786,-0.0092,-0.1519,-0.1493,-0.1188,-0.1139,-0.0906,-0.2012,-0.184,0.0461,-0.0034,0.2111,-0.1119,-0.022,0.0807,0.0003,0.0948,0.1153,0.0375,-0.0683,-0.102,-0.0611,-0.0144,-0.1429,-0.0774,-0.1151,0.0448,0.0929,0.05,0.0295,0.1212,-0.0046,-0.0013,0.0409,0.0276,0.0851,0.1223,0.021,0.0406,0.0216,-0.0027,0.0067,-0.1008,-0.0981,-0.0125,-0.0,-0.0719,0.0186,-0.025,-0.0484,-0.0062,0.0567,0.0404,0.0444,0.0658,-0.0295,0.169,0.1244,-0.0265,-0.1305,-0.0511,-0.0992,-0.107,0.0531,-0.0177,-0.0616,-0.0761,0.1106,0.0035,-0.1368,-0.0942,-0.0653,0.0742,0.0316,0.0644,0.0848,0.1253,0.1691,0.3091,0.0819,0.0484,-0.0263,-0.0139,-0.0128,-0.126,-0.0826,-0.0821,-0.0182,-0.1113,-0.0891,0.01,-0.0622,0.0307,-0.0271,-0.0996,-0.0853,-0.0599,-0.0562,-0.0729,-0.0218,-0.0583,-0.0687,-0.0128,-0.0425,-0.0898,-0.0721,0.1911,0.107,0.0318,-0.113,0.1703,0.1601,-0.1493,0.1763,-0.141,-0.0669,-0.0044,-0.0979,-0.0972,-0.0576,0.0236,0.002,0.0209,-0.0992,-0.0608,0.0456,0.0389,0.0559,-0.114,0.0016,-0.0002,0.0129,0.0394,-0.0954,-0.0465,-0.0216,-0.0607,-0.082,-0.0441,-0.0426,-0.0393,0.0069,0.023,-0.03,-0.1704,-0.0807,-0.1158,-0.1359,-0.0929,-0.0646,-0.0724,-0.0724,-0.0007,-0.0425,0.0431,-0.139,-0.0085,-0.1786,-0.1697,0.0711,0.0484,-0.1423,0.2087,-0.1684,0.0717,0.1139,0.0128,0.1262,0.081,-0.117,-0.1002,-0.0424,0.0023,-0.0317,-0.0009,-0.0451,-0.0373,0.0851,0.0578,0.0739,0.022,-0.0823,-0.076,-0.0625,-0.082,-0.0156,-0.0705,-0.0593,-0.0194,-0.015,-0.0418,0.0126,-0.0355,-0.0196,0.0094,0.0939,-0.025,0.1606,0.0619,-0.0604,-0.0287,-0.0986,-0.0271,-0.0134,0.0298,-0.0057,-0.0657,-0.0653,-0.0436,-0.0026,-0.0006,-0.0172,0.1361,0.0784,0.2995,0.1256,0.0216,0.003,-0.115,0.0134,0.1129,0.1188,-0.0712,0.0403,0.0435,-0.02,0.0238,-0.2508,-0.1417,-0.2099,-0.1627,-0.1436,-0.0957,-0.2204,0.1024,-0.0201,0.0895,0.1705,-0.039,0.0234,0.0182,-0.0432,-0.1001,-0.0341,-0.0051,0.067,-0.0259,-0.001,-0.1277,-0.0013,0.1168,0.0838,0.1211,0.0372,0.0583,-0.115,0.0406,-0.0543,-0.0056,-0.0361,0.0158,0.0073,-0.0255,-0.0238,-0.0863,-0.0524,0.0688,-0.0527,0.0824,-0.0615,0.0712,0.0111,0.076,0.0526,0.0235,-0.0662,-0.0686,-0.0313,-0.0019,0.009,0.0902,-0.0275,-0.0558,0.0089,0.1335,0.0788,-0.0847,-0.0542,-0.1208,-0.0998,-0.0052,0.0109,0.047,-0.0879,-0.0462,-0.0857,-0.0186,-0.0612,0.0161,-0.0026,-0.1686,0.0891,-0.033,-0.0687,-0.0818,0.0825,-0.0757,0.0319,0.0219,0.0189,-0.1334,0.0389,-0.0083,-0.0685,0.0403,0.0807,0.0088,0.0321,-0.1107,-0.0465,-0.1233,-0.1116,-0.125,-0.0378,-0.1056,-0.0792,-0.0692,0.0469,0.0396,0.0525,-0.0813,-0.0698,0.0972,0.2214,0.2805,0.1024,-0.0644,0.0232,-0.0331,-0.0432,0.0301,-0.0207,-0.0797,-0.0753,-0.0466,-0.0765,-0.1309,0.2983,0.0723,0.0322,0.2364,0.0783,0.1211,-0.0187,-0.0968,-0.0784,-0.0342,-0.1219,0.0115,0.036,0.0053,0.0269,-0.023,-0.0244,-0.0786,0.014,-0.0636,-0.0706,-0.0236,-0.0316,-0.0492,-0.0165,0.0347,0.0121,0.0349,-0.0411,0.0807,-0.1667,-0.0725,-0.0986,-0.1378,0.032,-0.0763,-0.0604,-0.1525,-0.0844,-0.1408,0.0662,-0.1311,-0.0151,-0.0527,-0.015,0.0928,0.0729,-0.0781,-0.0902,-0.0008,-0.0433,0.0733,0.1058,-0.054,-0.0188,0.0089,0.0588,0.0278,0.0497,0.0941,0.0015,-0.0572,0.0595,0.0128,0.0107,0.0757,0.0415,-0.0636,-0.0917,0.0027,0.178,0.0037,0.1978,0.2025,-0.1133,0.0267,0.0376,-0.095,-0.1012,-0.0475,0.0656,0.224,0.0303,0.0636,0.0575,-0.0098,0.1307,0.1716,0.0679,0.0641,-0.0741,-0.0272,-0.0502,0.0353,-0.0353,0.0194,-0.0825,-0.0079,0.0539,-0.0184,0.0467,-0.0179,0.0449,0.015,-0.1484,0.1003,0.0856,0.0323,0.0233,0.0985,0.1504,0.0215,0.0847,0.0013,-0.0176,-0.0119,0.117,0.1191,0.0078,-0.0093,0.1008,-0.0462,-0.1257,-0.2518,-0.2384,0.0189,0.0375,-0.0071,-0.0199,0.0264,0.1241,0.0137,0.0309,-0.0267,0.0826,-0.0379,0.0194,-0.0143,-0.0143,0.0345,-0.0983,-0.04,-0.1176,-0.0868,-0.0663,0.0058,-0.0031,-0.1488,-0.0705,0.0106,-0.0731,-0.0034,0.1009,0.0089,-0.125,-0.0811,0.1386,-0.0706,0.0801,0.0341,0.0515,0.0009,0.0606,-0.201,0.0134,0.006,-0.0734,-0.0475,-0.0438,0.0308,-0.033,-0.087,-0.1347,-0.1144,-0.0556,-0.0487,0.0157,0.088,0.014,-0.0657,-0.0535,-0.1603,0.1697,0.2147,-0.0995,-0.0857,-0.0673,-0.0918,-0.1108,0.2377,0.049,-0.0615,-0.0049,0.0316,0.1186,-0.1966,-0.1915,-0.1012,-0.1619,-0.0465,-0.0952,0.0265,0.0484,0.0602,0.0723,-0.074,0.0171,0.3223,0.0912,0.194,0.3208,-0.174,-0.0705,-0.089,0.1788,0.0298,0.0479,0.0527,0.0566,0.1064,-0.1844,-0.1497,0.0051,0.2018,-0.0453,-0.1687,-0.1927,-0.0941,0.0069,0.1285,-0.0943,0.0084,-0.013,-0.0098,0.0271,0.0824,-0.0277,0.0181,0.0188,-0.0806,0.0068,-0.0262,0.0031,0.0009,-0.0853,0.0022,-0.0441,-0.005,0.0072,-0.0168,0.09,0.0584,-0.0068,0.0137,-0.0512,-0.0141,-0.1152,-0.1083,-0.0419,-0.1021,0.26,-0.0143,0.2046,0.0888,0.0408,0.0368,0.0348,0.0454,-0.0933,0.0691,0.0715,0.0424,0.0515,0.0238,0.0098,-0.0796,-0.0886,-0.1835,-0.0375,0.0604,0.1624,-0.1235,-0.039,-0.0283,0.0022,-0.0145,-0.0483,-0.0138,-0.0779,0.0344,-0.1859,0.025,-0.0867,0.1496,0.0355,-0.0044,0.0874,-0.0612,-0.0074,-0.0917,-0.0794,0.0146,0.0468,-0.0627,-0.0687,-0.0687,0.0351,0.0071,-0.0293,-0.0072,0.1329,0.0127,-0.0267,-0.1575,-0.0637,-0.1062,-0.1255,-0.0364,-0.0653,-0.052,-0.0599,-0.0612,-0.0803,-0.0129,0.0019,-0.0063,-0.0076,0.0175,0.0213,-0.0781,0.0277,-0.2608,-0.2292,-0.2139,-0.0641,-0.0366,-0.1155,-0.1036,0.0069,0.048,0.026,-0.1132,0.1486,0.151,0.0756,-0.0257,-0.0044,-0.058,-0.0598,0.0217,-0.0268,0.1057,0.1279,0.1886,0.0029,0.0752,0.0881,0.0496,-0.1392,-0.0006,0.0178,-0.0025,-0.1024,-0.0994,-0.089,-0.1018,-0.0749,-0.1695,-0.1628,0.0187,0.0145,-0.187,0.0045,-0.0022,0.0317,-0.0436,-0.061,-0.2476,-0.1941,-0.1077,-0.1874,0.1548,-0.0563,-0.004,0.0579,-0.0698,-0.1451,-0.2659,-0.1638,0.1837,0.1267,0.1343,0.0786,0.0369,-0.0465,-0.0104,0.0733,0.069,0.0494,0.0138,-0.0015,0.1589,0.0464,-0.1052,-0.1716,-0.0762,-0.0969,-0.1222,0.0507,-0.1439,0.0895,0.0564,0.0725,0.0344,0.0314,-0.1389,-0.0318,-0.1083,-0.0211,-0.1155,-0.1372,-0.0281,0.0821,-0.0624,-0.0545,-0.0174,-0.1643,-0.0674,-0.0949,-0.1083,-0.0676,-0.0593,0.0452,0.1094,-0.0061,-0.0566,0.0113,0.0227,-0.0009,-0.0631,-0.0372,-0.0764,-0.0071,0.1067,0.0257,-0.0249,0.1133,0.0116,0.0595,0.0563,-0.0062,0.0342,0.033,0.0459,-0.0325,0.045,0.0168,0.1421,0.1851,0.1705,0.08,0.0894,-0.0158,0.0321,-0.0567,0.0728,-0.0331,0.0507,-0.0118,-0.1181,-0.12,0.1538,0.0297,0.0024,-0.0336,0.0541,-0.0323,-0.0367,-0.0323,0.0727,-0.058,-0.0618,0.0371,0.0592,0.0592,-0.1233,-0.0508,-0.133,-0.014,-0.1325,-0.0107,0.018,0.0305,0.0122,-0.0143,-0.0776,-0.0918,-0.1052,0.0771,-0.0949,-0.0944,0.0597,0.0128,-0.028,0.0274,0.1782,0.0764,0.0973,0.1678,-0.0692,0.0061,0.193,0.0502,-0.0156,0.1797,-0.0092,0.0473,0.0304,0.1977,0.0351,-0.095,-0.142,-0.1099,0.1248,0.2443,0.0011,0.0968,0.0328,0.0108,0.024,0.028,0.0357,0.1222,0.0105,-0.0819,0.0885,-0.0972,-0.0775,0.0421,-0.0042,0.0298,0.0296,-0.0397,-0.0344,-0.1314,-0.0852,0.1201,0.2144,-0.0387,-0.0712,0.0907,0.0659,-0.0407,-0.0535,-0.1138,-0.1608,0.1165,0.105,-0.0431,-0.0445,-0.0807,-0.0514,-0.11,-0.0083,-0.0532,-0.1046,-0.0018,-0.0662,-0.0171,0.0085,-0.0926,-0.1209,-0.0413,-0.0445,0.0605,-0.0857,-0.04,0.0787,-0.0253,-0.0814,-0.163,-0.0416,-0.0974,-0.0194,-0.0964,-0.1202,0.0612,0.054,0.099,-0.057,-0.0714,-0.061,0.0376,-0.0493,-0.0126,-0.1561,-0.0643,-0.1169,0.0232,0.0156,0.0925,-0.0935,-0.1519,-0.1071,-0.1717,-0.1718,-0.0292,-0.0278,0.0584,-0.0019,-0.056,-0.0696,-0.0635,-0.0805,-0.1973,-0.094,-0.0374,0.0116,-0.0294,0.0775,-0.0147,0.0997,-0.0062,0.0324,-0.0518,0.0726,0.1579,0.1069,0.0477,0.002,-0.0527,-0.0025,-0.0736,-0.0043,-0.0494,-0.0379,0.012,0.0004,-0.1061,-0.0559,-0.0183,-0.0141,-0.0394,-0.088,0.0003,0.2624,-0.0912,0.0932,0.0518,0.0512,0.0352,0.0525,0.0243,-0.0213,-0.1072,-0.0194,0.0441,0.0548,-0.0689,-0.0383,-0.071,-0.1018,-0.0629,-0.036,-0.0588,0.0842,0.0591,-0.1299,-0.1309,-0.0595,-0.113,-0.0599,-0.0643,0.1505,0.1402,-0.0314,0.0381,-0.09,-0.0207,-0.0767,-0.0805,-0.1871,-0.1435,0.0065,-0.0116,-0.076,0.029,-0.0431,-0.0545,0.1157,-0.0092,0.0353,-0.0024,0.0045,0.0072,-0.0537,-0.0042,0.127,-0.0894,0.0816,-0.0738,0.0411,-0.1164,0.3647,0.0357,0.0476,-0.1014,-0.0907,0.0654,0.1056,0.0085,0.1044,0.0863,0.0174,0.0087,0.0736,0.0934,0.0778,0.098,0.1595,0.1344,0.1803,0.2609,-0.0224,0.0847,0.1488,0.3827,0.1284,0.1374,0.2,0.1314,0.1025,0.1245,0.0779,0.1503,0.1648,0.186,0.2017,0.0515,0.1861,0.3724,0.1695,0.2257,0.1549,-0.0116,0.1233,-0.1585,-0.0681,-0.087,-0.1483,-0.0405,-0.1608,-0.1631,-0.0484,-0.1244,-0.0855,-0.1717,-0.1499,-0.1308,-0.0291,0.0832,-0.07,0.1855,-0.0101,-0.061,0.0379,-0.0764,-0.0968,-0.093,-0.0416,-0.113,0.0734,-0.1537,-0.1608,0.0168,-0.0129,-0.0641,-0.0143,-0.0182,-0.1375,0.0517,0.0605,-0.0607,0.2531,0.3575,0.0395,0.1756,0.2208,-0.0689,0.1339,0.1369,-0.004,-0.0038,0.2204,0.0148,0.0377,-0.1194,0.026,0.1346,-0.0046,-0.0176,-0.0327,0.0062,-0.016,-0.0321,sentence recognition 
trm_55ef153d47bc0,0.0225,0.0251,0.0276,0.0112,-0.0118,0.0042,0.0055,0.0212,0.0061,0.031,-0.0052,0.0027,-0.0022,0.0054,0.0276,0.023,0.0086,-0.0016,-0.0212,-0.0027,0.015,-0.0054,-0.0139,-0.0213,0.0049,0.0012,0.0012,0.0147,0.0222,0.014,0.0077,0.0014,0.0087,0.0116,0.005,-0.0086,-0.0197,-0.0121,0.0318,0.0088,0.0007,0.0191,0.0069,-0.0185,0.0101,0.0276,-0.0113,0.022,-0.0161,0.0021,0.0209,0.0115,0.0062,0.0078,-0.0035,-0.0119,-0.0032,0.0185,-0.0096,0.0209,0.0043,-0.0002,0.007,0.0082,0.0074,0.0141,0.0303,0.0241,0.0169,-0.0105,-0.0222,-0.0257,-0.0191,-0.013,0.0277,-0.0078,0.0242,-0.0229,0.0207,-0.0007,-0.0247,-0.0062,-0.0031,0.0066,0.0042,0.0057,-0.002,-0.0019,-0.0138,0.0112,0.016,0.0239,-0.0587,0.0123,0.0074,0.0148,-0.0096,0.0185,-0.0002,0.0002,0.0132,-0.0125,-0.0107,-0.0002,0.0062,-0.0024,0.0235,-0.016,0.0203,0.0282,-0.0128,0.0162,-0.0113,0.0022,0.0115,-0.0119,0.0078,0.0013,0.013,0.0049,0.0012,0.0108,0.0046,-0.0064,0.0001,0.0068,-0.0014,-0.0145,-0.0123,-0.0211,0.0006,0.004,0.0032,-0.017,0.005,0.0218,0.0086,0.0031,-0.001,0.0213,0.0187,0.0019,-0.0236,0.0018,0.0009,0.0016,0.0204,0.0053,0.0116,-0.029,0.0139,-0.0005,-0.017,0.0052,-0.0073,-0.0149,-0.0115,0.0105,-0.0188,-0.0114,0.024,0.0118,0.0131,0.027,-0.0012,-0.0003,-0.0083,0.0209,0.0201,0.0063,-0.0323,0.0033,-0.0131,-0.0014,0.0153,0.0017,0.0023,0.0016,-0.0007,-0.0077,0.0114,-0.0308,0.006,-0.0168,0.0287,0.0033,0.0158,-0.0026,0.0194,0.0119,0.0151,0.0066,0.0015,0.0236,0.0208,0.029,0.026,0.009,0.0104,0.0169,0.0041,0.0128,-0.0007,0.023,-0.0028,-0.0065,-0.0076,0.02,-0.0035,-0.0179,0.0021,-0.007,-0.0079,-0.016,-0.0041,0.0007,-0.0373,0.0141,0.0254,0.0026,-0.0096,0.0148,-0.0065,0.0084,0.0093,-0.0231,0.021,-0.0039,-0.0096,-0.0301,-0.003,-0.0043,-0.0194,-0.0038,-0.0069,0.0022,-0.0108,-0.0127,0.0026,0.0161,-0.0229,0.0143,-0.0017,0.0021,-0.002,0.0108,-0.0123,0.0072,0.0167,-0.0046,0.0126,-0.0006,-0.0018,-0.0124,-0.0008,0.0148,0.0075,0.0088,0.0019,-0.0079,0.0025,-0.0068,0.0141,-0.0059,0.0119,-0.0234,-0.0096,0.0125,-0.0344,0.0138,0.0037,0.0287,0.0074,0.0005,0.0136,-0.0127,0.0004,0.0074,0.0135,-0.0239,-0.0198,-0.0032,-0.0144,0.0065,0.0073,0.0173,-0.0256,0.0092,0.0277,-0.002,0.0016,0.0246,0.0056,0.002,-0.0061,0.0009,0.011,0.0051,0.0031,0.0098,0.0079,-0.0105,-0.0141,-0.0112,0.008,0.0083,0.0075,0.0066,0.0234,0.0156,-0.0148,-0.0021,0.019,-0.0128,-0.0183,0.0114,0.0025,-0.0061,0.0083,0.0188,-0.0117,0.0087,-0.0073,-0.0135,-0.001,0.0267,-0.0095,0.0001,0.001,-0.005,-0.0045,-0.0004,-0.0003,-0.0234,-0.0029,-0.0103,-0.009,-0.0107,0.0028,-0.0015,-0.0038,0.0013,0.0125,0.0018,0.0165,0.0119,0.012,0.0051,0.0098,0.0024,0.0204,0.002,0.0116,-0.0029,0.0085,0.0134,0.0053,0.0069,0.0224,0.0004,-0.0111,0.0182,0.0104,0.0054,-0.0122,-0.0081,0.0183,0.0119,0.0131,0.0205,0.0008,-0.0034,0.0027,-0.0056,0.0116,0.0017,0.0204,0.0054,-0.0468,-0.0192,-0.0443,0.012,0.0196,-0.0013,0.0175,0.0013,0.0171,-0.001,0.013,0.0006,0.0041,0.0176,0.006,0.0093,0.0061,0.0029,0.0121,0.0013,0.0259,0.0002,0.0131,-0.006,0.0239,0.0173,0.0027,0.0027,0.007,0.0247,-0.0134,-0.014,0.0192,-0.0023,0.0187,0.009,0.0009,0.0105,-0.0109,0.0057,0.0202,0.0218,-0.0068,0.0207,0.015,0.0331,0.0271,0.0198,0.0256,0.0006,0.0194,-0.005,0.0186,-0.0153,0.0159,0.0017,-0.0445,-0.0043,0.0021,-0.0123,0.0228,0.0172,-0.0082,-0.0119,0.0128,-0.009,0.021,0.0134,-0.0214,-0.0093,0.0145,0.012,0.0125,0.0121,0.0099,0.0162,-0.011,0.007,0.0045,0.0122,0.0146,-0.0222,-0.0037,0.0102,0.0152,-0.0312,0.0104,0.0041,-0.0165,-0.0287,0.0213,-0.0035,0.0137,-0.0009,0.0235,-0.0137,-0.0141,0.0041,-0.0001,-0.01,-0.0134,0.0217,0.006,0.0122,0.0185,0.0069,-0.0185,-0.0294,0.0084,-0.0065,0.0068,0.0017,-0.0368,-0.0364,0.0087,0.001,-0.0204,0.0092,0.0094,0.0088,-0.0223,0.0204,0.0181,0.0125,0.0106,0.0228,0.018,0.0053,0.0147,-0.0105,-0.0052,-0.0,0.0165,-0.0263,-0.0002,-0.0038,-0.0145,-0.0072,0.0121,0.0092,-0.0049,0.018,-0.0033,0.007,0.0106,0.0083,0.0039,-0.0154,-0.0114,-0.0308,-0.0259,0.0005,-0.0051,0.0269,0.0023,0.0169,-0.0006,0.0098,0.0118,0.0107,-0.0013,0.001,-0.006,-0.0103,0.0063,0.0129,-0.0217,-0.0089,0.0035,-0.0056,-0.0083,-0.02,-0.0298,-0.0094,0.0051,0.0018,0.0211,0.0084,-0.0169,0.0015,-0.0317,0.029,0.0066,0.0081,0.0225,0.0111,-0.0014,-0.01,-0.025,-0.0107,-0.0031,0.0078,0.0002,0.0017,-0.0251,0.0024,-0.0145,-0.0083,-0.0087,0.0126,-0.0003,-0.0183,-0.0083,0.0249,0.0035,0.0193,0.0066,-0.0031,0.0199,-0.0066,-0.0158,0.0062,-0.0049,0.0136,-0.002,0.0137,0.0109,0.0182,0.0212,-0.0105,0.0126,0.0042,-0.0017,-0.0167,-0.0051,-0.0191,0.0108,-0.0179,0.0166,0.0177,0.0205,0.0119,0.0206,0.0181,-0.0085,0.015,0.0315,0.0145,0.0224,-0.0043,0.0036,0.0384,0.0123,0.0225,-0.0361,0.0091,0.0128,-0.0199,0.0192,0.0118,0.0109,0.0054,-0.002,0.0036,0.0058,0.0112,0.0284,0.004,0.014,-0.0078,0.0088,0.019,0.0134,-0.0013,0.007,0.0045,-0.0116,0.0152,0.0116,0.0077,-0.0121,0.0111,-0.0224,-0.0045,0.0132,0.017,-0.0054,-0.0003,0.0158,-0.0182,-0.0029,0.0109,-0.0132,-0.0008,-0.0243,0.0058,0.01,0.004,0.0162,0.0097,0.0015,0.0026,-0.0155,-0.0075,-0.0056,0.0027,0.0129,0.0077,-0.0364,0.0231,-0.0053,-0.0072,-0.0054,-0.0094,0.0131,0.0136,-0.0204,0.0158,0.0135,0.011,-0.001,0.0181,0.0102,0.0073,0.0144,0.0151,-0.0377,0.0135,0.0004,0.0271,0.0052,0.017,-0.0024,-0.0045,0.0075,-0.0314,0.0215,0.0045,0.0239,0.0108,0.0094,-0.0163,0.0077,-0.0046,0.0002,-0.0366,-0.0219,0.0064,-0.0141,-0.0113,-0.0221,0.002,-0.0249,0.0103,0.0115,0.0105,0.0049,0.0158,0.0175,0.0102,0.0087,0.0155,-0.0293,0.012,-0.0166,-0.0012,-0.0014,0.0174,0.0201,-0.0169,0.0133,-0.0058,0.0116,0.0006,0.0149,-0.0016,-0.0082,0.012,0.0124,0.0029,0.0094,-0.0056,-0.0189,-0.018,0.0091,0.0212,0.0038,-0.0013,0.0079,-0.0122,-0.0227,0.0138,-0.0058,0.0057,-0.0012,-0.0091,-0.0183,-0.0002,-0.0151,0.0321,0.0076,-0.0046,0.002,-0.0159,0.0008,0.0117,0.0067,0.0187,-0.0142,0.0031,0.0257,0.0171,0.019,0.0187,-0.0183,0.0004,-0.0142,-0.0067,-0.0101,-0.0018,-0.0081,0.0186,0.008,0.002,-0.0183,-0.0066,-0.0006,0.0053,0.0017,0.0217,0.0071,0.0186,0.0163,-0.0192,-0.019,-0.0236,0.0001,-0.0046,0.0153,0.0141,0.0235,-0.0149,-0.0104,-0.0118,-0.0371,-0.036,0.001,-0.0367,-0.0146,-0.012,-0.0012,-0.006,0.0018,0.013,0.022,-0.0157,0.011,-0.038,0.0109,0.0101,-0.0079,0.008,0.0045,0.0016,-0.0036,-0.0009,-0.0065,0.0075,0.0018,-0.0033,0.012,-0.0218,-0.0107,0.01,0.0098,0.0206,-0.0017,0.02,0.0073,-0.0218,0.0011,-0.0028,-0.0077,0.0222,-0.023,0.0044,0.0107,0.006,0.0298,0.0119,0.0189,0.0043,-0.0143,-0.0295,0.0004,-0.0136,0.0031,-0.0075,0.0066,0.015,0.0037,0.0096,-0.011,0.0165,0.0125,0.0131,-0.011,0.0148,-0.0093,0.014,0.0148,0.0134,0.0102,-0.0174,-0.0027,0.0166,0.0185,0.0028,0.0017,0.0202,-0.0092,0.005,0.0056,0.0032,0.0019,0.0091,-0.0047,-0.0168,0.0257,0.0106,-0.009,0.0039,-0.006,-0.0098,-0.0478,-0.011,-0.0197,-0.0732,-0.0095,0.0032,-0.0078,0.0124,0.0222,-0.0282,0.0147,0.0153,-0.0012,-0.0482,-0.0272,-0.0177,-0.0132,-0.0021,-0.0016,-0.0001,0.0115,0.005,0.019,0.0021,0.0215,-0.0019,-0.0242,0.0053,-0.02,-0.0279,0.0123,-0.0012,0.0141,-0.0389,0.0115,-0.0269,0.0077,0.0194,0.0197,0.003,0.0055,-0.0064,-0.0122,-0.0041,-0.0134,-0.0099,-0.0177,0.0085,-0.0099,-0.0125,0.0052,0.0116,-0.0187,0.025,-0.0072,-0.0008,0.0123,-0.0109,-0.0309,0.0091,-0.0227,-0.0154,-0.0326,-0.0029,0.0207,0.0068,-0.0026,-0.0166,-0.0038,0.0142,0.0094,-0.0119,-0.0173,0.0067,0.0146,0.0082,0.0152,-0.0017,-0.0011,0.0017,0.0248,0.0244,-0.023,0.0125,0.0094,-0.0181,-0.0002,-0.0052,-0.0066,-0.0649,-0.0238,0.0243,0.0063,0.0119,0.0204,0.0022,-0.0056,-0.0055,0.0174,0.0136,-0.01,-0.0342,-0.0292,0.0213,0.0034,0.0061,-0.0087,-0.0031,-0.0049,0.0072,-0.0059,-0.0492,0.0156,0.0107,-0.0109,-0.0015,0.032,0.0019,-0.0033,-0.0285,-0.0128,0.0014,0.0014,-0.0009,0.003,-0.0011,0.0156,-0.0119,0.0045,-0.0068,0.0011,-0.0005,-0.0041,-0.0064,-0.0147,0.0044,0.02,-0.019,0.008,0.0194,0.0212,-0.0252,-0.0021,0.0032,0.0106,-0.0101,-0.0062,-0.0085,0.0033,0.0006,0.0078,0.0009,0.0032,-0.0351,-0.0048,-0.0391,0.005,-0.0236,-0.0077,-0.0011,0.0118,0.0135,-0.031,-0.0034,-0.02,0.0009,0.0147,-0.0478,0.0127,0.0161,0.006,0.0089,0.0143,-0.0227,-0.0156,0.0249,0.0079,-0.008,0.0071,0.0004,-0.0049,0.0112,0.0144,-0.0053,-0.0052,-0.0149,-0.0017,0.0071,-0.0414,-0.0295,-0.0275,0.0041,-0.0198,-0.0138,-0.0249,0.0011,0.019,-0.0342,-0.0056,-0.0037,-0.0268,-0.03,-0.0104,0.0029,-0.0254,0.0177,-0.0076,-0.018,-0.0017,-0.0146,0.0146,0.0132,0.0162,0.0057,0.0035,0.0184,-0.011,0.0023,-0.0087,0.0131,-0.0002,0.0128,-0.004,-0.0161,0.0087,0.0139,0.0138,-0.0042,0.0053,-0.0057,-0.0331,-0.0077,-0.0013,-0.0001,0.0094,-0.0099,-0.0166,-0.0004,0.0187,-0.0227,-0.0147,-0.0127,0.0189,-0.0128,0.0007,0.0011,0.0048,-0.0123,-0.0247,-0.0012,0.0009,0.0021,0.0038,0.0125,0.0009,0.0133,-0.0232,-0.0157,0.018,0.02,0.0319,0.013,-0.0082,0.0005,0.0204,0.0016,-0.005,-0.0046,0.0031,0.0028,0.0028,0.0155,0.0012,0.0202,0.0232,0.0008,0.0223,-0.0134,0.0017,-0.0136,0.0187,0.0012,0.0167,0.0065,0.0108,-0.0056,-0.0044,0.007,0.0274,-0.0011,-0.0098,0.0122,0.0185,0.0054,-0.0127,-0.0031,0.0237,-0.0068,-0.0087,0.004,0.0167,-0.0011,-0.0064,0.006,0.0126,-0.0052,-0.0092,0.0089,0.0101,0.0121,0.0091,-0.0047,0.0071,-0.011,-0.008,0.0083,0.0127,-0.0348,0.0032,-0.0337,-0.0249,-0.0114,-0.0267,0.0273,-0.0003,0.0102,0.0028,0.0303,-0.0308,0.0086,-0.0084,-0.0003,0.0062,-0.0059,0.0025,0.0057,-0.03,-0.0051,-0.0291,-0.0148,-0.0092,0.0112,-0.0048,0.0063,0.0083,0.0081,-0.008,-0.0108,-0.0108,0.0048,0.0214,0.0176,0.0031,-0.0138,-0.0426,0.013,-0.0232,0.0223,0.0201,0.0112,-0.0041,0.0244,0.0244,0.0152,0.0016,0.0072,-0.0031,-0.0036,-0.0076,0.0138,-0.0136,-0.0054,0.0253,-0.0084,0.0058,0.0012,-0.0036,0.0009,0.0026,0.0127,0.0216,-0.0013,-0.0102,-0.0128,-0.0051,-0.0076,0.0009,0.0115,-0.0097,0.0151,-0.0158,-0.0144,-0.0141,-0.0236,0.0023,-0.0069,0.0052,0.0045,0.0132,-0.0161,0.014,0.003,-0.023,0.018,-0.0036,-0.0036,-0.0225,0.0139,0.0137,0.0147,0.0231,-0.0054,0.002,-0.001,-0.0089,0.0016,0.0181,0.0125,-0.0023,0.0031,-0.003,0.0005,-0.001,-0.009,-0.0257,0.0208,0.0107,-0.0198,0.0116,-0.0092,0.0091,0.0209,-0.0013,0.0007,-0.0074,0.0185,-0.0127,-0.0056,0.0097,-0.0188,0.008,0.0003,0.0027,0.0023,-0.007,0.0124,0.0091,0.0021,0.0008,-0.0001,0.0239,-0.0045,0.0117,0.0098,-0.0137,-0.0004,-0.0158,-0.0021,0.0205,-0.0048,-0.0005,-0.0017,-0.0297,0.0029,-0.0034,0.0062,0.0286,-0.005,-0.002,-0.0088,0.0127,0.008,-0.0004,-0.003,-0.0062,-0.0104,-0.0143,0.0122,0.0127,0.0168,0.0082,0.0075,0.0138,-0.0087,-0.0103,0.0136,0.0113,-0.0057,0.0116,0.0009,0.0164,0.0034,-0.0079,-0.0153,0.013,-0.0031,-0.0066,-0.0231,0.0073,-0.0091,0.0023,-0.0019,0.0136,-0.0238,0.0035,0.0033,-0.0108,0.005,-0.0166,0.0052,-0.0035,-0.0043,0.0021,0.0214,-0.0074,-0.0166,-0.0086,-0.0039,0.0023,-0.0415,0.0147,0.0128,0.012,-0.0234,0.0112,0.0057,-0.0117,0.0079,-0.0115,0.0165,0.0122,0.0177,-0.0062,-0.0031,-0.025,-0.0309,-0.0019,0.0134,0.0094,0.0189,0.0099,0.0125,0.0028,-0.0304,0.0071,-0.0112,-0.0049,-0.0189,0.0008,0.0188,0.0115,-0.0192,0.0217,0.0184,-0.0004,0.0146,0.0208,-0.0072,-0.0062,0.0315,0.0082,0.0022,-0.0034,0.0262,-0.0,0.0113,-0.0094,0.0058,0.0002,0.0176,0.0191,-0.0061,0.0179,0.0077,0.0049,0.0083,-0.0178,0.0128,-0.0251,-0.0094,0.0167,0.0176,-0.0017,0.0089,0.0335,0.01,-0.0049,0.0042,0.0076,-0.0213,0.0172,0.015,-0.0103,0.0007,-0.0204,0.0128,0.014,-0.0507,0.0068,0.0059,-0.0021,-0.0053,-0.007,0.0058,-0.0359,0.0036,0.0073,-0.0145,-0.0044,-0.0028,0.0035,0.0014,0.0065,0.0065,0.0057,-0.0066,0.009,0.0058,-0.0028,0.0214,0.005,0.0189,0.0199,0.0212,0.0133,-0.0127,0.0057,-0.0107,0.0155,-0.0161,0.0061,-0.0065,0.0063,0.0155,0.0032,0.0085,-0.0163,0.0158,0.0082,0.0087,-0.0131,-0.0121,0.0024,-0.005,-0.0196,-0.0077,-0.0178,0.0052,0.0004,0.0081,-0.0217,-0.0575,0.0181,0.0064,-0.0276,-0.0102,0.0027,0.0058,0.0042,0.0002,0.0002,-0.0184,0.0108,0.0015,0.0115,0.0133,0.0121,0.0251,-0.0016,0.0193,0.0053,-0.019,-0.0269,0.0024,-0.0232,-0.0301,-0.0015,0.0187,0.0042,-0.0282,0.0027,0.0172,-0.0117,0.0209,0.006,0.0216,0.0032,0.0141,-0.0046,0.0097,0.0168,0.0014,0.0215,0.0205,0.0026,0.0154,-0.0126,-0.0073,-0.0099,-0.0056,0.0012,-0.007,-0.0,0.0342,-0.0088,0.0025,-0.0052,-0.0069,0.0058,-0.0041,0.0079,0.0034,0.0081,0.0278,0.0074,0.0271,0.0114,0.0091,-0.0097,0.0176,-0.0621,-0.0676,0.0069,0.0104,0.0175,-0.016,0.004,-0.0175,0.0095,0.0143,0.0108,-0.0234,-0.0021,-0.0101,0.0047,0.0186,0.0089,0.0052,0.002,0.0079,-0.0066,0.0036,0.0133,0.0125,0.0054,0.0114,0.0029,0.0032,0.0023,-0.0097,-0.0153,0.0195,0.0142,-0.0063,0.0111,0.0071,-0.015,0.0017,-0.0299,-0.0167,-0.0023,0.0063,-0.0041,0.0044,0.0029,0.014,-0.02,0.0158,0.0151,0.0107,0.0075,-0.0011,-0.0041,-0.0009,-0.0256,0.0045,0.0204,-0.0001,0.0003,0.0059,0.0053,0.0226,-0.0001,-0.0064,0.0111,-0.0272,-0.0025,0.002,-0.0031,0.0054,0.0131,0.0147,0.0008,0.0035,0.0217,0.0353,0.0068,0.0057,0.001,0.0015,-0.0257,-0.0163,-0.0443,-0.0202,-0.0123,-0.0214,0.0133,0.0222,0.0014,0.0156,0.0158,0.0047,0.0027,0.0014,0.0131,-0.0048,-0.0042,-0.0121,0.0106,-0.0107,0.0046,0.0186,-0.0555,-0.0033,0.024,0.0031,0.0159,0.0073,0.0026,-0.0185,0.0243,0.0284,-0.0032,-0.0005,0.0258,-0.0073,0.0019,0.0074,0.0153,-0.006,0.0102,0.0182,0.0045,-0.0219,0.0024,-0.003,-0.0034,0.0089,-0.023,-0.0149,0.0152,-0.0109,-0.0031,-0.0018,-0.0087,-0.0175,0.0154,-0.0113,0.0025,0.0123,-0.0098,0.0117,0.0159,0.0236,-0.0059,-0.0161,-0.0025,0.0247,-0.0202,-0.0142,0.0052,-0.0097,0.0151,0.0143,0.001,0.0131,0.01,0.0097,0.0045,0.0083,-0.0065,0.0026,0.0111,0.0201,0.0232,0.0111,0.0093,0.0169,0.0115,-0.0211,0.0127,0.0119,-0.0058,0.0238,-0.003,-0.014,-0.0461,-0.0287,0.0103,0.0175,0.0276,0.0074,0.0126,-0.0001,-0.0141,0.0145,-0.0027,0.012,0.0216,0.0191,0.0035,0.0183,0.0112,0.0112,0.0207,-0.0062,0.0223,0.012,0.0108,0.0073,0.0121,-0.005,-0.012,0.0059,0.0143,0.008,0.0022,-0.0347,0.0189,0.0141,0.0071,0.0069,0.0081,0.0168,0.0173,0.0067,0.0211,0.0002,0.0097,-0.0169,0.0208,0.0103,0.0111,0.0034,-0.0245,0.0072,0.0119,-0.0291,-0.0216,0.0163,0.0066,0.0144,-0.0111,-0.0026,0.0224,0.0042,-0.0347,-0.0352,0.0209,0.0033,0.0071,0.0003,0.0022,-0.0217,-0.0081,-0.0212,-0.0055,-0.0091,-0.0011,0.0075,-0.0071,-0.0246,-0.0072,0.0194,0.0153,0.0126,0.0152,0.0194,0.0198,0.0053,0.0161,0.0033,-0.0051,-0.0439,0.0064,0.0208,0.0255,0.0181,0.0163,0.0132,-0.0074,0.0168,0.0077,-0.0104,0.0122,0.017,0.0084,-0.0051,-0.0182,0.0103,-0.0039,0.0145,0.0063,0.0142,-0.0083,-0.0019,-0.0029,0.0141,0.0046,-0.0012,-0.0054,-0.0254,-0.0016,0.004,-0.0065,-0.0024,-0.0042,0.0098,0.0155,0.0052,-0.0252,-0.0104,0.0073,0.0211,0.0179,0.0126,0.0185,-0.0449,0.015,0.009,0.0114,-0.0016,0.0121,-0.0032,0.001,0.022,0.0038,0.016,0.0064,0.0066,-0.0265,-0.0044,0.0231,-0.0478,-0.0369,0.026,0.0158,-0.0361,0.0107,0.0091,0.0027,0.0083,0.0006,0.0198,0.0194,0.0153,0.0029,-0.0506,-0.0636,-0.0189,-0.0618,-0.0045,-0.0253,-0.0561,-0.0548,-0.0334,0.0145,0.0051,-0.0174,0.012,0.0196,0.0108,0.0038,0.0125,0.0169,-0.0004,-0.0108,-0.016,-0.0083,0.0021,0.0081,-0.0246,-0.0441,-0.0243,-0.0193,0.0261,0.0009,0.0118,0.0,0.0139,0.0126,0.0009,0.0038,-0.0076,-0.0055,0.009,0.0172,0.0154,0.0034,0.0184,0.0111,-0.0028,0.0072,-0.0126,-0.0117,-0.0059,-0.0235,-0.0091,0.0187,-0.0115,0.0121,-0.0036,0.0162,0.0143,0.0016,0.0134,-0.0107,0.0071,0.0095,0.0027,-0.0005,0.0084,0.0218,0.0074,-0.0191,-0.011,-0.0078,-0.0108,-0.0014,-0.0222,0.0206,0.0005,0.0046,0.0148,-0.0132,0.0196,-0.0074,0.017,-0.0075,0.0046,0.0034,-0.0063,0.0037,0.0147,0.0066,-0.0068,-0.0124,0.0164,-0.0091,-0.0,-0.022,0.0002,-0.0127,-0.0027,0.014,-0.0148,-0.0189,-0.0149,-0.0166,0.0039,0.0009,0.0224,0.001,-0.0034,0.0163,-0.0128,0.0038,0.006,-0.0187,-0.0031,-0.0158,-0.0184,-0.0079,0.0116,0.0051,-0.005,0.0234,0.0208,-0.0073,-0.0041,-0.0102,0.0093,-0.0055,-0.0087,0.0165,-0.0183,-0.0316,0.0228,0.001,0.0102,-0.0185,0.0069,-0.0251,-0.0354,0.0091,-0.0011,0.0152,0.0013,0.0004,0.0007,0.0127,0.0087,0.0,0.0053,0.0157,0.0107,0.0108,0.0174,0.0251,0.0104,-0.0033,0.0012,0.0148,0.016,-0.0137,0.0187,-0.0147,-0.0188,0.0174,0.0147,-0.0078,-0.0079,-0.0078,0.0079,0.0146,-0.0446,-0.0287,0.0067,-0.0037,0.0075,0.022,-0.0017,0.0034,0.0058,-0.0133,-0.0019,-0.0323,0.0167,0.0208,0.0003,0.0142,-0.0048,0.0076,-0.0204,0.0208,0.0144,0.0061,-0.0019,0.0152,0.0107,0.0001,0.0022,-0.006,0.006,0.0119,-0.0047,-0.0111,-0.003,-0.0012,0.0213,0.0201,0.0155,-0.0015,0.0252,0.0162,0.0184,0.0184,-0.0042,0.0187,0.0054,0.0264,-0.0074,0.0127,0.0031,0.0158,-0.004,0.0203,-0.0018,0.013,0.012,-0.0233,0.0038,0.0046,0.0145,-0.0129,0.0197,0.0126,-0.036,0.0073,0.0139,0.012,0.0161,0.0151,0.0187,-0.0062,-0.032,0.0116,0.0142,-0.0127,0.0114,0.015,0.0033,0.0143,-0.0029,0.0016,0.0099,0.0001,0.0008,0.004,0.0206,0.0119,0.0227,-0.0025,0.0044,0.0084,0.0129,0.0088,-0.0079,0.0096,0.0004,0.0075,0.0102,0.0152,0.0019,-0.0024,-0.0082,0.0044,-0.0192,-0.0021,-0.0116,0.0004,-0.0373,-0.0022,0.0263,0.0028,-0.0199,0.0136,-0.014,-0.0082,0.0016,-0.0109,-0.0176,0.0065,0.0066,0.0119,0.0128,-0.017,0.017,0.0048,-0.0146,0.0214,-0.0079,-0.0202,-0.0243,0.0135,-0.0225,0.0204,0.0305,0.016,-0.0318,0.0058,0.009,0.0098,-0.0012,-0.0263,-0.0095,0.0068,0.0088,-0.0237,0.0076,-0.0072,-0.0042,0.015,0.0005,-0.0015,0.0135,0.0121,0.0298,0.0272,0.0243,0.0037,0.002,0.0004,-0.0237,0.0189,-0.0038,-0.0054,0.0043,-0.0105,0.0223,0.0259,-0.0144,0.0301,0.0299,0.0033,-0.0013,-0.0092,-0.0163,-0.0033,0.0115,-0.0038,0.0182,0.0127,-0.0021,0.0053,0.0022,0.0071,-0.0077,0.0075,0.0114,0.0102,0.0073,0.0052,0.0228,-0.0054,0.0125,0.011,0.0152,0.0056,-0.005,-0.01,0.0189,-0.017,0.0148,0.0074,0.0212,0.0047,-0.0032,0.0131,-0.0141,0.0006,0.0099,-0.0224,0.01,0.0065,-0.001,0.0239,0.0067,0.0007,0.0105,0.002,0.0049,0.0176,0.0147,0.0059,0.015,0.025,0.0121,0.0041,-0.02,-0.0157,0.0073,-0.0203,-0.0037,-0.0003,0.002,0.0265,0.011,0.0168,0.0017,0.0141,0.0112,-0.0192,0.0044,0.0097,-0.0454,0.0074,-0.0038,-0.0087,-0.0208,0.0151,0.0086,0.0101,0.0,-0.0037,-0.0024,-0.0023,0.0233,0.0075,0.0092,0.0058,-0.0026,0.0131,0.0143,-0.0146,-0.0167,-0.0006,0.0175,-0.0041,0.0124,-0.0141,0.0014,0.0167,-0.0042,0.0121,0.0117,0.0058,0.0085,0.024,0.0112,0.0165,0.018,0.0038,0.0093,0.0061,0.0055,-0.0074,-0.0219,-0.005,0.0161,0.0318,0.0072,0.0064,-0.011,0.0078,0.0108,0.0155,0.0147,-0.0051,-0.0073,0.0083,0.0225,-0.0286,-0.0041,0.0043,-0.0078,-0.0089,-0.015,0.0005,0.0057,0.0171,0.0018,0.0004,0.0041,-0.0183,-0.0127,-0.0126,0.0093,-0.0071,0.0052,-0.0057,-0.0026,-0.008,-0.024,-0.0148,-0.0146,-0.0145,0.008,-0.0151,-0.0213,-0.0236,0.0027,0.0038,-0.051,0.0175,-0.0032,0.018,0.0179,0.0024,0.0158,-0.0023,-0.0301,-0.0083,0.0083,0.0002,-0.0239,0.0097,0.0061,0.0163,-0.0047,-0.0449,-0.0071,-0.0037,0.003,0.0018,-0.0014,0.0109,0.0079,0.0,-0.0054,-0.0367,-0.005,0.0104,-0.0053,0.0128,0.025,0.0224,-0.0009,-0.0084,-0.0027,0.0024,0.0036,0.0081,0.0186,0.0054,0.0098,-0.0038,-0.0037,-0.0052,-0.0106,0.0186,0.0071,0.0131,-0.0076,0.0036,0.0155,0.0133,0.0081,0.0021,0.0187,0.0115,-0.011,0.0107,0.0127,0.008,0.0242,0.0037,-0.0041,-0.0183,0.0012,0.0257,-0.0103,0.0102,-0.0172,-0.0037,0.0168,-0.011,-0.0143,-0.0255,0.0015,-0.0098,-0.0159,0.004,-0.0031,0.0169,0.0248,0.0036,0.0126,0.0058,-0.0061,0.0116,0.0083,0.0266,0.017,0.0023,-0.0005,-0.0014,-0.0082,0.0283,0.0191,0.0279,-0.0105,-0.0096,0.013,-0.0243,-0.0191,0.0082,0.0103,0.0154,0.0158,0.0177,0.0139,0.0005,0.0159,-0.0277,0.0103,-0.0316,0.0056,0.0066,-0.03,0.0082,0.0021,-0.024,0.019,0.0154,-0.0015,-0.0082,0.0003,-0.0065,0.0146,0.0026,0.0126,0.0192,0.0121,0.0136,-0.0193,-0.0047,0.0035,-0.01,-0.0066,0.0029,-0.0219,0.0255,0.0055,-0.0013,0.0041,0.0044,-0.0025,-0.0118,0.0028,0.017,-0.0071,-0.0034,0.0181,-0.0193,0.001,0.003,-0.0125,-0.0022,-0.0016,0.0124,0.0062,-0.0261,-0.0015,0.0074,-0.0135,0.0055,0.0079,0.0158,0.0138,0.0059,0.0107,-0.0273,-0.0156,-0.0254,0.0201,-0.0154,0.006,0.0042,-0.0106,0.0242,-0.0247,-0.0178,-0.0216,-0.0115,0.0214,0.0042,-0.0026,0.0143,0.0091,0.0272,-0.0198,0.0193,0.0242,0.0093,-0.0011,0.0054,0.0165,0.0099,-0.0142,0.008,0.0201,0.0147,0.0035,0.0076,-0.0104,-0.0021,0.0043,-0.0068,-0.0043,-0.0022,0.001,-0.0222,0.0049,-0.0269,0.013,0.0035,0.0265,0.022,0.0085,0.0127,-0.0083,0.0037,0.0173,0.0135,0.0273,0.0179,0.0007,0.0039,0.0229,0.0204,0.0025,-0.0074,0.0084,0.0058,0.0102,0.019,0.0057,-0.0048,0.0046,-0.0034,0.0193,0.002,0.0169,0.0112,0.018,-0.008,-0.0037,0.006,-0.0022,-0.0005,-0.0096,-0.0053,0.014,0.0111,-0.0033,-0.0006,0.0091,-0.0003,0.0096,0.01,-0.0151,-0.0031,-0.0081,-0.0211,-0.014,0.0052,0.0166,-0.0381,-0.0061,0.0121,-0.0182,-0.0038,-0.015,0.0056,-0.0021,-0.0037,0.0123,-0.0084,-0.0041,0.0194,0.0135,0.0014,0.0043,0.0083,-0.0335,-0.0279,-0.0025,0.0074,0.0218,0.027,0.0107,0.0339,0.0033,0.0087,0.019,0.0188,-0.0039,-0.0081,0.0101,0.0199,-0.0561,-0.0101,-0.026,-0.0023,0.018,0.0174,0.0168,0.0088,-0.0148,-0.0037,0.0162,0.0082,-0.0253,-0.0268,0.0101,0.0245,0.0101,0.0108,0.0093,0.0118,0.0095,-0.007,-0.0162,0.0215,0.002,0.0103,-0.0045,-0.0176,0.0151,-0.0088,0.018,0.0327,-0.0261,0.0058,-0.0049,-0.0012,0.021,0.0183,0.0279,0.0047,0.0176,0.0076,0.0003,0.012,0.0062,0.0165,0.01,-0.0413,-0.0051,-0.0089,0.008,0.0181,0.0128,0.0228,0.0011,-0.0136,0.0163,-0.0408,0.0045,0.0192,0.0095,0.004,-0.0099,-0.0132,-0.0229,-0.0099,0.0265,-0.012,-0.0071,0.0014,-0.0025,-0.0067,0.0103,-0.0126,-0.0037,-0.0198,-0.0219,0.0239,-0.0123,-0.0019,0.0102,0.0087,0.0019,-0.0015,0.0114,-0.0045,-0.0004,0.0047,0.0093,-0.0013,-0.0178,-0.0051,-0.0168,-0.0079,-0.0245,0.0177,0.0136,0.0042,0.0098,-0.0109,0.0271,0.0076,-0.0024,0.0157,-0.0212,0.0026,0.012,0.0071,-0.0005,0.006,0.0222,0.0117,-0.0168,-0.0064,-0.0087,-0.0189,-0.0073,0.004,0.0184,-0.0057,0.0016,-0.0074,0.0091,-0.024,0.0134,0.0005,0.0029,-0.0068,-0.0186,-0.0072,0.0144,0.0147,-0.0115,-0.0138,-0.0024,-0.0239,0.0065,0.0104,0.0096,-0.0028,0.0181,0.0129,0.0015,-0.016,0.0015,0.0104,0.0012,0.0058,-0.0053,-0.0018,-0.0001,0.0239,0.0176,0.0099,0.0084,0.0192,0.0037,-0.0163,-0.0269,0.003,0.0127,0.0234,-0.0054,-0.0048,-0.0029,0.0153,0.0076,0.0002,0.0043,0.0167,0.0084,-0.0003,-0.0164,0.0096,-0.0049,0.0222,-0.0019,0.0109,0.0148,0.0112,0.0189,0.0246,0.0277,-0.0032,0.0073,0.0198,0.0179,0.0171,0.0019,0.0056,0.0052,0.0122,0.0119,0.02,0.0168,0.0109,0.0091,-0.0125,-0.0029,-0.0205,-0.0053,0.0036,-0.0105,-0.0189,0.0081,0.0144,0.0185,0.0254,0.0101,-0.0162,0.0021,0.0004,0.0127,0.005,0.0006,0.0158,0.0168,-0.004,0.0041,-0.0487,0.0194,0.0097,0.0082,-0.0029,0.0012,0.0203,-0.0108,0.0163,0.0158,0.0165,0.0136,0.0138,-0.0059,-0.0113,0.0166,-0.004,0.0086,0.0104,-0.0149,-0.0016,-0.0143,0.0171,-0.0162,0.0106,-0.008,0.0133,0.0149,-0.0036,-0.0093,-0.0046,0.0015,0.0185,0.0108,0.0033,-0.0192,-0.0341,0.0065,0.0072,-0.0329,0.0055,-0.0135,-0.0002,-0.0138,0.0101,0.0068,-0.0047,0.0107,-0.0008,-0.0052,-0.0019,0.0079,0.0086,0.012,0.0181,0.0035,-0.0144,-0.0055,-0.0188,0.0178,0.0147,0.0054,0.0193,0.0026,0.0112,-0.0728,-0.0471,0.0032,-0.0041,-0.0175,0.0191,0.004,-0.0121,0.0132,0.026,-0.0026,-0.0154,-0.001,-0.0026,0.0026,0.0169,-0.0137,0.0187,0.009,0.0037,0.0268,-0.0057,0.0077,-0.0129,-0.0067,0.0014,0.0092,0.0149,0.0016,0.0148,-0.0495,-0.0115,-0.0118,-0.013,-0.017,-0.0086,0.0053,0.0033,0.0133,0.0117,-0.0039,0.0157,-0.0135,0.005,0.0075,0.0051,-0.0122,-0.0134,-0.0114,-0.045,0.0197,-0.0112,-0.0481,-0.0526,-0.0322,-0.0493,-0.0663,-0.0284,-0.0279,-0.0143,-0.0099,-0.0383,-0.0376,-0.0241,-0.0564,-0.0259,-0.0189,-0.0117,-0.0198,-0.0141,-0.0079,-0.0045,0.0038,0.0155,0.0027,-0.014,0.0181,-0.0071,0.0123,0.0178,0.0177,0.0182,-0.0069,0.0216,0.0071,0.0209,0.0196,0.0175,0.01,0.0071,0.0171,0.0059,0.0109,0.0223,0.0225,0.02,-0.0084,0.0159,-0.0302,0.002,0.0161,-0.0023,0.0203,0.0069,0.0018,0.0,0.0241,0.0006,0.0036,-0.0029,-0.0113,-0.0124,-0.0119,-0.0192,-0.004,0.0093,-0.0025,-0.0032,-0.0133,0.0154,0.0022,0.0045,-0.0108,0.0006,0.0038,-0.0156,-0.0135,-0.0133,-0.0235,-0.0075,-0.0063,0.0134,confidence judgment
trm_4a3fd79d09c28,-0.0101,-0.0187,-0.0329,0.0747,-0.0156,-0.0146,-0.0169,-0.0193,-0.0274,0.014,-0.0154,-0.0294,0.0252,0.0309,0.0203,0.007,-0.0045,0.1061,-0.0094,0.1013,0.0329,-0.0356,-0.015,0.0654,-0.0153,-0.032,-0.0295,0.0611,0.0373,-0.0169,0.055,0.066,0.0266,-0.0446,0.0844,0.0606,-0.1014,-0.0178,0.047,0.0355,0.0214,0.0423,0.0096,0.0304,0.0538,0.0825,-0.0709,0.0383,-0.0248,0.0364,0.0244,-0.0342,-0.0185,0.0282,0.0872,0.0146,0.0249,0.0087,-0.0141,0.0211,-0.0082,-0.0599,0.0764,-0.03,0.0071,-0.0985,0.0966,0.1528,0.1246,-0.0136,-0.0488,-0.0951,-0.0156,0.0448,0.0306,0.0578,0.0224,-0.0505,0.0009,-0.0314,-0.0098,-0.0083,0.0502,0.0888,-0.0002,-0.0239,0.0018,-0.0471,0.0228,-0.0032,0.0043,-0.0744,0.015,-0.2239,-0.1611,-0.1841,-0.0613,-0.0505,-0.1632,-0.1937,-0.0307,0.0294,-0.0736,-0.1765,-0.0942,0.021,0.1259,-0.0031,0.0154,0.0219,0.0498,0.0742,0.0038,-0.0756,0.0106,0.0231,0.0239,-0.0877,0.0603,0.0107,0.0876,0.0679,0.0962,0.0327,0.059,0.0945,0.1203,-0.0185,-0.0429,-0.0509,0.0892,0.0433,-0.0133,0.0451,0.0826,0.111,-0.0371,0.0518,0.0268,-0.0241,0.0408,0.0415,-0.0196,0.0817,0.0703,-0.0414,-0.0532,0.016,0.0401,0.0049,0.0414,0.0534,0.0465,0.1067,-0.0146,-0.0599,-0.0468,-0.032,-0.0447,0.0074,0.045,0.0512,0.1041,0.0554,0.0009,-0.0227,-0.0045,0.1463,0.1427,0.0494,-0.0683,0.0744,-0.1136,0.12,0.0469,0.0893,0.0599,0.0836,0.0425,-0.0721,0.0742,-0.0675,0.0254,0.0084,0.0114,-0.0004,0.0109,0.062,0.0754,0.0824,0.0778,0.0077,0.0068,0.158,0.1511,0.052,0.0707,0.0464,0.0683,-0.0731,-0.053,-0.1685,0.0923,0.0515,0.0531,-0.0183,0.1297,0.0114,0.0236,0.0138,0.1144,0.0546,0.0088,-0.0122,0.0223,0.0176,-0.0319,-0.0034,-0.1571,0.0023,-0.0463,0.0257,0.049,-0.008,-0.0434,-0.0283,0.081,-0.0531,0.0461,0.1001,-0.1542,-0.0013,-0.0495,-0.0113,-0.0214,-0.0321,0.0092,0.0876,-0.0029,-0.0166,-0.0475,0.0352,-0.0037,-0.0238,0.0212,0.0446,0.0789,0.0903,0.026,0.1442,-0.0046,-0.0222,0.0606,0.0226,0.0035,0.0988,-0.037,-0.0031,-0.0311,-0.0332,-0.0298,-0.0689,0.0161,-0.0232,-0.0421,-0.058,0.0348,0.0473,0.003,0.0041,-0.006,-0.0196,0.0558,-0.0174,-0.0356,-0.0358,-0.0614,-0.0125,-0.051,-0.0259,-0.0469,0.0133,0.0175,0.1471,0.1264,0.0056,-0.0103,-0.0072,-0.0508,0.004,0.029,0.0072,-0.031,0.0733,-0.0037,-0.011,0.0479,0.0315,0.0251,-0.0025,0.012,0.1482,-0.0066,0.0266,-0.1362,-0.1467,0.0166,-0.0106,-0.0888,0.0476,0.0013,0.0168,0.0339,0.0582,0.018,0.0136,0.0209,-0.0156,0.0294,0.0759,0.0063,0.0238,0.0539,0.0555,-0.0191,0.0527,0.057,0.0722,-0.0081,-0.0095,0.0263,0.007,0.0227,0.004,0.0586,-0.0822,0.0308,0.1102,0.0309,0.1343,0.1087,0.0249,-0.1004,-0.0692,0.0162,0.0013,0.0194,-0.0197,-0.0049,0.0279,-0.0485,-0.1185,-0.0863,-0.0648,-0.0175,-0.0679,0.0174,0.0571,0.0141,0.045,-0.0011,0.0274,0.0436,-0.0577,-0.043,-0.1074,0.0021,0.0511,-0.0137,0.0939,0.0636,-0.0063,0.021,-0.0862,0.0662,0.0273,0.095,-0.0356,0.0333,-0.0075,-0.0007,-0.1868,0.0731,0.0376,0.0173,0.021,0.0226,-0.0329,-0.0048,-0.0243,-0.0678,0.039,-0.1486,0.0646,-0.1876,-0.2499,-0.1359,-0.0083,-0.0319,0.0505,0.0424,0.0042,-0.0502,0.0134,-0.0643,0.0103,0.0308,0.0009,0.0228,-0.0326,-0.0493,0.0708,0.0576,0.0541,0.0612,0.115,0.0473,0.0877,0.1281,0.0521,-0.03,0.0026,-0.012,0.0933,0.0861,0.0101,0.0494,-0.0991,0.0448,-0.0586,0.0232,-0.023,-0.0228,-0.0364,0.0709,-0.0059,-0.0599,-0.0279,0.0617,0.0465,-0.0641,-0.0404,-0.07,-0.0153,-0.0258,0.0168,-0.0184,-0.0621,0.1315,0.1358,0.0901,0.0087,0.0603,0.0586,-0.0506,0.1547,0.002,0.0655,0.0707,-0.0158,-0.0139,-0.0171,0.0275,0.0116,0.0735,0.0798,-0.0189,-0.0317,0.0355,-0.0064,-0.0564,-0.0859,-0.075,0.0461,0.0301,0.0537,-0.0609,-0.0863,0.0047,-0.0021,-0.119,-0.0106,-0.0505,-0.0281,0.0167,0.0075,-0.0135,-0.0529,0.0674,0.0292,-0.0671,-0.1011,0.0571,0.0665,-0.0429,0.0113,0.1205,-0.065,0.0025,0.1029,0.1018,0.0813,0.0282,0.0388,0.0522,0.0405,0.084,0.0945,0.0316,-0.0591,0.0443,-0.0716,0.0427,0.0415,-0.0486,-0.0252,0.0197,-0.0554,-0.1623,-0.0284,0.0196,-0.0139,-0.0109,0.0238,-0.0098,0.0446,-0.0084,-0.0712,-0.0634,-0.0295,0.0146,-0.0272,-0.0673,0.0756,0.0394,-0.0086,0.053,0.0089,0.0017,0.0388,0.0614,-0.0259,-0.0475,-0.0085,0.0298,-0.0489,0.0612,0.0273,-0.0221,0.0027,-0.0651,0.0982,0.0059,-0.1021,-0.04,0.0754,-0.0758,0.0093,-0.0003,-0.0088,0.0762,0.026,0.1008,-0.0641,0.1014,-0.0037,0.0078,0.1227,0.0319,0.0353,0.0229,0.0696,-0.009,-0.0406,-0.2943,-0.3111,-0.055,-0.0296,-0.0158,0.0032,0.0006,0.0317,0.0494,0.0145,-0.0605,-0.0069,-0.0668,0.0063,-0.0377,0.0482,0.0249,-0.0044,0.0109,0.0333,-0.058,-0.0641,0.0925,0.0051,-0.0692,0.0471,0.0605,0.0026,0.0,-0.049,-0.0345,-0.2496,0.0681,0.0851,0.0939,0.0421,-0.0056,0.0003,0.0412,0.0615,0.0739,0.0557,0.0531,0.0404,0.0294,0.094,-0.0143,0.0346,-0.0656,0.0014,-0.0406,-0.1079,0.0112,0.0811,-0.0478,-0.0125,-0.0376,-0.1515,0.0801,0.0471,0.0584,-0.1121,-0.0206,-0.0337,0.0487,-0.0197,-0.0205,-0.0947,-0.0687,-0.2184,0.0376,-0.0081,0.1223,0.1116,-0.0758,0.0906,0.0579,0.0411,-0.068,0.0692,0.0189,-0.0709,-0.2781,-0.0378,-0.0352,0.0524,0.0996,-0.2007,-0.1067,-0.1577,-0.105,-0.0398,-0.104,0.0751,-0.1679,-0.0464,-0.071,0.017,0.0012,-0.055,0.0115,0.0551,-0.1231,0.0348,0.0104,0.0443,0.0085,-0.0455,0.0215,0.0058,-0.1033,0.0968,0.0222,0.0579,0.0378,-0.0674,-0.0984,-0.0155,-0.0689,-0.0168,-0.0851,0.1344,-0.0184,0.0479,0.0372,0.0453,-0.0298,0.0106,0.0497,0.0605,0.0649,-0.0103,0.0562,0.0555,-0.0256,0.0433,0.039,0.1017,0.08,0.0226,0.1004,0.0636,-0.0211,0.0134,0.0403,-0.0146,-0.054,-0.0149,0.1225,0.1084,0.0951,0.0312,0.0154,0.0258,0.0733,-0.0369,-0.0302,-0.0145,-0.0446,-0.039,-0.0453,-0.0033,-0.0878,0.0231,-0.0086,0.0318,0.1348,0.0064,0.0028,0.0082,0.0653,0.0503,0.0216,-0.011,0.0313,0.0084,0.0184,-0.0929,0.116,0.1806,0.147,0.1052,0.004,-0.0002,-0.0031,-0.037,0.0061,-0.0859,-0.0322,-0.0363,-0.0536,-0.048,0.0779,0.051,-0.0484,-0.0131,-0.0789,-0.0707,-0.0504,-0.0328,-0.0653,0.038,-0.0266,0.0332,0.0684,0.1251,0.1,0.0782,0.0587,-0.0282,0.0146,0.0009,0.0144,-0.0193,-0.0056,0.0168,-0.0827,0.0777,-0.0146,0.0194,-0.0441,-0.0716,0.0435,0.1156,0.0117,0.1604,0.1443,0.0172,0.0333,-0.0227,0.0679,-0.0064,-0.0257,-0.0108,-0.0409,-0.1639,-0.0544,-0.1057,-0.0726,-0.0762,-0.0431,-0.0136,-0.0967,-0.0585,-0.04,-0.0132,0.0392,0.1036,0.1265,-0.0232,-0.0192,-0.0053,0.1683,0.0202,0.0905,0.0722,0.0939,0.0411,-0.002,0.0109,0.0111,-0.053,0.0777,-0.0474,-0.0228,0.0414,-0.0047,0.0481,-0.0284,0.0207,-0.0301,0.0778,-0.0214,-0.052,0.0492,-0.101,-0.0353,-0.0084,0.0364,0.0488,0.0646,0.0122,0.062,0.1171,0.0869,0.0122,-0.0339,0.0518,0.0626,0.0757,-0.0052,-0.1918,0.0601,0.0671,-0.1495,0.0317,-0.023,0.0443,-0.3032,0.0551,-0.0742,0.0287,0.0874,0.0137,0.1079,0.1224,0.0624,-0.0769,0.0625,0.0723,0.036,-0.0682,0.0248,0.0772,0.0732,0.1021,0.0243,-0.0178,-0.0232,-0.0153,0.0465,-0.0835,0.0744,0.0728,0.0462,0.0321,0.0311,-0.0313,-0.0319,-0.018,-0.002,-0.0983,-0.0163,0.0729,0.0107,0.0677,0.1154,-0.0052,0.0806,-0.0009,-0.0342,-0.0746,-0.0069,0.0017,-0.0137,-0.0311,-0.0539,-0.0413,0.0427,0.0154,-0.1975,-0.0493,-0.0472,-0.1493,0.0305,0.0488,-0.0256,-0.0557,-0.0006,0.01,-0.0216,-0.0159,0.0347,0.0445,0.0029,0.0395,0.0377,0.1297,0.0748,0.1201,0.0518,0.0267,0.0549,0.0351,0.0365,0.0775,0.0569,0.0922,0.0047,-0.0135,-0.0237,0.0298,-0.0287,0.0123,-0.0139,-0.0174,-0.0307,-0.039,0.0839,0.0373,0.0291,0.0264,-0.0301,-0.0119,-0.0063,0.0052,0.0336,-0.02,-0.0095,0.0808,0.0386,-0.0193,0.002,0.0459,-0.0431,0.0003,-0.0097,0.0014,0.1137,0.103,0.084,0.1536,0.1281,-0.1066,-0.0479,-0.0726,-0.007,-0.0595,-0.0585,-0.0026,0.0169,0.0301,-0.0468,-0.0421,-0.0134,-0.0209,-0.0128,-0.0258,0.022,-0.012,0.0036,0.0422,0.0112,0.0933,0.0823,0.0757,-0.0538,-0.0681,-0.0849,-0.0245,0.0122,0.0249,0.0733,0.026,0.0655,0.0259,0.0214,0.0084,-0.0111,-0.1794,-0.0154,0.0268,0.0359,0.0129,0.0646,0.007,0.0198,-0.0741,-0.2045,-0.2952,0.074,0.0584,0.0719,0.0388,0.0481,0.0529,0.0697,0.0778,-0.0072,-0.0142,-0.0714,-0.0312,-0.0313,0.0039,-0.0085,0.0223,-0.1194,0.0551,0.0183,0.074,0.0325,-0.0729,-0.0432,-0.1091,0.0406,-0.0771,-0.0231,-0.0195,0.0316,0.0515,0.0301,0.0262,-0.0628,0.0502,0.0904,-0.0097,0.0169,0.0953,0.0549,0.0241,-0.0018,0.0588,-0.0096,0.0509,-0.002,-0.0227,-0.2492,-0.0115,-0.0287,0.0118,0.0013,-0.0922,0.0143,-0.0075,-0.0389,0.0334,-0.1267,-0.1166,-0.1526,-0.0983,-0.102,-0.0387,-0.1452,-0.0708,0.1508,0.0488,0.0106,0.0213,0.0265,0.0775,0.0787,0.0201,0.0676,0.0575,0.0478,0.0377,-0.0226,-0.0053,0.0472,-0.0779,-0.0825,0.0496,-0.0422,0.0461,0.0603,0.0312,0.0771,0.056,0.0262,0.0757,-0.0041,-0.0712,-0.0753,0.0786,0.0644,0.0505,0.0842,0.049,0.0332,0.0101,-0.1485,-0.0113,0.0587,0.0844,0.0219,0.0136,0.014,-0.1457,-0.1058,0.0525,-0.0387,-0.1536,-0.3373,-0.2684,-0.2734,-0.0366,-0.0535,0.0374,-0.0258,-0.0128,-0.0435,0.0469,0.0329,0.0567,-0.1439,-0.0106,0.0201,-0.0059,0.0653,0.0067,-0.0354,0.0383,-0.1485,-0.2712,0.0235,0.0604,0.0299,0.0625,-0.0023,-0.0663,-0.0267,0.1543,0.1565,0.0798,0.0576,-0.1352,-0.0325,0.0545,0.0241,0.0212,0.0216,0.0225,-0.0538,-0.1135,-0.0064,0.0448,0.1215,0.0493,-0.0715,-0.0459,0.0779,0.0086,-0.1045,0.0446,0.1251,-0.0217,-0.0305,0.0589,0.1085,-0.0037,0.0784,0.0435,0.0864,0.0251,-0.154,0.0001,-0.0181,-0.0574,-0.0129,-0.0362,0.0236,-0.0391,-0.0043,0.0736,-0.0236,-0.0535,-0.0398,0.0374,0.0085,-0.0175,0.0443,0.0823,-0.0183,0.065,0.0896,0.0931,0.0102,-0.1459,-0.0583,0.0891,0.0884,0.0225,-0.0915,0.0762,-0.0023,0.0152,-0.0594,-0.0291,-0.124,0.112,0.0852,0.0908,-0.0656,-0.0046,0.031,-0.0444,-0.0444,0.1175,-0.0099,-0.0372,-0.0117,-0.0332,0.0135,0.011,-0.2414,0.1323,0.1376,0.0836,0.0126,0.09,0.0951,0.0496,-0.0929,-0.0916,0.0283,0.0219,-0.0097,-0.1545,0.009,0.047,-0.001,0.0469,-0.0678,0.0299,-0.0259,-0.014,0.0723,0.0272,0.0794,0.0589,0.0689,-0.0438,-0.0393,-0.0049,-0.3103,-0.2301,-0.2171,-0.0003,-0.2031,0.0874,0.0449,0.0221,0.0832,-0.061,0.0842,-0.0146,0.0189,0.0546,0.0905,-0.1405,-0.0619,0.0918,-0.0102,-0.1317,-0.0319,0.0469,0.0242,-0.0002,-0.0801,0.0417,-0.0118,0.0003,-0.0268,-0.0884,-0.1631,-0.052,-0.1095,-0.1072,-0.0236,0.0034,0.004,0.036,0.0937,0.0439,0.1039,-0.0384,-0.0308,-0.0089,0.0708,0.0861,0.0787,-0.0187,-0.0383,-0.0474,-0.0445,0.0521,-0.0295,0.0006,0.0653,0.1444,0.1561,0.0669,-0.0301,0.0599,0.0526,-0.0027,-0.0067,-0.1004,-0.0765,-0.0258,0.013,0.0211,-0.0527,0.0546,-0.0141,-0.0351,-0.0845,-0.1602,0.062,0.0548,-0.1191,0.0857,-0.0334,0.013,0.0549,0.065,0.0332,-0.1167,-0.0888,0.116,-0.0457,-0.007,-0.0541,-0.21,0.0196,-0.0225,-0.1056,-0.0989,-0.1705,0.0081,-0.0352,0.054,0.0096,0.1295,0.1473,0.0655,-0.0259,0.0119,0.0139,0.1255,0.0077,0.061,-0.0098,0.0664,0.0078,0.0529,0.0371,-0.0388,-0.0079,0.0248,-0.0266,0.0339,0.0834,0.0704,0.0491,0.0637,0.0066,-0.0371,-0.012,0.002,0.0171,0.0469,0.0255,-0.0381,-0.0742,0.065,0.0716,-0.0602,-0.1754,-0.2989,0.0523,-0.0028,0.0664,-0.0048,-0.0211,0.0191,0.0511,0.051,-0.041,0.13,-0.0269,-0.0955,-0.0499,-0.047,-0.0064,0.0125,0.0557,0.081,-0.0116,0.0335,0.0448,0.0002,-0.0965,0.0676,-0.0624,0.0644,-0.008,0.0432,0.0277,-0.0361,0.0,0.0002,-0.0216,-0.0325,0.0129,0.0336,0.0134,-0.0998,-0.0955,-0.1568,-0.1231,-0.0,0.0191,-0.0049,-0.0917,-0.0005,-0.0033,-0.0798,-0.0553,-0.0822,-0.0938,-0.1045,0.0312,-0.0836,-0.0117,-0.0076,-0.0788,-0.012,0.0991,0.102,-0.0041,0.0017,-0.0582,0.0494,0.0322,0.0305,-0.0279,-0.0408,0.0076,0.0351,0.0124,-0.0032,-0.039,-0.0093,0.0037,0.0094,-0.055,-0.009,-0.034,0.0401,-0.073,0.0054,0.0284,-0.0704,-0.1004,-0.0697,0.0413,0.0097,-0.0132,-0.1011,-0.0979,0.0677,0.0509,-0.0415,0.0514,-0.004,0.0254,0.0565,0.0095,0.061,0.0581,-0.071,-0.0061,-0.1427,0.0747,-0.0535,-0.0016,-0.0708,-0.0507,-0.0431,-0.2671,0.08,-0.0209,-0.0569,-0.0296,0.0223,-0.0197,0.0231,0.0915,0.1132,-0.0776,-0.13,0.0395,-0.0038,0.1018,0.0581,0.1139,0.0248,0.0058,-0.0858,0.0583,-0.0646,0.0233,0.0907,0.0802,-0.0206,-0.0155,0.0107,0.0282,-0.0415,0.0081,0.0761,0.0786,0.0641,0.0676,0.0272,0.0236,-0.028,0.0091,0.0245,-0.0567,-0.0715,-0.0667,0.0686,-0.0085,0.0147,0.0123,-0.0523,0.0728,0.0847,0.0389,0.1035,-0.0239,-0.0089,-0.068,0.0261,-0.008,-0.0134,0.024,0.0041,-0.0161,0.0773,-0.0592,0.0275,-0.0125,-0.0063,-0.0842,0.0344,0.0285,-0.0379,-0.0134,0.0743,0.0397,0.0626,0.0225,0.072,-0.0338,0.0272,0.0147,-0.1317,-0.2317,0.1075,0.0696,0.0163,0.019,-0.0703,-0.0878,-0.0042,-0.0219,-0.0303,0.0571,0.0365,0.091,0.0202,0.0161,0.0109,-0.0089,0.0312,0.0201,-0.0234,0.0022,0.0215,0.0091,0.0901,0.1019,0.0818,-0.1708,-0.0086,-0.1722,-0.0229,-0.0328,-0.0458,-0.0635,-0.1082,-0.0866,-0.0261,0.028,0.0441,0.0928,-0.0357,0.0494,-0.0813,0.0855,0.0929,0.0797,0.05,-0.0007,-0.0242,-0.0267,-0.2598,0.0473,-0.1245,-0.1186,-0.1092,-0.0291,0.0289,-0.0392,-0.0429,-0.0433,-0.0152,-0.0401,-0.0297,0.0001,0.1203,0.0788,0.1121,0.0126,0.0611,0.075,0.0513,0.0393,0.0135,0.0682,0.0566,0.0699,-0.0639,0.0192,0.0259,-0.1011,-0.053,-0.0067,-0.061,-0.0157,0.0303,-0.054,0.1116,0.0052,0.0645,0.0113,-0.0364,-0.0155,0.075,0.0599,0.0346,-0.0588,0.1864,0.099,0.1004,0.0796,0.0132,-0.0671,-0.1527,0.1546,0.1002,0.0489,0.026,0.0726,0.0073,-0.0629,0.0266,-0.0203,-0.0867,0.0578,0.0199,0.057,-0.0089,0.035,-0.0013,0.1652,0.0755,0.0469,0.0977,0.1594,-0.0146,0.0941,-0.0777,0.0443,0.0102,-0.0093,0.0261,0.0637,-0.0104,0.1468,0.1719,0.0463,0.0144,0.0831,-0.0059,0.1558,0.108,0.0311,-0.0083,-0.0356,-0.0179,0.0543,-0.077,0.0908,0.0912,0.0628,-0.0402,0.0712,0.0989,0.1027,0.0115,-0.0051,0.0617,0.0379,0.0253,0.1476,0.0616,0.0472,0.0639,-0.0258,0.0386,0.1199,0.0007,0.0448,0.0644,-0.0156,-0.0051,0.1426,0.0908,0.0521,0.139,-0.0537,0.112,0.0824,-0.0207,-0.1623,-0.1106,0.0007,-0.0184,0.0112,-0.1227,-0.1111,-0.0907,0.0845,0.0982,-0.0392,-0.0393,-0.0164,-0.0713,-0.0117,-0.0011,0.0551,-0.0055,0.0177,0.0489,-0.0316,0.0441,0.0683,0.0394,0.0548,-0.0524,-0.0107,-0.0453,-0.1181,-0.067,-0.0201,0.1149,0.0449,0.0774,0.0767,0.1511,0.1107,-0.0903,0.0639,0.0678,-0.3413,-0.2428,-0.2954,-0.2419,-0.2253,-0.2459,-0.1043,-0.1294,-0.1231,-0.0591,-0.2268,-0.2268,-0.3199,-0.3181,-0.1958,0.1201,-0.101,-0.091,-0.0945,0.0774,0.1064,-0.0647,-0.0167,-0.0051,-0.0892,-0.1042,0.0039,0.0242,-0.1851,-0.0584,-0.0553,-0.1359,0.0099,0.032,-0.0207,0.0394,0.0406,-0.0206,0.0192,-0.0072,-0.0922,-0.0015,0.0399,0.0257,0.0178,0.1738,0.0571,0.0922,0.091,0.0848,0.1329,0.0945,0.0344,0.0113,0.0778,-0.0935,-0.1232,-0.0509,-0.0187,0.1172,-0.0667,-0.0209,-0.056,-0.0132,0.0592,-0.0504,0.0752,0.0458,0.0751,0.0089,0.0555,0.0447,-0.0163,-0.0908,-0.1204,-0.0675,-0.0883,0.0428,0.1034,0.0624,0.0829,0.0741,0.0087,0.0566,-0.0161,0.0325,0.0368,-0.1035,0.0101,-0.0137,-0.0772,-0.0416,-0.0012,0.0415,0.0746,-0.0384,0.0022,-0.0136,0.0766,0.0062,-0.0348,0.0676,0.0638,0.0234,-0.0446,-0.0905,-0.0769,0.0475,0.0882,0.0157,-0.0128,0.0129,0.0297,-0.1042,-0.0238,0.0491,0.0264,-0.0616,-0.2074,-0.0025,-0.0415,-0.0109,-0.1284,0.1102,0.1066,0.0341,0.0007,-0.0454,-0.0819,-0.0254,-0.0204,0.0124,-0.0134,-0.052,-0.0461,-0.0391,0.0642,-0.0229,0.0002,-0.0335,-0.0181,-0.0785,0.1188,0.0507,0.0228,0.0632,0.0651,0.0535,0.0129,-0.0346,-0.0419,-0.0299,-0.0353,-0.0071,-0.0268,-0.1453,-0.0352,-0.1426,-0.0021,-0.0043,0.0059,0.0164,0.0358,0.0365,-0.028,0.0864,0.1524,0.1414,-0.0801,-0.0804,-0.0222,-0.0467,-0.0095,-0.08,-0.0538,0.031,0.0288,-0.0404,0.0901,0.1235,-0.1521,-0.0079,0.0495,-0.0222,-0.0617,-0.0567,-0.1525,-0.0006,-0.0065,0.0307,0.0215,-0.2236,-0.1089,-0.1222,0.0268,0.0589,0.0932,-0.0444,0.0019,0.0097,-0.0047,0.0809,0.0367,0.0863,0.0363,0.0542,-0.0567,-0.0339,-0.0661,-0.0016,-0.0046,0.0283,-0.1222,-0.0946,-0.0316,-0.0747,0.0277,-0.0594,0.0211,-0.1089,-0.1212,-0.0385,0.0322,-0.0123,-0.0059,-0.0735,-0.0146,-0.0448,-0.0323,-0.0346,-0.0352,0.0398,-0.0261,-0.02,-0.0534,-0.0222,-0.0223,-0.0014,-0.0164,-0.1468,-0.096,-0.0432,-0.0397,0.1216,0.0603,0.0256,0.0613,0.0947,-0.0498,-0.0474,0.0225,0.0469,-0.0905,-0.1056,0.0905,-0.0071,-0.1112,0.0788,-0.0063,-0.0594,-0.0631,-0.0181,-0.1202,-0.11,-0.1554,-0.0106,0.0099,-0.0467,-0.0982,0.0091,0.0252,-0.0001,-0.0143,-0.0175,-0.1202,0.0248,-0.0215,0.0809,0.1293,0.1391,0.0882,0.0359,-0.0163,0.0528,0.103,0.0352,-0.0973,-0.0339,-0.0218,-0.0411,0.0174,0.0188,0.0367,-0.0786,-0.0535,0.0541,0.0767,-0.0313,-0.0073,0.0599,0.0011,-0.1392,-0.0389,-0.0376,-0.0406,-0.0046,-0.0017,-0.0288,0.005,0.0164,0.062,0.0112,0.0326,0.0263,-0.0362,0.0191,-0.0674,0.003,0.1173,0.0951,0.0333,0.1034,0.0245,0.0026,0.062,0.0365,-0.094,-0.0157,-0.0187,0.142,0.0769,0.0283,0.1454,0.1184,0.0671,0.0362,0.0362,0.0465,0.002,-0.0461,0.0931,-0.0295,-0.0832,-0.0438,0.0493,0.065,0.1789,-0.0321,-0.0815,0.0527,0.0667,-0.1129,-0.0041,0.0545,0.0787,0.0449,-0.0516,-0.0738,0.0142,-0.0682,-0.0827,-0.1367,-0.1566,-0.078,0.0224,-0.0534,-0.1518,-0.0803,-0.0042,0.0864,0.0852,0.0296,0.0793,0.0114,-0.0061,0.0228,-0.0733,0.0153,0.0183,-0.0963,0.0166,0.0691,-0.0065,0.0145,0.1729,0.0523,0.1764,0.0554,-0.0048,-0.0112,0.0463,-0.3165,-0.3166,-0.1349,-0.2109,-0.0949,-0.0686,0.02,0.0251,-0.0107,-0.0009,-0.0407,-0.0929,-0.0173,-0.0805,0.0475,-0.0005,-0.0769,0.0453,0.0174,0.0179,0.0297,-0.2833,-0.0203,-0.2794,-0.1549,-0.2597,-0.0866,-0.1873,-0.1006,-0.0398,0.0502,0.087,-0.055,-0.0052,0.0297,-0.0065,0.1213,0.0337,-0.0755,0.0296,0.0806,0.0812,-0.0058,-0.0133,0.0671,0.0367,0.0683,-0.0068,-0.0347,-0.0226,-0.1031,-0.0386,0.005,-0.0603,0.0004,0.0406,0.0386,0.0499,0.0131,-0.0564,-0.059,0.024,-0.1612,-0.0892,-0.0656,0.0193,0.0288,-0.071,-0.0227,0.0487,-0.0363,0.0239,0.0482,-0.0291,-0.065,0.0218,0.0305,-0.0025,-0.0043,-0.0052,0.1009,0.0893,0.0674,0.075,-0.0575,-0.0096,-0.0063,0.094,0.051,0.0787,0.0141,0.0432,-0.0007,0.0087,-0.1349,0.0103,0.035,0.0295,0.0083,0.0234,0.0506,0.0614,-0.0924,-0.1116,0.0509,0.0304,-0.0543,0.0106,-0.0452,-0.0319,-0.0626,0.0066,-0.0344,0.0541,-0.0551,0.0284,0.0438,-0.0817,0.0829,-0.0726,-0.1367,-0.0313,-0.0339,-0.05,-0.0198,0.059,0.0905,0.0625,0.0576,-0.014,-0.0843,0.0171,0.0121,0.0457,0.0844,0.1196,0.0587,0.0586,-0.0241,0.0361,0.097,0.1086,0.1055,0.0452,0.0265,0.0436,0.0448,0.1533,-0.0657,-0.1132,-0.108,-0.0534,-0.013,-0.0248,-0.0702,-0.0045,0.0194,0.0418,0.0189,0.0415,0.0256,0.091,0.0341,-0.004,-0.0067,0.0724,-0.012,-0.0274,-0.0147,0.0346,-0.0531,0.0523,0.0021,0.0661,0.0617,-0.0321,0.0665,0.0657,0.1118,0.0627,-0.1365,-0.1001,0.054,0.055,0.0376,-0.0501,0.0308,0.0705,0.0565,0.0905,0.1071,-0.0061,0.0299,-0.0173,-0.0243,0.0087,-0.0023,-0.0114,-0.0444,0.003,-0.0198,-0.0292,0.0091,0.0024,-0.0031,0.0893,0.052,0.0893,-0.0081,-0.1203,0.0461,-0.0342,-0.0111,-0.0344,-0.0422,-0.1694,0.0428,0.0417,0.0884,-0.0181,-0.0151,-0.1289,-0.0864,-0.0657,0.0184,0.019,-0.0237,-0.0554,-0.039,-0.03,-0.0113,0.1225,0.0001,-0.0028,-0.0537,0.0532,-0.0202,-0.1225,-0.0877,0.0047,-0.0717,-0.0167,0.0132,-0.0473,-0.0176,-0.0014,-0.0291,-0.0145,-0.0297,0.0634,-0.0803,-0.0323,-0.0209,-0.0568,-0.0337,-0.0345,-0.1114,-0.029,-0.0234,-0.0188,-0.0393,0.0361,0.0194,-0.0347,0.1064,0.112,-0.1065,-0.0558,-0.1123,-0.0459,0.0207,0.168,0.1467,0.0858,0.1046,0.0272,0.0025,-0.0054,0.0499,0.0001,0.0346,0.1172,0.0296,0.0917,0.1016,-0.1797,0.0964,-0.0299,0.162,0.0773,-0.0182,-0.061,0.0506,0.0165,0.0178,-0.1158,0.0716,-0.058,0.059,-0.0549,0.0431,0.0254,-0.0381,-0.0358,-0.213,-0.0936,-0.0756,0.0983,0.0254,0.0206,0.002,0.1109,0.0438,-0.0351,0.0852,0.0444,0.0272,0.0964,-0.0164,0.0804,-0.0247,0.0062,0.0137,0.019,0.0303,0.1383,0.0578,-0.0383,0.0242,0.1091,0.0305,-0.0842,0.0342,-0.0157,0.0171,-0.0508,-0.2347,-0.2102,0.0968,0.0418,0.0202,0.0404,-0.0736,-0.0701,0.0128,-0.0065,0.0144,-0.0366,-0.019,-0.0301,-0.0031,-0.0579,0.0716,0.0872,0.0728,0.146,0.0591,0.0523,0.1178,0.0911,0.0454,-0.0849,-0.0652,-0.0193,0.0145,0.0937,-0.2864,-0.2594,-0.2354,-0.0801,-0.0304,-0.1809,0.1342,0.0852,0.087,-0.0536,-0.059,-0.0954,-0.0365,0.0161,-0.1934,-0.1079,-0.1779,-0.0192,0.0313,0.0621,-0.0324,-0.0824,-0.0345,-0.02,-0.0485,0.0346,0.0656,-0.0285,-0.0526,-0.0,0.0344,0.0717,0.0342,0.0639,-0.0016,-0.0526,-0.01,-0.0515,-0.0452,-0.0658,-0.0313,-0.0273,0.0001,-0.0379,-0.0281,-0.0986,-0.0393,-0.0257,-0.0918,0.0015,-0.0205,-0.0071,-0.1881,-0.0745,-0.0801,-0.0083,-0.0831,-0.0805,-0.0543,-0.0161,-0.0119,-0.0234,0.0228,0.0299,-0.0228,-0.2057,-0.0372,0.0705,0.022,-0.0228,-0.1934,-0.0011,-0.0084,-0.0239,-0.103,-0.0751,-0.0814,-0.0787,-0.109,-0.098,-0.0149,-0.1195,0.0511,0.0574,-0.0347,-0.0176,-0.0743,-0.0682,-0.0774,-0.0306,0.0549,0.0289,-0.0003,-0.2733,-0.0261,0.0244,0.0216,0.0577,0.136,0.0879,0.0776,0.0257,0.064,0.0456,0.0339,0.0581,-0.2407,-0.219,-0.1813,0.0423,-0.0625,-0.0107,0.028,0.002,0.0151,0.0242,-0.1052,-0.0801,-0.0836,-0.0404,-0.0196,-0.0682,-0.0403,0.0282,0.029,0.039,0.0657,-0.0713,-0.0191,0.0468,0.0426,-0.0292,-0.073,0.004,0.0379,-0.0095,0.0214,0.0257,0.0138,-0.0223,0.0595,-0.0569,-0.003,-0.1019,-0.0978,0.021,0.0543,0.0263,0.0128,-0.0544,0.001,0.0271,0.1269,0.111,0.0316,0.0503,-0.0804,0.0726,0.0978,0.0083,-0.0182,-0.1897,-0.1886,-0.0854,-0.0793,-0.088,-0.1998,-0.0597,-0.0523,0.0276,-0.0177,0.0159,0.0595,0.0631,0.0321,0.0395,-0.0757,-0.0627,-0.0089,0.0805,0.0815,0.0344,0.0714,0.063,-0.1478,0.0222,0.0409,0.0015,0.0638,0.075,0.0803,-0.01,0.0916,0.0338,0.0561,0.038,-0.0212,0.0002,0.0186,0.0287,-0.0423,-0.0656,0.0084,0.0729,-0.105,0.0531,-0.0304,0.0644,0.0923,0.0336,0.0197,-0.003,0.007,-0.0603,0.0542,0.0736,0.0292,-0.0775,0.0125,-0.0491,0.0315,-0.0431,0.0872,0.1324,0.0085,-0.0441,-0.0237,0.0124,0.0487,-0.051,0.0365,0.0302,0.0073,-0.0865,-0.0395,-0.0297,-0.0131,-0.0299,-0.0554,-0.0012,-0.1376,-0.0593,-0.1424,0.0069,-0.3066,-0.3083,0.0266,0.0586,0.0144,-0.0249,-0.0263,-0.1457,-0.1445,-0.0993,-0.0085,0.0024,0.0189,-0.0504,-0.0165,0.0327,0.0952,0.0635,0.1107,-0.0279,0.0514,0.0978,0.0391,0.0127,-0.0706,0.0057,0.0434,0.061,-0.2179,0.0152,0.0674,-0.2771,-0.1249,-0.1046,-0.0083,-0.0606,-0.0521,-0.1094,0.0131,-0.0055,0.0073,-0.0019,-0.0358,-0.0514,-0.011,-0.0273,0.0067,0.0218,0.0211,-0.1009,-0.0672,0.0678,-0.0112,-0.014,0.0931,0.0673,0.0792,0.0061,0.01,0.0665,0.0276,0.1453,0.0715,0.0094,0.1036,0.1043,0.04,-0.0376,-0.0169,-0.0083,0.0134,0.0444,0.0359,0.0131,0.0739,0.1509,0.1153,0.0533,0.0301,-0.0025,0.0054,0.1017,-0.0111,-0.0084,0.0657,-0.0159,-0.0391,0.0649,0.0441,0.1326,0.101,0.0091,-0.0052,0.0647,0.1363,-0.0325,0.0288,0.0742,0.0546,0.0595,0.0418,-0.0416,-0.0574,-0.075,-0.0387,-0.0757,0.0014,-0.0442,-0.0341,-0.1956,0.0934,-0.124,0.0839,0.0464,0.0409,-0.0495,-0.0739,0.0257,-0.077,-0.1021,-0.0461,0.005,-0.2081,0.0152,0.0187,-0.1075,0.05,0.0605,0.1031,-0.0288,-0.0025,-0.0828,-0.1259,0.145,0.1097,-0.0944,-0.1113,0.0094,-0.1631,-0.0207,-0.0015,0.0703,0.0992,0.0146,0.0813,0.0883,0.0312,0.0496,-0.0676,-0.0479,-0.03,-0.0422,-0.1168,0.0234,-0.0189,-0.0007,-0.0233,0.0098,0.0314,0.0361,-0.0029,0.0043,0.0193,0.0429,0.0683,-0.0144,-0.0055,0.0806,0.0668,0.0259,-0.0225,0.0576,0.0297,0.0224,-0.0358,-0.0449,0.0128,-0.091,-0.0068,0.0317,-0.0143,0.034,-0.002,0.0486,0.06,0.0104,0.0827,-0.1005,-0.0208,-0.1452,0.0323,-0.0421,0.0336,0.0824,-0.061,0.0143,-0.0742,-0.0929,0.0671,0.096,-0.0732,0.056,-0.0198,0.0325,-0.1148,-0.116,0.1143,-0.0172,0.0202,0.0452,-0.0519,0.1212,0.0961,0.0043,-0.0699,-0.0204,-0.0206,0.0347,0.0848,0.0387,-0.033,-0.0429,-0.0209,-0.0152,0.0455,0.0274,0.1196,0.0277,0.0065,0.0478,0.0355,0.0801,-0.2729,0.1162,-0.003,0.0211,0.0286,0.1459,0.1275,0.0004,0.0656,0.0546,-0.0366,0.0184,-0.1796,0.0634,0.0367,-0.1502,-0.1194,-0.0751,-0.0354,0.0262,0.0208,-0.0274,0.001,-0.0011,-0.1099,-0.1446,-0.0269,-0.0724,-0.1132,-0.0592,-0.0345,-0.1003,-0.1144,-0.1025,-0.0607,-0.0282,-0.0588,-0.1097,-0.0674,0.0569,-0.2142,-0.0406,-0.1181,-0.2196,-0.0404,0.0855,0.0578,0.1135,-0.0068,0.0701,0.087,0.0975,0.0415,-0.2463,-0.1767,0.1688,0.1489,0.0453,-0.0374,0.0528,0.1018,-0.0953,0.024,0.0545,-0.0042,0.019,0.0129,0.0111,0.0062,0.0552,-0.0367,0.1585,0.1576,-0.0607,-0.0165,-0.0025,-0.004,-0.0143,0.0494,0.0518,0.0404,0.0454,0.115,0.0614,0.1185,0.0198,0.1141,0.0234,0.0217,0.0191,0.0321,0.1076,0.0223,0.1001,0.0409,0.0412,0.006,-0.1113,0.0201,0.0406,-0.0428,0.0454,0.0654,-0.0735,categorization
trm_557b476527a27,0.0098,0.0508,0.0623,0.0663,-0.0075,-0.0203,0.0222,-0.0437,-0.0709,0.0333,0.0319,0.0385,0.0295,0.0583,0.0736,0.0267,0.074,0.1271,-0.011,0.116,0.08,0.0296,0.0261,0.011,0.0649,0.0428,0.0424,0.0947,0.0693,0.0346,0.0989,0.1053,0.0836,0.0661,0.156,0.1274,0.0124,0.0204,0.0817,0.0115,0.0888,0.0519,0.0129,0.0068,0.075,0.1231,-0.0674,-0.0115,-0.1123,0.0611,0.0329,-0.0886,-0.0423,-0.0752,0.0742,0.039,0.0372,0.054,-0.0298,0.0472,0.0183,-0.009,0.1921,-0.0477,-0.0413,-0.1443,0.202,0.2153,0.0764,0.0338,-0.1121,-0.0178,-0.0601,0.129,0.0791,0.0273,0.0558,-0.0135,-0.0599,0.0221,0.0382,-0.0697,0.0881,0.1183,-0.0716,-0.0889,-0.0457,-0.0102,0.0217,0.0396,0.0927,-0.0601,0.0279,-0.3125,-0.1951,-0.2291,-0.1427,-0.0991,-0.2761,-0.1609,-0.0418,0.0226,-0.1346,-0.182,-0.1216,0.1051,0.2246,-0.1396,-0.0173,-0.0031,-0.0065,0.0958,-0.0927,-0.1604,0.0036,0.0244,0.0891,-0.1787,0.0197,0.0133,0.1585,0.1663,0.1914,0.0122,0.1048,0.1804,0.1112,-0.0649,-0.0676,-0.0527,0.1562,0.0148,-0.0049,0.2336,0.0692,0.2289,-0.0612,0.1368,0.0758,-0.0242,0.0623,0.0508,0.0075,0.0665,0.0933,-0.0906,-0.0322,-0.0163,0.0473,0.0067,0.0675,0.1575,0.1061,0.1301,-0.0794,0.0038,-0.0863,-0.0489,-0.0129,0.039,0.0401,0.1092,0.1987,0.1922,-0.0025,0.0097,0.03,0.2179,0.2114,0.0179,0.0727,0.1814,-0.0429,0.2562,0.1406,0.2117,0.1581,0.1296,0.0885,-0.0075,0.1688,-0.0219,0.077,-0.0594,0.025,0.0356,0.0428,0.1711,0.0856,0.1094,0.1129,0.0979,0.0558,0.1078,0.0982,0.1531,0.1663,0.0995,0.0346,-0.0454,-0.119,-0.3943,0.262,0.1739,-0.036,0.0415,0.2196,0.0456,0.0341,0.013,0.1849,0.0846,-0.0216,-0.0005,0.002,-0.0053,-0.0411,0.0876,-0.0365,0.0588,-0.0948,0.1427,0.1581,0.053,-0.1088,-0.0217,0.0679,-0.0871,0.0465,-0.1787,-0.1166,0.196,-0.1662,0.0564,0.0436,-0.1388,0.0839,0.0037,-0.025,0.0717,-0.0525,0.1516,0.012,-0.0088,0.0495,0.1041,0.1234,0.1317,0.0067,0.1961,-0.0092,-0.0381,0.0314,-0.0742,-0.0521,0.1419,-0.0294,0.0145,-0.0858,-0.1246,-0.094,-0.2407,0.0924,-0.0629,-0.1977,-0.3123,-0.1553,0.0475,0.0746,0.092,0.0357,-0.0103,0.1436,0.0625,-0.0337,-0.0354,-0.0591,0.0352,-0.0302,-0.0788,-0.0585,0.1372,0.1171,0.3791,0.3311,0.0582,-0.0147,-0.0044,0.0733,0.1113,0.0576,0.0872,0.0118,0.0983,0.0541,-0.0526,0.0268,-0.1328,0.04,-0.208,-0.0735,0.2122,0.0686,0.0927,-0.1338,-0.1509,0.095,0.0588,-0.0539,0.0146,-0.0517,-0.0077,0.0758,-0.0381,-0.0429,-0.0249,-0.1412,0.0094,-0.0209,0.1526,0.0238,-0.0257,0.1216,0.2092,0.0494,0.07,0.0249,0.0585,0.0137,0.0482,0.0031,0.0852,0.0441,0.0342,0.003,-0.1775,-0.048,0.0019,0.1097,0.1141,0.0899,0.0404,-0.0636,-0.0481,-0.0405,-0.0959,0.1254,0.0722,0.0833,0.0588,0.0332,-0.1485,-0.0289,-0.0698,0.06,0.0036,0.0403,0.1292,0.0458,0.0436,0.02,-0.0187,-0.0928,-0.0668,-0.0695,-0.0808,0.0762,-0.2789,0.0127,0.0461,0.068,-0.0642,0.0132,-0.1573,0.1079,0.0008,0.0574,-0.0507,-0.0006,-0.0765,-0.0093,-0.1325,0.0211,-0.0831,-0.0725,-0.1309,0.1061,0.0089,-0.0516,-0.0076,-0.1001,0.0229,-0.0275,0.0765,-0.1028,-0.1323,-0.082,0.0896,0.0112,0.044,0.071,-0.0168,-0.0323,0.0164,-0.043,-0.0866,0.0182,-0.0245,0.0659,0.0146,0.0051,0.1962,0.0763,-0.0967,0.1829,0.0782,-0.1165,0.0163,0.0853,0.0182,-0.0115,0.1191,0.0524,0.3048,0.291,0.043,0.1679,-0.0285,0.1098,-0.0163,0.0914,-0.05,0.0367,-0.0133,0.0701,-0.0377,-0.0401,-0.0437,0.1669,0.0823,-0.0197,-0.0724,0.0465,-0.0307,0.0647,0.0069,-0.0622,-0.2154,0.2014,0.0568,-0.0693,-0.069,0.0767,0.0346,-0.0463,0.1839,0.0152,0.0612,0.0412,0.0552,-0.0175,0.0333,0.075,0.0754,0.1207,0.0928,-0.0306,-0.2276,0.0437,-0.0018,-0.1077,-0.0571,-0.1176,0.0945,0.1326,0.0258,-0.0485,-0.0265,0.0159,0.0006,-0.224,-0.0906,-0.0624,-0.0771,-0.0516,-0.0984,-0.0327,-0.0357,0.1176,0.0096,-0.0306,-0.1892,0.1514,0.2391,-0.0266,0.0374,0.1475,0.001,0.0093,0.0709,0.0542,0.0292,0.0243,0.1039,0.0386,0.1213,0.0421,0.0818,0.0646,-0.1605,0.1201,-0.1186,0.1064,-0.0301,-0.0796,-0.0636,0.1029,0.0738,-0.1931,0.0837,0.0225,0.0171,-0.0118,-0.1281,-0.1338,-0.0132,-0.1536,-0.2023,-0.0889,-0.0366,0.0838,0.0146,0.0323,0.2753,0.1596,0.0223,0.2051,0.111,0.0608,0.1675,0.0605,0.0233,-0.0298,0.0138,0.083,0.0298,0.0079,-0.0381,0.0232,0.0803,-0.0914,0.0617,0.0391,-0.1317,0.0019,0.1632,-0.0518,-0.0683,0.039,0.0121,0.1165,0.0307,0.1689,-0.0538,0.0806,-0.0322,-0.0226,0.1782,0.0154,0.0788,0.1052,0.1064,0.0122,-0.0533,-0.2275,-0.1661,-0.0523,-0.0828,-0.0311,-0.0234,0.002,0.0939,0.0476,0.0044,-0.1614,0.0059,-0.2185,-0.0261,-0.1331,0.0396,0.1099,-0.057,-0.1334,-0.114,-0.0592,-0.0274,0.1895,0.0773,-0.1636,0.0659,-0.0075,-0.0683,-0.0541,-0.0394,-0.103,-0.1924,0.0813,0.0602,0.0461,-0.0691,0.1507,0.025,-0.0515,0.0277,0.2042,0.0785,0.0603,0.0332,0.0099,0.241,0.0259,0.1691,-0.104,0.0009,0.0234,-0.0785,0.0753,0.1156,0.0092,-0.0598,-0.096,-0.1472,0.0862,0.0104,-0.0864,-0.1401,-0.048,-0.0297,0.095,-0.0744,0.0094,-0.129,-0.0394,-0.1284,0.1374,0.0564,0.3642,0.1889,-0.1933,0.3287,-0.0332,0.2239,-0.2552,0.2363,0.0512,0.0256,-0.2004,0.0091,0.0456,0.0683,0.2917,-0.2005,-0.1255,-0.1242,-0.1601,-0.0981,-0.0697,0.1124,-0.1446,-0.0074,0.0106,0.0684,0.0843,0.0163,0.0445,0.0607,-0.1756,0.137,0.0167,0.052,-0.0704,-0.0995,-0.0851,-0.0596,-0.1658,0.1285,0.0375,-0.0145,-0.0664,-0.0786,-0.0192,-0.1494,-0.1809,-0.0674,0.004,0.1193,0.0192,0.0391,0.0259,-0.002,-0.0426,-0.0104,0.0274,0.1259,0.0954,-0.001,0.1552,0.2065,0.1405,-0.0558,-0.0435,0.0576,0.0919,0.0222,0.0927,0.0526,0.0149,-0.0102,0.1561,-0.0153,-0.0682,0.0553,0.4495,0.4337,0.3196,0.0363,0.0326,0.092,-0.0202,-0.0024,-0.0075,0.0679,-0.0261,-0.075,-0.0952,-0.0133,0.0025,-0.0585,-0.0859,-0.2133,0.1684,0.026,0.0272,0.0146,0.0692,0.1195,-0.0362,-0.0365,0.028,-0.0074,-0.0125,-0.0365,0.1767,0.2706,0.2362,0.16,-0.0221,-0.0785,0.052,0.0753,0.0679,-0.0842,-0.08,-0.0274,-0.0412,-0.0248,0.1506,0.0364,-0.0838,-0.127,-0.1413,-0.1201,-0.0062,-0.0528,-0.0581,0.0631,-0.0208,0.0989,0.1081,0.0565,0.1536,0.1135,0.0852,-0.077,-0.0166,0.011,-0.0314,0.0339,-0.0805,-0.0615,-0.0476,0.0639,0.0302,0.0336,-0.0385,-0.0477,-0.0974,0.146,-0.106,0.0957,0.097,-0.1295,-0.0487,-0.0861,0.0242,0.0674,-0.0557,-0.0293,-0.0315,-0.2022,-0.0398,-0.1278,-0.0427,-0.0876,-0.0611,-0.0632,-0.2132,-0.1326,0.0168,-0.017,-0.037,0.1553,0.2185,-0.0739,0.0903,0.0939,0.2401,0.0781,0.1601,0.1469,0.2583,0.0058,0.0022,0.0392,0.107,0.0169,0.0038,-0.1361,-0.0876,0.0214,-0.0705,-0.1415,-0.0357,-0.0582,-0.0739,-0.0285,-0.1087,-0.106,0.1197,-0.1101,-0.0366,-0.0371,0.0704,0.0993,0.0656,-0.0948,-0.0975,0.4109,0.2502,-0.0176,-0.0502,-0.0988,-0.0498,0.0109,-0.0967,-0.1731,0.0017,0.0569,-0.1702,0.0847,0.0208,0.2161,-0.284,0.0612,-0.108,-0.1838,-0.018,-0.1821,0.2732,0.2838,0.0737,-0.2087,0.047,0.0613,0.0837,-0.0357,-0.0269,0.1041,0.0997,0.0806,-0.0736,0.007,0.0007,-0.1403,0.047,-0.0242,0.1706,0.0998,0.0207,-0.0526,0.1104,-0.0725,0.0016,-0.0697,-0.0985,-0.0783,-0.1288,0.1135,0.0519,0.1607,0.0739,0.0696,0.061,-0.0554,-0.1181,-0.0677,0.0216,0.0535,-0.1041,-0.1499,-0.1531,-0.0589,0.017,0.0895,-0.0227,0.0298,0.0323,-0.0823,0.0112,0.1243,-0.0147,-0.0062,-0.01,0.0288,0.0546,-0.0253,0.1202,0.0132,0.0381,0.1073,0.0967,0.323,0.1735,0.341,0.0662,0.0791,0.1265,0.1941,0.1792,0.1866,0.2071,0.286,0.0761,0.1,-0.015,-0.0117,-0.126,0.0329,-0.0556,-0.0861,0.0417,-0.0772,-0.0054,-0.023,0.0239,0.0534,-0.0958,-0.0873,0.0505,0.0268,-0.0148,-0.0754,-0.0072,-0.0527,0.0743,-0.034,0.0609,-0.0003,-0.012,-0.0897,-0.03,-0.0492,0.1469,0.1019,0.1074,0.2616,0.2062,-0.1159,-0.0869,-0.0885,-0.0611,-0.0593,0.0102,-0.0779,-0.0667,-0.0199,-0.0034,-0.0439,-0.0207,0.0033,0.0616,0.0382,0.0502,-0.0286,0.0052,0.054,0.0537,0.1598,0.2303,0.1948,-0.114,-0.0959,-0.1541,-0.0044,0.0191,0.1652,0.1018,-0.0114,0.0224,0.0521,0.0048,0.0332,0.0212,-0.0474,-0.0013,-0.0403,0.1143,0.025,0.1299,-0.0128,0.0682,-0.076,-0.1961,-0.3611,-0.1161,-0.0374,-0.0389,-0.1112,0.0002,0.0478,0.0556,0.0979,0.0048,-0.0258,-0.0825,-0.0701,-0.0144,-0.1063,-0.0325,0.0809,-0.0562,0.1609,0.1009,0.2379,0.0886,-0.1422,0.0046,-0.0463,0.1524,-0.1459,-0.051,0.0131,0.0517,0.0463,0.0434,0.0548,-0.0942,0.0733,0.1147,0.0528,-0.0037,0.1458,0.1221,0.0682,0.081,0.1258,0.0828,0.0762,0.0685,0.003,-0.0904,0.0059,-0.0375,-0.0647,0.0889,-0.0648,0.1366,0.0047,0.0171,0.1324,-0.1383,-0.1005,-0.2822,-0.2561,-0.251,-0.0471,-0.2365,-0.0144,0.1028,0.0396,0.0292,0.0397,0.006,0.1043,0.1475,0.0444,0.1024,0.0891,-0.0176,0.0224,-0.0682,-0.0058,0.127,-0.0566,-0.0413,-0.0136,-0.0933,0.0127,0.0943,-0.0086,0.0736,0.1243,-0.026,0.0311,-0.1025,-0.0532,-0.1726,0.0371,0.22,0.1996,0.1339,0.0621,-0.0748,-0.05,-0.1153,0.0686,0.2039,0.1835,0.0374,0.0206,0.0208,-0.1911,-0.2151,0.0963,-0.0301,-0.1045,-0.3222,-0.3157,-0.2386,-0.1113,-0.0482,-0.0831,-0.0874,-0.1013,0.0464,0.2202,-0.0349,0.0722,-0.2031,0.0277,0.0623,-0.0345,0.0946,0.0593,-0.0455,0.0894,-0.0141,-0.1616,-0.0458,0.0809,0.0077,0.0486,-0.1026,-0.0921,-0.0822,0.1235,0.1038,0.1696,0.0867,-0.0233,0.0714,0.1087,0.0309,0.0583,-0.2213,-0.0708,-0.1763,-0.314,-0.0278,-0.0693,0.0594,-0.0736,-0.0991,-0.2518,0.0698,-0.2283,-0.3543,-0.0631,0.1282,-0.2625,-0.2298,0.0742,0.1187,-0.0054,0.1613,0.0833,0.2904,0.0554,-0.1867,0.0754,0.0899,-0.0986,0.0234,0.0286,0.0237,0.088,0.0579,0.1404,-0.0381,-0.0372,-0.004,-0.0079,0.0202,-0.0448,-0.0003,0.1715,-0.002,0.0502,0.1192,0.0598,0.062,-0.1486,-0.0945,0.1942,0.0575,-0.0366,-0.04,0.0364,-0.0609,0.004,-0.0365,0.0021,-0.1589,0.0582,0.0818,0.0248,-0.1087,-0.0686,0.0435,-0.0606,-0.0606,0.1226,-0.0355,-0.0035,-0.0479,-0.0336,0.0098,0.0876,-0.3224,0.1996,0.1931,-0.0274,0.0545,0.1454,0.1646,0.112,0.019,0.0156,0.1215,0.0023,-0.0454,-0.2217,0.0502,-0.0262,0.0247,-0.0506,0.0036,-0.0814,-0.0691,-0.0111,0.1135,-0.0368,0.0963,0.0893,0.1163,-0.0591,-0.078,0.0446,-0.2966,-0.1725,-0.2956,-0.06,-0.2556,0.1656,0.0877,-0.0317,0.1445,-0.0045,0.1781,0.1306,-0.0144,0.0983,0.1722,-0.1404,-0.0002,0.1806,-0.0076,-0.0532,-0.0052,0.0811,-0.0075,0.0637,-0.008,0.0815,-0.0865,0.0639,-0.0919,-0.1996,-0.2056,-0.1928,0.0025,-0.057,0.0537,0.0308,0.0379,-0.0187,0.0792,-0.0335,0.1218,0.0307,0.0166,-0.0489,0.0778,0.1223,0.1228,-0.0494,-0.0372,-0.0979,-0.0081,0.0911,-0.0064,0.0776,0.1215,0.1947,0.2579,0.0974,0.0186,0.1496,0.1385,0.0266,0.0313,-0.0025,-0.0537,-0.0681,0.1142,0.0888,-0.091,0.1417,0.0305,-0.0733,-0.0704,-0.0719,0.2366,0.0036,-0.1522,0.0855,0.0265,0.0349,0.0427,-0.0702,-0.0817,0.0196,0.0071,0.2002,-0.0525,-0.0242,0.0125,-0.2494,0.0428,-0.0285,0.0013,-0.0558,-0.1712,0.083,-0.0185,0.1159,0.051,0.1264,0.1325,0.0727,-0.1159,-0.0226,0.0989,0.17,0.0208,0.0834,-0.0097,0.1265,0.0958,0.0269,0.0058,-0.0122,-0.0731,0.0443,-0.0137,0.033,0.1261,0.0759,0.0918,0.0677,0.0456,0.0041,0.032,-0.1704,0.0041,0.0186,0.0407,-0.0693,-0.0857,0.142,0.2616,-0.1057,-0.0867,-0.2324,0.0006,-0.0007,-0.0062,-0.0881,-0.0931,0.0339,0.072,0.1305,-0.0018,0.2604,-0.0,0.0195,-0.0182,0.0853,0.0241,0.0488,0.154,0.1478,-0.252,-0.117,-0.0434,-0.047,-0.3302,-0.0093,-0.1249,-0.0091,0.0047,0.0315,0.0529,-0.1684,-0.0785,-0.0592,-0.0953,-0.0552,-0.0232,0.0953,0.0032,-0.0645,-0.1223,-0.1452,-0.1006,0.0956,0.0988,0.0265,-0.1119,-0.0972,-0.0193,0.0472,0.0024,-0.0759,-0.0164,-0.0524,0.0066,-0.1022,-0.0547,-0.0225,-0.0496,0.0264,0.1252,0.0247,-0.0502,0.0183,0.085,0.1366,0.0054,0.1316,0.0211,-0.1024,0.0702,0.0648,0.0721,-0.0348,-0.1154,-0.2742,-0.0075,0.0174,-0.0398,0.0338,0.0512,0.0903,-0.0775,-0.0496,0.0166,-0.1504,-0.1307,-0.105,0.0584,0.0712,-0.0819,-0.4592,-0.4625,0.1979,0.1682,-0.1234,0.0347,-0.0188,0.0603,0.1525,-0.0497,0.1018,0.0891,0.0005,-0.0214,-0.2523,0.0654,-0.1956,-0.0506,0.0119,-0.2056,-0.4002,-0.171,0.0701,-0.1749,-0.0392,-0.0909,0.0038,0.0143,0.0422,-0.0289,0.008,-0.009,-0.0342,0.0391,0.0533,0.0617,0.006,0.1692,0.0655,0.0691,-0.0978,0.1541,0.0389,0.0171,0.1438,0.1139,0.0471,-0.0384,0.0639,0.046,-0.0574,0.0431,-0.0314,0.0833,0.0071,-0.065,0.0579,0.1083,-0.0046,0.0619,-0.0152,-0.0185,-0.1457,-0.0654,0.0537,-0.074,-0.0818,-0.0179,-0.167,0.152,0.1768,-0.0957,0.1955,-0.1065,-0.059,-0.1588,0.0638,-0.0636,-0.009,0.0325,-0.0408,-0.0681,0.0518,-0.0854,-0.0616,-0.1019,-0.0291,-0.0983,-0.1581,-0.1741,0.0379,0.061,0.0819,0.017,-0.0239,-0.0025,0.1701,0.0242,0.0048,-0.0524,-0.0658,-0.1128,0.2569,0.133,0.0417,-0.1157,0.0073,-0.052,-0.0297,-0.0266,-0.01,-0.0162,0.0537,0.0842,-0.0108,-0.0218,-0.055,0.0331,0.0815,0.0577,-0.0117,0.077,0.0588,-0.2409,0.1168,0.1351,0.0703,-0.2839,-0.1755,-0.1398,0.0607,-0.0682,-0.0859,-0.0504,-0.1376,-0.2318,-0.1568,0.0065,-0.0399,0.0146,-0.1081,0.0479,-0.0907,0.2019,0.064,0.1145,0.1322,0.0152,0.0045,-0.0536,-0.1602,0.052,-0.1379,-0.1222,-0.1885,0.009,-0.0269,0.0142,0.0004,-0.0651,-0.108,-0.1861,-0.1431,-0.2601,0.1994,0.1226,0.1705,0.0463,-0.0636,0.124,0.093,0.1261,0.0924,0.1031,-0.1232,-0.0154,-0.2142,-0.0568,-0.0161,-0.1258,0.0096,0.0313,-0.0027,-0.1007,0.0992,0.0007,0.1575,0.0413,0.0792,0.0516,-0.0676,-0.1169,-0.012,-0.0326,-0.0584,-0.0112,0.2055,0.1044,0.1537,0.1173,0.006,0.0075,-0.0476,0.1473,0.1733,0.0657,0.0469,0.0295,0.0025,-0.0358,0.0417,0.0269,-0.0054,0.125,0.0517,0.1031,-0.0987,-0.0362,-0.0072,0.4494,0.0542,0.1546,0.2111,0.5045,-0.0215,0.1396,-0.0065,0.0588,-0.0194,-0.0041,-0.0164,0.0856,0.0079,0.3033,-0.0109,0.0516,-0.2064,0.0431,-0.055,0.1724,-0.0181,-0.1177,-0.2845,0.0736,0.0498,0.0754,-0.1446,0.254,0.2936,0.2652,0.0337,0.0745,0.1484,0.1416,0.0891,0.1068,-0.0362,0.0255,0.0033,0.2228,0.0163,-0.0191,0.0558,0.0109,0.0223,0.0816,0.1301,-0.0971,-0.0051,-0.0208,0.017,0.1721,0.3141,0.1152,0.1759,-0.0091,0.3224,0.2308,-0.0015,-0.1543,-0.1196,0.0518,0.0412,0.0211,-0.1893,-0.1716,-0.2137,0.4056,0.4228,-0.0543,-0.1179,0.0276,-0.0208,-0.0527,0.0708,0.0166,-0.0056,0.0566,0.1074,-0.0505,0.0452,0.1199,0.0017,0.1732,-0.0927,-0.0066,-0.1146,-0.1726,-0.1486,0.0461,0.187,0.2872,0.09,0.0796,0.1919,0.1234,-0.118,0.0664,0.0882,-0.3124,-0.1887,-0.1813,-0.2696,-0.1169,-0.1736,-0.2103,-0.1527,-0.1557,-0.0937,-0.1643,-0.1958,-0.2431,-0.3152,-0.2256,0.3568,-0.0421,-0.0692,-0.1539,0.0703,0.1358,-0.0472,0.0535,-0.0161,-0.1567,-0.1441,0.0783,0.0228,-0.0526,-0.019,0.0243,-0.1908,0.062,0.0196,-0.0843,-0.1209,0.0426,0.0698,0.0232,-0.0405,-0.0594,-0.01,-0.0119,0.041,-0.0205,0.3609,0.1537,0.1454,0.1696,0.1547,0.1844,0.2161,0.1359,0.0585,0.1027,0.0232,0.0083,-0.0282,0.1584,0.4179,-0.1508,0.0953,-0.0268,-0.0275,0.0683,-0.1031,0.1181,0.1226,0.0814,0.0243,0.0522,-0.0277,0.06,-0.1211,-0.1449,-0.1582,-0.0521,0.1247,0.0038,0.0907,0.2213,0.0938,0.1552,0.0988,-0.0672,0.027,0.0362,-0.0384,0.1423,0.0216,-0.0753,0.0367,0.0388,0.058,0.0635,0.0123,0.0314,-0.0487,0.1299,0.046,-0.0739,0.015,0.0215,-0.0095,-0.0078,0.0162,-0.0176,0.0315,0.1153,-0.1879,-0.2915,-0.2591,0.0091,-0.2357,-0.0489,0.0561,0.0947,-0.1692,-0.2194,-0.0296,-0.0872,-0.044,-0.1273,0.0676,0.0613,0.0586,0.0176,-0.1289,-0.1291,-0.0492,0.0453,-0.0464,-0.0585,-0.1788,-0.1612,-0.1373,0.0202,0.0111,-0.0031,-0.0216,-0.0344,-0.0399,0.2326,0.0745,0.0299,0.1143,0.1241,0.1112,-0.0253,0.0038,-0.0405,-0.0436,0.0347,-0.1649,-0.2301,-0.117,-0.0817,-0.123,0.0054,0.0608,0.0289,-0.0125,0.06,0.1044,-0.0325,0.1559,0.2398,0.2099,-0.1751,-0.071,0.0183,-0.0931,-0.0545,-0.1909,-0.0895,-0.0521,-0.157,0.0633,0.176,0.2076,-0.1232,-0.0534,0.125,-0.0736,-0.0408,-0.1558,-0.1443,0.0927,0.0821,0.0597,0.0476,-0.2564,0.0332,-0.0508,-0.0415,0.0854,-0.0301,-0.0606,0.0571,-0.1157,-0.0359,0.2068,0.0582,0.2007,0.159,0.178,-0.0392,0.01,0.0056,-0.117,-0.0553,-0.0645,-0.4398,-0.3852,-0.1509,-0.2486,0.1219,-0.1591,-0.0651,-0.3088,-0.2623,-0.2805,-0.0155,-0.0937,-0.0091,-0.186,-0.0771,-0.0828,-0.0735,-0.0506,-0.0817,0.1103,-0.011,0.1018,-0.0459,-0.0545,-0.0046,-0.0486,0.0344,-0.1627,-0.0121,-0.0321,-0.0464,0.23,0.1464,0.109,0.0816,0.1633,-0.0999,0.0157,0.0672,-0.0266,-0.1535,-0.0537,0.3462,-0.0483,-0.0026,0.2396,-0.0337,-0.0149,-0.0391,-0.0992,-0.1286,-0.2095,-0.2659,-0.2333,-0.038,0.002,-0.179,0.0578,0.0753,-0.0621,0.026,0.0078,-0.0511,0.0046,0.0349,0.2339,0.3122,0.2741,0.247,0.093,0.1023,0.1096,0.0628,0.0429,-0.0712,-0.0533,0.0312,-0.0447,-0.0224,-0.1913,0.142,-0.04,0.0788,0.0544,0.1693,-0.1031,0.0316,0.1028,0.0419,-0.2957,-0.0232,-0.0185,-0.0204,0.0134,-0.0197,-0.0142,-0.032,-0.0063,0.0701,0.0008,0.0258,0.149,-0.0421,0.0205,-0.1379,0.0254,0.2434,0.0921,-0.0225,0.0848,0.0114,0.0061,0.1216,0.0594,-0.0918,-0.0283,-0.143,0.3739,0.118,0.0923,0.2994,0.1864,0.1135,0.098,0.098,0.0876,0.0388,-0.1206,0.1696,0.0193,-0.0661,-0.0082,0.1117,0.1234,0.4672,-0.1107,0.0031,0.0144,0.0293,-0.3315,-0.0423,0.0373,0.1813,0.0367,-0.0017,0.0196,0.0421,-0.2598,-0.1135,-0.2378,-0.3132,-0.2455,0.0092,-0.0421,-0.2128,-0.1173,-0.0287,0.2035,0.2069,0.0458,0.106,0.0294,0.0089,0.0007,-0.0892,0.0042,0.0756,-0.1204,0.044,0.1526,-0.0855,0.0651,0.1858,0.0654,0.2366,0.0481,-0.0394,-0.1997,0.1196,-0.3947,-0.369,-0.1687,-0.2537,-0.22,0.0595,-0.1031,0.0341,-0.1179,-0.0222,0.0106,-0.1351,0.0081,-0.0821,-0.0631,-0.0351,-0.002,0.0772,0.0019,0.009,0.0295,-0.1712,0.0309,-0.1697,-0.1227,-0.145,-0.0322,-0.1598,-0.0435,-0.0773,0.0375,0.0412,0.0357,0.003,0.0029,0.104,0.0884,-0.0086,-0.0879,-0.1079,0.0032,-0.0306,0.0471,-0.0653,-0.0269,-0.015,-0.0498,-0.0495,-0.0033,-0.0462,-0.0787,0.0387,-0.0189,-0.097,-0.0145,0.0299,0.0896,0.0373,0.0188,-0.0645,-0.0382,0.0805,-0.0319,-0.0632,-0.0352,-0.0805,-0.0588,-0.1436,-0.0459,0.0344,0.0234,0.0971,0.0771,-0.084,-0.011,0.0295,0.0349,0.0685,-0.0756,0.0538,0.1935,0.1671,0.1482,0.1289,0.0045,0.0179,-0.0232,0.1904,0.1203,0.1697,-0.0043,0.0947,-0.0779,-0.008,-0.0982,-0.122,0.1231,0.127,0.007,0.0003,0.0292,0.1217,-0.0956,-0.1068,0.0709,0.0031,0.0161,0.0459,-0.0605,-0.072,-0.0482,-0.004,-0.0003,0.2062,-0.0007,0.1545,0.1863,0.006,0.0697,-0.0998,-0.1663,-0.1496,-0.1262,-0.1605,0.1182,0.1686,0.0458,-0.0709,-0.0913,0.0193,0.0154,0.0941,0.0131,0.107,0.078,0.1303,0.1325,-0.0092,-0.0004,0.0668,0.1045,0.0426,0.0696,0.0173,-0.029,0.0519,-0.0154,0.2028,0.0212,0.0322,-0.0164,0.0168,-0.0463,-0.1585,-0.0924,0.0231,0.0559,0.0643,0.0918,0.0399,0.0979,0.3688,0.0199,0.0592,0.0124,0.0597,-0.0119,-0.012,-0.0101,0.0898,-0.0158,0.1349,0.0453,0.1239,0.1503,-0.0587,0.1695,0.1118,0.2612,0.0923,-0.0715,-0.2322,0.1354,0.0831,0.0222,-0.0667,-0.0598,-0.0156,0.1236,0.2006,0.0779,0.1299,0.0346,-0.0486,0.0166,0.0172,0.0704,-0.0805,-0.0548,-0.0466,-0.1157,0.0478,0.0338,-0.0339,0.0055,0.0334,0.1093,0.1694,0.0813,-0.1112,-0.0381,-0.0483,-0.0315,-0.0613,-0.0732,-0.1679,0.0076,0.0682,0.189,0.0485,0.0352,-0.2242,-0.2048,-0.0595,0.0761,0.0352,-0.0327,-0.2792,-0.1299,-0.1166,-0.1067,0.2448,0.0364,0.0142,0.0206,0.0728,-0.0802,-0.1245,-0.0842,-0.0454,-0.0839,-0.0345,0.0469,-0.0442,-0.0709,0.1076,-0.2087,-0.0661,0.0029,0.0051,-0.0808,0.0125,0.0205,-0.0178,-0.0656,-0.1301,-0.239,-0.1379,-0.2104,0.1083,-0.0756,0.0444,0.0066,0.1823,0.4078,0.399,-0.0575,-0.0962,-0.1498,0.0743,-0.0242,0.1211,0.1664,0.2275,0.2344,-0.0079,0.0564,-0.0028,0.0389,-0.0656,0.0467,0.1835,0.0672,0.1306,0.1548,-0.1163,0.1966,-0.0188,0.2218,0.0976,0.0901,0.0074,-0.0088,-0.0298,-0.0129,-0.0463,0.1206,-0.2169,0.1582,-0.1505,-0.1122,-0.1118,-0.0068,0.0017,-0.1661,-0.2052,-0.1891,0.1793,0.1476,0.0866,0.0598,0.1879,0.0924,0.0612,0.2461,0.1055,0.0016,0.1645,-0.0489,0.0848,-0.0075,0.0695,0.157,0.0797,0.1071,0.2103,0.1119,-0.1108,0.071,0.2086,0.0276,-0.1405,0.0311,-0.0649,-0.0538,-0.0959,-0.1146,-0.1028,0.1285,0.2035,0.086,0.053,-0.0504,-0.109,-0.0477,-0.0255,-0.019,-0.2062,-0.158,-0.1846,-0.0942,-0.0787,0.3521,0.3611,0.1627,0.1436,0.0598,0.0856,0.2112,0.0671,-0.0508,-0.0712,-0.0219,0.0222,-0.0132,0.1151,-0.1755,-0.1291,-0.1867,-0.1165,-0.0926,-0.1072,0.099,0.0233,0.0785,-0.1141,-0.1463,-0.2122,-0.0084,-0.0094,-0.2399,-0.2602,-0.2696,-0.1642,0.0171,0.0775,-0.0267,-0.0346,-0.0445,0.0402,-0.037,-0.0721,-0.0497,-0.0656,-0.0481,0.0488,-0.0012,0.176,0.1041,0.092,0.0361,-0.2129,0.0207,-0.12,-0.1142,-0.1201,0.0455,0.0432,-0.1501,-0.0679,-0.1872,-0.2168,-0.1177,-0.1937,-0.0601,-0.0452,0.0523,0.0467,-0.1474,-0.1359,-0.0491,-0.1069,0.0321,0.0009,-0.0527,-0.0592,-0.0029,-0.0005,0.0477,0.0914,-0.063,-0.0912,-0.0606,0.1018,-0.0121,-0.0465,-0.2038,-0.122,0.0197,0.0293,-0.0894,0.0144,-0.1458,-0.1537,-0.0631,-0.0574,-0.0702,-0.0968,0.0589,0.0712,-0.0636,-0.0586,-0.1758,-0.088,-0.0031,0.0805,0.1127,0.0543,-0.095,-0.3,0.0679,0.0028,0.1241,0.1561,0.3569,0.2479,0.2196,0.1837,0.1481,0.1333,0.0882,-0.0668,-0.1336,-0.1083,-0.101,0.1009,-0.0922,0.0275,0.076,0.0029,-0.1133,-0.0397,-0.0001,-0.3002,-0.2659,-0.1509,-0.0364,-0.0583,0.0334,0.0793,-0.0399,0.0052,0.0408,-0.1369,-0.1067,0.0319,0.0295,-0.0194,-0.103,0.0792,0.1427,0.1326,0.076,0.0232,0.0139,-0.0236,0.031,-0.0832,0.0649,-0.0172,-0.2369,-0.0045,0.2401,0.0522,-0.1165,-0.1212,0.0691,0.1021,0.4407,0.3315,0.1952,0.2914,-0.1283,0.0865,0.1111,-0.0232,-0.0177,-0.1405,-0.1521,-0.1012,-0.099,-0.1172,-0.2737,-0.1986,-0.2139,-0.0785,-0.0955,-0.1654,0.0017,-0.0175,-0.0363,-0.0206,-0.1905,-0.1494,0.1682,0.2124,0.1656,0.0135,0.0995,0.0944,-0.0782,-0.0161,0.0225,0.0075,-0.1223,-0.0842,0.1233,0.0365,0.1129,0.0028,0.1144,0.1752,-0.046,0.0474,-0.0185,0.1378,0.0064,-0.0384,0.0215,0.1831,-0.0292,0.1926,-0.0002,0.1099,0.1295,0.0513,0.1054,0.0079,-0.0981,-0.0617,0.0691,0.0742,0.069,-0.058,-0.0852,-0.0694,0.0086,-0.2802,0.0555,0.0851,0.0066,-0.1498,0.043,0.0487,0.0936,-0.0748,0.0208,0.0816,-0.1,-0.3265,-0.3949,0.0239,0.0287,0.0107,-0.143,0.0027,-0.2432,-0.0014,-0.3593,0.0479,-0.3074,-0.2932,-0.0746,-0.0251,0.0055,0.0337,-0.0167,-0.1845,-0.1824,-0.135,0.0183,0.0055,0.1158,-0.083,-0.1816,-0.157,0.1694,0.1624,0.1684,-0.0256,0.0798,0.0125,0.0509,-0.0346,-0.0271,0.0304,0.0738,0.0888,-0.2612,0.0624,0.134,-0.2388,-0.2705,-0.0851,0.0512,-0.1641,-0.3297,-0.1711,-0.1316,-0.0913,0.043,-0.0371,-0.1693,-0.1836,0.1231,-0.2198,-0.0988,-0.1103,-0.0338,-0.3675,-0.0713,0.0974,0.0807,-0.0212,0.1637,0.0478,0.1137,0.0122,0.0627,0.0969,0.0024,0.2088,0.1505,-0.0153,0.1106,0.2119,0.0776,-0.0185,0.0292,0.0548,0.1015,0.1527,0.1627,0.0542,0.0684,0.1118,0.0759,-0.1025,-0.1528,0.0352,0.0168,-0.0124,-0.0441,0.0612,0.0606,0.068,0.02,0.0976,-0.0,0.2757,0.3127,0.0679,0.0328,0.1114,0.2555,-0.0125,0.1124,0.1207,0.1866,0.1027,0.0669,-0.0161,-0.0044,-0.0076,0.0218,-0.1607,0.0734,-0.1204,-0.1905,-0.1336,0.1069,-0.1711,0.2348,0.1214,0.0586,-0.0578,-0.0737,0.0059,-0.1185,-0.1123,0.0307,0.0732,-0.1813,0.1057,0.0383,-0.1798,0.0346,0.0372,0.064,-0.0255,-0.0579,-0.1494,-0.1559,0.2821,0.2705,-0.1603,-0.1861,-0.0226,-0.1643,-0.0344,0.0204,0.1156,0.1706,0.0191,0.1458,0.2346,0.0771,0.0797,-0.1225,0.0013,-0.1878,-0.0292,-0.2067,0.0587,-0.0551,-0.0111,-0.0325,-0.0691,-0.0012,0.0141,-0.0053,0.0119,-0.1123,0.0232,-0.0251,0.0533,0.0653,0.0778,0.0024,0.0125,-0.0276,0.0675,0.1006,0.206,0.0207,-0.0487,0.0035,-0.0273,-0.0602,0.022,0.0467,0.0808,0.0725,-0.0316,0.0139,0.1082,0.1045,-0.2057,-0.1466,-0.0994,0.0316,-0.0318,0.1244,0.0933,-0.0215,0.0549,-0.1076,-0.1005,0.2092,0.1088,-0.0287,0.1297,-0.0161,0.0228,-0.0651,-0.15,0.2904,-0.0514,0.0924,0.0114,0.0205,0.25,0.1925,0.0968,-0.0384,0.0481,0.0774,-0.0138,0.0943,0.0319,-0.0975,-0.0506,-0.0295,-0.0278,-0.0026,-0.0291,0.1295,0.0598,0.0399,0.1532,-0.023,0.317,-0.3325,0.1892,-0.0412,-0.1536,-0.113,0.3674,0.338,-0.0395,-0.173,-0.0171,-0.1617,-0.0153,-0.0613,-0.1081,0.0357,-0.0403,-0.0476,-0.0525,0.0077,0.0416,0.0853,0.0159,0.0638,-0.0718,-0.1431,-0.2501,-0.1176,-0.1119,-0.1245,-0.0364,-0.0611,-0.0998,-0.1844,-0.1229,-0.051,-0.1594,-0.1239,-0.1442,-0.0741,-0.0984,-0.2625,-0.1025,-0.2523,-0.263,-0.2039,0.1286,0.0252,0.325,-0.0045,0.0377,0.1896,0.1278,0.1041,-0.2036,-0.0952,0.2283,0.1858,0.0872,0.0064,0.0626,0.2059,-0.0837,0.0679,0.0248,-0.0256,0.0802,0.0126,-0.0347,0.0903,0.0663,-0.0629,0.1329,0.1393,-0.0436,-0.0099,-0.0686,0.0386,0.026,0.1204,-0.2305,-0.1411,0.1338,-0.0552,-0.066,0.0709,-0.0093,0.0112,0.0596,-0.3504,-0.3544,0.1407,0.0949,-0.0142,0.0964,0.0266,0.0897,0.0121,-0.0716,0.1172,0.0844,0.006,0.0381,0.0643,-0.0362,auditory tone discrimination
trm_4a3fd79d0b58f,0.0183,0.0475,0.0748,0.0038,0.0176,0.028,0.0298,-0.0092,-0.0438,0.0246,0.0643,0.0735,-0.0074,-0.0237,0.0448,0.0469,0.098,0.0362,-0.0243,0.0816,0.0649,0.0274,0.0364,0.0356,0.0319,0.0367,0.036,-0.0198,0.0047,0.0214,0.0072,0.0764,0.0348,0.0435,0.0229,0.0455,0.0281,0.0172,0.0202,0.0358,0.0781,0.0218,0.0042,0.0115,0.0327,0.0006,0.1023,-0.0084,0.0056,0.0009,-0.005,-0.1093,-0.1262,-0.0499,-0.0956,0.0174,-0.0467,0.0308,-0.0035,0.0467,0.071,0.0057,0.0556,-0.0171,0.0014,-0.0554,0.1099,0.078,0.0251,0.0307,-0.0291,0.0499,-0.0379,0.0412,-0.0883,-0.0548,-0.0284,0.0573,0.0244,-0.0074,0.0018,-0.0217,-0.0067,-0.0018,-0.0496,-0.0176,-0.0433,0.0184,0.0556,-0.1087,0.0488,-0.0646,0.0589,0.0281,0.0678,0.0428,-0.0468,-0.0405,-0.1147,-0.0271,0.011,0.0598,-0.0311,-0.003,-0.0169,0.0834,0.1176,-0.0456,-0.025,-0.0515,0.0122,0.0128,-0.0475,-0.0566,-0.0379,0.0174,0.0309,-0.0246,0.0228,0.0159,0.0644,0.0319,0.0806,-0.0082,0.0111,0.0682,0.0153,0.0295,0.0415,-0.1412,-0.0183,0.0082,0.0401,-0.029,0.0225,0.0817,0.0156,0.0546,0.029,0.0077,0.0472,0.0229,0.048,-0.051,0.0731,-0.0099,0.0043,0.0042,0.09,0.0183,0.0359,0.1215,0.0765,0.0782,-0.0399,0.0284,-0.0054,0.0416,0.0311,0.034,0.0323,0.07,0.1113,0.0776,0.0311,0.0057,0.0563,0.0922,0.0924,-0.0837,0.1078,0.1462,0.0688,0.0253,-0.0235,0.033,0.0313,0.0215,0.0016,-0.047,0.027,0.0406,0.013,-0.0566,-0.0133,0.0265,0.0248,0.0093,0.0069,0.0481,0.0382,0.0421,0.0421,0.0266,0.024,-0.0602,-0.0321,0.0678,0.0416,-0.1691,-0.1356,0.0247,0.0593,0.0281,-0.0261,-0.0418,-0.0081,0.0272,-0.0177,0.0222,0.0421,0.0379,-0.0342,-0.0284,-0.0129,-0.0229,0.0186,0.0067,-0.0062,0.0537,0.0486,0.0332,0.0761,0.0043,-0.0073,0.04,0.0363,-0.034,-0.012,-0.0373,0.0675,0.0178,0.0111,0.0341,0.0301,-0.1261,0.0123,-0.0511,-0.0333,-0.0286,0.0269,0.0142,0.0364,-0.0265,0.0071,0.0159,0.0421,0.0265,-0.0598,0.076,-0.0178,-0.0149,0.0174,-0.0457,-0.0291,0.0675,-0.055,-0.0373,-0.0105,0.0067,-0.002,0.0153,0.0434,0.0117,-0.0256,-0.017,-0.0334,-0.0285,0.0831,0.0357,0.0128,-0.0324,-0.0039,-0.016,-0.0938,-0.0453,-0.158,-0.1248,-0.0979,-0.0869,-0.0668,0.0346,0.0235,0.0475,0.0591,0.0161,0.0221,0.0087,-0.0212,-0.0219,0.0701,-0.014,-0.0453,0.0385,0.0206,0.0266,0.0106,-0.0943,0.0393,-0.0572,-0.1224,0.0526,0.0239,0.0775,-0.0548,-0.051,0.0351,-0.0428,-0.0774,-0.0235,-0.0411,-0.0121,0.0166,-0.0967,0.0213,-0.0173,-0.0125,-0.0475,-0.0435,0.0117,-0.0166,0.0043,0.0034,0.009,0.0003,0.0245,0.0039,0.0564,0.0125,0.0856,-0.0314,0.0002,0.0358,0.0078,0.0364,0.0121,-0.1128,-0.0339,0.074,-0.0074,-0.0121,0.076,-0.0013,-0.024,0.0137,-0.0219,0.0448,0.0526,0.0441,0.017,-0.0035,0.1226,0.0041,-0.0174,0.0112,0.0528,0.0153,0.0401,-0.0019,0.0138,-0.0171,0.0251,-0.1721,-0.0628,-0.078,-0.0301,0.0219,-0.0686,0.0621,0.016,0.0231,-0.0498,0.0502,-0.0252,0.0903,-0.0139,0.0546,-0.0043,0.0211,-0.0407,-0.0216,-0.0208,-0.0407,-0.0436,-0.0087,-0.0496,0.0142,0.0261,-0.0012,-0.0095,-0.071,0.0223,0.0304,0.028,0.0095,-0.0015,0.0255,0.0368,0.0334,0.0147,0.0072,-0.0119,-0.0395,-0.0107,0.0137,-0.0578,-0.0684,0.0199,0.0529,0.0366,0.0032,0.11,0.0083,-0.0566,0.0735,-0.0342,-0.1114,0.0128,0.0105,-0.0394,0.0118,0.0151,0.0311,0.0275,0.0186,0.0138,0.0127,0.0039,0.0146,-0.0231,0.0456,-0.0482,-0.0454,-0.0057,0.0053,0.0066,-0.0467,-0.0219,0.0851,0.002,0.0763,0.0119,0.1188,0.0439,-0.0096,0.0307,-0.0125,0.0107,0.05,-0.0627,-0.0914,-0.0397,0.0101,0.0053,-0.0401,0.0623,-0.0307,0.0511,-0.0401,0.0222,0.0116,0.058,0.0227,0.0819,0.0576,0.0423,0.058,0.0156,0.0101,-0.0488,-0.0051,-0.0506,-0.0808,-0.0082,-0.0025,-0.0158,-0.0203,0.0275,0.0113,-0.0164,0.0215,-0.0169,0.0171,-0.0256,-0.1084,-0.0692,0.0196,0.0632,0.0644,-0.0126,0.0486,-0.1432,0.0617,0.0711,0.0034,0.0398,-0.1115,0.0017,0.0461,0.0259,0.0337,0.0449,0.0259,0.0603,-0.0057,0.0231,-0.0235,-0.0571,0.013,-0.0166,0.0365,-0.0421,-0.0301,-0.0168,0.0307,-0.0158,-0.0038,-0.016,-0.0821,-0.0062,-0.0384,0.0074,0.072,-0.1159,-0.1039,0.0278,-0.1196,-0.093,-0.0802,-0.0074,-0.0113,-0.024,0.0459,0.1144,0.0309,-0.0336,0.0951,0.0645,0.0407,0.0679,0.045,0.0355,-0.0283,-0.0568,-0.006,0.0128,0.0112,-0.0522,-0.0053,0.0886,-0.0294,-0.0216,-0.0093,-0.0567,0.0381,0.0395,0.0139,-0.0722,0.0214,-0.004,0.0821,0.044,0.0578,-0.0101,0.0044,-0.0432,0.0055,-0.0217,-0.0137,-0.0883,0.0012,-0.0183,0.0261,0.0433,0.0193,-0.0201,-0.0095,-0.0472,-0.0367,-0.043,-0.092,0.064,0.0061,0.0095,-0.062,-0.0179,-0.0389,0.0069,-0.041,0.0305,0.0558,-0.0349,-0.0823,-0.0599,-0.0299,0.0169,0.0889,0.0098,-0.0622,-0.0073,0.0153,-0.0398,-0.001,-0.0066,0.0379,-0.016,-0.0335,0.0171,0.016,-0.0642,0.0438,0.0027,-0.0044,0.0211,0.045,0.0079,0.0044,-0.048,0.0204,0.0993,0.0174,0.0983,0.0329,0.0076,0.0044,0.0005,-0.0779,0.0049,-0.0325,-0.0427,0.0138,-0.019,0.0407,-0.0449,-0.0325,0.0077,-0.0132,0.0005,0.0225,-0.1118,-0.0229,0.0167,0.003,0.032,0.055,0.0009,0.0068,-0.0007,-0.0118,0.1297,-0.0657,0.0837,0.0887,0.0981,0.0059,0.0047,-0.0258,-0.0055,0.0199,-0.0073,0.0736,0.0323,0.0078,-0.0051,-0.0157,0.0428,-0.0579,0.1384,-0.0178,-0.0246,-0.0083,0.0168,0.0386,0.017,0.0499,0.0252,-0.0437,0.055,0.0355,0.0117,0.0061,0.0072,0.0268,0.0089,-0.0313,0.0435,-0.0009,0.0237,-0.0179,-0.0394,0.0343,0.0068,-0.004,0.0306,0.0889,0.0834,0.0088,0.018,-0.0051,-0.0558,-0.0243,0.0033,0.0641,0.0663,-0.0049,-0.009,0.05,0.0817,0.0508,-0.021,0.0077,-0.0708,0.0093,-0.0503,-0.0259,-0.0221,0.039,-0.0478,0.0483,-0.0071,-0.0253,-0.0362,0.1548,0.1628,0.0966,-0.0001,-0.0042,0.0309,-0.0262,-0.0072,0.0614,-0.0195,0.0246,-0.0014,0.0055,0.0367,0.0094,-0.0766,0.0039,-0.169,0.0438,0.0194,0.024,0.0233,0.0462,0.089,-0.0493,-0.0248,0.0529,-0.0378,-0.0762,-0.0103,0.0337,0.0781,0.1016,0.0675,0.0516,0.0557,0.0332,0.0284,0.0061,-0.0259,-0.0464,-0.0022,-0.0005,0.0873,0.0241,-0.0157,0.0406,-0.0834,0.0008,-0.0264,-0.026,-0.0276,-0.0053,0.0129,0.0356,0.0309,0.0633,0.0129,0.0499,0.051,0.0333,0.0285,0.0575,0.0041,-0.0248,0.0093,-0.0177,0.0214,0.0083,-0.0049,0.0118,-0.0104,0.0024,-0.0191,-0.0353,0.0112,-0.1213,0.0204,0.0181,0.039,0.0297,0.0939,-0.0102,-0.0313,-0.0256,-0.0327,0.0541,0.0849,0.0407,-0.0094,0.0335,0.0108,0.0065,0.0473,-0.0569,-0.0605,0.0047,-0.0186,-0.0414,0.1129,0.1206,0.0455,0.0526,0.0237,0.0894,0.0158,0.076,0.0758,0.0642,0.05,0.0379,0.0395,0.0381,0.0477,-0.0385,-0.0941,-0.0414,0.0492,0.0216,0.0375,0.0277,0.0194,-0.0412,-0.0369,-0.0473,-0.06,0.0114,-0.0161,-0.0133,0.016,0.0219,-0.0256,0.0061,0.0161,-0.0468,0.1728,-0.0091,-0.023,-0.0627,-0.117,-0.1018,-0.0544,-0.0511,-0.0329,0.0029,0.0136,0.0118,-0.0233,0.0499,0.0008,0.0172,0.0142,0.0102,-0.0618,-0.0637,-0.0414,-0.0355,-0.0105,0.0644,0.0837,0.0612,0.05,0.0195,0.0166,0.0328,0.0307,0.0358,0.0113,-0.0862,0.0076,0.0186,-0.0465,-0.0613,0.0296,0.0606,0.0227,0.0151,-0.0699,0.037,-0.0312,0.0969,0.0273,-0.0283,0.0868,-0.0255,0.0341,0.0183,0.025,0.0778,0.0988,0.0288,-0.0239,-0.0061,-0.0369,0.0127,-0.0092,-0.007,-0.0235,-0.1003,-0.0762,-0.0319,0.0465,-0.0127,0.02,0.0116,0.0638,0.0024,0.0435,-0.0558,-0.0122,0.0181,-0.0048,0.0188,0.0034,0.0384,0.0529,0.0201,0.0412,0.0351,0.0038,-0.0116,0.0073,0.0437,-0.0441,0.0376,-0.0179,0.0092,-0.0068,0.0269,0.0269,-0.0007,-0.0717,0.0062,-0.0029,-0.024,-0.007,0.0373,0.0165,0.0009,0.0191,0.0164,-0.0014,0.0301,0.0365,-0.0543,-0.0067,-0.0459,-0.0567,-0.0494,-0.0093,-0.0242,-0.1556,0.0087,0.0056,0.0115,-0.0368,-0.0072,0.0636,0.0148,0.0522,0.012,0.0511,0.0261,0.0878,0.0849,-0.0528,-0.0858,-0.0106,0.0358,0.0435,0.0744,-0.0833,-0.0473,0.0059,-0.0483,-0.0,0.0096,0.0005,0.0308,0.0313,0.0179,0.0146,0.0175,0.0255,0.0086,-0.0267,-0.001,0.0144,-0.1093,-0.0157,-0.1216,0.0287,0.0434,0.0135,0.0318,-0.0014,0.0191,0.0095,-0.0238,0.0001,0.0034,0.0152,-0.0069,0.018,0.0345,0.0303,0.0039,0.0075,0.0371,-0.0135,0.0002,0.0018,-0.0612,-0.0398,-0.0639,-0.0574,-0.0042,-0.0398,-0.0192,0.0206,0.0479,0.0293,-0.0288,-0.0592,0.0319,-0.0578,-0.0482,0.0117,0.0118,0.0446,0.0014,0.0654,-0.0422,-0.0458,0.0404,0.0568,-0.0002,0.0535,0.0363,-0.0247,0.0406,0.0275,-0.0632,-0.017,-0.0106,0.0746,0.0178,-0.0074,-0.0415,0.0298,0.0622,-0.0094,0.0571,-0.0138,0.0038,0.0161,0.0067,-0.0026,0.0334,0.0069,-0.0016,-0.0674,0.0339,0.0174,0.0571,0.0394,-0.0101,0.0098,0.1106,0.0357,0.0468,-0.02,0.0279,0.0677,0.0542,0.1314,0.0191,0.0248,0.0649,0.0457,0.023,0.0539,0.0202,0.0508,-0.0002,0.0335,0.0038,-0.0394,-0.081,0.0506,0.0394,-0.0839,-0.0361,-0.0459,0.0425,0.0001,-0.0581,0.0132,0.0143,0.0794,0.0108,-0.0013,-0.0237,0.0018,-0.0484,0.0052,0.0991,0.0337,0.0344,0.0448,-0.0127,-0.0462,-0.0525,0.0045,0.0575,0.0467,0.0022,0.0503,-0.0067,0.0735,0.0415,0.0019,-0.0054,-0.0269,-0.0194,-0.0036,-0.0477,0.0806,-0.0506,0.0205,-0.0243,-0.0386,0.1137,0.126,-0.0918,0.0248,0.0439,0.0049,-0.0467,-0.0219,0.0265,-0.0024,0.0526,0.0525,0.0223,0.0117,-0.004,0.0319,0.0446,0.0208,-0.0934,0.0049,-0.0226,0.0571,0.0265,0.0019,-0.0092,0.0067,0.0441,0.0868,-0.0192,-0.0169,-0.1976,-0.1135,-0.091,-0.0157,-0.0851,-0.1979,-0.0003,-0.0639,-0.1663,-0.0045,-0.0461,-0.033,-0.0223,0.0092,-0.1181,-0.0152,-0.0076,0.0143,-0.0366,0.0061,0.0274,0.0012,0.1282,0.0456,-0.0923,0.0413,0.0331,-0.0835,0.0266,-0.0836,-0.0316,0.045,-0.0035,-0.0024,-0.0826,-0.0269,-0.0071,0.0272,0.0497,0.0489,0.0022,0.037,-0.0242,-0.007,0.0404,0.0006,0.0602,-0.0481,0.0651,0.0269,0.0617,-0.0767,-0.005,0.0697,0.0107,0.0072,0.0133,0.0078,-0.048,0.0757,0.0862,-0.078,0.0262,-0.0051,0.0508,-0.0169,-0.0169,0.0547,0.0706,0.0054,0.0241,0.0087,0.0087,0.0748,0.05,0.0937,0.1155,-0.1101,-0.0043,0.0579,0.0532,0.0204,0.017,-0.0167,0.0266,-0.0048,-0.0055,0.0685,-0.0359,-0.1379,-0.0368,-0.0578,0.0603,-0.2254,-0.0739,-0.0775,-0.009,-0.0403,-0.0328,0.0475,0.0538,-0.1637,-0.0433,-0.013,0.0471,0.0313,-0.0597,0.0157,0.0414,0.034,0.0391,-0.041,0.0377,0.0864,0.0387,0.0566,-0.0547,0.0218,0.0848,0.0028,0.0151,0.0579,-0.0391,0.0155,0.0287,-0.1354,-0.1137,0.0044,-0.0527,0.0481,-0.0365,0.0358,0.0711,-0.0545,-0.0379,-0.0712,0.0018,-0.0062,-0.0005,-0.1159,-0.1061,0.0136,0.0492,-0.0506,0.0432,-0.0237,-0.0269,0.0191,0.0182,0.0718,0.0269,-0.0509,-0.1101,-0.0491,-0.0615,-0.0249,0.0429,0.0781,0.0548,0.0974,0.0806,0.0448,-0.0126,0.1513,0.1375,0.0554,0.059,0.0805,0.08,0.0222,0.0539,0.0304,-0.1104,0.0247,0.0605,0.0002,-0.0344,0.0495,0.0656,0.0033,-0.0425,0.0208,0.087,0.0548,0.0134,-0.0364,-0.2261,0.0135,-0.0236,0.0514,0.0483,-0.0429,0.0831,0.0548,0.1268,-0.0186,0.0077,0.0462,0.0577,0.0334,0.0465,0.0111,0.0216,0.0563,0.0528,0.0058,-0.009,-0.0231,0.0488,-0.0124,0.0154,0.0816,0.0317,-0.0246,0.0023,0.0009,-0.0055,0.021,-0.032,0.0482,0.0166,0.02,0.0683,0.0073,0.0118,0.0178,0.0287,-0.0323,-0.0459,-0.1285,-0.0059,-0.0038,0.012,-0.0387,-0.0196,0.0786,0.0896,-0.0757,0.0114,-0.0168,-0.0078,-0.0121,0.0403,-0.005,-0.0783,-0.0538,-0.0318,0.0351,-0.022,0.0702,0.0239,0.0259,0.0198,0.0497,-0.0101,-0.0469,-0.0136,-0.0521,-0.1854,-0.253,-0.09,0.0638,-0.0153,-0.0638,0.0033,0.0055,-0.019,0.0399,0.0278,-0.0904,-0.0085,-0.0381,-0.0274,-0.0198,-0.0074,0.0039,0.0067,0.0428,-0.0341,-0.0273,0.007,0.0563,0.0478,0.0372,-0.0421,-0.0169,0.004,-0.1138,-0.0985,-0.1026,-0.0823,-0.0711,0.0361,-0.0412,-0.0163,-0.0456,-0.045,-0.0489,0.0604,0.0424,0.013,-0.0107,-0.0201,0.0722,0.0217,0.0456,0.0375,0.0012,-0.0008,-0.0148,0.0187,-0.0027,0.0038,-0.0999,0.0185,-0.0027,0.0188,0.0316,0.0169,-0.0082,-0.0207,-0.0095,-0.0018,-0.0607,-0.0064,-0.0423,0.0063,-0.0052,0.0231,0.0285,0.0197,0.117,0.0997,-0.0289,-0.011,0.0768,0.0269,-0.0055,-0.0117,-0.0157,0.011,0.0095,-0.0103,-0.103,-0.0552,-0.0464,-0.032,0.0184,0.0084,0.0008,0.0069,0.0336,-0.0233,0.003,-0.0035,0.0011,0.0028,0.0709,0.0051,-0.0035,0.019,0.0177,-0.0351,0.0068,-0.0654,-0.0679,-0.0229,-0.0156,0.0102,-0.0439,-0.0099,0.0132,0.0033,0.0088,-0.0158,-0.0103,-0.0021,0.009,0.023,-0.0418,-0.0009,-0.2035,-0.0937,-0.104,-0.1363,0.0754,0.0331,0.0536,0.0461,0.0543,0.0404,-0.0571,0.0152,0.0116,0.0268,-0.0539,-0.0168,0.1282,0.0067,0.0974,-0.0853,-0.0141,-0.0408,-0.1034,-0.1255,0.0036,-0.0473,-0.0353,-0.0079,0.0445,-0.0092,0.0122,-0.0375,-0.0336,0.0109,0.031,0.023,-0.0493,-0.0402,0.0002,0.0341,-0.0165,-0.0166,-0.1309,-0.0321,0.0636,0.0416,-0.0156,-0.0493,-0.0366,0.0503,0.0395,0.0279,-0.0126,-0.011,0.0342,0.0079,0.0081,0.0474,0.0116,-0.174,-0.0032,0.0065,-0.0365,0.0337,-0.0611,-0.1481,-0.1288,-0.1723,0.0435,0.0446,0.0253,-0.1137,0.0583,0.0434,-0.001,0.0387,0.0155,0.0174,0.087,0.0665,-0.0265,-0.0003,-0.0095,0.0701,0.0797,0.0076,0.0422,0.0331,-0.0338,0.0011,-0.0365,0.0712,-0.0182,0.024,0.1198,0.0541,0.0062,-0.0083,0.0199,0.0734,-0.0326,-0.0372,0.0046,0.0457,-0.0067,-0.0443,-0.0683,-0.0091,-0.0607,-0.0039,-0.0164,-0.0951,0.0566,0.0418,0.0669,-0.0295,-0.0183,0.021,0.023,0.0124,0.0232,0.0579,-0.0906,-0.039,-0.0517,-0.0608,0.0317,0.0022,0.0684,0.059,0.0736,0.0208,0.0192,-0.0248,0.0498,0.0301,0.0158,0.0704,0.0026,-0.0352,-0.0334,-0.0137,0.0065,-0.0129,0.1023,0.0572,0.0858,0.0924,0.0331,0.0177,0.0293,0.0579,0.0685,0.0113,-0.006,-0.1452,0.041,0.0354,0.0404,0.1073,0.043,0.0681,0.032,0.0689,-0.0344,0.0189,0.0024,0.0609,-0.0815,-0.0149,0.0558,0.0625,0.0127,0.0639,0.0239,0.0318,0.0253,-0.0079,-0.0331,0.0264,0.079,0.0521,-0.0167,0.0053,-0.0497,0.0373,-0.019,0.0188,-0.051,-0.0672,-0.0602,-0.0022,-0.0185,0.0154,0.0406,0.0015,-0.0106,-0.0041,-0.0064,-0.0312,0.0622,0.0719,0.0834,0.044,-0.0214,0.0253,0.0365,0.1005,-0.0449,-0.0478,0.0211,-0.0525,-0.0444,-0.0736,0.0307,-0.0693,-0.0836,0.1004,-0.0586,-0.0428,0.1063,0.0522,0.077,0.0144,-0.0029,-0.0076,0.0156,0.0332,0.0495,0.0168,0.0187,0.005,-0.028,-0.0216,-0.1237,0.1576,0.1679,-0.0621,-0.0637,-0.0159,0.0011,-0.0438,0.0111,0.0204,-0.0431,0.044,0.015,-0.0479,-0.0082,0.0109,-0.0228,0.0673,-0.0886,-0.0094,-0.0951,0.0255,0.0257,-0.0038,0.0056,0.0382,0.0264,0.0025,0.1151,0.0787,0.1502,-0.0413,-0.0124,-0.029,-0.0112,-0.0197,0.0157,0.0121,0.0419,-0.0885,-0.0319,-0.0432,-0.015,-0.0351,-0.0102,0.018,0.0277,0.1173,0.0185,0.0051,0.0373,0.1158,-0.0924,0.0387,0.0004,0.0276,0.0075,-0.0614,0.0334,0.0786,0.0372,0.0031,-0.1407,-0.122,-0.1176,0.0692,-0.0335,-0.0539,-0.1426,0.0512,-0.0011,-0.003,0.1216,0.1143,0.0413,-0.0452,-0.0183,0.0321,0.0551,0.0139,0.0426,0.0065,-0.0015,0.0195,0.0527,0.0413,-0.0097,-0.0051,-0.0102,0.0129,0.0007,0.0939,0.1647,-0.03,0.0637,-0.012,0.0276,0.0024,-0.0637,-0.0016,-0.0161,0.0056,-0.0078,0.0697,0.0132,0.1108,0.0515,-0.0269,0.0125,0.0086,0.0241,0.0507,0.0442,0.0306,0.0491,0.0256,-0.0295,-0.0043,0.0358,-0.0262,-0.0552,0.0708,0.0585,0.0156,-0.085,0.0296,0.0242,0.0295,0.0035,0.0536,-0.0134,0.0,0.0663,-0.0658,-0.0313,-0.0889,-0.0018,-0.0047,-0.0294,-0.0285,-0.0347,-0.0033,0.0007,-0.0241,-0.0247,0.0006,0.0895,0.1059,0.0116,0.063,0.0788,0.061,-0.0238,0.0787,0.069,0.062,0.0347,0.0352,-0.0065,0.0277,0.1781,0.0819,0.1069,0.0891,0.1044,0.057,0.0613,0.0692,0.0391,0.0424,-0.0463,-0.0112,0.0441,-0.012,-0.0342,0.0172,-0.0188,0.0496,0.0804,0.0286,0.0319,-0.0319,0.0117,-0.0055,0.0526,0.1073,-0.0122,-0.0838,-0.0551,-0.1032,-0.1211,0.0493,0.0809,0.0518,-0.0479,0.0108,-0.0012,-0.0374,0.0069,0.0243,0.0164,-0.0865,-0.0062,0.0525,0.094,0.0527,-0.0165,0.0477,-0.0051,-0.1301,0.0789,-0.0166,0.0368,-0.0367,0.0077,-0.0024,-0.0044,0.0332,0.0067,-0.0605,0.0437,0.0473,0.0224,0.0273,-0.0841,-0.032,-0.0424,-0.0418,0.0259,-0.0929,-0.0169,0.0343,-0.0585,-0.0014,0.094,0.0511,0.0989,0.0356,0.0015,0.0797,-0.0151,-0.0175,-0.029,0.0028,-0.0494,0.044,0.0332,0.0401,0.0271,-0.0383,0.0332,0.0015,0.0378,-0.0088,-0.0194,0.1013,0.0219,0.0624,0.1136,0.1576,0.0554,0.0533,-0.1537,-0.1032,0.0562,-0.0084,0.0865,0.0383,-0.0632,-0.0125,0.0055,0.0313,0.0254,-0.0384,0.0428,0.0557,0.0493,0.044,0.0343,0.0366,0.0579,0.0131,0.0224,0.0516,-0.0035,-0.0125,0.0256,0.1346,0.0594,-0.0041,0.0543,-0.0208,-0.017,0.0115,-0.0305,-0.0133,-0.0141,-0.0379,-0.0269,-0.0342,-0.031,-0.0443,0.0579,-0.0342,-0.0072,0.0535,0.0153,0.0429,-0.0643,0.0005,0.0605,0.0311,0.0478,0.02,-0.0244,0.0375,0.0324,-0.0547,0.0208,-0.0293,-0.0494,0.0138,-0.0058,-0.0916,-0.2032,0.1109,0.029,0.0002,0.0091,0.0168,-0.1314,0.0335,0.0468,0.0445,0.0109,-0.1001,-0.0997,0.0027,-0.0254,0.0046,-0.0115,-0.0539,0.0265,0.03,-0.0113,0.0204,-0.031,0.0128,0.071,0.029,0.0289,-0.0192,0.061,0.0083,-0.0096,0.0247,0.0273,0.0971,0.0506,-0.052,0.0355,0.0063,0.0561,0.009,0.0385,0.0311,0.0397,0.0428,0.0362,0.0362,0.0501,0.0035,-0.0603,0.0747,-0.0135,0.0315,0.028,0.0789,0.027,0.1391,-0.0303,-0.0253,-0.0416,-0.0537,0.081,-0.0601,0.0007,0.0533,0.0171,0.0487,0.1032,0.0001,0.077,-0.0025,-0.0782,-0.1234,-0.1151,-0.0084,-0.0436,-0.0803,-0.0693,-0.0146,0.1671,0.0741,0.0187,0.0017,0.0072,-0.0185,-0.0469,-0.0279,0.015,0.0077,-0.0344,-0.0073,-0.0209,-0.0081,0.0154,-0.0238,0.0527,-0.0134,-0.0026,0.0054,-0.0671,0.0349,-0.0245,-0.0205,-0.0117,0.0116,0.0362,0.0445,-0.0782,-0.0039,-0.0092,0.0355,0.0395,-0.0779,-0.0553,-0.0439,-0.0491,0.0048,0.0076,0.0268,-0.0262,-0.0185,0.023,0.0013,-0.1094,-0.0032,-0.0899,0.0281,0.0308,0.0163,0.0699,-0.0177,0.0313,-0.0158,0.0589,0.0081,-0.003,0.0339,0.0021,-0.0413,0.0186,-0.0997,-0.0564,-0.0471,0.0481,-0.0342,-0.0528,-0.0432,-0.0845,-0.0275,-0.0502,-0.0062,-0.0599,-0.0232,-0.0389,-0.117,-0.022,0.0276,0.0416,-0.0029,-0.0185,-0.0313,-0.0361,0.0254,-0.0086,-0.0054,-0.0286,0.006,0.013,-0.0245,-0.0044,0.0587,-0.002,0.0351,0.0221,-0.0063,0.03,0.0023,0.0016,-0.005,-0.0947,-0.0183,0.0699,0.031,0.0312,0.0771,0.0112,0.0087,-0.0026,0.0195,0.0335,0.0826,-0.0776,-0.0211,-0.0766,0.0135,-0.0226,0.036,0.0221,0.0027,-0.0274,-0.0496,-0.0347,-0.0098,0.0142,-0.0494,-0.0007,0.0296,0.0578,0.0311,-0.0519,-0.0514,-0.0011,0.0303,0.0226,-0.0398,-0.0182,0.004,-0.0293,-0.0049,0.0565,0.1118,0.0927,-0.0362,-0.0504,-0.0237,0.0294,0.0296,-0.098,-0.1293,-0.1245,0.052,-0.0102,0.0312,0.0416,-0.0436,-0.0262,-0.0307,0.0101,0.0366,-0.0315,0.0724,0.0351,0.0035,0.0023,0.0278,0.0227,-0.0202,-0.0524,0.059,0.097,0.0574,0.0253,0.02,-0.0366,-0.0837,-0.0306,-0.0363,0.0062,0.0022,0.0349,0.0258,0.0705,0.097,-0.0219,-0.0224,-0.0034,-0.023,-0.0331,-0.0308,-0.0279,0.012,-0.0113,0.0844,0.0471,0.0658,0.1501,-0.0569,0.0102,-0.0047,0.0177,-0.055,0.0194,-0.0887,0.1408,0.0011,0.0215,-0.0446,-0.0456,0.0561,0.0626,0.0278,0.0117,0.0468,-0.0051,0.0675,0.0285,-0.0007,-0.0354,-0.0238,0.0071,-0.0338,-0.0036,-0.0216,-0.0264,0.0136,-0.0034,0.0457,0.0247,0.0224,0.0345,-0.0266,0.061,0.0022,0.0199,-0.0591,-0.0037,0.0097,-0.0142,0.0633,0.0391,0.0238,0.0296,0.0119,-0.0194,-0.0291,0.0137,0.0526,-0.0472,-0.0695,0.0038,-0.0309,0.0157,0.0823,0.0599,-0.0398,0.1196,0.0074,-0.0474,-0.0403,-0.0125,-0.0286,-0.0079,-0.0317,0.0583,0.0339,-0.046,0.0343,-0.0682,-0.0072,-0.0112,-0.0105,-0.0218,-0.0308,-0.033,-0.0031,-0.0493,-0.0732,-0.0554,-0.0928,-0.0523,-0.0425,-0.0405,0.0495,-0.0151,0.1333,0.2021,0.2021,0.0499,-0.038,-0.045,0.0001,0.0237,0.0001,0.0379,0.1237,0.1008,-0.022,-0.0577,0.0024,0.0317,-0.0109,0.0446,0.0281,0.0227,0.007,0.0333,-0.0678,0.0087,0.0386,0.0607,0.0145,0.027,-0.0018,0.0359,-0.0212,-0.0183,-0.0087,0.0246,0.0339,0.0929,-0.0438,-0.0123,-0.0203,0.0356,0.0364,-0.0144,0.0509,0.0332,0.0274,0.0415,0.0269,0.0113,0.0995,0.0423,-0.0423,0.0791,0.0689,0.0729,0.0843,-0.0608,0.0025,-0.0017,-0.0292,0.0462,0.0853,0.1046,0.0102,-0.0077,-0.054,0.0234,0.0726,0.0846,-0.0073,-0.001,-0.0247,-0.0325,-0.0799,-0.0535,-0.0447,0.0435,0.0718,0.0485,-0.0078,0.0307,-0.0279,-0.0098,0.0235,0.0459,-0.0607,0.0476,-0.0167,-0.0356,0.0464,0.0789,0.0965,0.0146,-0.1285,-0.0718,-0.0167,-0.0132,-0.1197,-0.1078,-0.004,-0.0131,0.0205,0.0339,-0.0033,0.0143,0.0053,-0.0089,-0.0219,0.0005,0.0176,-0.1539,-0.1074,-0.1768,-0.0615,0.0216,-0.0092,-0.0198,0.0026,-0.0268,-0.0922,-0.0507,-0.0658,0.019,0.0143,-0.003,-0.0162,-0.0316,-0.0001,0.0416,-0.0489,-0.0508,-0.0204,0.0175,-0.0377,0.0532,0.1079,0.0223,0.0229,0.0566,0.0467,0.0231,0.0147,-0.0591,-0.0435,0.0043,0.0129,-0.0448,-0.0548,-0.0335,0.0041,-0.0784,-0.0939,-0.0516,0.0028,0.0414,0.0328,-0.0079,-0.0946,0.0805,-0.0632,-0.0145,-0.0647,-0.0219,-0.0734,-0.0133,0.0525,-0.0047,0.0318,0.0268,-0.0219,-0.0834,0.0328,-0.0403,0.0125,0.0088,-0.0318,0.0503,-0.0105,-0.0217,0.0388,-0.0515,0.0049,0.0113,0.0218,-0.0249,0.0379,-0.0347,-0.051,0.0112,0.0743,-0.0011,-0.0263,-0.012,-0.0075,0.0459,0.0454,-0.0255,-0.0871,0.061,0.0243,0.1323,0.1311,0.0237,0.0424,0.0058,-0.0174,0.001,-0.0398,0.0555,-0.0178,0.0073,0.0056,-0.0353,0.0255,-0.1259,-0.1187,0.0711,0.0325,0.1172,-0.0365,-0.0056,0.0807,0.0498,0.0575,0.0134,0.1095,0.0278,-0.1272,-0.1471,-0.1123,-0.0259,-0.0574,0.0275,0.0552,0.0152,0.0056,-0.0024,-0.0294,0.051,0.0226,0.0136,-0.1531,-0.0872,-0.0981,-0.0608,0.0279,0.035,-0.0059,0.0382,-0.1795,0.1136,0.0294,0.0202,-0.0488,0.0113,-0.0166,0.1588,0.1842,0.0924,0.0328,0.0699,0.0248,0.0324,0.0297,-0.1605,0.0156,-0.0019,0.0053,-0.0266,-0.0386,-0.0675,-0.0198,-0.0117,-0.0988,-0.0925,-0.05,0.0214,-0.027,-0.077,-0.0779,0.009,-0.0363,0.0605,0.0647,0.0822,-0.0148,0.005,0.0326,0.0086,-0.0476,-0.0306,0.0093,-0.048,-0.0206,0.1092,0.0792,0.0615,-0.0036,0.0496,0.0271,-0.0201,-0.0572,-0.0093,0.048,0.0049,-0.0513,-0.044,0.0389,-0.0178,0.0463,-0.0158,-0.0196,0.031,0.0329,0.0074,-0.0118,0.002,-0.0402,0.0544,-0.0051,0.0168,-0.016,-0.022,-0.0686,0.0104,-0.0771,0.0045,0.0132,-0.0191,-0.0211,0.0442,0.0693,0.0026,-0.0131,-0.0048,0.0305,-0.0063,-0.0131,-0.0084,-0.0072,-0.0521,0.012,-0.0859,0.0379,-0.0279,-0.0894,0.0406,-0.116,-0.0712,-0.0832,-0.0018,-0.0194,-0.0407,0.0058,-0.0057,-0.0299,-0.0172,0.052,0.0323,0.0494,0.0557,-0.0336,-0.0021,-0.0235,0.0812,0.0872,0.0718,-0.0004,0.0701,-0.1619,0.0122,-0.0264,-0.0693,-0.0192,0.0278,0.0555,0.0337,0.0045,-0.0552,-0.0652,-0.0367,-0.0312,0.0026,0.0049,-0.1316,-0.0908,-0.1355,-0.073,-0.0615,0.062,-0.0442,-0.0016,0.0627,0.0004,-0.0267,-0.0535,-0.0283,-0.1001,0.0307,0.0015,0.0511,0.0351,-0.0631,-0.0409,0.0285,-0.0245,-0.0706,-0.1285,-0.0564,0.0268,-0.0144,0.0582,0.0066,-0.0431,-0.0451,-0.0997,-0.0037,-0.0065,-0.0168,0.0441,0.027,0.0341,0.0265,0.0176,0.017,-0.0329,-0.0649,-0.01,0.0319,0.0265,0.0067,-0.0097,0.0224,0.0132,-0.0579,-0.0382,-0.0559,-0.0167,0.007,0.0372,0.0597,0.1347,-0.0029,-0.0086,0.069,0.016,0.0539,-0.0042,-0.0154,-0.0354,0.0119,0.0105,0.0184,-0.0182,0.042,-0.0428,-0.0554,-0.079,0.0241,-0.0158,-0.0072,0.0664,0.0105,-0.083,-0.1161,-0.0333,0.0151,0.0139,0.0482,0.0629,0.0391,0.0318,0.0299,0.0323,0.0001,-0.0068,0.0042,-0.0122,-0.0188,0.002,-0.0287,0.034,0.0261,0.0173,0.003,0.054,-0.0098,-0.0096,0.0142,0.0432,0.0779,0.0298,0.038,0.0421,0.0263,0.0486,-0.0281,-0.003,-0.0763,0.041,-0.03,-0.037,-0.0585,-0.0166,-0.0296,-0.0748,-0.0231,0.0073,0.0056,0.006,-0.0493,-0.0223,0.0068,0.0414,0.0463,0.0241,-0.0375,-0.0377,0.0351,0.0139,0.035,0.0275,0.0146,-0.0503,0.017,0.0616,0.0046,0.0005,-0.0136,0.0369,0.0346,-0.0281,0.0087,-0.0457,-0.0055,0.0097,-0.0073,0.0421,0.0595,-0.0191,0.0503,0.0496,-0.0034,0.0413,-0.0816,-0.0731,0.1138,0.0849,-0.006,0.0171,-0.0147,-0.0121,0.1391,0.102,0.0125,-0.0099,0.0295,0.0728,0.0266,0.0646,0.0693,0.0031,-0.0141,0.0252,0.0342,-0.0097,0.0284,0.0122,-0.0772,-0.0324,0.0002,0.0327,-0.0282,-0.0454,0.0595,0.055,0.0521,0.0463,-0.0059,0.0931,-0.0118,0.0398,0.0433,-0.1143,-0.0873,0.0939,0.0982,-0.1113,-0.1568,-0.0577,-0.13,-0.077,-0.0093,-0.0873,0.033,0.0237,0.0834,0.0723,0.0836,0.0346,0.0833,0.0767,-0.076,0.1045,0.1366,0.0942,0.065,-0.0455,0.0784,0.0786,0.0211,0.1172,-0.015,0.096,0.0724,0.0182,0.0326,0.0267,0.0287,-0.0519,0.0608,-0.0254,0.0775,0.062,0.0642,0.0316,-0.0753,0.0932,-0.1271,-0.1149,0.1075,0.0938,0.0853,0.0011,-0.0162,0.1367,0.1201,0.0473,0.072,-0.0057,0.005,0.0611,0.0425,-0.037,-0.0444,-0.0124,-0.0001,0.015,0.0862,0.0453,-0.0231,0.065,0.0532,0.0505,0.0273,-0.0274,0.0586,0.0535,0.064,-0.0398,0.0307,-0.0023,-0.1585,-0.0399,-0.0055,-0.067,-0.1404,-0.0273,-0.1187,-0.1202,0.0484,0.0334,-0.0992,0.0232,0.0086,0.0269,0.014,0.0119,0.0632,0.0569,0.0041,0.0499,0.0495,-0.0416,word recognition
trm_557b478ce1c24,0.0237,0.0284,0.0044,0.045,-0.0112,0.0464,0.0154,-0.0314,-0.0355,0.0029,0.0118,0.0242,0.0337,0.0354,0.0325,0.0039,0.0329,0.1003,-0.0024,0.0619,0.0507,0.0327,0.0374,-0.0291,0.0027,0.0045,-0.0002,0.0337,0.0556,0.015,0.0114,0.0815,-0.0026,0.0322,0.0243,0.0482,0.0102,0.0117,0.0568,0.0256,0.0108,0.025,-0.0306,0.0145,0.0329,0.0283,0.0373,-0.0004,0.0003,0.0286,0.0023,-0.0619,-0.0258,-0.0112,0.0406,0.0216,0.0195,0.0406,0.0291,0.0611,-0.0064,0.0337,0.0446,0.0116,-0.0411,-0.0905,0.0869,0.131,0.0608,-0.0337,-0.0287,-0.0288,-0.0123,0.0318,0.0077,0.028,0.0078,0.0283,-0.0015,-0.0182,0.0023,0.0048,0.0193,0.0449,-0.007,-0.0136,-0.0471,-0.0391,0.0337,-0.0658,0.005,-0.0807,0.0016,-0.1606,-0.1183,-0.1263,-0.0747,-0.0188,-0.1177,-0.1458,-0.057,0.0048,-0.041,-0.1086,-0.0435,0.0687,0.0775,0.0086,0.0003,0.0146,0.0083,0.0414,-0.0144,-0.0553,-0.0099,0.0278,0.0529,-0.1016,0.0699,0.013,0.0895,0.0611,0.0966,0.0325,0.0251,0.0618,0.0624,-0.0184,-0.0222,-0.0238,0.0561,0.0688,-0.0114,0.0418,0.0187,0.0898,0.0136,0.05,0.0228,-0.0001,0.0235,0.0574,-0.0172,0.0425,0.0364,-0.0211,-0.0282,0.052,0.0284,0.0154,0.0149,0.0644,0.0245,0.0772,-0.0222,-0.0352,0.0002,-0.0194,0.028,0.0358,0.0235,0.0562,0.118,0.0712,-0.0134,0.0018,0.0294,0.0799,0.0795,0.0371,0.0273,0.0772,-0.0451,0.076,0.0491,0.0403,0.0561,0.0812,0.0146,0.0085,0.0351,-0.0296,0.0175,-0.0014,-0.0258,0.0195,-0.019,0.0563,0.0545,0.0841,0.0669,0.0292,-0.0074,0.0895,0.0825,0.0202,0.0442,0.0638,0.0519,-0.0805,-0.0393,-0.0785,0.0565,0.0458,0.0473,-0.0377,0.0655,-0.0042,0.0195,0.0062,0.0938,0.0297,-0.0898,0.0157,0.025,0.0207,0.0402,-0.002,-0.0667,0.0053,-0.0299,0.0431,0.0255,-0.0012,-0.0417,-0.0315,0.03,-0.0699,0.0255,0.0411,-0.0818,0.0285,-0.0086,0.0235,0.0205,-0.1516,0.0491,0.017,-0.0136,0.0276,-0.0037,0.016,-0.0165,-0.0376,0.0336,0.0238,0.0372,0.0565,0.0192,0.1217,0.0198,-0.0151,-0.0253,-0.0139,-0.0457,0.0793,-0.026,-0.0127,-0.0414,-0.007,-0.0132,-0.0438,0.0453,0.0102,-0.0208,-0.0583,0.0235,0.0322,0.0232,0.023,0.0193,-0.0321,0.068,0.0362,-0.0888,-0.0525,-0.1002,-0.0004,-0.0749,-0.0477,-0.0835,0.0758,0.0698,0.1021,0.0857,0.0181,0.0014,-0.0497,-0.0255,-0.005,0.0513,0.0372,0.0046,0.0691,0.0117,0.0085,0.0347,-0.0112,0.025,-0.0212,-0.0288,0.1127,-0.0044,0.0472,-0.0548,-0.0615,0.0017,0.0263,-0.0552,-0.0061,-0.0279,0.0058,0.0104,-0.0006,0.0332,-0.0088,-0.0429,-0.0093,-0.0021,0.0338,-0.0479,0.0112,0.0506,0.0551,0.0365,0.0155,-0.0043,0.0183,-0.0038,0.0159,0.0191,0.0453,0.0324,0.0544,0.0142,-0.0668,-0.0521,0.0368,-0.003,0.0765,0.0766,0.0495,-0.0663,-0.0498,-0.008,-0.0059,0.0226,0.009,0.0038,0.0022,-0.0407,-0.039,-0.0477,-0.0633,-0.0192,-0.0148,0.0291,0.0312,0.009,-0.0107,-0.0063,0.0488,-0.0712,-0.0269,-0.0677,-0.0545,0.0003,-0.0162,-0.0141,0.0233,0.0486,-0.0302,0.0274,-0.0135,0.0631,-0.0547,0.0345,0.0032,0.0006,-0.0421,0.0066,-0.1105,0.0333,0.0202,0.0135,-0.013,0.04,0.0312,0.0295,-0.0035,-0.0174,0.0266,-0.0179,0.043,-0.0444,-0.0942,-0.0787,0.0255,-0.0242,0.0293,0.0173,-0.0216,-0.0309,-0.0029,0.0054,0.016,0.004,0.039,0.0668,0.0082,-0.0369,0.0508,0.0617,-0.0098,0.0468,0.0726,-0.0058,0.0489,0.0726,0.0173,0.0012,0.0011,0.0106,0.0648,0.0572,-0.001,0.0409,-0.0572,0.0102,-0.051,-0.0029,-0.0474,-0.0071,-0.0508,0.0471,0.0481,-0.0577,-0.0568,0.0474,0.0186,-0.0135,-0.046,-0.0168,-0.0326,0.0385,0.019,0.0041,-0.0292,0.0896,0.0596,0.023,-0.0276,0.0561,0.015,-0.0314,0.1015,0.0029,0.018,0.0425,-0.0025,0.02,-0.0478,0.0271,0.0327,0.0526,0.0339,0.0007,0.0048,0.0249,-0.0365,-0.0074,-0.0006,-0.0638,-0.023,-0.0157,0.0006,-0.0601,-0.0471,-0.0183,0.0521,-0.0558,-0.0448,-0.081,-0.0298,0.0258,0.0193,-0.0015,-0.015,0.062,-0.0154,-0.0151,-0.1279,0.0857,0.0856,0.0068,0.0158,0.0069,-0.006,-0.0014,0.0836,0.0836,0.0233,0.0316,0.0177,0.0205,0.0196,0.0327,0.0452,0.0346,-0.0506,0.0551,-0.0228,0.0344,0.0024,-0.0233,-0.0354,0.0476,0.0366,-0.0974,0.0076,0.0053,0.028,-0.0077,-0.024,-0.0335,0.0348,-0.0292,-0.0559,-0.0719,-0.0526,-0.0275,-0.054,-0.0334,0.0935,0.045,-0.0257,0.0692,0.0347,0.0742,0.0653,0.0279,0.0017,-0.0197,0.0133,0.0286,-0.0205,0.0385,0.0085,-0.0058,0.0585,-0.0353,0.0362,-0.0223,-0.1161,-0.0526,0.0583,-0.0409,-0.0184,0.0163,-0.0171,0.0531,0.0224,0.0514,0.0057,0.0191,-0.029,0.0372,0.0554,0.0199,0.0263,0.0019,0.0593,0.0268,0.001,-0.1322,-0.1359,-0.04,-0.0626,-0.0015,-0.0101,-0.0296,0.0336,0.0472,0.0056,-0.0193,0.006,-0.0703,-0.0124,-0.0332,0.0222,0.0194,0.0025,-0.0191,-0.039,-0.0473,-0.0276,0.0962,0.0415,-0.0513,0.0234,0.0085,0.0012,0.0014,-0.0305,0.0056,-0.112,0.01,0.0283,0.0233,0.0436,0.0292,-0.0073,0.0489,0.0731,0.0731,0.0375,0.0338,0.0339,0.029,0.0888,0.0048,0.0528,-0.0481,0.0126,0.0165,-0.0554,-0.0013,0.0413,-0.042,0.0003,-0.0138,-0.0712,0.0349,0.0519,-0.0065,-0.078,-0.0083,-0.0548,0.0543,-0.0231,-0.0039,-0.0236,-0.0343,-0.1093,0.0458,-0.0128,0.089,0.0666,-0.0623,0.0831,0.0037,0.0366,-0.0423,0.0701,0.0268,-0.0683,-0.1403,-0.0352,-0.0074,0.0261,0.0682,-0.1129,-0.039,-0.1273,-0.067,-0.0204,-0.0762,0.0669,-0.0772,-0.0223,-0.0249,0.0105,-0.0183,-0.0297,0.0166,0.0262,-0.1449,0.0561,0.0278,0.0406,0.0358,-0.0093,0.0162,0.0128,-0.043,0.0506,0.0054,0.019,0.024,-0.0769,0.0006,-0.0635,-0.0604,-0.0043,0.0121,0.0723,-0.0065,0.0253,0.0036,0.0485,-0.0174,0.0069,0.0004,0.0612,0.0229,-0.0359,0.0359,0.0258,0.021,-0.0091,-0.0002,0.0635,0.0835,-0.0105,0.0972,0.0403,0.0095,-0.0328,0.0631,-0.0092,-0.0664,0.0512,0.1089,0.1065,0.0673,0.0344,0.011,0.0466,0.014,-0.0436,0.0345,0.0288,0.0009,-0.0682,-0.0537,-0.0094,0.0097,0.0041,-0.0245,-0.0445,0.0901,0.0249,0.0011,-0.0016,0.043,0.0849,-0.0131,-0.015,0.0519,-0.0366,0.0266,-0.0455,0.0818,0.1384,0.123,0.0859,-0.0317,0.0167,0.0105,-0.0406,0.0115,-0.0716,-0.0089,-0.0082,-0.0107,-0.0151,0.0538,-0.0132,-0.0321,-0.0158,-0.0224,-0.0408,-0.0503,0.0107,-0.0214,0.0333,0.0108,0.0631,0.0832,0.0323,0.0771,0.0625,0.0293,-0.0034,0.0533,0.0109,0.0082,0.0325,-0.0109,-0.0067,-0.0132,0.0077,-0.0033,0.0247,-0.0254,-0.0146,-0.0155,0.0281,-0.0226,0.0746,0.0765,0.0352,0.0387,0.02,0.0456,0.0149,-0.0021,-0.0212,0.0005,-0.0585,-0.0047,-0.0499,-0.0412,-0.0172,-0.015,0.042,-0.0194,-0.0067,0.0152,-0.0307,-0.0422,0.0597,0.0844,-0.0391,0.0422,0.0576,0.1348,0.0469,0.0809,0.059,0.0752,0.0124,0.0132,0.0132,0.045,0.0096,0.0282,-0.0651,-0.0675,0.0125,-0.0134,0.0536,-0.0096,-0.0238,-0.0107,0.004,-0.0227,-0.0107,0.0275,-0.0344,0.0112,-0.0055,0.0009,0.0317,0.0197,0.0099,0.0084,0.1066,0.0676,0.0145,-0.0075,-0.0133,0.0071,0.03,-0.0975,-0.1097,0.0397,0.0471,-0.0656,0.0102,0.0274,0.0542,-0.1665,0.0581,-0.0488,-0.0064,0.0295,-0.014,0.0719,0.0645,0.0459,-0.0088,0.0378,0.0368,0.0209,0.0017,0.0391,0.0411,0.0359,0.0455,-0.0335,-0.0067,-0.0289,-0.0326,0.0334,-0.004,0.0461,0.0391,0.0217,-0.0322,0.0256,0.0108,0.0917,0.0295,-0.002,0.0145,-0.0139,0.0475,0.0397,0.0361,0.0373,0.044,0.0471,-0.0093,-0.0309,-0.0147,-0.0149,0.033,-0.0108,-0.08,-0.0529,-0.0241,0.0083,0.0376,-0.0886,-0.0042,0.0013,-0.0175,0.0089,0.0269,-0.0158,-0.0233,-0.0298,0.011,-0.0188,-0.0464,-0.02,0.032,-0.0239,0.0559,0.0526,0.0911,0.0644,0.0944,0.0429,0.0324,0.0401,0.0317,0.0702,0.0475,0.0748,0.073,-0.0303,-0.0049,-0.0396,0.001,-0.0313,-0.0024,0.0012,-0.0011,-0.0065,-0.0572,0.0432,0.0427,0.03,-0.002,-0.0123,-0.0623,-0.0339,-0.0309,0.0383,-0.0046,-0.0423,-0.0345,-0.0058,0.0189,-0.0043,-0.005,-0.0461,0.0402,0.0034,0.0352,0.0622,0.0888,0.0469,0.1236,0.103,-0.0141,-0.0985,-0.0454,-0.0077,0.0148,0.0194,0.009,0.0063,-0.0296,-0.0365,-0.0597,0.0067,0.002,0.0188,-0.0211,0.0147,0.0022,0.0145,0.0392,-0.0154,0.066,0.0481,0.0602,-0.0324,-0.0486,-0.0337,0.0118,0.0105,0.0536,0.0208,0.03,-0.0294,-0.0208,-0.0166,0.0179,-0.033,-0.0842,-0.0448,-0.0013,0.0276,0.0138,0.0274,0.0175,0.0202,-0.0536,-0.113,-0.2059,0.0247,0.0274,0.0315,0.0071,0.0098,0.0304,0.0537,0.0475,-0.0198,-0.0349,-0.0447,-0.0219,0.0031,0.0042,-0.0282,0.0252,-0.0567,0.0239,0.0116,0.0483,0.019,-0.0648,0.018,-0.0138,0.0474,-0.0732,0.0006,0.0284,0.0249,0.035,0.0353,0.0194,-0.0337,0.0325,0.0406,0.0067,-0.0187,0.0516,0.0568,0.0241,0.0208,-0.0033,0.0589,0.0291,0.0227,-0.0411,-0.0893,-0.0201,-0.0302,-0.0378,0.0169,-0.0563,0.0602,0.0354,0.0245,0.0429,0.0152,-0.015,-0.1513,-0.1552,-0.1449,-0.0797,-0.1381,-0.0388,0.0857,0.026,0.0315,0.0286,0.0135,0.0625,0.0066,0.0062,0.0093,0.0426,0.0411,0.0062,-0.0396,-0.0131,0.0163,-0.0732,-0.0697,0.0066,-0.0798,0.026,0.036,0.04,0.04,0.0534,0.0008,0.0349,-0.0283,-0.0301,-0.0267,0.039,0.0675,0.0674,0.0509,0.0364,0.0446,0.0016,-0.0626,0.0236,0.01,0.043,0.0232,0.0241,0.0394,-0.0463,-0.1034,0.0648,-0.0271,-0.0777,-0.1651,-0.1428,-0.1529,-0.0434,-0.0032,0.0263,-0.0417,-0.0163,0.0234,0.0959,-0.0423,0.0711,-0.0907,0.0026,0.0036,-0.0183,0.0689,0.0062,-0.0092,0.0591,-0.0809,-0.1099,0.004,0.0549,0.0124,0.0333,-0.0117,-0.0492,-0.0594,0.0977,0.0887,0.0552,0.0052,-0.0421,0.0358,0.0927,-0.073,0.0191,-0.0797,-0.0378,-0.0543,-0.1602,-0.0133,-0.0496,0.0316,0.0094,-0.1094,-0.0116,-0.0222,-0.0059,-0.0492,0.0146,0.0444,-0.0157,-0.0259,0.0229,0.0075,-0.0145,0.0431,0.0554,0.1061,0.0245,-0.0833,0.0266,-0.0075,-0.0881,0.0012,-0.0395,-0.0023,0.0071,-0.0209,0.0499,-0.028,0.0185,-0.0099,0.0256,0.0244,0.0208,0.0089,0.0839,0.0216,0.0699,0.0717,0.0618,0.0402,-0.0601,-0.009,0.0731,0.0824,-0.0383,-0.0337,0.0523,-0.0024,-0.0051,-0.0293,-0.0237,-0.1533,0.0848,0.1068,-0.0264,-0.0801,-0.0172,0.0536,-0.011,-0.011,0.0778,0.0214,-0.0133,0.0111,-0.0115,0.0068,0.0055,-0.1174,0.0845,0.0939,0.0029,-0.0093,0.0757,0.0904,0.0388,-0.0081,-0.0128,0.0424,0.0364,-0.0275,-0.1177,-0.0104,-0.0367,-0.0107,0.0128,0.0072,-0.0611,-0.0311,-0.0367,0.0283,0.0055,0.0155,-0.0004,0.0483,-0.087,-0.0454,0.0346,-0.1431,-0.0965,-0.1522,-0.0483,-0.0883,0.0548,0.0572,0.0265,0.0739,-0.015,0.0398,0.0158,-0.0344,0.0258,0.0958,-0.0848,0.029,0.034,-0.01,-0.0716,0.0121,-0.0186,-0.0059,0.022,-0.0423,0.0511,-0.0341,0.0521,0.0405,-0.054,-0.0948,-0.1307,-0.0228,-0.0361,0.021,-0.0056,0.0019,0.0123,0.0595,0.0011,0.1106,0.009,0.0344,0.0044,0.0114,0.0902,0.0788,0.0082,-0.0441,-0.0305,-0.0282,0.0426,0.0022,0.0354,0.0251,0.0908,0.0962,0.0616,-0.0018,0.0632,0.071,0.0211,0.0182,0.0206,-0.059,-0.0418,0.0315,0.0459,-0.067,0.0375,0.0301,-0.0199,-0.0566,-0.0605,0.0904,0.0128,-0.0348,0.053,-0.0192,0.0001,0.0135,0.0212,-0.0469,-0.0282,-0.0232,0.074,-0.0081,-0.0255,0.0196,-0.1406,0.0758,-0.003,-0.1005,-0.0411,-0.0837,0.0202,-0.0022,0.0656,0.008,0.0597,0.083,0.0641,0.0102,-0.0287,0.051,0.0443,-0.0054,0.0387,-0.0303,0.0301,0.006,0.0139,0.0067,-0.0098,0.0011,0.0116,-0.0072,0.039,0.0592,0.0103,-0.014,0.0473,0.0116,-0.0526,-0.03,-0.0444,0.0287,0.0213,0.0306,-0.0221,0.0001,0.0684,0.0884,-0.014,-0.0585,-0.1155,0.0365,0.035,0.0227,-0.0279,-0.0191,-0.0358,0.02,0.0083,-0.0046,0.0927,0.0098,-0.0054,-0.0552,-0.0075,0.0326,0.0334,0.0342,0.0639,-0.0654,-0.055,-0.0457,-0.0239,-0.0651,0.0264,0.0005,0.0411,0.0023,0.0175,0.0098,-0.0354,-0.011,-0.0157,-0.0344,-0.0618,0.0037,0.0168,-0.0032,-0.0382,-0.0607,-0.0981,-0.0381,0.02,0.0285,0.0187,-0.0943,-0.0408,0.007,-0.0508,-0.0533,-0.0581,-0.0235,-0.0394,0.0253,-0.0312,-0.0036,0.0039,-0.0513,-0.0464,0.0667,0.0852,-0.0544,0.0029,-0.0062,0.0274,0.0192,0.0039,0.0068,-0.0153,-0.0019,0.0236,-0.0263,-0.0051,-0.0311,-0.0307,0.0226,0.0265,-0.0482,-0.0031,0.0059,0.0235,-0.0439,0.0166,0.0239,-0.0711,-0.042,-0.0855,0.0332,-0.0068,0.0098,-0.0587,-0.054,0.0562,0.0532,-0.03,-0.0082,-0.0192,0.0245,0.0634,-0.018,0.0621,0.0242,0.0005,-0.0166,-0.1392,0.0224,-0.0505,0.0033,-0.022,-0.039,-0.0347,-0.1048,0.0399,-0.0057,-0.0726,-0.0258,0.0307,-0.0189,0.0093,0.0605,0.0608,-0.0161,-0.0139,0.048,0.0097,0.0578,0.0299,0.0956,0.0045,0.0121,-0.0487,0.0667,0.0219,0.0184,0.05,0.047,0.0353,-0.0351,0.0219,0.0057,-0.0015,0.0061,-0.0888,-0.0364,-0.0369,-0.049,0.0331,0.0289,-0.0123,0.0283,0.0055,0.0161,-0.1045,-0.0296,0.0921,0.0073,-0.0227,0.0019,0.0086,0.0634,0.0821,0.0332,0.0531,-0.0864,-0.0793,-0.0829,0.0441,0.0074,0.0042,0.0096,-0.054,0.0061,0.0268,-0.0123,-0.0556,-0.0336,0.0133,-0.0735,-0.0749,-0.0149,-0.0098,-0.0048,0.0221,0.0389,-0.0582,-0.029,0.0874,0.0155,-0.0184,-0.0354,-0.0545,-0.0611,0.0581,0.0407,0.04,0.015,0.0153,-0.0247,-0.0031,0.0135,-0.0135,-0.0411,0.0045,0.0565,0.009,0.0046,-0.022,-0.0285,-0.0263,-0.0798,-0.0255,0.0262,0.0405,-0.0545,0.0562,0.0583,0.0511,-0.0716,-0.0074,-0.0178,0.0195,0.0011,-0.0326,-0.0378,-0.1024,-0.0407,0.0038,-0.0005,0.0064,0.0206,-0.0363,0.0378,-0.0674,0.0516,0.0818,0.0621,0.0673,0.0119,-0.0099,0.0219,-0.1432,0.0435,-0.0446,-0.0392,-0.0711,0.0314,0.0429,-0.0262,-0.0409,-0.0537,-0.0648,-0.0596,-0.0477,-0.0769,0.0801,0.0799,0.0894,0.0185,0.0455,0.0846,0.0188,0.0249,0.0309,0.0377,0.003,0.0203,-0.0091,0.0124,-0.0383,-0.1054,-0.0564,0.0182,0.0045,-0.0383,-0.006,0.0002,0.0619,0.0032,0.0526,0.0498,-0.0206,0.0121,0.0272,0.056,-0.0015,-0.0326,0.1245,0.0675,0.0923,0.0618,0.0465,-0.0306,-0.022,0.083,0.0876,0.0218,0.014,0.0142,-0.0356,-0.0286,0.0355,0.0255,0.0363,0.0443,0.0196,0.0458,-0.0063,0.0117,0.0148,0.1218,0.0026,0.0273,0.0363,0.1187,-0.0434,0.0965,-0.0179,0.0046,0.0383,-0.0032,0.0256,0.0715,0.0265,0.1039,0.082,0.0339,-0.0311,0.0621,0.0199,0.0781,0.0329,-0.0157,-0.0506,-0.0342,-0.0153,0.0271,-0.0356,0.0557,0.0676,0.0529,-0.0116,0.0417,0.0695,0.0935,0.059,0.0326,0.0128,0.0166,0.0184,0.1113,0.0268,0.0085,0.054,-0.0233,0.026,0.0156,0.0125,-0.0248,0.043,0.0226,-0.0433,0.0478,0.076,0.0518,0.0836,0.0173,0.073,0.0499,-0.0152,-0.0864,-0.0642,-0.0271,0.0159,0.0377,-0.0505,-0.0589,-0.0839,0.0961,0.1081,-0.0418,-0.0303,-0.0174,-0.0191,0.0062,0.0291,0.0431,0.0234,0.0082,0.0391,-0.0167,0.0265,0.0341,0.0383,0.0313,-0.0893,-0.0041,-0.0233,-0.1341,-0.035,-0.0324,0.0819,0.0135,0.0056,0.0201,0.1141,0.0709,-0.0313,0.0303,0.0247,-0.2374,-0.1306,-0.1798,-0.1974,-0.1297,-0.1306,-0.1223,-0.0663,-0.0459,-0.0325,-0.2208,-0.1465,-0.1787,-0.1916,-0.0889,0.089,0.005,0.0062,-0.0153,0.0373,0.0624,-0.0278,-0.0142,0.0295,-0.0856,-0.0539,0.0262,0.0047,-0.0925,-0.0916,-0.0814,-0.1127,0.0083,0.0429,-0.0878,-0.0827,0.0174,0.0052,-0.0399,0.0386,-0.0201,0.0283,0.0143,0.0251,-0.0451,0.1444,0.0464,0.0472,0.0605,0.078,0.0718,0.1006,0.0654,0.0457,0.0387,-0.0306,-0.048,-0.0484,0.0392,0.1019,-0.057,0.0096,-0.0363,0.0227,0.025,-0.0765,0.0191,0.0462,0.0427,0.0323,0.0769,0.0254,-0.0492,-0.0517,-0.015,-0.03,-0.0514,0.0411,0.0719,0.0109,0.0785,0.0436,0.0377,0.0414,0.0042,0.0325,0.0609,-0.03,0.017,-0.0197,-0.0236,0.0053,-0.0312,0.0552,0.0512,0.04,-0.0119,-0.0004,0.027,0.0249,-0.0636,-0.0373,-0.0006,-0.0053,-0.0123,-0.0288,0.0254,0.0491,0.0437,-0.0218,-0.0158,-0.0218,0.003,-0.018,0.0377,0.0478,0.0297,-0.0053,-0.1354,-0.0269,-0.0439,0.0006,-0.0854,0.0824,0.0817,0.0424,0.0306,0.035,0.0043,-0.0093,0.0321,0.0455,-0.0023,0.0002,0.0041,-0.0233,0.0595,-0.0256,-0.0187,-0.0135,-0.0249,-0.0523,0.0762,0.0147,0.0399,0.0841,0.0295,0.0343,-0.007,-0.0122,-0.0088,0.0024,0.0274,-0.0101,-0.0154,-0.1344,-0.0727,-0.1353,0.053,-0.0039,-0.0028,0.0429,0.0332,0.0623,-0.0866,0.0663,0.0925,0.0809,-0.0632,-0.0621,-0.0109,0.0595,0.0169,-0.0682,-0.0252,0.0212,-0.0676,0.0315,0.0675,0.1033,-0.1461,-0.0283,0.0399,-0.0373,-0.0303,-0.0899,-0.17,0.0084,0.0026,0.0039,-0.0008,-0.1492,-0.037,-0.0488,0.0133,0.051,0.0214,-0.011,0.011,-0.02,-0.0345,0.0924,0.0456,0.0744,0.0608,0.0136,-0.0205,0.0196,0.0008,0.0092,0.0029,0.0225,-0.0593,-0.0462,-0.0053,-0.0302,0.0259,-0.0217,0.0166,-0.0662,-0.0724,-0.0119,0.0559,0.0341,0.0001,-0.0218,0.0116,-0.0295,-0.0259,-0.0806,-0.0727,0.0545,-0.0207,0.0086,-0.0142,0.0207,-0.0491,0.0206,-0.0002,-0.0506,-0.0839,-0.0029,-0.0139,0.1076,0.0308,0.0465,0.036,0.0922,-0.0494,0.0327,0.0128,-0.0098,-0.1098,-0.0616,0.0783,-0.0275,-0.038,0.0437,-0.0111,-0.0318,-0.0212,-0.0234,-0.0555,-0.002,-0.157,-0.0431,0.0208,0.0014,-0.1001,0.0403,-0.0063,-0.026,0.0174,-0.0184,-0.0648,-0.0447,0.022,0.0566,0.0846,0.0857,0.0707,0.0362,0.032,0.0423,0.0457,0.0259,-0.0635,-0.0197,-0.0362,0.0058,-0.0307,-0.1156,0.0584,-0.0547,0.0423,0.0313,0.0748,-0.0757,0.0081,0.0443,0.0209,-0.1175,-0.0858,-0.0834,-0.015,0.0212,-0.0181,-0.0176,-0.0195,-0.0095,0.0294,-0.0014,0.0002,0.0191,-0.0218,0.0042,-0.01,0.0091,0.0517,0.0839,0.0051,0.0455,0.0653,0.061,0.0545,0.0654,-0.1016,-0.0135,0.0024,0.1319,0.0565,0.003,0.1099,0.0892,0.0406,0.052,0.052,0.0424,-0.0123,-0.0461,0.0696,-0.0018,-0.0356,-0.0407,0.0038,0.0019,0.1233,-0.045,-0.0338,0.0196,-0.0085,-0.0507,-0.0939,-0.0326,0.0518,0.0587,-0.0138,0.0307,0.0112,-0.0409,-0.1057,-0.1439,-0.2002,-0.1308,0.0268,-0.0003,-0.1853,-0.1409,-0.0294,0.0828,0.0649,0.0145,0.0585,0.0289,0.0247,0.0168,-0.0477,-0.0273,0.0147,-0.0457,0.0,0.0481,-0.0188,0.0018,0.0993,0.0556,0.1031,0.0439,0.0351,-0.0088,0.0314,-0.2556,-0.2573,-0.1143,-0.163,-0.0964,-0.0028,0.0167,0.0605,-0.0108,-0.0322,-0.0002,-0.0555,-0.0037,-0.0322,0.0065,-0.0155,-0.0702,0.025,0.0122,0.0122,0.0067,-0.1253,0.0013,-0.1716,-0.0818,-0.1173,-0.0771,-0.0578,0.0436,-0.0317,0.0117,0.0497,-0.0112,-0.0091,0.0318,0.0458,0.0502,0.0118,-0.0818,-0.0212,0.0328,0.0457,0.0155,0.007,0.0401,0.0386,0.0014,0.0075,-0.0202,-0.0017,-0.1002,-0.0133,-0.0616,-0.1662,0.011,0.0239,0.0457,0.0331,-0.0432,-0.0054,0.0156,-0.0111,-0.0565,-0.1498,-0.0262,0.0292,0.0097,-0.03,-0.0009,0.0362,-0.0051,-0.0312,-0.0231,-0.0158,-0.0118,-0.0024,0.0437,-0.0037,-0.1182,-0.0758,0.0567,0.0311,0.0712,0.0599,-0.0038,0.0056,-0.0123,0.0792,0.0516,0.0671,-0.0106,0.0464,-0.0261,0.007,-0.0888,0.0114,0.0457,0.0443,0.0181,0.0312,0.0247,0.0437,-0.0323,-0.0896,-0.0223,0.0082,0.0046,0.0258,-0.0231,-0.0158,-0.0429,0.0006,-0.0026,0.059,-0.0105,0.0536,0.0317,-0.009,0.058,-0.0238,-0.0689,-0.0423,-0.0431,-0.0198,0.0174,0.084,-0.0118,-0.038,-0.0732,0.032,-0.0378,0.041,0.0115,0.0509,0.0625,0.0803,0.0556,0.0639,-0.0116,0.0425,0.0591,0.0833,0.0998,0.0318,-0.0051,0.0508,0.0139,0.0996,0.0008,-0.0167,0.011,-0.03,-0.0484,-0.1076,-0.1026,-0.0101,0.0033,0.0185,0.0303,0.0117,0.0587,0.0859,-0.0036,0.0081,0.0228,0.038,0.0023,0.0056,-0.0013,-0.0196,-0.0299,0.06,0.0165,0.0651,0.07,-0.0654,0.0424,0.0548,0.0645,0.0241,-0.0544,-0.1367,0.0724,0.0378,-0.0092,-0.0094,0.0365,0.0719,0.0421,0.0353,0.0511,0.027,0.0217,-0.0111,-0.0561,-0.0253,-0.0215,-0.0009,-0.0289,-0.0352,0.0098,0.0308,0.0113,0.0169,-0.0396,0.0647,0.0774,0.0687,0.0325,-0.077,0.0244,-0.0222,-0.0009,-0.0749,-0.048,-0.0942,-0.0105,0.0692,0.0556,-0.0084,0.0014,-0.1039,-0.0786,-0.0572,0.0092,0.0242,-0.0064,-0.0504,-0.0116,-0.0506,0.0265,0.0949,0.0236,-0.003,0.0058,0.0682,-0.005,-0.0415,-0.0741,0.0035,-0.0052,-0.0075,0.0518,-0.006,-0.0288,0.0289,-0.0401,-0.0072,-0.0006,0.0537,0.0043,-0.0184,0.0409,-0.0168,0.0153,-0.0418,-0.0918,-0.0007,0.026,0.0223,-0.0503,0.0416,0.0186,0.0074,0.1149,0.1317,-0.0464,-0.0159,-0.0539,-0.0004,-0.0092,0.0863,0.0921,0.0759,0.0764,-0.0081,-0.007,-0.0249,-0.0024,-0.0211,0.0029,0.0735,0.0089,0.0479,0.0581,-0.1013,0.0592,0.0154,0.1328,0.062,0.0285,-0.038,-0.0024,0.0043,0.003,-0.0136,0.068,-0.0096,0.0801,-0.0585,0.0141,0.0065,-0.0099,0.0255,-0.0995,-0.1194,-0.1311,0.0506,0.0849,0.0461,0.0202,0.0906,0.0226,-0.0408,0.0735,0.0609,0.0242,0.0505,-0.0151,0.0183,0.0163,0.0026,0.0462,0.0603,0.0579,0.075,0.0225,-0.0474,0.0659,0.0863,0.0228,-0.0248,0.0212,-0.0062,0.0226,-0.0199,-0.0951,-0.083,0.0506,0.0554,0.0308,0.008,-0.0178,-0.0502,0.008,0.021,0.0363,-0.0331,-0.0101,-0.0301,-0.0078,-0.0189,0.0628,0.0893,0.0364,0.0253,0.0284,-0.0001,0.06,0.0317,-0.0212,-0.0592,-0.0435,-0.007,0.0184,0.0031,-0.1612,-0.1392,-0.0939,0.0139,0.0036,-0.1092,0.0063,-0.0075,-0.0217,-0.0372,-0.0661,-0.0519,-0.0307,-0.0771,-0.1042,-0.1036,-0.1467,-0.0738,0.0121,0.0633,0.0139,-0.0239,0.0012,-0.0262,-0.0209,-0.0347,0.0217,-0.0118,-0.0086,0.0587,0.0204,0.0754,0.0151,0.0485,0.0304,0.0094,0.0278,-0.0071,-0.0655,-0.0606,0.0108,0.0195,-0.0116,-0.0744,-0.0166,-0.0834,-0.1088,-0.0905,-0.0017,-0.0698,0.0286,0.0149,-0.0707,-0.0476,0.0169,-0.0348,-0.0544,-0.0557,-0.0586,-0.0459,0.0325,0.0102,0.036,0.0249,-0.0533,-0.1048,-0.0843,0.0565,0.0141,0.0099,-0.1059,-0.0046,0.057,-0.0503,-0.0494,0.0019,-0.0223,-0.0817,-0.0386,-0.0203,-0.0518,-0.0603,0.0161,0.0666,0.0119,0.06,-0.0606,-0.0253,-0.0122,0.006,0.0273,-0.0044,-0.0239,-0.2682,-0.0111,0.0175,0.0455,0.0859,0.1003,0.0721,0.05,0.0342,0.0306,0.04,0.0439,0.0822,-0.096,-0.0823,-0.0794,0.0005,-0.076,-0.0379,0.0243,0.0079,0.0633,0.0104,-0.0736,0.0062,-0.0925,0.0034,0.0001,-0.0103,0.0213,-0.0284,-0.0247,-0.0323,0.0107,-0.1048,0.0081,0.0196,0.0184,-0.0023,-0.0208,0.0154,0.0876,0.0388,0.0616,-0.1079,-0.0852,-0.1348,-0.0163,-0.0482,0.0284,-0.0511,-0.0623,-0.0731,0.0792,0.0363,0.0086,-0.0785,0.0008,0.0244,0.1231,0.1222,0.0605,0.0343,-0.0646,0.0583,0.0536,0.04,-0.0721,-0.1008,-0.0715,-0.0218,-0.0022,-0.0543,-0.074,-0.0285,-0.018,-0.0233,-0.0489,-0.0396,0.0343,0.0573,0.0216,0.0066,-0.0325,-0.0296,0.0136,0.0693,0.0637,0.0122,0.0513,0.0551,-0.1103,-0.0066,0.0052,-0.0191,0.0137,0.0248,0.0763,0.0464,0.0826,0.0036,0.0437,0.0179,-0.0316,-0.0638,-0.0148,0.0127,-0.0077,-0.0717,-0.0073,0.0489,-0.0747,0.0488,-0.012,0.0474,0.0489,0.001,-0.0064,-0.0021,0.0292,-0.029,0.0324,0.0616,-0.0196,-0.0285,0.0074,-0.0338,-0.0395,-0.0387,0.0521,0.0704,-0.0092,-0.105,-0.0033,0.0611,0.0604,-0.0249,-0.024,0.0393,0.0171,-0.0966,-0.0432,-0.0792,-0.063,0.0118,-0.1113,-0.0294,-0.068,-0.0406,-0.0749,-0.0738,-0.2543,-0.2539,-0.0029,-0.0281,-0.039,-0.0127,-0.0126,-0.1042,-0.1007,-0.0292,-0.0097,0.025,0.0596,-0.0297,-0.0266,-0.0105,0.0755,0.0686,0.0956,0.0027,0.0365,-0.0268,0.0271,-0.0309,-0.0512,-0.021,0.0434,0.068,-0.0632,0.0011,0.0528,-0.1897,-0.0828,-0.0446,0.0272,-0.02,-0.0909,-0.0739,-0.0282,-0.0299,0.0217,-0.0062,-0.0244,-0.0265,0.0215,-0.0042,0.0109,-0.0285,0.0256,-0.1409,-0.018,0.0335,-0.0058,-0.0078,0.0109,0.0095,0.0435,0.0091,-0.0463,-0.013,-0.0318,0.074,0.029,0.0226,0.0712,0.0344,-0.0565,-0.0834,-0.0125,-0.0136,0.0076,0.0194,0.0205,0.0194,0.0577,0.0828,0.0585,-0.0398,-0.0456,0.0074,0.0096,0.0387,0.0012,0.0367,0.0427,0.026,-0.0085,0.035,-0.0279,0.0603,0.0693,0.014,-0.0026,0.0729,0.098,-0.0239,-0.0157,0.0306,0.0732,0.0405,0.0411,-0.0087,-0.0385,-0.0759,-0.0305,-0.0522,0.0256,-0.0388,-0.0227,-0.1078,0.0343,-0.05,0.0529,0.0595,0.0195,-0.0659,-0.0484,0.0372,-0.0101,0.0146,0.0133,0.0416,-0.0554,0.024,-0.0104,-0.0472,0.0039,0.0133,0.0493,-0.026,0.0162,-0.0793,-0.1112,0.0934,0.0729,-0.0533,-0.0742,0.0423,-0.0935,-0.0084,0.0474,0.0623,0.0834,0.0167,0.0295,0.0638,0.0409,0.0176,-0.0257,0.0004,-0.0156,-0.0388,-0.1001,0.001,-0.0259,-0.0187,-0.0141,-0.004,0.0249,0.0024,0.0226,0.0308,0.0258,0.0701,0.0273,0.0194,0.0062,0.0322,0.004,0.0541,0.0286,0.0272,0.0266,0.0201,0.0288,-0.0317,0.0185,-0.0053,-0.0245,0.0007,0.0083,0.0503,0.0197,0.0111,0.0648,0.0292,0.0455,-0.0928,-0.0125,-0.0832,-0.0045,-0.0721,0.0245,0.0413,0.0016,0.0172,-0.048,-0.0744,0.0723,0.0646,-0.0652,0.0467,0.0235,0.0224,0.039,-0.0357,0.0779,-0.0065,0.036,-0.0057,-0.0136,0.0864,0.0726,0.0083,-0.0167,0.0108,-0.0165,-0.0222,0.0641,0.006,-0.0096,-0.0065,0.0019,0.0003,0.0045,-0.0021,0.0702,0.0275,-0.0185,0.0347,0.0236,0.0776,-0.2135,0.0616,0.0338,0.033,0.0554,0.0759,0.0568,-0.0932,-0.0418,-0.0318,-0.0514,-0.0833,-0.0217,-0.0031,0.0872,-0.0106,-0.0341,-0.0205,-0.0297,0.0246,0.0566,0.009,-0.0288,0.0049,0.0185,-0.0302,0.0271,-0.0687,0.0205,0.0437,0.0243,0.015,-0.0481,-0.0383,0.0099,0.0095,0.0178,0.001,0.0055,-0.0297,-0.1347,-0.0488,-0.0283,-0.072,-0.0015,0.0234,0.035,0.0789,-0.1348,-0.0175,0.0944,0.0541,0.0586,-0.135,-0.0751,0.1174,0.1074,0.0257,-0.0174,-0.0043,0.0878,-0.0326,-0.0299,0.0159,0.0216,0.0314,0.0077,0.0138,0.0668,0.0556,-0.014,0.1002,0.1013,-0.0201,-0.0303,0.0041,0.0181,0.0174,0.0174,-0.013,-0.0155,0.0196,-0.0551,-0.018,0.0398,-0.002,-0.0436,0.0243,-0.0503,-0.0493,0.0568,0.0848,-0.0085,0.0846,0.0471,0.0517,0.0149,-0.0786,0.0555,0.0619,0.0189,0.0009,0.0338,-0.0324,color recognition
trm_56798c5f25b0c,-0.1062,-0.1271,-0.1318,-0.1211,0.0112,-0.0502,-0.1111,-0.0682,-0.0592,-0.1045,-0.0034,-0.0033,-0.1315,-0.0906,-0.1389,-0.0769,-0.0887,-0.1035,-0.0731,-0.0369,-0.0737,0.0304,-0.0579,0.034,-0.0187,0.0245,0.0199,-0.1238,-0.1709,-0.088,-0.1231,-0.1179,-0.158,-0.0874,-0.1781,-0.1249,-0.0753,-0.0866,-0.1593,-0.0181,-0.1303,-0.1422,-0.0722,0.0971,-0.0957,-0.0828,0.1845,-0.079,0.0623,-0.1009,-0.0522,0.1004,0.0953,0.0758,-0.0099,-0.0803,-0.1271,-0.0525,0.0058,-0.0542,0.0108,0.0465,-0.1667,0.1176,0.049,0.0781,-0.2173,-0.2552,-0.1329,-0.0181,0.0726,0.0217,0.2113,-0.1131,-0.1504,0.0908,-0.1589,0.0593,0.0613,-0.0639,-0.0051,0.1079,-0.0622,-0.1649,0.083,0.0707,0.0026,-0.004,0.0008,-0.2372,-0.1089,-0.0439,-0.0241,0.1876,0.1735,0.1618,0.1611,0.0259,0.2702,0.1,0.0908,0.0445,0.1288,0.0634,0.1199,-0.1779,-0.1899,0.1578,-0.0294,-0.0581,0.0153,-0.1264,0.1269,0.2,0.0588,0.0208,-0.0927,0.0417,-0.0279,-0.0933,-0.0948,-0.1856,-0.1339,-0.0141,-0.0901,-0.1465,-0.0645,0.0659,0.0939,0.0268,-0.1133,-0.0966,-0.0479,-0.3127,0.0103,-0.2031,0.001,-0.1583,-0.0464,-0.0556,-0.1148,-0.13,0.039,0.0065,-0.0219,0.0907,-0.083,0.0503,-0.1071,0.0985,-0.0906,-0.0957,-0.185,-0.172,0.1855,-0.0032,0.0712,0.0388,0.0325,-0.0652,-0.0658,-0.0959,-0.232,-0.2491,-0.0377,-0.0112,-0.0306,-0.2038,-0.1896,0.0206,-0.0689,-0.1225,0.0605,-0.2733,-0.1792,-0.2399,-0.1744,-0.1439,-0.0958,-0.0342,-0.1969,0.0602,-0.06,0.0237,-0.0727,-0.0722,-0.1116,-0.1097,-0.0911,-0.0194,-0.0082,-0.0675,-0.0235,-0.1867,-0.1702,-0.2716,-0.2334,-0.0383,-0.0003,-0.1559,-0.0549,0.2456,-0.1752,-0.1726,0.0943,-0.1173,-0.1668,-0.0275,-0.0825,0.0035,-0.2166,-0.1007,0.002,0.0187,0.066,0.034,0.1026,-0.1737,-0.1639,0.0568,0.1022,-0.1315,-0.1821,-0.0724,0.0904,0.0099,-0.0509,0.1434,-0.0334,0.2605,-0.0888,-0.201,0.1892,-0.1628,-0.1551,0.0954,-0.0564,0.0985,0.0454,-0.0937,0.0046,-0.2247,-0.078,0.0115,-0.0804,-0.0987,-0.0925,-0.1361,-0.0778,-0.0915,0.0453,0.0178,0.0025,0.0627,0.0324,-0.2032,0.0071,-0.082,0.1372,0.2918,0.0902,0.3188,-0.1102,0.1413,0.2275,0.3755,0.1624,-0.02,0.0054,-0.0302,-0.0692,-0.0239,-0.1582,0.0086,-0.0896,0.0192,-0.1283,-0.2075,-0.1599,0.01,0.0561,-0.09,-0.0618,-0.2246,-0.1708,-0.1017,0.0511,0.0601,-0.1538,-0.1395,-0.1238,-0.1321,-0.0275,-0.0799,-0.1215,0.0139,-0.0082,0.156,-0.0329,0.199,0.1395,-0.1701,-0.1456,-0.1117,-0.0505,-0.0323,-0.1499,-0.0253,-0.0477,0.0015,0.0051,-0.0156,-0.1293,0.0997,0.0833,-0.0665,0.1803,0.0214,0.0851,-0.1449,-0.0077,0.0491,-0.1464,-0.1559,-0.1315,-0.052,-0.0,-0.0741,-0.0978,-0.1349,0.0523,-0.1012,-0.0045,0.0173,0.0572,0.1424,0.1057,0.0325,-0.0222,-0.1441,-0.1219,0.0433,0.0163,-0.0227,0.0955,0.0514,-0.3096,-0.2266,-0.2082,-0.1439,-0.1415,0.0272,-0.1167,-0.0561,-0.0948,-0.1015,-0.0563,-0.148,-0.1528,-0.1384,0.0097,-0.0322,0.0504,0.0077,-0.0008,0.0768,-0.1472,0.2957,0.0303,-0.1702,0.0311,0.1143,-0.0057,0.1306,-0.1658,-0.0333,-0.0969,0.1237,0.151,0.1503,0.2058,0.0353,-0.0664,0.0747,0.0314,0.0735,-0.1089,-0.0477,0.0496,-0.0433,-0.0597,-0.0246,-0.0543,-0.0322,0.1551,0.0647,-0.1002,-0.2148,-0.1084,-0.0632,-0.0737,0.0436,0.0059,-0.0473,0.0702,0.0984,0.096,0.0139,-0.1362,-0.0499,-0.0051,-0.2111,-0.0255,0.2725,-0.1406,-0.0133,0.3006,0.0131,-0.0907,-0.0241,0.0181,-0.2723,-0.1758,-0.3841,-0.3491,-0.144,-0.1916,-0.1074,-0.173,-0.1215,-0.032,0.0749,-0.0267,-0.025,-0.0148,0.0937,-0.0122,0.0186,-0.3025,-0.1778,0.0214,0.0476,0.0113,0.0597,-0.0434,-0.1081,0.0317,0.1198,-0.111,0.0277,0.0947,0.1042,-0.1282,-0.0447,0.0457,-0.1542,0.0276,-0.0533,-0.0086,0.0209,0.0833,-0.0659,-0.0685,0.0647,-0.1425,-0.1159,0.0426,0.4302,-0.1504,-0.0701,0.0222,0.0277,0.1243,-0.0542,-0.1166,-0.0512,0.0383,0.0455,-0.0459,-0.0452,0.0717,0.0441,-0.0088,0.079,0.1637,0.1698,-0.0217,0.0036,-0.0881,-0.0413,0.06,0.145,-0.1064,-0.1596,0.1362,0.0392,-0.0795,-0.0221,0.0649,-0.0951,-0.0809,0.0403,-0.0571,-0.1231,-0.1121,-0.1466,0.0578,0.0289,-0.0424,0.1355,-0.1814,0.0193,-0.0008,0.0093,0.1113,0.0963,-0.1353,-0.1181,0.1207,-0.1098,-0.0894,-0.0587,0.0998,0.1605,0.2164,0.0405,0.1948,0.1302,0.0481,0.0684,-0.0968,-0.0373,-0.1146,-0.2682,-0.1121,-0.0012,-0.1695,-0.1033,-0.042,-0.158,-0.0494,0.0289,0.0126,-0.0473,-0.1043,-0.0489,0.0364,0.039,0.0121,-0.0238,0.0865,-0.0119,-0.0197,-0.0223,-0.0281,-0.1719,0.1263,0.0565,0.0803,-0.0545,-0.0592,0.0253,-0.0866,0.0477,-0.087,0.0479,0.1101,-0.0286,0.0137,-0.0567,-0.0771,0.0081,-0.1267,0.0226,-0.0361,-0.0454,0.043,0.0329,0.108,0.1175,0.0172,-0.1068,-0.0073,-0.0525,0.1765,0.0711,0.0737,0.0609,0.0806,-0.0455,-0.1287,0.0466,0.1551,0.1357,-0.0235,-0.0238,-0.2393,-0.0731,0.1961,-0.0525,0.0203,0.0881,0.0691,0.0554,0.0735,0.0215,-0.0378,-0.1772,-0.1702,0.1312,-0.1912,-0.0639,0.093,-0.0829,-0.3055,-0.0565,-0.0772,0.0507,0.0246,-0.2423,-0.0791,-0.228,0.0446,0.0198,-0.0553,0.0387,-0.121,-0.1853,-0.1062,0.0543,0.0884,0.0733,-0.0981,-0.0007,0.0643,0.04,0.0882,-0.0553,-0.0706,-0.0433,-0.1233,0.0817,-0.0063,-0.0844,-0.1011,-0.0369,-0.2563,-0.1899,0.1484,-0.2099,0.0711,-0.1842,0.2054,-0.1209,-0.0492,-0.0696,0.0314,-0.1022,-0.0617,-0.0925,-0.2033,0.0161,0.188,-0.0559,0.0486,0.1385,-0.1393,-0.1322,-0.055,0.0008,-0.0766,-0.1043,-0.0919,-0.0615,-0.0494,-0.1043,0.2055,-0.1073,0.0287,-0.0399,0.0761,0.0517,0.0991,0.0531,0.1681,-0.1695,-0.1161,0.0401,0.0284,0.0022,0.1287,0.2108,0.1857,0.1186,0.1837,-0.0341,0.0465,-0.0783,-0.1073,-0.002,0.0661,0.0416,-0.0151,-0.1307,-0.0927,-0.0799,-0.1501,-0.1413,-0.1233,0.0757,0.1379,0.0655,-0.0227,0.0914,0.0492,0.0006,-0.0129,0.0299,-0.1342,0.0423,0.1082,-0.0827,-0.3066,-0.304,-0.2213,-0.0028,-0.0199,-0.1159,0.0401,-0.0695,0.0257,-0.0379,-0.0686,0.135,0.1272,-0.007,-0.1757,0.1466,0.1534,0.329,-0.179,-0.0393,-0.1021,-0.0369,0.0391,-0.1304,0.1427,0.0453,-0.0405,0.0225,-0.0153,0.0525,-0.2006,-0.2875,-0.2411,-0.174,0.0695,0.2208,0.0271,-0.1502,-0.0258,0.036,0.0872,0.0756,0.067,0.0186,-0.0877,-0.1094,-0.0614,0.1401,0.0979,0.1653,-0.0702,-0.0299,0.0314,-0.0955,0.0781,-0.0825,-0.1457,0.0061,-0.1771,-0.1802,-0.1029,0.0667,0.1066,0.0287,-0.0284,-0.0466,0.0237,0.1791,-0.023,-0.1322,0.0664,0.0073,0.0274,0.0124,0.1394,-0.0774,0.1753,-0.1928,-0.2005,0.1333,0.1346,0.1833,-0.0231,-0.0504,0.0701,-0.0001,0.0165,0.2308,0.0178,0.0844,0.1019,0.1628,0.0374,0.0067,0.1918,0.1997,-0.1602,0.0189,0.0792,-0.2236,-0.1635,-0.0466,-0.1477,-0.0449,-0.2662,-0.0809,-0.182,-0.1203,-0.2427,0.0175,-0.0202,0.0617,-0.0777,-0.0322,0.0446,0.0579,0.1423,0.0605,0.1046,0.1768,0.0291,0.0748,0.0479,-0.0005,0.1555,0.1715,-0.1268,0.1804,0.0751,-0.0403,-0.0655,-0.1184,-0.0578,0.1387,0.0692,-0.3147,-0.1675,-0.0604,0.0995,0.2189,0.085,0.0586,0.0287,0.0007,-0.0426,-0.0982,0.1272,-0.0677,0.0601,-0.2111,0.0703,-0.0781,0.1617,0.1785,0.0584,0.1718,-0.2269,-0.21,-0.0955,0.2516,-0.0803,-0.1042,-0.1155,0.0949,-0.0009,-0.1778,-0.0573,-0.1578,0.0909,-0.0927,-0.0136,0.0809,0.0048,0.1157,-0.1966,-0.11,-0.0664,0.1086,-0.145,0.0436,0.1188,0.0871,0.1338,0.3602,0.1504,-0.1193,-0.0791,-0.12,-0.0627,-0.127,-0.0524,0.0357,0.1624,0.0905,-0.0021,-0.1326,0.134,0.2434,0.0955,-0.003,-0.0265,-0.0419,-0.2052,-0.083,-0.0766,-0.0022,0.0599,-0.1516,-0.0567,0.1257,0.0127,-0.1095,-0.0291,0.0966,-0.069,-0.0387,-0.0856,-0.1509,-0.1482,-0.3099,-0.1726,-0.3178,-0.0187,-0.0372,-0.1108,-0.1599,-0.138,-0.2085,-0.1375,-0.2652,-0.1527,-0.15,0.0163,0.0754,0.1359,-0.0445,0.0458,-0.0103,0.0605,0.1016,0.1462,0.1935,0.1263,-0.0588,-0.0159,0.0211,-0.0012,0.1398,0.1282,0.1427,-0.0257,0.1429,-0.0618,0.1103,-0.0608,-0.0618,-0.0402,0.0964,-0.0511,0.0964,-0.1833,-0.0638,-0.0441,-0.044,-0.0189,0.0179,0.1241,0.0581,0.0987,0.1542,0.1096,0.0502,0.0467,-0.0183,-0.0054,0.0514,0.0077,-0.0254,-0.0739,-0.1329,-0.0686,0.1192,0.1012,-0.1542,-0.1036,-0.086,-0.2348,-0.1204,0.2123,0.0979,0.1786,0.0958,0.065,-0.087,-0.0131,0.0803,-0.0041,-0.0481,-0.0292,0.0313,-0.0806,-0.1064,-0.0049,0.0955,-0.1071,-0.019,-0.1079,0.0713,-0.1669,0.0557,0.1037,0.197,0.1628,0.1227,0.0648,0.057,-0.0174,-0.0183,-0.0565,-0.0937,0.0059,0.0052,0.0802,-0.0117,-0.043,0.0412,-0.0187,-0.0807,-0.0406,-0.1732,-0.2222,-0.1919,-0.14,0.2138,0.0161,0.0807,-0.1684,0.2171,0.1263,-0.0094,-0.0385,0.0246,0.0654,-0.0194,0.0981,-0.1332,-0.1207,-0.0429,-0.033,-0.1473,-0.0421,-0.1111,-0.0324,-0.069,-0.062,-0.0895,-0.0715,0.0025,-0.0625,0.0034,0.0097,0.0546,-0.122,0.0116,-0.1083,0.0751,-0.0495,-0.0833,0.4089,0.3017,0.3414,0.2339,0.2521,0.0749,0.3196,0.191,-0.1716,0.2001,0.207,0.1263,0.1071,0.1297,-0.0863,-0.017,-0.0762,-0.0018,0.0339,0.0275,0.0487,0.0439,-0.1386,0.0302,0.0453,0.0178,0.0903,-0.0277,-0.0911,0.1156,0.0693,-0.0793,-0.0028,-0.0728,0.0823,0.022,0.1791,-0.0168,-0.1847,-0.1799,-0.1054,-0.0425,0.1313,0.1105,-0.0866,-0.1139,-0.2759,-0.196,-0.1063,0.2151,-0.0839,0.2727,0.2366,-0.0724,0.0037,-0.0505,0.0521,0.1218,0.0559,0.2187,0.1047,0.0456,0.1026,0.0689,-0.1222,-0.1682,0.1107,-0.0877,0.057,-0.006,-0.0996,-0.0317,-0.1524,-0.0822,-0.0412,-0.0826,-0.2091,-0.0263,0.1874,-0.0439,0.0068,-0.0009,0.17,0.0329,0.0289,-0.1804,-0.1852,-0.0717,-0.0667,-0.0826,-0.1617,-0.0467,-0.0546,-0.0176,0.2308,0.1007,0.098,0.273,0.0117,0.0522,-0.0091,0.159,0.0017,0.2533,-0.0845,0.2477,0.3605,0.0708,-0.1161,0.3059,0.2571,-0.0172,-0.1792,0.0336,-0.1909,-0.0747,-0.2738,-0.0545,0.0895,-0.0609,-0.0851,0.0401,-0.078,-0.0139,-0.0963,-0.0724,-0.0535,-0.078,0.0261,0.1113,-0.0356,0.339,0.195,0.267,0.2932,-0.1215,-0.0353,-0.0942,-0.1177,-0.0783,-0.0523,-0.0342,0.1636,-0.1566,-0.0956,0.1222,0.0165,-0.0067,0.1043,0.1014,-0.0038,-0.0114,0.1475,-0.0555,-0.0891,0.0172,0.1146,0.0408,0.0075,-0.0306,-0.0306,-0.193,0.0878,0.0166,0.052,-0.0434,0.0935,-0.0483,0.2378,-0.3078,-0.2762,0.1101,-0.0701,-0.2442,-0.2429,-0.2043,-0.0386,-0.0834,-0.0543,-0.0026,-0.0274,0.1684,-0.0064,0.1074,-0.0924,0.1273,-0.0054,0.0869,0.0539,-0.0747,-0.0653,-0.0027,-0.0647,-0.0245,-0.0314,-0.0669,0.0622,0.0134,0.0687,0.0199,0.1228,0.0301,0.1254,-0.1789,-0.1036,0.0498,-0.1583,-0.0155,-0.1966,-0.3167,-0.0265,-0.1007,-0.2219,-0.0121,-0.0915,-0.2112,-0.0207,-0.1015,0.0394,-0.2247,-0.0721,-0.1207,-0.2238,-0.0713,0.0857,-0.0856,0.2585,0.142,0.1112,0.1652,-0.0558,0.0606,-0.083,-0.2126,-0.209,0.0285,-0.1025,-0.0239,-0.0854,-0.0416,0.0602,0.0728,0.0173,-0.1627,-0.1002,-0.0131,0.025,-0.0358,-0.0364,-0.0402,0.0829,-0.077,-0.1345,-0.0786,-0.1843,-0.1166,-0.0686,-0.1651,-0.1825,0.0216,0.0219,-0.0398,0.0157,0.0157,-0.1429,-0.1069,0.0583,-0.2099,0.0375,0.0048,-0.0111,-0.1633,-0.1559,0.013,0.1549,-0.0162,-0.0019,0.0154,-0.0521,0.1957,0.0994,0.0209,-0.0039,-0.2187,0.0648,-0.0033,0.0806,0.1291,0.0952,0.017,-0.1023,-0.0088,0.173,-0.0971,0.0181,-0.1223,-0.0167,-0.1146,-0.1017,0.0041,0.1494,-0.0384,-0.0734,-0.1372,-0.0107,-0.0172,0.0004,-0.0595,-0.1783,-0.0076,-0.0056,-0.0969,0.081,-0.0734,-0.054,-0.0627,-0.0718,-0.0922,-0.0784,-0.0575,-0.0467,0.0097,-0.0325,0.1077,-0.0536,-0.0168,-0.0248,0.0366,0.0027,-0.0344,-0.1868,0.0575,-0.1162,-0.0183,0.0119,0.0492,0.0875,0.0572,0.0682,-0.0995,-0.0582,-0.1173,-0.062,-0.2549,-0.0027,-0.2332,-0.037,-0.0796,-0.0944,-0.0441,-0.1154,-0.101,0.2266,0.1311,0.0154,0.2751,0.1341,0.1065,0.0711,0.2038,-0.0176,-0.0678,0.0261,0.2767,0.0147,0.0446,-0.0417,-0.118,-0.0636,-0.0866,0.0378,0.0164,-0.0287,0.0545,0.0992,-0.0688,-0.0732,-0.051,0.0761,0.147,0.1019,-0.3295,-0.1542,-0.0647,-0.2696,-0.2194,0.0425,0.1301,0.0354,0.0426,0.0076,0.0153,-0.1926,-0.0267,-0.0479,-0.1137,-0.28,-0.0687,-0.0211,-0.1362,-0.0919,0.1416,-0.0485,-0.0602,-0.0578,0.0157,0.1148,0.2722,-0.0554,0.0829,0.0051,-0.0299,-0.1365,-0.0662,0.0337,0.0154,-0.0164,0.1796,0.1319,0.0728,-0.0652,-0.1222,0.0526,0.4704,0.4681,-0.1946,-0.1449,0.0747,-0.0925,-0.0926,-0.0455,-0.2162,0.0636,-0.0283,-0.094,0.0083,0.0269,0.2529,-0.0338,0.1975,0.046,0.0081,0.1246,0.4266,-0.111,-0.0593,0.3064,0.0249,0.0863,0.0754,0.0652,-0.0669,0.2025,0.1535,-0.0193,-0.0798,0.0282,0.0185,0.1555,0.1324,0.0015,-0.0303,-0.0463,0.1303,-0.1447,0.0387,0.1801,-0.0697,-0.0027,0.0129,0.0082,-0.1607,-0.0358,0.0596,-0.0711,0.0832,-0.1072,0.0961,0.1574,-0.0341,-0.03,0.0397,0.0141,0.0124,0.1515,0.1116,0.1343,0.0351,0.2011,0.0968,0.0699,0.4042,-0.1523,-0.1264,0.1289,-0.165,0.0544,0.0843,0.1341,-0.0838,0.0013,0.0124,-0.0245,0.0369,0.0598,-0.0211,-0.0018,0.0264,0.0785,0.0628,0.1099,0.323,0.3005,-0.0976,-0.1898,-0.1234,-0.0178,0.1178,0.0516,-0.0118,0.0365,0.0676,0.0195,0.1009,-0.0979,-0.329,-0.1133,-0.0217,0.132,-0.0147,0.0273,0.0383,0.2863,0.225,0.0471,-0.0233,-0.0917,0.015,0.0561,0.1376,-0.1525,-0.1953,-0.2357,0.0351,0.0011,0.043,0.2999,-0.0713,-0.0492,0.0629,0.1937,0.1166,0.2256,-0.0591,-0.0266,-0.0319,0.0186,0.1348,0.1962,0.2352,-0.0351,0.0605,0.0764,0.0683,-0.1094,0.1161,-0.2759,-0.0711,-0.0303,-0.1229,-0.0154,0.064,-0.045,-0.0783,-0.0716,-0.0219,-0.0201,-0.0237,-0.1064,-0.0669,-0.0187,-0.0244,-0.0781,0.099,0.2271,0.1681,0.269,-0.2307,-0.1385,-0.1885,-0.0621,0.0949,-0.0553,-0.1571,-0.1098,-0.1686,-0.0438,0.1561,0.0571,0.2062,0.1,0.0304,0.0305,-0.0352,0.0219,0.0135,0.0013,-0.2344,-0.0059,-0.1228,-0.0259,-0.114,-0.0001,0.0994,0.3026,0.1945,0.1471,0.1033,-0.1398,-0.3166,-0.1794,-0.2495,-0.1771,0.0358,-0.0525,0.0348,-0.1231,-0.2004,-0.1711,-0.0918,0.0346,0.0117,-0.0572,-0.0809,-0.0292,-0.06,-0.2248,-0.1455,-0.1122,0.0943,0.034,-0.0331,-0.2853,-0.0486,-0.1325,-0.1736,-0.3945,0.0453,-0.0139,-0.117,-0.0938,-0.0509,-0.0226,-0.0316,-0.1459,-0.1153,-0.1211,0.2347,0.0877,0.196,0.0558,0.136,-0.0577,0.095,0.1439,0.282,-0.1069,-0.0406,-0.0046,0.1749,-0.183,-0.2342,-0.1786,-0.0912,-0.0848,-0.1548,-0.1093,-0.0861,-0.1097,-0.0247,0.0068,0.0157,-0.2811,0.0179,-0.0209,-0.1045,-0.119,-0.0963,-0.0054,-0.193,0.0823,0.0363,0.1945,-0.0371,-0.0572,-0.2652,-0.1195,-0.1467,-0.1174,-0.2506,-0.1801,0.0331,0.0669,0.053,-0.0368,-0.0798,0.0325,0.1738,0.2252,0.203,-0.2898,-0.3119,-0.0197,0.0818,-0.0035,-0.1072,0.0465,-0.1038,-0.002,-0.0422,-0.0896,-0.1477,-0.0319,-0.1171,-0.1023,0.0151,-0.1195,0.0191,-0.0187,0.0583,0.1329,0.115,-0.1039,-0.1758,-0.2265,-0.161,-0.1243,-0.2834,-0.1498,0.2713,-0.0714,-0.1275,0.0488,0.0294,-0.0911,0.0453,-0.0266,0.0005,0.1814,-0.0275,0.083,0.0327,-0.077,-0.0126,-0.0079,0.1187,0.2267,-0.2483,0.0111,0.0476,0.298,-0.0508,-0.0313,0.0453,-0.0491,0.0344,0.0478,0.0658,-0.0359,-0.0238,-0.1868,-0.1613,-0.1898,-0.0066,-0.0825,0.111,0.1938,0.2417,-0.009,-0.0044,0.0999,0.2144,0.0824,0.0655,0.0378,0.039,0.0338,-0.3482,-0.1609,-0.1793,-0.1781,-0.1053,-0.1741,-0.1809,-0.1268,-0.0173,-0.0731,-0.2563,-0.1544,0.0388,-0.0985,-0.3251,0.0839,-0.0852,-0.0115,0.0562,-0.0985,0.0115,-0.1868,-0.1051,0.0029,-0.1115,-0.049,0.0593,-0.1512,0.0585,0.0947,0.1013,-0.0182,-0.147,0.0758,-0.0352,-0.1978,-0.0403,-0.112,-0.1086,0.1277,0.0297,-0.0007,-0.1939,-0.1169,-0.0365,0.0133,-0.0696,-0.1014,-0.1509,-0.0774,0.0047,-0.0816,0.0921,-0.1441,-0.0625,0.0742,0.065,0.0464,0.0541,0.0308,-0.2443,0.0152,-0.0853,-0.1625,0.2161,0.3285,0.2888,-0.0551,0.4357,0.2263,-0.1893,-0.1174,0.3987,0.1536,0.077,0.1117,0.113,0.0811,-0.1039,-0.0957,-0.0855,-0.0989,0.4979,0.3974,0.2936,0.0822,0.2216,0.2154,0.433,0.4166,0.3633,-0.012,-0.0157,-0.0503,-0.0248,-0.0512,-0.0015,-0.2058,-0.1024,0.0164,-0.0124,-0.0953,-0.0819,0.1237,-0.0243,0.0213,-0.1008,0.0679,0.2148,0.2987,-0.0431,-0.0436,-0.1235,-0.0061,0.0034,-0.0399,-0.0369,-0.102,-0.0353,-0.0379,-0.1738,-0.2777,-0.2547,0.0414,-0.0737,-0.0184,0.2078,0.0651,0.2323,0.0688,0.1359,0.3168,-0.0435,-0.2004,-0.2025,-0.0455,0.1094,-0.076,0.1904,0.0996,0.18,0.0631,-0.2103,-0.2078,-0.1475,-0.1298,0.0766,-0.3242,-0.2148,0.063,-0.0538,0.1837,-0.0306,-0.0053,0.1248,0.0245,-0.0349,0.0373,-0.0785,-0.1808,-0.2284,0.029,0.0128,-0.0835,0.0178,-0.0562,0.0733,0.3651,0.3155,0.1442,0.2598,-0.0945,0.0558,0.1155,0.1932,0.2475,0.3331,0.0672,0.0849,0.0074,0.1867,0.1792,-0.0094,-0.0155,-0.0493,-0.0436,-0.1,0.0062,-0.041,0.0035,0.018,0.0224,0.0677,0.0065,0.1394,-0.1111,0.0926,0.0819,-0.1326,-0.1979,-0.0954,-0.137,-0.1831,0.1155,-0.0571,-0.111,-0.058,0.2012,0.0145,-0.2489,-0.0577,-0.0298,-0.1512,0.0116,-0.0426,0.0433,0.1176,0.0965,0.3898,0.2541,0.2452,-0.0065,0.0547,0.1321,-0.1521,-0.17,-0.0295,0.0207,-0.0618,-0.0211,-0.0422,-0.1118,-0.1211,-0.1929,-0.2402,-0.1966,-0.098,-0.053,-0.1438,-0.0012,-0.0935,-0.0152,-0.0105,-0.0854,-0.1062,-0.0774,0.2466,0.0046,-0.0389,-0.1441,0.1072,-0.0202,-0.1268,0.109,-0.2119,-0.1109,0.2074,-0.1551,-0.1591,-0.0499,0.0248,-0.0023,0.0442,-0.0677,-0.0725,-0.0398,0.0176,0.0246,-0.2348,0.0601,-0.0072,0.1416,0.0227,-0.2485,-0.1018,0.0055,-0.0625,-0.0667,-0.0417,-0.1605,-0.0319,0.025,-0.0199,0.0724,-0.3761,-0.1549,-0.1701,-0.296,-0.2145,-0.1633,-0.1412,-0.1412,-0.0743,-0.0524,0.09,-0.2491,-0.0665,-0.1432,-0.1378,-0.0196,-0.0625,-0.3525,0.1734,-0.255,0.077,0.0269,0.2797,-0.0183,-0.0202,-0.1763,-0.0844,-0.0237,0.0236,-0.0456,0.2123,0.0217,0.0882,0.2507,0.2133,-0.0037,0.0432,0.0114,-0.0182,-0.0176,-0.1001,-0.115,-0.0787,-0.1209,-0.0272,-0.0027,0.0118,0.0673,-0.0318,-0.0431,0.0829,0.0923,-0.0752,0.1302,-0.0184,-0.0877,0.0094,-0.1438,0.0149,-0.039,0.1412,-0.0963,0.1342,0.1217,0.0005,0.1721,0.1681,-0.0431,0.1561,0.0265,0.3189,0.1259,-0.0113,0.1432,-0.1721,0.0642,0.1375,0.0838,-0.0336,-0.0462,0.0522,-0.027,0.0132,-0.1532,-0.1988,-0.1118,-0.1394,-0.0312,-0.0599,-0.1934,0.2899,-0.0002,0.0555,0.078,-0.0162,-0.0106,0.0336,-0.0615,-0.149,-0.0527,0.109,0.1592,-0.0002,0.0536,-0.1208,0.0247,0.125,0.0976,0.1794,0.0689,0.0232,-0.0902,0.0647,-0.1233,-0.0455,0.0198,-0.0157,-0.0415,-0.0951,-0.0899,-0.116,-0.0304,0.0613,-0.1212,0.082,-0.0247,0.0615,0.0685,0.1061,0.1279,0.0782,-0.0727,-0.0763,-0.0948,-0.0523,0.0555,0.0661,-0.0614,-0.0614,-0.0202,0.0815,-0.0987,-0.1591,-0.1235,-0.1844,-0.156,-0.0482,-0.0499,0.0189,-0.1228,-0.1339,-0.1486,-0.0502,-0.106,0.0136,0.0596,-0.1028,0.1675,-0.153,-0.1395,-0.0684,0.0721,-0.0908,-0.0637,0.1186,0.0612,-0.2265,0.0343,-0.0054,-0.0677,0.0518,0.0768,0.0136,0.0842,-0.086,-0.2048,-0.0838,-0.2104,-0.266,0.0193,-0.1328,0.0644,0.0747,0.1588,0.1608,0.1545,-0.1571,-0.1979,0.0582,0.2226,0.2956,0.0317,-0.0867,0.0007,0.0185,-0.0832,0.08,-0.0796,-0.1597,-0.0509,-0.0283,-0.1029,-0.1693,0.1705,0.0413,0.0362,0.1527,-0.0093,0.0453,-0.0703,-0.0641,-0.0661,0.0052,-0.1045,0.0112,0.1326,0.0789,-0.0167,-0.0826,-0.0571,-0.1347,-0.0319,-0.0261,-0.2596,-0.0633,-0.0419,-0.0155,-0.0346,0.0499,0.0283,0.0512,-0.0704,0.0989,-0.2275,-0.1462,-0.1711,-0.1812,0.0073,-0.1702,-0.1485,-0.32,-0.1432,-0.1007,0.2009,-0.1811,-0.0478,-0.0582,0.0591,0.1547,0.1305,-0.1132,-0.1763,-0.0755,-0.0537,0.027,0.1382,-0.0775,-0.0776,-0.0767,0.1085,0.079,0.094,0.1911,-0.0116,-0.0306,0.1078,-0.0272,0.0672,0.0563,-0.0013,-0.0987,-0.0186,0.0256,0.1238,0.0149,0.1262,0.1358,0.0053,0.0235,-0.0181,-0.198,-0.1286,-0.0388,0.1452,0.2819,0.0929,-0.0152,-0.006,0.0181,0.3405,0.2115,0.1714,0.2121,-0.229,-0.0202,-0.048,0.0524,-0.0847,0.1085,-0.0177,-0.015,0.0334,0.0417,0.0714,-0.0735,0.0731,0.0773,-0.1619,0.2392,0.1202,0.0303,0.0434,0.0459,0.0533,-0.0145,-0.0333,-0.0062,0.0196,0.1356,0.219,0.2443,-0.1271,0.0303,0.0027,-0.0809,-0.1754,-0.3846,-0.3595,0.0244,0.0774,0.1024,-0.0682,0.0531,0.0979,-0.0471,-0.0688,-0.1151,0.064,-0.0689,-0.0165,0.0053,0.0786,-0.0188,-0.1813,-0.0518,-0.1792,-0.1164,-0.0036,-0.1311,0.0196,-0.2067,-0.0967,-0.0448,-0.0515,0.0243,0.1483,0.0173,-0.0868,-0.1255,0.2644,-0.1143,0.1486,0.1822,0.1622,-0.0133,0.0382,-0.1574,0.2585,0.234,-0.2069,-0.1241,-0.0611,-0.0301,-0.1156,-0.1347,-0.2177,-0.2548,-0.1067,-0.0141,-0.0843,0.0609,-0.0279,-0.0458,-0.1327,-0.2145,0.0996,0.0642,-0.1595,-0.1039,0.0003,-0.1161,-0.2296,0.1068,0.1883,-0.1348,0.0604,0.1488,0.1148,-0.2147,-0.2288,-0.1695,-0.2525,-0.0975,-0.0926,0.0045,0.0972,0.0401,0.1383,0.0016,0.2322,0.3237,0.238,0.1417,0.2605,-0.3289,-0.2539,-0.1698,0.0628,-0.0065,-0.0323,-0.0885,0.0221,0.0972,-0.1871,-0.1928,-0.0528,0.1814,-0.1663,-0.078,-0.0832,-0.0181,0.0904,0.1228,-0.0298,-0.0522,-0.0093,-0.0721,0.0348,0.16,0.1475,0.0658,0.0098,0.1036,0.1506,0.114,0.1098,-0.005,-0.1231,0.0096,-0.0362,0.0141,-0.0216,0.0253,0.1747,0.0809,0.0437,0.0522,-0.0199,-0.0159,-0.2211,-0.1832,-0.133,-0.1513,0.4001,0.0027,0.2484,0.1802,0.1189,0.0015,0.001,0.1707,-0.0515,0.281,0.2039,0.0641,0.1481,0.0767,0.0236,-0.0927,-0.0767,-0.1536,0.0543,0.2266,0.138,-0.1298,-0.0378,-0.0035,-0.0209,0.014,-0.0474,-0.107,-0.1269,-0.0123,-0.2223,0.0058,-0.096,0.1094,0.0968,0.1157,0.088,-0.0427,-0.0307,-0.0528,-0.0675,0.0938,0.1877,-0.0601,0.029,-0.067,0.0556,-0.0411,-0.0862,-0.0055,0.144,0.1076,-0.0195,-0.1976,-0.1071,-0.1591,-0.1229,0.037,0.089,-0.0799,-0.0189,-0.1037,-0.1589,-0.2675,-0.1816,-0.1614,-0.1643,-0.1257,-0.0965,-0.0987,0.1321,-0.2369,-0.2371,-0.2002,-0.0631,-0.0526,-0.2092,-0.097,0.0301,0.1541,0.077,-0.1157,0.3597,0.3298,0.2091,0.0053,0.0463,-0.0211,-0.1739,0.04,-0.0464,0.0399,0.1786,0.2041,-0.0463,0.03,0.0902,0.1286,-0.2124,-0.1217,-0.0549,-0.063,-0.1674,-0.1266,-0.0901,-0.1357,0.0349,-0.1845,-0.1645,0.1908,-0.0405,-0.255,0.0094,0.1409,0.1294,-0.0962,-0.1157,-0.4216,-0.3214,-0.1415,-0.3177,0.1147,-0.1116,-0.0991,0.0683,-0.1119,-0.089,-0.1931,-0.083,0.1233,0.1214,0.2531,0.183,0.2283,-0.0502,-0.021,0.1958,0.0299,0.1361,0.0982,0.0577,0.2481,0.157,-0.173,-0.279,-0.1396,-0.0688,-0.1479,-0.0375,-0.0918,0.0521,0.0367,0.0273,0.148,0.1006,-0.2236,-0.0358,-0.1629,-0.0317,-0.1913,-0.2694,0.0004,-0.0617,-0.0097,-0.0951,-0.0192,-0.1598,-0.0973,-0.2344,-0.1046,-0.1782,-0.055,-0.0449,-0.0286,-0.0385,-0.0675,0.0649,0.1097,0.041,-0.0848,-0.0882,-0.1426,-0.0288,0.1145,0.1149,-0.0993,0.2763,-0.0092,-0.0489,0.0784,0.0587,-0.0577,-0.0104,0.0082,0.049,-0.0022,-0.0109,0.1746,0.2974,0.4183,-0.0799,-0.0411,-0.0001,0.049,-0.0329,0.2114,-0.0414,0.3298,-0.1571,0.0674,0.042,0.1237,0.0211,-0.0032,-0.0148,0.0257,-0.0186,-0.0144,0.0709,0.0258,-0.059,-0.1387,0.0973,0.1952,0.2197,-0.2241,-0.1865,-0.203,0.0068,-0.1992,-0.0513,-0.0215,0.0454,0.0157,-0.047,-0.1604,-0.1747,-0.0157,0.0042,-0.1181,0.0344,0.299,0.0344,-0.0714,0.1815,0.4298,0.171,0.1259,0.2059,-0.0947,0.0341,0.2563,0.2098,-0.1231,0.2877,0.1178,0.0833,0.0856,0.4158,0.1041,-0.1795,-0.1579,-0.0996,-0.1047,0.0601,-0.1149,0.0064,-0.1182,-0.1223,-0.0233,-0.17,-0.0877,0.1295,-0.086,-0.2314,-0.1071,-0.1591,-0.065,-0.0598,-0.1033,-0.1095,-0.1129,-0.0601,-0.0598,-0.2161,-0.1554,0.1697,0.2895,-0.0312,-0.0406,0.0784,0.0289,-0.057,-0.08,-0.1269,-0.1863,0.0609,0.0875,-0.1968,-0.2545,-0.1136,-0.0691,-0.1192,-0.1529,-0.0025,-0.1298,-0.047,-0.128,-0.1059,-0.071,-0.124,-0.0443,-0.04,-0.0647,0.1703,-0.1157,0.0439,0.198,0.0792,-0.1842,-0.0593,-0.1819,-0.1731,-0.1,-0.0872,-0.0947,0.0788,0.1121,0.1489,-0.0212,-0.0766,-0.0171,-0.0739,0.0053,0.138,-0.1793,-0.0967,-0.1685,0.0349,0.0478,0.1443,-0.0282,-0.2746,-0.2296,-0.0392,-0.0284,0.0099,0.1429,0.1137,0.0003,-0.1245,-0.1435,-0.0784,-0.1678,-0.3331,-0.1411,-0.0962,0.1117,-0.0078,0.2094,-0.0413,0.1372,0.014,0.0382,0.03,0.0989,0.1804,0.058,-0.0212,0.0114,-0.0837,0.0305,-0.0221,0.0075,-0.0518,-0.0307,-0.0227,0.0106,-0.1034,-0.0649,-0.0829,-0.0737,-0.1838,-0.0399,0.0136,0.1014,-0.0793,0.0707,0.0094,0.0682,-0.0443,-0.0263,0.0353,-0.0559,-0.2342,-0.0903,0.1917,0.1868,-0.0102,-0.0736,-0.0952,-0.1565,-0.0818,-0.0185,-0.0944,0.1341,0.0828,-0.2171,-0.1996,0.007,-0.1639,-0.0556,-0.0481,0.4059,0.2567,-0.266,0.0852,-0.0934,-0.0146,-0.1006,-0.203,-0.2251,-0.1956,0.0475,-0.0073,-0.1212,-0.0036,-0.1125,-0.0654,0.1707,0.0055,0.0689,0.0044,0.0026,0.0259,-0.173,-0.0503,0.0767,-0.1488,0.1048,-0.24,0.1448,-0.1987,0.3046,0.1429,0.146,-0.2807,-0.2452,0.1095,0.2617,0.053,0.2453,0.0439,0.081,0.1212,0.0553,0.1179,0.0603,0.0539,0.0709,0.1031,0.0781,0.1147,-0.0779,0.1465,0.3072,0.566,0.251,0.1952,0.3973,0.2104,0.2449,0.2999,0.2126,0.2541,0.1622,0.2709,0.2797,0.1744,0.2245,0.3082,0.3507,0.2946,0.3188,0.1753,0.2719,-0.2392,-0.0619,-0.223,-0.1944,-0.1145,-0.2772,-0.2481,-0.1147,-0.0143,-0.0881,-0.3133,-0.2683,-0.1968,-0.0512,-0.0002,-0.1892,0.1191,-0.0303,-0.0799,0.0377,-0.1182,-0.0947,-0.0542,-0.0835,-0.1696,0.0933,-0.2169,-0.2287,0.0731,-0.0191,-0.0689,0.0142,0.0207,-0.1852,0.2002,0.1654,-0.1687,0.2528,0.2983,0.0602,0.0941,0.1589,-0.1015,0.3825,0.3856,-0.0444,-0.0459,0.1306,-0.0494,0.0176,-0.149,-0.0517,0.1242,-0.0279,-0.0772,0.0512,0.0168,-0.033,-0.0361,context representation
trm_4a3fd79d0a20c,0.1122,0.1554,0.1311,0.1925,0.0144,0.0816,0.1011,0.0627,0.0176,0.1178,0.0248,0.0092,0.1236,0.0769,0.1663,0.0964,0.1317,0.1574,0.0671,0.0761,0.1028,0.0128,0.0549,-0.0242,0.0237,-0.0112,-0.0127,0.1281,0.155,0.0844,0.1107,0.1359,0.143,0.1252,0.1505,0.1659,0.0612,0.0991,0.1907,0.0419,0.1566,0.1468,0.0492,-0.0889,0.1306,0.0998,-0.1546,0.0558,-0.0528,0.1123,0.0687,-0.1341,-0.1143,-0.034,0.0422,0.0627,0.0873,0.057,0.0024,0.0696,-0.0146,-0.0173,0.219,-0.1053,-0.0283,-0.1419,0.2671,0.279,0.142,0.008,-0.0602,-0.0114,-0.1892,0.1052,0.2103,-0.1078,0.1105,-0.0216,-0.0584,0.0129,-0.0303,-0.0841,0.0649,0.1473,-0.0423,-0.0628,0.003,0.0001,-0.0016,0.106,0.1057,-0.0362,0.0213,-0.1897,-0.2004,-0.1688,-0.1956,-0.0426,-0.288,-0.0985,-0.0734,-0.0225,-0.1165,-0.0858,-0.1224,0.1959,0.2164,-0.2246,0.0311,0.066,-0.0027,0.1464,-0.1078,-0.2082,-0.0635,-0.0031,0.1258,-0.0787,0.0246,0.0894,0.1548,0.2138,0.1733,-0.0059,0.112,0.1595,0.1127,-0.0529,-0.1028,-0.0805,0.0717,0.1045,-0.0029,0.2541,0.0187,0.2468,-0.006,0.171,0.058,0.0288,0.1224,0.1282,-0.0426,0.0171,0.0946,-0.0463,0.0629,0.001,0.1195,-0.0627,0.1047,0.1272,0.1829,0.1882,-0.1491,-0.0082,-0.0659,-0.0271,-0.0123,0.0598,0.1008,0.1247,0.2831,0.2666,0.0192,0.0179,0.0426,0.2165,0.2069,-0.0424,0.0665,0.1706,-0.0332,0.1899,0.1622,0.1894,0.1311,0.1338,0.0542,0.0306,0.1788,-0.0861,0.0925,-0.0072,0.0174,0.0807,0.0338,0.0588,0.027,0.1433,0.1305,0.0617,0.0065,0.1547,0.1368,0.3321,0.3182,0.0425,0.0238,0.1172,0.0287,-0.2084,0.2147,0.2072,0.01,0.0344,0.0832,0.0479,0.0909,0.0213,0.2007,0.0782,-0.07,-0.0417,-0.0798,-0.0294,-0.1114,0.1627,0.138,-0.02,-0.1094,0.1445,0.2043,0.0885,-0.0901,-0.0304,0.1075,-0.1799,0.0136,-0.1687,0.0375,0.1711,-0.1782,0.1743,0.1669,-0.1807,0.0337,-0.0752,-0.0348,0.0862,0.0291,0.2133,0.0921,-0.0308,0.0954,0.0946,0.0968,0.1512,0.0459,0.129,-0.0702,-0.0491,-0.001,-0.0784,-0.0474,0.1954,-0.0076,0.1,-0.1678,-0.2637,-0.0564,-0.231,0.139,-0.061,-0.1893,-0.2948,-0.0998,0.0505,0.0047,0.0554,0.0997,0.0059,0.1315,0.0011,0.0034,-0.1441,-0.0051,0.0881,0.0696,-0.0564,-0.1408,0.075,0.0497,0.2543,0.2087,0.0848,-0.0495,-0.1097,0.1551,0.1215,0.12,0.1071,0.022,0.1047,0.1201,0.0173,-0.0085,-0.1268,0.0976,-0.1586,-0.1671,0.2251,0.1477,0.0989,0.0128,0.003,0.1433,0.0259,0.0031,-0.0094,-0.0293,-0.0109,0.2171,-0.0855,-0.0373,0.0623,-0.1583,-0.0625,-0.0771,0.172,0.0174,-0.0554,0.1652,0.2146,0.1317,0.1038,-0.0047,0.0667,0.0966,0.1461,-0.0395,0.0923,0.0143,0.0046,-0.0384,-0.1394,-0.1436,-0.0213,-0.0332,0.1692,0.1517,-0.0296,-0.0421,-0.0141,-0.0983,-0.069,0.2732,0.2111,0.1783,0.1317,0.1003,-0.1004,0.0905,0.0051,0.0669,0.115,0.0803,0.1372,0.1343,0.1254,-0.0039,0.0399,-0.0932,-0.0023,-0.0184,-0.0561,0.1505,-0.1969,-0.0109,0.1226,0.0138,-0.0754,0.0224,-0.1555,0.1913,-0.0056,0.1041,-0.1313,-0.2231,-0.1825,-0.276,-0.0213,0.0968,-0.0312,-0.051,-0.1083,0.1428,0.0267,-0.018,0.0334,0.0133,0.0583,0.1022,0.0713,-0.1327,-0.0815,0.0567,0.2036,0.099,0.0904,0.086,-0.0551,-0.0139,0.0319,-0.0359,-0.079,-0.0962,0.0168,0.1357,0.0381,0.0363,0.2352,0.0773,-0.284,0.1257,0.0243,-0.2902,0.0689,0.1585,0.0727,0.0151,0.2596,0.1737,0.4878,0.4397,0.1747,0.2345,0.1,0.1845,0.1407,0.0634,-0.1144,0.0109,0.0043,-0.0106,-0.0851,-0.033,-0.037,0.319,0.1623,-0.0473,-0.0565,0.0266,-0.0545,0.0148,0.0821,-0.0491,-0.1429,0.1681,0.1239,0.0196,-0.0838,0.153,0.0831,-0.0038,0.1836,-0.0434,0.1063,0.0762,0.0346,-0.0025,0.122,0.0593,0.0048,0.1483,0.15,0.0014,-0.3643,0.1294,0.0119,-0.0188,-0.0411,-0.0715,0.0343,0.0457,0.061,-0.0535,-0.0241,0.0129,0.0566,-0.0948,-0.0495,0.0093,-0.0769,-0.12,-0.1545,0.0142,0.0143,0.1218,0.019,-0.1125,-0.176,0.2212,0.2705,-0.0843,-0.0561,0.0279,0.0499,-0.0268,0.1481,0.1316,-0.0058,0.0815,0.1554,0.0961,0.1498,-0.0406,-0.0376,0.0774,-0.1398,0.1912,-0.0218,0.0087,-0.0022,-0.1066,-0.057,0.1311,0.1062,-0.1453,0.0976,0.0901,0.0621,-0.0886,-0.0814,-0.1989,-0.0377,-0.1985,-0.184,-0.1205,-0.0595,0.1022,0.0238,0.0905,0.3369,0.0808,0.0002,0.2324,0.187,0.0866,0.1667,0.0536,-0.0007,-0.0328,0.0272,0.1144,0.0223,-0.0049,-0.0599,-0.0165,0.066,-0.1067,0.0296,0.0726,-0.021,0.0284,0.1504,-0.1344,-0.0786,-0.0788,0.0611,0.1196,0.0142,0.1184,-0.049,0.0602,-0.0992,-0.1126,0.0202,0.0,0.036,0.0986,0.0265,0.1375,-0.0025,-0.0378,-0.0136,-0.0873,-0.0309,-0.1126,-0.0892,-0.0492,0.1516,0.0216,0.0739,-0.1229,0.0087,-0.0069,-0.0337,-0.0847,0.052,0.1235,0.0292,-0.1035,-0.1122,0.0755,0.0334,0.2721,0.0942,-0.1868,0.0551,-0.0353,-0.1307,-0.0691,-0.0848,-0.0674,-0.0625,0.0197,0.1308,0.1226,-0.0461,0.1957,0.0558,-0.0582,0.0749,0.3139,0.0726,0.0788,0.0064,0.0088,0.29,0.1043,0.2795,-0.0643,-0.0134,0.0433,-0.0391,0.1713,0.1373,0.1163,-0.0281,-0.0723,-0.0734,0.1055,0.0454,0.0587,-0.0415,-0.0428,0.0666,0.0655,0.0309,0.1073,-0.0653,0.0111,0.0363,0.1643,0.0537,0.2992,0.1663,-0.1305,0.2923,-0.006,0.2187,-0.1402,0.1899,0.0406,0.0852,-0.0525,0.086,0.0827,0.1146,0.2502,-0.0729,-0.1965,-0.0045,-0.0841,-0.0753,0.0697,0.1574,0.0524,-0.0052,0.0651,0.0782,0.0935,0.0963,0.1005,0.0983,-0.2944,0.1373,-0.0291,0.0505,-0.0376,-0.0515,-0.0688,-0.0349,-0.1993,0.1927,0.0948,-0.0319,-0.0271,-0.0383,-0.0914,-0.1532,-0.1407,-0.0869,-0.0761,0.0887,-0.0122,0.0757,0.0805,0.0573,-0.0194,-0.0133,0.0122,0.1156,0.0673,0.0478,0.1925,0.2202,0.1829,-0.0731,-0.1428,0.0046,0.127,-0.1236,0.0259,0.0151,0.0441,-0.0888,0.1604,-0.022,-0.1703,0.0598,0.4461,0.4466,0.292,0.0297,0.0224,0.1375,-0.0147,0.06,-0.0629,0.0305,0.0701,-0.1025,-0.0778,-0.002,0.1618,-0.1003,-0.0919,-0.2754,0.1552,0.037,0.1096,-0.0135,-0.0093,0.1363,-0.1126,-0.0781,0.0889,-0.0347,0.0219,-0.1051,0.2164,0.3119,0.2654,0.1861,-0.0723,-0.1981,0.0037,0.1373,0.0268,-0.0639,-0.0824,-0.0894,-0.0498,-0.0035,0.0761,0.0979,0.0581,-0.1288,-0.0869,-0.1516,0.0368,0.0175,-0.0452,0.0897,-0.048,0.0946,0.171,0.016,0.1658,0.1737,0.1128,-0.0721,-0.0717,-0.0183,0.0198,0.0372,-0.0078,-0.1257,0.0224,0.1549,-0.0741,0.0136,-0.0446,-0.0106,-0.134,0.0955,-0.1236,0.1519,0.1576,-0.0803,-0.1103,-0.15,0.0331,0.01,-0.0637,-0.0117,0.0554,-0.2442,-0.0277,-0.069,-0.1203,-0.1771,-0.0514,0.0103,-0.2192,-0.2174,0.1611,-0.028,-0.097,0.2521,0.2031,0.0505,0.1376,-0.0055,0.3132,0.1087,0.1869,0.1414,0.2406,-0.0274,0.0516,-0.1127,0.1107,0.0601,0.0221,-0.0893,-0.1307,-0.0232,-0.0643,-0.1125,-0.0556,-0.013,-0.0385,-0.0005,-0.1253,-0.1504,0.125,-0.1315,-0.0573,0.0004,0.0618,0.1049,0.0576,-0.1155,0.0632,0.4305,0.2232,0.0342,-0.1153,-0.183,-0.0389,-0.0358,-0.0976,-0.0414,0.0796,0.1118,-0.027,0.139,0.0188,0.2247,-0.086,0.0953,-0.1333,-0.0274,0.0082,-0.0257,0.2612,0.2291,0.1198,-0.2146,0.1171,0.1121,0.1426,-0.0432,0.0106,0.1914,0.0971,0.1195,-0.0895,0.07,-0.0753,-0.1313,-0.0165,-0.0709,0.2519,0.1192,0.0533,-0.1576,0.1415,-0.05,-0.1077,-0.0783,-0.1044,-0.3385,-0.1384,0.0911,0.0756,0.1331,0.1083,0.1022,0.043,-0.0578,-0.1753,-0.0617,-0.0232,0.1182,-0.1012,-0.2493,-0.0859,-0.0212,0.0246,0.0982,0.1586,0.0745,0.0615,-0.0176,-0.0094,0.1407,0.0097,-0.1674,-0.0277,0.1151,0.0229,-0.1108,0.0636,0.048,0.059,0.161,0.162,0.2506,0.1797,0.2515,-0.0218,-0.0033,0.0914,0.1728,0.0938,0.1569,0.096,0.2071,0.1121,0.0927,-0.0396,-0.0554,-0.1114,0.0345,-0.0181,-0.0041,-0.0484,-0.1272,-0.1077,-0.1842,-0.0906,0.0632,0.0175,-0.0172,-0.0085,-0.1105,-0.1103,-0.128,0.0102,-0.1783,-0.0041,-0.116,0.0345,0.0364,0.0361,-0.0604,0.0502,-0.0567,0.1653,0.0918,0.0936,0.1339,0.0943,-0.0847,-0.1448,-0.0692,-0.0969,-0.1321,-0.1057,0.03,-0.0002,0.0065,0.0096,-0.0648,0.0043,0.0239,0.0903,0.166,0.0908,-0.0847,-0.0645,0.1435,0.1045,0.0921,0.2487,0.1506,-0.1823,-0.0958,-0.1624,-0.0924,-0.0532,0.1418,0.0268,-0.0634,-0.0059,0.0007,0.0067,-0.0323,0.0305,0.0171,-0.0165,-0.039,0.1538,0.0145,0.1293,-0.0486,0.1592,-0.0538,-0.1274,-0.2143,-0.0283,-0.0491,-0.0019,0.0132,0.0326,0.0513,0.0722,0.1154,0.0064,-0.0237,-0.1045,0.0231,0.0683,-0.0128,-0.0022,0.0684,0.0108,0.1474,0.1986,0.2025,0.1203,-0.2103,0.0066,-0.0761,0.1803,-0.2413,-0.1464,0.0099,0.0369,-0.0036,-0.0611,0.0328,-0.1186,0.1384,0.1357,0.0471,0.0319,0.1429,0.0732,0.0767,-0.0193,-0.0515,0.0693,0.0631,0.0577,-0.0464,0.0237,-0.0101,-0.0442,-0.0488,0.1493,0.0359,0.094,-0.0593,0.0358,0.0926,-0.423,-0.2952,-0.3306,-0.2072,-0.22,-0.0777,-0.3177,-0.1959,0.1362,-0.3269,-0.29,-0.1984,-0.1787,-0.2329,-0.0444,-0.065,-0.0359,0.0114,-0.0289,-0.0321,-0.0783,-0.0308,0.1444,-0.0807,-0.0804,-0.0389,-0.1108,0.0479,0.0987,-0.135,-0.044,0.1063,0.028,0.0305,-0.1021,-0.0483,-0.1887,0.0479,0.2525,0.1301,0.03,-0.0062,-0.1313,-0.1487,0.0374,0.1054,0.2249,0.1565,0.0848,-0.2992,0.0611,-0.2348,-0.2204,0.0806,-0.0613,0.0421,-0.1054,-0.1504,-0.1073,-0.198,-0.1363,-0.0022,-0.0559,-0.0708,0.1324,0.2462,-0.1203,0.0878,-0.0806,0.0267,0.1079,0.0249,0.155,0.0547,0.0099,0.0737,0.1627,-0.0125,-0.2078,0.0213,-0.0029,0.0427,-0.1735,-0.0776,-0.0451,0.1632,0.1527,0.0853,0.1007,0.0592,0.1417,0.0772,0.0222,0.0466,-0.1845,-0.0712,-0.0844,-0.2452,-0.0166,-0.0719,0.0557,-0.1398,-0.0408,-0.1392,0.0697,-0.1466,-0.2591,-0.0432,0.0669,-0.1762,-0.1508,0.081,0.1138,-0.0311,0.2184,0.0776,0.3572,0.0689,-0.119,0.1227,0.1495,-0.0847,0.1111,-0.0485,0.0556,0.0862,0.0986,0.1133,0.0405,-0.0961,0.0391,-0.4302,-0.2874,-0.2968,-0.3833,0.1783,0.0362,0.1083,0.1533,0.1452,0.0551,0.0073,-0.1967,0.157,0.1039,-0.1184,-0.0216,0.0554,-0.0988,-0.0594,-0.0088,0.0109,-0.1889,0.1163,0.1166,-0.0148,-0.1632,-0.0249,0.0396,0.0293,0.0293,0.1811,0.0229,0.0619,-0.0018,0.0231,-0.0782,0.097,-0.229,0.2987,0.2784,-0.1299,0.0486,0.2108,0.22,0.2047,0.0613,0.0587,0.0867,0.0102,0.0205,-0.1379,-0.0419,-0.1782,0.1014,-0.1421,0.025,-0.1498,-0.1039,0.0352,0.0912,0.0159,0.0637,0.0751,0.0855,-0.0577,-0.0913,-0.0215,-0.0977,-0.0411,-0.1822,-0.0063,-0.1517,0.0864,0.0565,-0.0131,0.1811,-0.0122,0.2109,0.3189,0.022,0.1119,0.2668,0.0026,0.0671,0.2029,0.0027,0.0722,-0.0346,0.1302,-0.0167,0.1289,0.195,0.0671,-0.0421,0.0961,-0.2552,-0.2137,-0.1349,-0.1881,0.0388,-0.0311,0.0619,0.0988,0.0991,-0.0103,0.0962,0.0013,0.1355,0.0164,-0.0439,-0.0451,0.0039,0.141,0.1372,0.046,-0.0646,-0.013,0.0336,0.0204,-0.0591,0.0535,0.1524,0.0839,0.1788,0.1385,0.0324,0.205,0.228,0.0083,0.0016,0.0041,-0.0191,0.007,0.1658,0.1314,-0.074,0.1758,0.001,-0.0227,0.0206,0.1207,0.2715,-0.0158,-0.1743,-0.0087,0.0351,-0.0335,0.0507,-0.2426,-0.1536,-0.0265,-0.019,0.2342,-0.0988,-0.0027,-0.102,-0.14,-0.1269,-0.0342,0.0589,0.0351,-0.1489,0.1129,-0.0242,0.1113,0.0476,0.1502,0.0989,0.0386,-0.0849,0.0373,0.0967,0.1457,-0.004,0.0092,0.0247,0.0193,0.1436,-0.0068,0.0256,0.0867,-0.0875,0.049,0.066,0.067,0.1343,0.0881,0.0715,0.0783,0.0739,-0.0517,-0.0043,-0.1534,0.0418,0.0386,0.0599,-0.0112,0.0033,0.1472,0.3153,-0.0854,0.087,-0.0163,-0.0108,-0.0633,-0.0464,-0.0754,-0.0832,0.0614,0.0152,0.1095,0.0471,0.2511,0.0006,0.1885,0.0327,0.0444,0.0765,0.06,0.1242,0.1281,-0.2427,-0.1875,-0.0246,-0.3199,-0.0613,-0.0958,-0.0504,-0.2333,0.0172,0.0622,-0.0547,-0.2599,0.0494,-0.0191,0.0699,0.1057,0.0858,0.0684,-0.0515,-0.005,0.0054,-0.1451,-0.1717,0.0839,0.1041,0.0737,-0.0671,-0.1002,-0.0668,0.2619,0.1295,0.0312,0.2203,0.1672,-0.0621,-0.1027,-0.056,-0.0165,-0.1015,-0.033,0.1965,0.0716,0.0647,0.1082,0.2409,0.1143,0.0499,0.1394,0.1445,-0.1352,0.0204,0.0419,0.0221,-0.0077,-0.1331,-0.2226,0.0436,-0.0502,0.0132,0.0793,0.1406,0.0599,-0.0668,-0.0286,-0.0082,-0.2003,-0.1113,-0.0846,0.0596,0.1003,0.0283,-0.3757,-0.3688,0.247,0.2352,-0.074,0.0476,0.0712,0.0605,0.1994,-0.0624,0.0556,0.0595,0.0118,0.013,-0.2786,0.092,-0.1642,-0.0843,0.0385,-0.0815,-0.3338,0.0288,0.0689,-0.2729,-0.0491,-0.079,-0.1021,-0.0478,0.0848,-0.1364,-0.0832,0.0469,0.0551,-0.0213,0.0008,-0.106,-0.1004,0.0888,0.0687,0.0898,-0.144,0.1681,-0.0026,-0.1554,0.0616,0.0516,-0.0028,-0.041,0.1491,0.0553,-0.0753,0.0344,-0.192,0.043,-0.139,-0.2138,0.1074,0.0839,-0.001,-0.0211,0.0043,-0.1418,-0.1564,-0.1419,-0.0312,-0.1442,-0.0393,-0.0385,-0.4182,0.1469,0.24,-0.0078,0.1219,-0.1038,-0.1369,-0.181,0.0892,-0.0199,-0.0275,0.0205,-0.0404,-0.0622,0.0403,-0.0088,-0.039,-0.074,-0.0976,-0.1465,-0.3087,-0.2993,0.0721,0.1623,0.106,0.0505,-0.1835,-0.1005,0.043,-0.072,-0.0881,-0.0222,-0.1111,0.0409,0.29,0.1605,0.0042,-0.0918,0.0511,-0.0402,-0.0201,-0.2374,-0.1868,-0.1219,0.0264,0.1098,-0.0287,-0.0346,-0.13,0.0584,0.1054,0.1033,-0.0463,0.0398,0.0107,-0.2026,0.075,0.038,-0.0717,-0.1345,-0.0646,-0.1789,0.0319,0.0229,-0.0664,-0.05,-0.1562,-0.1463,-0.1823,0.0276,-0.0457,-0.0638,-0.067,0.0646,-0.1043,0.2376,0.1051,0.0889,0.1658,0.0342,-0.0817,0.0674,0.0167,0.0776,-0.0021,-0.0044,-0.0013,0.0844,0.0626,0.02,0.0041,0.0354,-0.0711,-0.1735,-0.0875,-0.1931,0.2462,0.1756,0.2063,0.0329,-0.0134,0.1706,0.1193,0.0553,0.1518,0.0559,-0.1619,-0.0294,-0.1561,-0.1099,-0.0134,-0.0709,0.0627,0.0016,-0.0042,-0.0098,0.2161,0.0054,0.1373,0.0651,0.0813,-0.0047,-0.0834,-0.3041,-0.1884,-0.1063,-0.0879,0.1147,0.3007,0.1668,0.2329,0.1677,0.0037,0.0423,0.0052,0.1132,0.2081,0.1608,0.0791,-0.0843,-0.0411,0.0588,0.0858,0.0298,0.0681,0.2064,0.1149,0.1229,-0.0852,-0.0303,0.0121,0.3687,0.1225,0.1676,0.1719,0.46,-0.0156,0.0139,0.071,0.1113,0.0585,0.0415,0.0233,0.1903,0.0868,0.156,-0.0927,-0.0906,-0.0961,-0.0237,-0.0993,0.1413,-0.0171,-0.1014,-0.1846,0.0893,0.0363,0.0943,-0.1674,0.2013,0.2354,0.1872,0.1099,0.0638,0.1784,0.1339,0.1233,0.0943,0.0323,0.0349,0.0369,0.2963,-0.0227,0.0389,0.1113,0.0926,0.0608,-0.0017,0.2042,-0.0136,-0.0428,-0.1697,0.0111,0.002,0.3335,0.1458,0.1727,0.0974,0.2702,0.1928,-0.003,-0.1119,-0.0861,0.033,0.1039,0.0111,-0.1953,-0.2296,-0.2348,0.4348,0.444,0.0227,-0.0898,0.0025,0.1246,-0.0177,0.1035,0.0109,0.0428,0.1025,0.111,0.0196,0.0964,0.1087,-0.0017,0.1588,-0.04,0.0499,0.0333,-0.1496,-0.1504,0.0644,0.1636,0.2458,0.143,0.0898,0.2601,0.1406,-0.3043,0.0869,0.1427,-0.118,-0.0672,-0.0032,-0.0954,-0.007,-0.0329,-0.184,-0.0444,-0.0571,-0.0729,-0.0062,-0.0407,-0.0606,-0.1838,-0.2372,0.298,-0.0169,-0.0676,-0.2972,-0.0098,0.024,-0.0562,0.0166,0.0113,-0.0641,-0.1235,0.0519,-0.0341,0.1123,0.056,0.1109,-0.0396,0.0901,-0.1094,-0.2636,-0.325,-0.0339,-0.0401,-0.1054,-0.1193,-0.0434,-0.0568,-0.0211,-0.0132,-0.0443,0.3657,0.165,0.2042,0.1627,0.0696,0.1755,0.2072,0.1421,0.0246,0.0715,0.2165,0.1324,0.0682,0.2103,0.432,-0.0718,0.2232,0.038,-0.0526,0.0928,-0.0537,0.1952,0.1104,0.0141,0.0735,0.0997,-0.0312,0.1258,-0.0797,-0.0979,-0.1341,-0.0144,0.1492,-0.0366,0.047,0.1238,-0.0204,0.0739,0.0852,-0.1009,0.012,0.0289,0.1638,0.1469,0.0706,0.0224,-0.0198,0.0582,0.1179,0.1203,0.0199,0.0789,-0.0985,0.1539,0.0732,-0.0756,-0.0862,-0.0758,-0.0382,-0.0388,0.2265,-0.0009,0.0966,0.1448,-0.1535,-0.2647,-0.2348,0.0566,-0.4297,-0.2298,0.1925,0.1413,-0.4225,-0.2076,-0.0735,-0.129,-0.1329,-0.1407,0.1514,0.1452,0.0793,0.121,-0.48,-0.4121,-0.2979,-0.0607,-0.1436,-0.2536,-0.473,-0.4552,-0.4217,-0.0199,0.0003,0.0398,-0.0161,0.0171,0.0106,0.1973,0.0531,0.0205,0.0849,0.137,0.1281,-0.1153,0.0393,0.0035,0.0652,-0.0351,-0.1619,-0.2372,-0.0191,-0.0397,0.0492,0.0176,0.0366,0.0607,0.0738,0.0768,0.0966,-0.044,0.1622,0.2679,0.2396,-0.0492,0.0514,0.0474,-0.1641,-0.022,-0.1741,-0.0603,-0.122,-0.3832,0.0675,0.2238,0.2673,-0.0393,-0.069,0.0736,-0.1566,-0.0806,-0.1866,-0.1322,0.1843,0.178,0.1364,0.1265,-0.1395,0.2782,0.1909,-0.0564,0.0474,-0.1815,0.0293,0.013,-0.1091,0.0052,0.0485,-0.0264,0.0966,0.1727,0.2191,0.006,-0.01,0.0603,-0.0028,0.0524,-0.0708,-0.2207,-0.1872,-0.0507,-0.2063,0.12,0.0138,-0.0864,-0.1264,-0.236,-0.2141,-0.0197,-0.0328,0.0172,-0.1283,-0.1023,0.0338,0.0377,-0.0402,-0.0397,0.1295,-0.0292,0.0667,0.0213,-0.0358,-0.0317,-0.0756,-0.0022,-0.1458,0.0036,-0.1365,-0.1102,0.1855,0.2016,0.1151,0.1479,0.2293,-0.1527,0.0207,0.0658,0.0545,-0.2085,0.0025,0.3488,0.0704,-0.0272,0.1491,-0.0655,-0.024,-0.0894,-0.1633,-0.2552,-0.4285,-0.225,-0.126,0.0799,-0.0187,-0.132,0.1532,0.1252,0.0449,0.0013,0.0878,0.0124,0.0012,0.0993,0.1538,0.2256,0.2628,0.2045,0.0887,0.1138,0.1167,0.0892,0.1142,-0.0094,-0.0014,0.0803,0.0611,0.0014,-0.3213,-0.0008,-0.0211,0.1259,-0.1369,-0.0221,0.0302,-0.1081,0.1965,0.129,-0.1458,0.0115,0.0197,0.019,-0.0043,-0.0471,-0.027,0.0678,0.0437,0.0196,-0.0199,-0.0296,0.1591,-0.063,0.006,-0.0701,-0.0161,0.198,0.14,0.0234,0.0679,0.0893,0.0621,0.1451,0.0447,-0.0919,0.0412,-0.0756,0.3868,0.1448,0.1749,0.3087,0.2379,0.1813,0.1521,0.1521,0.0678,0.0484,-0.0922,0.2334,0.0262,0.1096,0.117,0.0747,0.0436,0.4711,-0.1751,0.1965,-0.0028,-0.0786,-0.1696,-0.1095,-0.0351,0.1861,0.1146,-0.0115,0.0036,0.0559,-0.1445,-0.0636,-0.0972,-0.2646,-0.2012,0.0108,-0.0518,-0.0701,-0.0348,-0.0122,0.2661,0.199,0.0799,0.1165,0.0283,0.0214,-0.0035,-0.0718,0.0061,0.0351,-0.0658,-0.0885,0.0919,-0.1491,0.0104,0.2493,0.0985,0.3023,0.0512,0.107,-0.0762,0.1056,-0.2024,-0.1941,-0.0434,-0.1685,-0.1286,0.0354,-0.1968,-0.0299,-0.3306,-0.1537,0.0216,-0.1215,0.1124,-0.0749,-0.1029,-0.0824,0.0181,0.0599,-0.0443,0.0318,0.0191,0.0559,0.0974,0.0231,0.0551,-0.0073,0.034,0.1371,-0.2663,-0.0164,-0.0551,-0.1159,0.0562,-0.0186,-0.0141,0.0841,0.1339,0.0575,-0.1098,-0.1431,0.0178,-0.0052,0.1153,-0.0207,-0.1006,-0.1164,-0.0911,-0.0368,-0.0267,0.0709,-0.1473,0.1219,-0.0043,-0.1388,0.007,0.043,0.1088,0.0763,0.0495,0.0279,-0.0524,0.1212,-0.0862,-0.0347,-0.1343,-0.026,-0.0517,-0.1166,-0.0096,0.0984,0.0798,0.1169,0.071,-0.0275,-0.0402,0.0321,0.0754,-0.0019,-0.1884,-0.0029,0.189,0.1366,0.2179,0.188,0.0131,0.0327,-0.0286,0.1546,0.1373,0.1712,0.0284,0.1218,-0.0512,-0.0523,0.0328,-0.1479,0.1483,0.1037,0.0279,-0.0344,0.1087,0.0477,-0.0757,-0.0665,0.1874,-0.0382,0.0157,0.1177,-0.085,-0.1115,-0.0231,-0.0516,0.0734,0.1878,0.0965,0.2229,0.2292,-0.0121,0.1363,-0.0238,-0.0213,-0.1232,-0.1245,-0.1328,0.163,0.1906,-0.0699,-0.239,-0.3741,-0.0016,0.0566,0.0482,0.0254,0.1164,0.0246,0.1115,0.1319,0.083,0.0069,0.1191,0.184,-0.1712,0.0128,-0.0036,-0.1885,0.0084,-0.069,0.1528,0.0491,0.0885,-0.0124,0.073,-0.0317,-0.0939,-0.0873,0.0316,0.0827,0.064,0.1374,0.0276,0.0846,0.3224,0.0353,0.0329,0.0406,0.0295,-0.0441,-0.0096,-0.0061,0.0933,-0.0991,0.2456,0.1242,0.1604,0.2259,-0.0658,0.1836,0.1458,0.3218,0.1424,0.0545,-0.2118,0.2289,0.043,0.0696,-0.0543,-0.1071,-0.0413,0.1771,0.2048,0.0789,0.0896,-0.0253,-0.0849,0.0591,0.0191,0.0498,-0.1287,-0.056,-0.0787,-0.1378,0.0338,0.0539,-0.0507,-0.0239,0.0077,-0.0142,0.0458,0.0832,-0.0312,-0.01,-0.1645,0.0189,-0.2076,-0.1697,-0.0325,-0.0018,0.0455,0.2262,0.0993,0.0434,-0.1992,-0.2858,-0.1377,-0.0018,0.0284,-0.0122,-0.2579,-0.1768,-0.1393,-0.121,0.2673,0.0479,0.0516,-0.0575,0.0656,-0.0617,-0.0068,0.0048,-0.0741,-0.0314,-0.0695,0.0853,-0.0771,-0.0516,0.1683,-0.1963,-0.0871,-0.013,-0.0016,-0.0786,-0.0767,0.0112,-0.0333,-0.0239,0.0194,-0.1115,-0.1928,-0.193,0.0262,-0.0538,-0.0618,0.0472,0.2429,0.4985,0.4823,-0.0402,-0.0886,-0.1014,0.0404,-0.0175,0.004,0.096,0.1453,0.1754,-0.0933,0.0268,-0.0108,0.0481,-0.0559,0.0325,0.1935,0.0341,0.1589,0.154,-0.0586,0.0923,-0.0033,0.2957,0.1428,0.0535,0.0146,0.0019,-0.1361,0.0077,0.1403,0.1611,-0.2174,0.1927,-0.0946,-0.0865,-0.075,0.0091,-0.0537,0.0963,-0.2048,-0.2091,0.1472,0.1649,0.1291,0.0249,0.1489,0.1408,0.1514,0.3122,0.1233,0.0279,0.0682,-0.0958,0.0473,0.0329,0.1129,0.2197,-0.0811,-0.0521,0.2115,0.0848,-0.0202,0.1154,0.2401,-0.1975,-0.1603,0.0856,-0.0502,-0.1377,-0.1447,0.1266,0.146,0.1927,0.3175,0.1182,0.11,-0.0427,-0.0764,-0.0285,-0.0626,0.0413,-0.1422,-0.3796,-0.2016,-0.1255,-0.3012,0.3859,0.3225,0.1552,-0.0931,0.0153,0.0369,0.1038,-0.0477,-0.1272,0.149,0.1477,0.055,-0.2254,0.127,-0.0041,0.0061,-0.0413,-0.0817,-0.1407,0.0137,0.0112,0.0061,-0.0086,-0.0683,-0.13,-0.093,-0.0725,-0.0469,-0.1025,-0.1686,-0.1443,-0.1398,-0.0039,0.1348,-0.0178,0.0061,-0.0002,-0.009,-0.0066,-0.1205,-0.0501,-0.0328,-0.031,0.0609,0.0205,0.2501,0.1664,0.1149,0.1774,-0.3323,0.0277,-0.2392,-0.1731,-0.1164,-0.0137,-0.0191,-0.1533,0.0131,-0.1918,-0.2036,-0.1148,-0.1588,-0.0492,-0.0441,0.1202,0.0704,0.0928,-0.0734,-0.1847,-0.2003,0.1125,0.0134,-0.0406,0.0173,-0.0093,0.0108,0.1035,0.1486,-0.0286,0.1296,-0.1208,0.1208,-0.1205,-0.0685,-0.1306,-0.0608,0.0536,-0.0152,0.0102,0.0684,-0.1036,-0.2177,0.0259,-0.0232,0.0265,-0.1057,0.0676,0.1428,0.0082,-0.0753,-0.1129,-0.0301,0.1684,0.0949,0.1468,0.114,-0.0364,-0.1641,0.0783,0.0179,0.1837,0.2154,0.2461,0.1696,0.1708,0.1396,0.1392,0.0486,0.1081,-0.0354,0.1537,0.1501,0.1409,0.098,-0.038,0.0786,0.1163,-0.0487,-0.1083,-0.0765,0.0693,-0.2394,-0.2904,-0.1181,0.0471,-0.0474,0.0245,0.0619,-0.115,-0.0355,-0.0489,-0.2403,-0.2276,0.0225,-0.0231,-0.1034,-0.0999,0.1506,0.1023,0.0579,0.0479,-0.0001,0.006,-0.0423,0.0707,-0.0435,0.197,0.1203,-0.1452,-0.0952,0.307,0.0305,-0.1213,-0.1374,0.0594,0.1084,0.513,0.4251,0.2303,0.3394,-0.209,0.0737,0.1109,-0.0618,-0.0147,0.0517,0.1107,0.0567,-0.2404,-0.1576,-0.2831,-0.1547,-0.1506,0.0444,0.0224,-0.1504,-0.0098,-0.059,-0.0585,-0.0073,-0.2827,-0.1628,0.1803,0.2828,0.1583,0.0724,0.1594,0.077,0.0284,-0.0606,-0.0742,-0.0231,-0.0903,-0.0717,0.1883,0.0432,0.1573,-0.0218,0.1872,0.2333,-0.0265,-0.1008,0.0279,0.0963,0.0575,0.0813,0.0694,0.2337,0.0407,0.1834,0.0663,0.0285,0.009,0.0488,0.0872,-0.0379,-0.0425,-0.0212,0.1166,0.0681,0.1288,-0.0002,-0.1196,-0.0991,0.0748,-0.25,0.0642,0.0758,-0.0976,-0.1101,0.0169,0.0265,0.0281,-0.0078,0.0164,-0.0033,-0.1735,-0.3192,-0.3419,-0.0134,-0.1074,0.0242,-0.137,0.1026,-0.195,0.0202,-0.2405,-0.011,-0.1222,-0.1129,-0.106,-0.0167,0.0094,0.0152,-0.0231,0.0006,0.0003,-0.0843,-0.0342,0.0406,0.1406,-0.0811,-0.1612,-0.1502,0.2356,0.1916,0.2311,0.0001,0.156,-0.0032,0.0312,-0.0428,-0.0366,0.0282,0.1289,0.1428,-0.0373,-0.0366,0.1662,-0.0792,-0.265,-0.0293,0.0744,-0.1419,-0.3209,-0.142,-0.1307,-0.1494,0.1096,0.004,-0.2618,-0.1083,0.1591,-0.2566,-0.0605,-0.0314,-0.0967,-0.3517,-0.0753,0.1433,0.1571,0.0738,-0.0306,-0.1737,0.089,-0.0556,0.0244,0.0064,0.0095,0.1163,0.0318,-0.1462,0.0926,0.157,-0.0474,0.0197,0.1148,0.0397,0.1082,0.1366,0.1445,0.0764,0.0909,0.1682,0.1189,-0.1638,-0.2793,0.0334,0.0441,-0.0124,-0.0444,0.0585,0.0672,0.1328,0.1533,-0.0245,-0.067,0.2148,0.2606,0.1072,0.0551,0.1443,0.1894,0.0089,0.1427,0.0896,0.2128,0.089,0.0157,0.07,0.0617,0.0153,0.1084,-0.119,0.124,-0.0526,-0.1816,-0.1292,0.1522,0.0176,0.1956,0.1891,0.0865,0.0261,0.031,-0.0425,-0.1131,-0.1603,0.0591,0.1081,-0.0259,0.117,0.0208,-0.1029,0.1201,0.0464,0.1156,-0.074,-0.0551,-0.1479,-0.0326,0.3055,0.2514,0.0229,0.0026,-0.0142,-0.1257,-0.1234,0.0237,0.1196,0.149,0.0782,0.1862,0.3238,0.1347,0.1437,-0.05,0.0422,-0.1178,0.0328,-0.1724,0.0026,-0.0567,-0.038,-0.0855,-0.1605,-0.0785,-0.0012,-0.029,0.1143,-0.0208,0.0968,0.0362,0.0852,0.0479,0.0632,-0.0136,0.113,0.0937,0.0957,0.0712,0.1681,0.0506,-0.0174,-0.1365,0.0278,-0.1527,-0.035,-0.0617,0.0492,-0.0148,-0.0446,0.0847,0.1687,0.0881,-0.1862,-0.1209,-0.044,0.081,0.0666,0.1668,0.1003,0.0043,0.0672,-0.1251,-0.1367,0.2648,0.1784,-0.0052,0.1681,0.0383,0.0406,-0.3786,-0.3102,0.2251,-0.0559,0.0968,0.0236,0.1072,0.2179,0.2412,0.1696,-0.0609,0.0232,0.1288,-0.0194,0.1508,0.0486,-0.1805,0.0052,-0.0734,0.0223,-0.0147,-0.0457,0.1534,0.0421,-0.0882,0.1842,-0.0555,0.2936,-0.2183,0.2125,-0.3412,-0.0753,-0.0669,0.3068,0.2799,-0.1527,-0.2467,-0.0631,-0.2213,-0.0996,-0.0614,-0.0612,-0.0053,-0.0861,-0.0825,-0.0828,-0.1222,-0.1039,-0.1265,-0.2003,0.0698,-0.0533,-0.2649,-0.5731,-0.1924,-0.2549,-0.4125,-0.2202,-0.2223,-0.2917,-0.2218,-0.2843,-0.19,-0.2113,-0.2889,-0.1571,-0.2651,-0.3423,-0.3524,-0.3259,-0.2799,-0.1548,-0.1827,0.2064,0.0956,0.2742,0.036,-0.0042,0.264,0.2444,0.1277,0.0169,0.0518,0.296,0.2519,0.1761,0.0258,0.0136,0.1881,-0.1376,0.0277,0.1022,-0.0008,0.1416,0.0685,0.0705,0.0952,0.1397,-0.1107,0.1801,0.2023,-0.0595,0.0339,0.053,0.0083,0.0013,0.1641,-0.1196,-0.0874,0.1297,-0.2965,-0.3366,-0.0091,-0.1406,-0.2331,0.1129,-0.2605,-0.2628,0.0838,0.1082,-0.1913,0.0546,-0.0001,0.1436,0.0365,-0.1688,0.0818,0.0943,-0.0031,0.0294,0.0811,0.0159,error detection
trm_55b6b92c1fd76,-0.0863,-0.029,-0.0915,-0.1222,-0.0261,0.0162,-0.0593,0.0326,0.0062,-0.0793,-0.0766,-0.0558,-0.0754,-0.0567,-0.0794,0.0132,-0.0265,-0.1936,-0.0045,-0.1444,-0.1215,-0.0307,-0.0258,-0.042,0.0129,0.0197,0.0216,-0.1785,-0.135,-0.0831,-0.0983,-0.1657,-0.0951,-0.0434,-0.1538,-0.0879,0.0211,-0.0248,-0.0653,-0.0406,-0.0822,-0.027,-0.0136,0.0068,-0.0819,-0.1119,0.1017,-0.0591,0.0227,-0.1145,-0.0397,0.0821,0.0225,0.0116,-0.1094,-0.0638,-0.0276,-0.0578,-0.0114,-0.0333,-0.0208,0.0497,-0.1556,0.0589,-0.0021,0.1826,-0.2047,-0.3119,-0.1677,-0.0211,0.0757,0.0366,0.0218,-0.1206,-0.0509,-0.04,-0.0392,0.0042,0.0552,0.0531,-0.0361,-0.0206,-0.0132,-0.1839,0.0252,0.0492,0.0245,0.0481,-0.0692,0.0091,-0.019,0.0831,0.007,0.3818,0.2886,0.3156,0.1614,0.0787,0.3012,0.3108,0.0868,0.0307,0.1054,0.3213,0.1855,-0.0682,-0.2214,0.0817,0.0121,0.0101,-0.0253,-0.1654,0.0704,0.1944,0.0008,-0.0275,-0.1544,0.2283,-0.1153,-0.0474,-0.1803,-0.1626,-0.2091,-0.0591,-0.1328,-0.2235,-0.1616,0.1031,0.0749,0.0594,-0.1944,-0.0553,0.0094,-0.2149,-0.0409,-0.2399,0.0183,-0.1608,0.0013,0.0125,-0.1066,-0.1198,0.008,-0.0888,-0.0712,0.168,-0.0291,-0.0503,-0.0483,-0.0262,-0.1219,-0.1184,-0.1347,-0.2162,0.0828,0.0629,0.0472,0.0767,-0.013,-0.0464,-0.0716,-0.0939,-0.2725,-0.1649,-0.0104,0.0666,-0.0471,-0.2688,-0.2632,-0.1001,0.0332,-0.175,0.1235,-0.3326,-0.1974,-0.2179,-0.159,-0.2555,-0.151,-0.0198,-0.1272,0.0838,-0.0169,0.0284,-0.0726,-0.1008,0.0218,-0.1933,-0.1707,-0.1334,-0.1275,-0.0994,-0.0325,-0.322,-0.3106,-0.131,-0.1626,-0.1028,-0.0812,0.1385,0.0831,0.3547,-0.2124,-0.0953,0.0045,-0.0131,-0.2566,0.0096,-0.0302,-0.006,-0.239,-0.1226,0.0386,-0.0289,0.0242,-0.0471,0.065,-0.0102,0.1527,0.0253,0.0972,-0.1132,-0.0951,-0.0449,0.087,0.0128,-0.0678,0.1564,-0.0885,0.0454,0.2324,-0.0994,0.1707,0.004,0.0218,0.1686,-0.1153,-0.0998,0.03,-0.0775,0.0984,-0.1399,0.0396,0.0223,-0.1257,-0.0991,-0.1201,-0.1308,0.004,-0.2434,-0.025,0.038,-0.0548,0.0142,0.0145,-0.2602,0.0591,0.0213,0.0778,0.1359,0.0363,0.2527,-0.1281,0.096,0.1941,0.2685,0.1004,-0.0808,0.0129,-0.06,0.0228,0.082,-0.1583,-0.0668,0.0731,0.0856,0.1176,0.0162,0.1102,0.0905,0.096,-0.1293,-0.1325,-0.3473,-0.2822,-0.0214,0.0613,0.0236,0.0187,-0.1065,-0.0863,-0.1261,0.0173,-0.098,-0.0605,0.0515,-0.1106,0.0574,-0.0245,0.0928,0.0508,-0.3249,-0.0143,-0.0642,0.1809,0.2079,-0.0786,-0.0357,0.1214,-0.0704,0.0196,-0.0314,-0.0734,-0.0496,0.0286,-0.0127,0.0762,0.0649,0.0022,-0.1814,-0.0643,-0.0245,-0.1202,-0.1721,-0.0412,-0.0561,0.0129,-0.0092,-0.0473,0.0133,0.0096,-0.0962,-0.1201,-0.0111,-0.0816,0.1666,0.0551,-0.1204,-0.0776,-0.2681,-0.239,-0.0251,0.1574,0.0552,0.058,0.0345,-0.1264,-0.0758,-0.0635,-0.0452,0.0095,0.1925,0.1233,0.072,0.0265,0.086,-0.0222,-0.1411,-0.0246,-0.0654,-0.0285,-0.0598,-0.0149,0.0451,0.0713,0.1194,-0.0374,0.1488,0.0626,-0.1887,-0.0245,0.0506,0.0119,0.1226,-0.168,0.0173,-0.0867,0.0456,0.018,0.1482,0.0784,0.2021,-0.1151,0.0182,0.0326,0.0879,-0.0882,-0.014,0.0361,-0.0116,0.0578,0.023,0.196,-0.0341,0.0541,0.144,0.1388,-0.0803,0.0034,-0.0562,-0.09,-0.0023,0.0076,-0.0499,0.0859,0.0416,-0.015,-0.0223,-0.139,0.0034,0.051,-0.1411,-0.0969,0.1139,-0.1681,-0.165,0.1099,-0.0801,-0.1774,-0.0673,0.0099,-0.0747,0.0114,-0.22,-0.1865,-0.0163,-0.1403,0.0517,-0.1237,0.0801,-0.0289,0.0548,-0.0063,-0.0197,-0.1086,0.0107,0.1782,0.0585,-0.1764,-0.0972,0.0807,0.1114,0.0668,0.0595,-0.0617,-0.0493,0.0444,0.1861,-0.2516,-0.1884,-0.0662,0.0463,-0.0997,-0.1019,-0.0063,-0.2502,0.0086,-0.087,-0.0622,-0.0174,-0.0068,-0.0187,-0.0856,0.0483,-0.1442,-0.039,0.0864,0.2249,-0.0153,0.031,0.0814,0.0648,0.1226,-0.0469,-0.1137,-0.0468,0.1282,0.1178,-0.0266,-0.0248,0.2828,0.1045,0.1695,0.0788,0.0601,0.0876,0.0405,0.0914,-0.128,0.0059,0.1153,0.203,-0.0333,-0.081,0.1357,0.0084,-0.1533,0.0401,0.0142,-0.1509,-0.135,-0.0696,-0.024,-0.0801,-0.1021,-0.1136,-0.0587,-0.1162,-0.0185,0.186,-0.15,0.151,-0.1313,0.0039,0.0757,0.0706,-0.1857,-0.1496,0.2756,-0.0812,-0.1195,-0.0378,0.0487,0.0551,0.0425,-0.0262,0.1213,0.1412,0.0895,0.104,-0.0102,0.0073,0.0337,-0.175,-0.1969,0.0444,-0.13,0.0043,-0.0337,-0.1189,-0.059,-0.0047,0.0041,0.0284,-0.1237,-0.0014,-0.0662,-0.043,-0.0057,-0.0368,0.1415,-0.1078,-0.0331,0.1653,0.051,-0.1471,0.0564,0.0218,0.0232,-0.0,-0.1326,0.017,-0.1347,0.0456,-0.112,0.0709,0.0362,-0.2026,-0.0415,-0.118,-0.1109,-0.1261,-0.028,-0.0,0.3862,0.2956,0.1141,0.102,0.0539,0.017,-0.0343,-0.1094,-0.0558,-0.0189,0.0881,0.0087,0.1379,0.0105,0.1378,-0.0954,-0.0797,0.0298,0.1003,0.015,0.0616,0.0467,-0.2281,-0.1127,0.1512,-0.018,0.0326,-0.0002,-0.0023,0.039,0.137,0.3005,-0.0403,-0.19,-0.1887,-0.0267,-0.1732,-0.0072,-0.0169,-0.0792,-0.2225,-0.1122,-0.0908,-0.043,0.0456,-0.1653,-0.0127,-0.1545,0.1539,-0.03,0.021,0.1349,-0.054,-0.1655,0.0238,0.0401,0.1046,0.1403,-0.1241,-0.0448,0.0041,0.1924,0.0434,0.0808,-0.1436,0.027,-0.0003,0.1432,0.0707,0.2732,-0.0583,-0.0247,-0.3356,-0.3036,0.11,-0.2289,-0.0835,-0.1116,0.2363,-0.1143,-0.0776,0.0666,0.2649,0.0558,-0.0527,-0.0461,-0.2436,0.3218,0.1328,0.1977,0.155,0.1231,0.1356,-0.1048,0.2516,0.0317,0.0612,-0.0958,-0.0151,0.1292,-0.0299,-0.0802,0.2827,-0.1269,-0.0048,-0.0898,0.0057,0.1352,0.0598,0.0026,0.1567,-0.1828,-0.0699,-0.0054,0.0224,0.1029,-0.0715,0.1362,0.1753,0.0631,0.1394,-0.1735,0.0332,-0.078,-0.0682,-0.0429,0.0271,-0.0205,-0.09,-0.1497,-0.1267,-0.0542,-0.0918,0.0067,0.0368,-0.0293,0.0311,-0.1135,-0.1174,0.0162,-0.1585,-0.1086,-0.0331,-0.0061,-0.0861,0.0117,0.0967,-0.1095,-0.2641,-0.2473,-0.2003,-0.0156,-0.0733,-0.1334,-0.0986,0.091,0.0462,-0.0535,0.0541,0.0706,0.1284,0.0859,0.0079,0.0393,0.0977,0.1061,-0.2781,-0.0187,-0.044,0.0501,-0.0753,-0.1936,0.0289,0.0926,-0.0882,-0.0067,-0.0281,0.062,-0.2753,-0.3869,-0.3341,-0.2565,0.0646,0.1095,-0.0203,0.0698,-0.0574,0.1138,0.0984,0.1131,0.0617,0.0774,-0.1877,-0.1108,0.1031,0.0684,0.1557,0.1699,0.0485,0.0072,0.0489,-0.0861,0.0588,-0.1197,-0.1583,-0.0827,-0.227,-0.2138,-0.1228,0.0502,0.049,0.0368,-0.0219,-0.0561,0.038,0.0514,0.0761,-0.1453,0.0098,0.0074,0.0592,0.0771,0.0814,-0.1243,0.0963,-0.3156,-0.3118,0.0418,0.0175,0.1098,-0.0638,-0.0407,0.0512,0.0394,0.1101,0.2311,0.0794,0.1872,0.0664,0.1186,0.0725,0.0428,0.1664,0.1046,0.0838,0.0252,0.003,-0.199,-0.2171,0.1185,-0.0802,-0.0709,-0.3651,-0.146,-0.2281,-0.1594,-0.2801,0.033,-0.015,0.0023,-0.0863,-0.0465,-0.0526,0.1564,0.1006,0.0138,0.0463,0.0322,-0.0049,0.0259,0.0536,-0.0096,0.0831,0.08,-0.0971,0.14,0.0358,0.034,-0.0902,-0.1248,-0.0642,-0.0098,-0.0132,-0.2776,-0.2399,0.0075,0.0221,0.0571,0.0296,-0.0982,0.1252,0.2444,-0.0316,-0.1229,0.2553,-0.0612,0.0341,-0.2062,0.3836,-0.0984,0.126,-0.0048,-0.0963,0.0263,-0.2862,-0.2659,-0.1088,0.1927,-0.1041,-0.1435,-0.088,0.0671,0.0501,-0.1905,-0.0697,-0.2539,0.0487,-0.0062,0.0847,0.1196,-0.0328,0.1532,-0.1802,-0.1324,-0.0526,0.0141,-0.1816,0.0248,0.028,0.0007,0.0754,0.1881,0.0868,-0.1681,-0.1341,-0.0938,-0.1148,-0.0375,-0.1258,0.0482,0.1444,0.0848,-0.0031,-0.0458,0.0897,0.1526,0.127,0.0425,-0.0088,-0.0764,0.1635,0.0162,-0.0162,0.0868,0.0306,-0.1268,0.0324,0.0589,0.0389,-0.0239,-0.0495,0.045,-0.0365,-0.0928,-0.0288,-0.194,-0.1871,-0.3523,-0.2138,-0.3835,-0.1335,-0.1356,-0.1336,-0.1714,-0.2294,-0.2526,-0.2375,-0.265,-0.0638,-0.0382,0.0504,0.0178,0.0833,0.0183,0.0539,0.1234,0.03,0.139,-0.0101,-0.0453,-0.0216,-0.0339,0.0696,0.0767,-0.0285,0.0519,0.001,0.0966,0.0297,0.015,-0.0725,-0.0011,-0.0363,-0.0549,0.0923,0.0891,0.0046,0.0553,-0.2059,-0.1777,-0.0999,-0.2454,-0.2052,0.0869,0.0767,0.1267,0.092,0.077,0.0516,0.0448,0.0039,0.0268,-0.0012,0.0788,0.0004,0.0011,-0.0644,0.0327,-0.0824,0.0116,-0.0226,-0.0005,-0.052,-0.1666,-0.2328,-0.1926,0.1497,0.1436,0.1289,0.0121,-0.025,-0.1301,-0.0578,0.0062,-0.0073,-0.0532,-0.0009,-0.0197,-0.0204,0.2026,0.0503,-0.0061,-0.1151,-0.0143,-0.0975,0.0107,-0.0689,0.0606,0.2946,0.4665,0.0087,-0.0167,-0.051,0.0305,-0.0321,-0.1482,-0.0878,-0.1405,0.0243,0.0344,0.142,0.0774,0.0054,0.0099,0.0449,-0.0322,0.1096,-0.0445,-0.1098,-0.1852,-0.0901,0.1493,0.0474,0.1246,-0.1433,0.2044,0.0662,-0.0476,-0.0764,-0.0408,-0.0689,-0.0525,0.1199,-0.1103,-0.1435,0.0115,-0.046,-0.1807,-0.088,-0.0621,-0.0489,-0.1451,-0.1089,-0.03,-0.0785,-0.0008,0.2608,0.0594,0.0914,0.0803,-0.0382,0.0997,-0.1634,-0.0319,-0.0026,-0.1319,0.2308,0.2078,0.33,0.2623,0.2852,0.0991,0.2906,0.1156,-0.3111,-0.0469,0.032,-0.0389,-0.031,-0.1457,-0.1619,0.0,-0.1272,-0.1078,-0.024,-0.058,0.093,0.0362,-0.1393,0.1173,0.099,-0.029,0.104,-0.0339,-0.1399,-0.0354,-0.0885,-0.1431,-0.0033,-0.193,0.0134,0.0394,0.1652,-0.0461,-0.1466,-0.233,-0.1928,-0.1207,0.0489,0.0825,0.1707,0.0068,-0.0942,-0.1836,-0.0758,0.0266,-0.1426,0.198,0.2787,-0.1619,0.0418,0.1467,0.3782,0.3361,0.2709,0.1516,0.07,-0.0149,0.0483,0.0594,0.0026,-0.1518,0.0228,-0.1632,0.2348,-0.006,-0.038,0.0539,-0.1315,-0.0078,0.081,-0.1409,0.2087,0.2196,0.1089,-0.1425,0.0056,-0.0761,0.0692,0.0828,0.0649,-0.3131,-0.3195,-0.0652,-0.0893,0.1078,0.013,-0.1257,-0.0332,-0.0769,0.1007,0.0402,0.1017,0.3171,0.0148,-0.0205,-0.2062,0.0179,0.1291,0.1729,-0.1515,0.1172,0.2922,0.0107,-0.1959,0.2404,0.2207,-0.1115,-0.2034,0.0301,-0.2156,-0.1407,-0.2049,-0.0536,0.2594,0.0432,0.0162,0.1035,0.0568,0.0122,-0.0922,0.0776,0.0446,-0.145,-0.0468,0.0599,0.0286,0.0496,0.0081,0.0818,0.0515,-0.212,0.0032,-0.1167,-0.1862,-0.1233,-0.0459,0.2068,0.1478,-0.232,-0.1884,0.0928,0.1891,-0.0676,0.0845,0.0061,0.0908,0.0218,0.2626,-0.1608,-0.1873,-0.0631,0.1685,0.0167,-0.0436,0.0369,0.0369,-0.2778,0.0977,0.0982,0.0683,0.022,-0.0473,0.0458,0.372,-0.309,-0.3166,0.0033,-0.0427,-0.2264,-0.2448,-0.1335,-0.0033,0.0517,-0.1221,-0.0745,0.0292,0.2768,0.0201,0.0053,-0.0227,0.0256,0.0119,0.0088,0.0805,0.0222,-0.1316,-0.008,-0.1128,-0.1055,-0.1203,0.0866,0.0941,-0.0711,0.4333,0.2445,0.3174,0.0599,0.3255,-0.2533,-0.1978,-0.0272,-0.244,0.0652,-0.1779,-0.1284,0.0529,-0.1405,-0.2208,0.1856,0.0276,-0.1769,-0.0189,0.1175,-0.0605,-0.0835,-0.0033,-0.0751,0.1001,-0.0659,0.0689,-0.0774,0.14,0.1808,0.2341,0.1684,0.1089,0.1377,-0.0395,-0.0077,-0.0093,-0.0799,-0.1063,-0.037,-0.2264,0.0193,0.0261,-0.0255,-0.0613,-0.234,-0.1846,-0.0045,-0.019,0.1185,0.0216,-0.0952,0.0749,-0.0475,-0.0847,-0.2485,-0.3209,-0.216,0.0225,-0.1378,-0.1391,0.0217,0.0276,0.0712,0.1039,0.0817,-0.1255,-0.1288,0.0622,-0.1563,0.0286,0.0394,0.0693,0.1697,-0.0929,-0.0554,0.1755,-0.07,0.1316,0.0154,-0.1012,0.0048,0.0072,0.011,-0.0051,-0.2799,0.096,0.0047,-0.0225,0.359,-0.1186,0.0181,0.0516,0.1015,0.2771,-0.0591,0.0263,-0.1753,-0.0962,-0.1939,-0.2088,-0.1069,0.0857,0.032,-0.1329,-0.2472,-0.0388,-0.0956,0.0186,-0.0684,-0.1229,-0.0281,0.0212,0.0131,0.0382,-0.0566,-0.005,-0.0194,-0.1621,-0.1372,-0.1084,-0.1164,-0.0471,0.0351,0.0148,0.0673,-0.0241,-0.0511,-0.0478,0.0555,0.0698,-0.0242,-0.0843,0.0943,0.1061,0.255,-0.0613,0.0215,-0.0336,0.0732,0.0707,-0.0372,-0.0608,-0.0842,0.0069,-0.2842,0.045,0.0981,0.0767,0.0098,0.0246,-0.0745,-0.0932,-0.1817,0.1146,0.0491,-0.0368,0.1376,0.2057,-0.0559,0.1232,-0.0175,-0.0149,-0.0441,-0.0655,0.1267,0.0194,0.062,0.0852,0.0771,-0.0191,-0.1138,-0.0087,0.0667,0.0679,0.2147,0.1643,0.0179,-0.0761,0.0167,0.1069,0.0765,0.0015,0.057,0.1079,0.0889,0.0763,0.1094,-0.0034,0.1632,0.0447,0.0212,0.1452,0.0248,-0.2415,-0.1641,0.0751,0.0131,0.0313,-0.1196,-0.0538,-0.0699,0.0807,0.1075,-0.034,-0.1002,0.013,-0.0045,0.1556,0.1563,-0.0506,0.0002,0.0262,-0.0394,-0.0123,-0.0908,0.1341,0.0011,-0.0035,0.1462,0.0702,0.0672,-0.0629,-0.0712,0.0491,0.3979,0.3898,-0.0799,-0.0667,0.1048,-0.0474,0.0244,-0.0757,-0.1117,0.0618,-0.0983,-0.0828,-0.0137,0.0762,0.264,-0.1363,0.1761,0.0391,0.0514,0.128,0.2785,0.299,-0.1274,0.1674,0.0952,0.0955,0.0315,0.0365,-0.0549,-0.0001,-0.0486,-0.0103,0.1575,-0.0794,-0.0317,-0.1148,-0.0589,-0.1919,-0.0295,-0.0437,0.1609,-0.1479,0.0479,0.0085,-0.112,-0.1202,-0.0149,0.0635,-0.0447,-0.0029,0.0355,-0.0682,-0.01,-0.1086,0.0198,0.0571,-0.0031,-0.0305,0.0336,-0.0423,-0.0024,0.0614,0.1475,0.1149,-0.1252,0.0298,0.0144,0.0451,0.213,-0.254,-0.1572,-0.0412,-0.1805,0.146,0.1119,0.1819,-0.0496,0.0127,-0.023,-0.058,0.0808,0.0022,-0.1147,0.0351,0.0609,0.0312,-0.0005,0.1631,0.1803,0.1317,-0.0277,-0.0113,-0.1139,-0.0879,0.0527,0.0369,-0.1458,-0.0193,-0.0355,0.023,0.0878,0.2528,-0.2286,-0.1391,-0.0087,0.0866,0.0609,0.1826,-0.0021,0.1402,0.112,-0.0237,-0.0888,-0.1756,-0.041,0.027,0.0531,-0.0114,-0.0597,-0.03,0.031,-0.0568,-0.0638,0.1343,-0.2399,-0.2083,-0.1022,0.2565,0.0883,0.1016,0.003,0.0835,0.0837,0.0776,0.1579,0.2897,0.1161,-0.013,-0.0561,-0.0859,0.1186,-0.1748,0.1099,-0.1937,-0.1286,-0.1154,-0.0682,0.0066,0.0608,0.026,0.3024,-0.0592,0.1645,0.1523,0.1945,0.0366,0.0028,0.0139,0.0087,0.0497,0.0712,0.1688,0.1497,0.1446,-0.294,-0.1878,-0.2809,-0.0149,-0.017,-0.1464,-0.1248,-0.0893,-0.0922,-0.1023,0.0426,-0.0696,0.1747,0.089,0.071,0.1929,0.117,0.0276,0.0335,0.0578,-0.01,-0.0168,-0.2144,-0.0742,-0.1258,-0.041,0.0789,0.1559,0.0157,-0.0537,0.0238,0.0696,-0.41,-0.2425,-0.2384,-0.1978,-0.0412,0.0299,0.0821,-0.2259,-0.2492,-0.1217,-0.0544,-0.0269,0.0227,0.0463,0.0058,0.0062,-0.0074,-0.1647,0.015,-0.0625,0.0924,-0.0302,-0.0153,-0.4101,-0.1185,-0.156,-0.2248,-0.42,0.0962,-0.2096,0.1133,0.0039,-0.0151,-0.0559,-0.065,-0.1517,0.034,-0.3037,-0.1499,-0.0759,0.0872,-0.0818,-0.0234,-0.199,-0.087,-0.0271,0.2064,-0.0531,-0.0538,-0.0757,0.1394,-0.2202,-0.2448,-0.1768,0.0023,-0.107,-0.1902,-0.2255,-0.1282,-0.0431,0.0052,-0.0186,-0.012,-0.3273,-0.0687,-0.0512,-0.1231,0.022,-0.0704,-0.0791,-0.0237,0.0392,-0.0522,0.1119,-0.0025,-0.185,-0.1442,-0.1369,-0.2089,0.0256,-0.2837,-0.191,0.0929,0.2277,0.1541,0.0779,-0.1066,-0.0163,0.1935,0.1964,0.2083,-0.2156,-0.2579,0.0964,0.1614,0.0511,0.0124,0.0551,-0.0561,-0.0297,0.0169,-0.0845,-0.0791,0.057,-0.0445,-0.1366,-0.0785,-0.0976,0.104,-0.0075,0.1285,0.2294,0.1155,-0.0503,-0.3172,-0.2266,-0.1523,-0.1369,-0.3399,-0.2334,0.2293,-0.1388,-0.1126,0.4785,0.2635,0.355,0.3955,0.2317,0.2147,0.18,0.1918,0.1415,0.1102,0.3527,0.2754,0.3981,0.4532,0.2791,-0.3259,0.016,0.0486,0.2152,-0.0881,-0.2167,0.0875,-0.029,-0.0118,0.056,0.2714,-0.0141,-0.0684,0.1858,-0.0251,-0.0324,0.1463,-0.0907,-0.0714,0.1675,0.1372,-0.0339,-0.0154,0.0189,0.0909,0.1368,0.0145,0.0187,-0.084,-0.0036,-0.4262,-0.1698,-0.1665,-0.2322,-0.1837,-0.2286,-0.255,-0.122,-0.0974,-0.1449,0.0631,0.1843,0.198,0.0168,-0.2992,0.1557,0.0588,0.0787,0.0406,-0.1055,0.1021,-0.1179,-0.1204,-0.1114,-0.0994,-0.129,0.0127,-0.0247,0.1375,0.0735,0.1455,0.1564,-0.1425,-0.1367,-0.0879,-0.2729,-0.1635,-0.1599,-0.1484,0.0572,-0.0123,-0.1454,0.124,-0.0597,0.0489,0.0948,-0.0558,-0.0018,-0.0953,-0.1299,-0.1066,-0.0477,0.0895,-0.0915,-0.0877,0.0399,0.0235,-0.064,0.0094,0.0338,0.0719,-0.0353,-0.1038,-0.1793,0.0896,0.161,0.1404,-0.082,0.3018,0.1104,-0.1176,-0.1132,0.1938,0.3387,0.0014,0.1249,0.0618,0.182,-0.1495,-0.1409,-0.1158,-0.0501,0.2353,0.2168,0.1393,0.0348,0.0481,0.064,0.2253,0.2164,0.1841,-0.0551,0.0074,-0.0185,0.069,0.0041,0.1351,-0.323,-0.0556,0.0045,-0.0642,-0.1404,-0.1263,0.034,0.0233,0.0748,0.0445,0.0845,0.1094,0.1632,0.2215,0.0646,0.1957,-0.0176,0.0405,0.0417,-0.0753,-0.1145,-0.0883,0.0825,-0.274,-0.3898,-0.3604,0.1198,0.1662,0.0602,0.0832,-0.0027,0.2004,0.1059,-0.0025,0.118,0.0288,-0.1902,-0.2761,0.2176,0.0602,-0.0495,0.0835,0.074,0.2056,0.2754,-0.0736,-0.0599,-0.0503,-0.0382,0.313,0.125,0.1784,0.0187,-0.0872,-0.009,0.0369,0.0065,0.0774,0.0479,-0.2183,-0.0824,-0.2092,-0.1602,-0.1588,0.1333,-0.0247,0.0119,0.0138,-0.0125,0.0279,0.3793,0.2952,0.0987,0.171,-0.0922,0.1551,0.0271,0.2804,0.2729,0.2227,0.0295,0.032,0.0226,0.2432,0.1828,0.1178,0.1081,0.0706,0.0646,-0.0631,0.0454,-0.0202,0.0798,-0.053,0.1043,-0.0059,0.0406,0.2194,0.1293,0.0441,0.0664,-0.2651,-0.1431,-0.2118,-0.1413,-0.2305,0.1488,-0.0347,-0.0676,-0.0405,0.2008,0.1415,-0.1991,0.0734,0.1375,-0.2332,-0.0309,0.0674,0.0682,0.1099,0.2149,0.2583,0.24,0.1162,-0.0062,0.0084,0.2136,-0.0778,-0.0633,0.0309,0.0241,0.0694,0.1713,0.0092,-0.0637,-0.1883,-0.2975,-0.3267,-0.2873,-0.1007,-0.0846,-0.1775,-0.1598,-0.07,0.165,0.0172,0.0572,0.1202,-0.0291,0.1134,-0.0979,0.1217,-0.0572,-0.0717,-0.1841,0.0879,-0.0357,-0.1558,-0.0653,0.3182,0.0532,0.0395,0.0433,0.0278,0.0428,0.0839,-0.0037,-0.0198,-0.0278,-0.0082,-0.029,-0.1833,0.0892,-0.0217,0.1381,-0.0106,-0.2826,-0.1771,-0.0197,-0.1618,-0.0643,-0.0547,-0.1481,-0.0472,0.1604,0.061,0.1513,-0.378,-0.1618,-0.0851,-0.3252,-0.2522,-0.1478,-0.1897,-0.1897,-0.0939,-0.0197,0.127,-0.176,0.0239,0.169,0.1097,0.0188,-0.0791,-0.3293,0.1068,0.149,0.0034,-0.066,0.3247,0.0864,-0.0248,-0.1628,-0.0484,0.0528,0.115,0.0275,0.2349,0.1614,0.2372,0.2679,0.1897,-0.0113,0.0308,0.2731,0.1496,-0.0208,-0.0414,-0.1119,-0.0608,-0.0999,-0.0335,-0.067,-0.0525,0.0808,-0.0832,-0.0471,0.1515,0.0411,-0.124,0.0707,-0.0055,-0.3207,-0.0398,-0.3431,-0.1298,-0.0463,0.0529,-0.1677,0.4916,0.4638,0.1983,0.3628,0.2836,0.0318,-0.0016,-0.0556,0.1109,0.0258,0.0292,0.1813,-0.0106,0.1102,0.0048,0.0492,0.0905,-0.1115,-0.0264,-0.0327,0.0004,0.3713,0.0068,0.3584,0.2595,0.2832,0.1732,0.2798,0.142,0.0771,-0.0255,-0.0862,0.0905,-0.0086,-0.0713,-0.0711,-0.1774,-0.0612,0.137,0.0421,-0.0576,-0.0917,-0.071,0.0378,-0.0307,-0.0338,0.0358,-0.0046,0.0153,0.0618,0.1974,0.0227,0.1121,0.2083,-0.0804,-0.0579,-0.1211,-0.1489,-0.0305,0.1006,0.0099,-0.0839,0.124,0.1497,0.1252,-0.0058,0.0143,0.1405,0.0407,-0.0416,-0.0172,-0.0032,-0.0056,0.0537,0.0362,0.0019,-0.0372,-0.0337,0.132,0.0107,-0.2272,-0.1842,-0.1626,-0.1473,0.0646,-0.0072,-0.0108,-0.1696,-0.118,-0.186,0.0031,-0.1318,0.0249,0.0308,0.1917,0.0829,-0.1449,-0.1284,0.0023,-0.1018,-0.0447,-0.1272,0.1314,0.1356,-0.0737,0.0371,0.0213,0.021,0.0809,0.0478,0.0885,0.0788,-0.0346,-0.1678,0.0292,-0.1423,-0.1464,-0.0361,-0.1374,0.121,0.1839,0.1274,0.0983,0.1349,-0.1107,-0.2141,-0.0777,0.0187,0.1091,0.0516,0.0735,-0.0588,-0.0232,-0.151,-0.1083,-0.1839,-0.1432,-0.0712,-0.0048,-0.1006,-0.1792,-0.0922,-0.1315,-0.0124,0.0002,-0.0144,-0.0323,-0.2117,0.0935,0.1035,0.0515,0.0494,0.063,0.1306,0.1666,-0.0345,-0.0289,-0.0919,-0.0862,-0.1284,-0.013,-0.2836,-0.0246,-0.0107,0.0507,-0.103,-0.0094,-0.0068,0.0428,-0.0573,0.0716,-0.189,-0.0877,-0.1997,-0.1402,0.0343,-0.2386,-0.1807,-0.2995,-0.1557,0.1699,0.1447,-0.1401,-0.1249,-0.0228,0.0571,-0.0327,-0.0551,-0.1374,-0.1868,-0.1379,-0.0435,-0.0189,0.071,0.0106,0.0062,-0.0672,0.0805,0.0753,0.034,0.1315,-0.076,-0.037,0.0844,-0.0253,-0.0599,-0.1278,-0.1339,-0.0239,0.1637,0.0124,0.0761,-0.0182,0.1136,0.1193,0.154,-0.0074,-0.0717,-0.2042,-0.0078,-0.0363,0.3061,0.229,0.0851,-0.0416,-0.0255,0.0514,0.224,0.0856,0.1076,0.0817,-0.2801,-0.0297,-0.0639,0.0533,-0.1503,0.0523,0.1569,0.104,0.0332,0.1105,0.0522,-0.0639,0.0834,0.0247,-0.1209,0.1718,0.0529,0.0491,-0.0895,0.0902,0.0009,-0.0363,0.0046,0.0439,0.0789,0.1909,0.1373,0.1232,-0.0409,0.0785,0.0082,-0.0296,-0.0379,-0.2633,-0.2668,0.1059,0.1169,0.1527,-0.0252,0.0144,-0.151,-0.1674,-0.1583,-0.1813,0.0447,-0.0527,0.0547,-0.1,0.0679,-0.0365,-0.2439,-0.0683,-0.1578,-0.1741,0.1449,-0.1856,0.0236,-0.3125,-0.1278,-0.0079,0.024,-0.0539,0.0398,-0.01,0.0299,-0.1717,0.1882,-0.1084,0.1397,0.0418,0.0522,0.0018,-0.0017,0.2905,0.2239,0.2237,-0.2018,-0.0779,0.0187,-0.0851,-0.2507,-0.1069,0.1098,-0.2009,-0.1022,0.012,-0.1987,0.0684,-0.0896,-0.0231,-0.0741,-0.1465,-0.0852,-0.0973,-0.2488,-0.0638,-0.025,-0.1091,-0.2604,-0.0065,0.1482,-0.0588,0.0445,0.0354,0.0364,0.2737,0.2823,-0.1828,-0.107,-0.0947,-0.0625,0.1176,0.0746,0.0597,0.0105,-0.0242,0.1572,0.1386,0.1925,0.0745,0.1244,-0.2506,-0.28,-0.1752,-0.1695,-0.0791,-0.0893,-0.219,-0.0731,-0.0153,0.1412,0.0981,0.019,0.0749,-0.118,0.391,0.3176,0.3471,0.1031,0.0985,0.2345,-0.1574,-0.0606,-0.1071,0.0618,0.139,0.2458,0.0708,0.0149,0.2366,0.169,0.2785,0.0927,0.0103,-0.2061,0.0398,0.0784,0.0417,0.0253,0.0455,0.1518,0.0156,0.0413,0.0168,-0.0727,-0.0527,-0.1892,-0.1196,-0.1192,-0.0385,0.2362,0.0024,0.1427,0.1498,0.1385,-0.0899,-0.0952,0.1385,0.1381,0.1931,0.2455,0.1055,0.1221,0.0805,0.0707,-0.0696,-0.0284,0.269,0.105,0.1581,0.0917,0.0424,0.0453,0.0647,0.0612,-0.0082,0.0662,-0.021,-0.0771,0.0385,0.2421,0.1342,-0.096,0.0366,0.083,0.254,0.0575,0.0356,0.0546,0.1467,0.0403,0.1302,0.2433,0.1152,0.1707,0.0931,0.1472,-0.0393,-0.1435,0.0196,-0.0156,0.1828,0.1209,0.0195,-0.0762,-0.1004,-0.049,0.0364,0.4093,-0.0388,-0.0657,-0.0762,-0.1452,-0.357,-0.2039,-0.2231,-0.1775,-0.1439,-0.1423,-0.0884,0.0053,0.3766,0.2771,0.3169,-0.0991,0.1449,-0.0025,-0.0252,0.0558,0.0883,0.0402,0.1973,0.2795,0.257,0.1424,0.0095,0.1987,-0.0387,-0.0647,0.1017,0.0173,-0.088,0.1683,0.1079,-0.055,-0.0605,0.0389,0.1187,-0.0361,-0.1715,-0.101,-0.1204,0.0287,0.0125,0.1812,-0.0584,0.1123,-0.0203,0.0594,0.2341,0.0052,-0.1524,0.0289,0.0528,0.1657,-0.0568,-0.0668,-0.3047,-0.2701,-0.1062,-0.1623,0.1351,-0.1526,-0.1431,0.0043,0.0441,0.2741,0.281,0.1275,0.1197,0.1205,0.3387,0.1616,0.1718,0.0363,0.0725,0.0799,-0.0218,-0.0315,-0.0345,-0.0488,0.2378,0.1554,-0.0681,-0.2315,-0.1896,-0.0469,-0.1592,-0.0874,0.1509,0.0317,-0.0202,0.0459,0.0264,-0.0354,-0.248,-0.0463,-0.2456,-0.0717,-0.1262,-0.0996,0.0436,-0.0077,0.0162,-0.0427,0.0206,0.0832,-0.0257,-0.2292,0.0998,-0.148,-0.0047,-0.0739,-0.1709,-0.0623,-0.0732,-0.0046,0.0159,0.1233,-0.1399,-0.1358,-0.0638,0.0871,0.0434,0.1019,-0.0708,0.1614,-0.1403,-0.1737,0.0176,0.1123,0.0042,-0.0652,-0.0721,0.094,-0.0139,-0.0899,0.0882,0.3428,0.2836,0.0419,0.0044,0.0306,0.1885,-0.0301,0.2129,0.1016,0.4207,-0.0023,0.4392,0.4372,-0.0039,-0.0127,0.0146,0.0875,0.076,0.2406,0.2562,0.1558,0.0633,-0.0167,-0.1684,0.1255,0.1603,0.1219,-0.2197,-0.1549,-0.2346,-0.0238,-0.0845,-0.0916,-0.0785,0.0718,0.0501,-0.0596,-0.181,-0.1856,0.3619,-0.0976,-0.1802,0.2782,0.3263,0.1641,-0.0524,0.1759,0.2481,0.1497,0.0237,0.1381,-0.0618,0.0412,0.1519,0.1254,-0.0941,0.1725,0.0807,0.0503,0.0287,0.3192,0.0894,-0.1571,-0.0426,-0.0131,-0.1703,-0.0532,-0.1151,0.0252,-0.047,-0.1036,-0.0234,-0.3136,-0.1297,-0.0004,-0.1724,-0.2689,-0.0262,0.0395,0.0262,-0.0054,-0.0456,-0.0596,-0.0666,-0.1093,-0.158,-0.3282,-0.2673,0.0034,0.088,0.0124,0.0213,-0.093,-0.0402,-0.0106,-0.1797,0.0151,0.0383,-0.0735,-0.0166,-0.2363,-0.2716,-0.0806,0.0062,-0.1316,-0.2597,0.0608,-0.064,-0.129,-0.1352,-0.1439,-0.1142,-0.0237,0.095,0.0996,0.1309,0.1659,-0.0118,0.0685,0.1369,0.148,-0.1679,0.1634,-0.1951,-0.2035,-0.118,0.0686,0.0822,-0.0625,0.1515,0.1516,0.0103,-0.1431,0.3367,-0.066,0.0052,0.2301,-0.1736,-0.1418,-0.2256,0.049,-0.0,0.1323,0.175,-0.3159,-0.3201,0.1598,0.1933,-0.016,0.1689,0.0418,-0.0349,-0.1865,-0.182,-0.0809,-0.1507,-0.2788,-0.0943,-0.0747,0.1601,0.0795,0.0956,0.0829,0.2002,-0.029,-0.0077,0.0349,0.079,0.0714,-0.0134,0.0095,-0.0144,-0.0766,0.0449,-0.0982,-0.0199,-0.065,-0.0329,-0.076,-0.05,-0.0503,0.0274,-0.0739,-0.0663,-0.1551,0.0184,0.0838,-0.0111,0.1009,0.0794,-0.0034,0.0054,-0.0487,-0.0623,-0.0288,-0.1315,-0.1371,-0.0867,0.2387,0.0654,0.178,0.0017,0.0797,-0.0421,-0.1503,-0.0282,-0.0295,0.1328,0.1364,-0.1442,-0.1699,0.1022,-0.1744,-0.0368,-0.0479,0.2037,0.1853,-0.3238,0.0253,-0.1411,-0.0536,0.0362,-0.2618,-0.2312,-0.0572,0.1035,-0.0012,-0.0022,-0.0709,-0.1967,0.0238,0.0939,-0.0044,-0.0095,0.0437,-0.0628,0.0049,-0.2497,-0.0583,-0.01,-0.1248,-0.0194,-0.1965,0.4024,-0.2406,0.0659,0.0297,0.0069,-0.3589,-0.3109,0.0327,-0.0073,0.0115,0.0437,0.0616,0.0273,0.006,-0.0424,-0.0018,0.1286,0.099,0.0718,-0.0026,-0.0898,0.0068,-0.0774,0.0671,0.2275,0.366,0.1841,0.1856,0.2028,0.1018,0.1261,0.1864,0.1941,0.1907,0.1441,0.1209,0.1286,0.1607,0.1382,0.1157,0.3829,0.1513,0.2442,0.2956,0.1584,-0.1525,-0.0689,-0.2621,0.0582,-0.0708,-0.2902,-0.2405,-0.1535,0.3316,0.1434,-0.3546,-0.327,-0.11,0.0468,-0.0109,-0.2742,0.1361,-0.0387,-0.0849,0.0455,-0.0464,-0.0459,-0.0423,-0.1232,-0.1786,0.081,-0.3434,-0.3466,0.1139,0.0196,-0.0325,0.0131,0.0241,-0.1136,0.0678,0.1188,-0.1687,0.0329,0.0931,-0.0391,0.0248,-0.0105,-0.0494,0.1344,0.1402,-0.0925,-0.1636,0.0324,-0.1433,-0.0352,-0.1287,-0.0686,0.1536,-0.1526,-0.1472,-0.0067,0.0073,-0.0395,0.0474,left finger response execution
trm_559f0986182cc,0.0806,0.1057,0.0432,0.1106,-0.0137,0.0274,0.0543,0.0115,0.0172,0.0747,0.0088,-0.0039,0.0734,0.0664,0.1391,0.0942,0.0941,0.114,0.0328,0.0943,0.0858,0.0111,0.0512,0.0074,0.0253,0.0077,0.0081,0.091,0.1297,0.0654,0.1015,0.0916,0.0727,0.0598,0.1035,0.1063,0.0009,0.0296,0.1327,0.0329,0.0914,0.1146,0.0263,-0.0456,0.0831,0.0978,-0.0788,0.0506,-0.0554,0.0585,0.0444,-0.0961,-0.0614,-0.0257,0.0479,0.0339,0.0591,0.0428,0.0088,0.0518,-0.0173,-0.0285,0.1647,-0.0722,-0.0233,-0.1108,0.1884,0.2141,0.1149,0.0054,-0.0319,-0.052,-0.1364,0.1056,0.1721,-0.0392,0.0724,-0.0219,-0.0174,-0.0104,-0.0507,-0.0518,0.0425,0.1323,-0.0255,-0.0632,-0.0087,-0.0239,-0.0211,0.0606,0.0599,-0.0467,-0.024,-0.1654,-0.1451,-0.1438,-0.1167,-0.0188,-0.217,-0.1145,-0.0114,-0.0247,-0.1254,-0.0911,-0.0648,0.1245,0.1878,-0.1325,0.0333,0.0501,0.0068,0.1106,-0.0663,-0.132,-0.0347,-0.0044,0.0915,-0.0774,0.0209,0.0558,0.119,0.1636,0.1301,-0.0325,0.0658,0.1244,0.1249,-0.0402,-0.0929,-0.0681,0.0647,0.0657,-0.0257,0.1687,0.0212,0.1723,-0.0287,0.1076,0.0633,0.0129,0.0643,0.0752,-0.0512,0.0314,0.0857,-0.0253,0.0272,0.0203,0.0726,-0.0579,0.0495,0.0864,0.0914,0.1404,-0.0621,-0.0415,-0.0693,-0.0126,-0.012,-0.0112,0.0632,0.1103,0.2023,0.2188,-0.0026,0.0042,0.0213,0.1908,0.1875,0.007,-0.0019,0.1228,-0.0657,0.1571,0.1267,0.1579,0.0976,0.1015,0.0531,0.017,0.1319,-0.0988,0.0799,-0.0116,0.0139,0.0508,0.0415,0.058,0.0281,0.1236,0.1193,0.0631,0.0149,0.1384,0.123,0.2366,0.2382,0.0506,0.0335,0.0594,0.0067,-0.195,0.1481,0.1717,0.0113,-0.0022,0.0769,0.0352,0.0888,0.0244,0.1475,0.0783,-0.0406,-0.0631,-0.0397,-0.0243,-0.0886,0.0986,0.0405,0.0121,-0.0726,0.121,0.1193,0.0357,-0.0842,-0.0098,0.0847,-0.1148,0.0226,-0.112,-0.0341,0.1092,-0.1244,0.1268,0.1177,-0.1343,0.0505,-0.0264,-0.0332,0.0482,0.0223,0.1507,0.0429,-0.047,0.0726,0.0784,0.0887,0.0881,0.0289,0.1153,-0.0144,-0.0521,0.0144,-0.0684,-0.0449,0.1428,-0.0033,0.0742,-0.0932,-0.1705,-0.0383,-0.1358,0.1122,-0.0316,-0.103,-0.1915,-0.0611,0.0532,0.0116,0.0424,0.0895,0.0198,0.1097,0.0254,0.0137,-0.0879,-0.0255,0.0508,0.0412,-0.0735,-0.093,0.0772,0.0598,0.2028,0.1754,0.0729,-0.024,-0.0708,0.1026,0.0872,0.0619,0.0809,0.0021,0.0889,0.0726,-0.0004,-0.0077,-0.0805,0.0529,-0.1196,-0.0914,0.1689,0.0827,0.0671,0.0082,-0.0033,0.1023,-0.0094,-0.0176,-0.0122,-0.0217,-0.0295,0.1528,-0.0244,-0.0392,0.0578,-0.1082,-0.0256,-0.0297,0.1427,0.0134,-0.0472,0.0775,0.1227,0.093,0.0883,0.0184,0.0742,0.0519,0.0776,-0.0282,0.0513,0.0237,-0.0058,-0.0235,-0.1037,-0.1118,0.0018,-0.0014,0.1285,0.1114,-0.0403,-0.0676,-0.0543,-0.0515,-0.0698,0.157,0.111,0.0971,0.0806,0.0743,-0.083,0.0164,-0.0444,0.0462,0.0435,0.0332,0.0948,0.1029,0.0648,0.0082,0.0256,-0.0626,-0.0202,-0.0308,-0.0732,0.0939,-0.1315,-0.0078,0.088,0.0388,-0.0379,-0.0013,-0.1164,0.1435,0.0056,0.0764,-0.0824,-0.1361,-0.1281,-0.1765,-0.0441,0.1129,0.0162,-0.0502,-0.0664,0.0911,-0.019,-0.0214,-0.0053,-0.0189,0.0583,0.0139,0.0767,-0.1727,-0.158,-0.0295,0.1191,0.0454,0.0649,0.0412,-0.0496,0.0035,0.0237,-0.0331,-0.0494,-0.0291,0.0514,0.0805,0.0148,0.0424,0.146,0.0827,-0.1356,0.0929,0.0373,-0.1749,0.0426,0.1377,0.0504,0.0012,0.1524,0.0872,0.3617,0.3312,0.1233,0.1862,0.0599,0.1486,0.0905,0.0543,-0.0866,0.0051,-0.0215,0.0114,-0.0444,-0.0181,-0.0213,0.2007,0.1047,-0.0303,-0.0535,0.0176,-0.0341,0.0333,0.0572,-0.0692,-0.1127,0.1304,0.1161,0.0423,-0.0261,0.1185,0.0632,-0.0347,0.1682,-0.0586,0.0777,0.0614,0.0092,-0.0156,0.1113,0.062,0.0091,0.1183,0.1363,-0.0055,-0.2397,0.0775,-0.001,-0.0372,-0.0478,-0.0724,0.0224,0.0252,0.0528,-0.0472,-0.0366,-0.0233,0.0479,-0.1152,-0.0366,-0.0255,-0.0574,-0.0582,-0.1288,-0.0212,-0.007,0.0968,0.0258,-0.0681,-0.1687,0.1663,0.1903,-0.0301,0.0109,0.042,0.0158,0.0035,0.122,0.1104,0.0203,0.0787,0.1198,0.0825,0.095,-0.0211,0.0133,0.0304,-0.1245,0.1592,-0.0547,0.0309,-0.0187,-0.0612,-0.0276,0.098,0.0694,-0.1242,0.0851,0.0575,0.0421,-0.0605,-0.0265,-0.1337,-0.0306,-0.1222,-0.1339,-0.1008,-0.04,0.0521,-0.0055,0.0324,0.2356,0.0541,0.0193,0.1751,0.1371,0.0562,0.1126,0.0685,0.0165,-0.039,0.0282,0.0614,-0.0148,-0.004,-0.0387,-0.036,0.0301,-0.0932,0.0494,0.0598,-0.0347,0.0176,0.1295,-0.1284,-0.0428,-0.0701,0.0566,0.1183,0.0248,0.1175,-0.0569,0.0598,-0.0721,-0.0789,0.0213,-0.001,0.0341,0.0794,0.0365,0.0512,-0.008,-0.1345,-0.1153,-0.0715,-0.0268,-0.0664,-0.0434,-0.0085,0.1187,0.028,0.0485,-0.0921,0.0297,-0.0093,-0.0234,-0.0786,0.0433,0.0791,0.0256,-0.0388,-0.0688,0.0353,-0.0004,0.2072,0.0737,-0.1404,0.0423,-0.011,-0.1125,-0.0339,-0.0616,-0.0426,-0.1114,0.0452,0.0925,0.088,-0.0039,0.0814,0.0239,-0.022,0.0574,0.2313,0.0876,0.0807,0.0089,0.0401,0.2231,0.0661,0.2039,-0.0848,0.0066,0.0092,-0.0917,0.1445,0.1112,0.0494,-0.0188,-0.0517,-0.1292,0.0876,0.0255,0.0522,-0.0504,-0.0475,0.0415,0.0384,0.0445,0.0611,-0.0765,0.0084,-0.0662,0.1001,0.0333,0.1882,0.1281,-0.1193,0.2234,-0.0166,0.1457,-0.1091,0.1586,0.0208,0.0463,-0.0992,0.0548,0.0375,0.0964,0.1911,-0.111,-0.1616,-0.0852,-0.0563,-0.0631,0.0212,0.1098,-0.0117,-0.026,0.0167,0.0398,0.0678,0.0715,0.0529,0.0725,-0.2277,0.1286,-0.0132,0.021,-0.0243,-0.0419,-0.0154,-0.0267,-0.1356,0.1415,0.0728,0.0134,-0.0037,-0.0139,-0.0982,-0.0975,-0.0994,-0.0364,-0.0683,0.0516,-0.0392,0.0536,0.0549,0.038,-0.0527,-0.0187,0.0096,0.0763,0.0437,-0.0017,0.1478,0.181,0.1486,-0.0417,-0.0543,0.0005,0.0878,-0.0949,0.0183,0.0435,0.0111,-0.065,0.1153,-0.0178,-0.1487,0.0348,0.3276,0.3289,0.2037,0.0179,0.0433,0.1095,0.0235,0.0582,-0.058,0.0258,0.0456,-0.078,-0.0521,0.0178,0.0912,-0.0762,-0.061,-0.1691,0.1349,0.0219,0.0819,-0.003,0.018,0.0995,-0.0413,-0.0561,0.0686,-0.0421,-0.0095,-0.0925,0.1496,0.2279,0.1845,0.123,-0.0315,-0.1081,0.0197,0.0618,0.0033,-0.0757,-0.0441,-0.0523,-0.047,-0.0147,0.093,0.0682,0.0271,-0.0777,-0.061,-0.1172,0.0103,0.0261,-0.049,0.0587,-0.0215,0.0604,0.1328,0.009,0.1321,0.1179,0.0897,-0.0539,-0.0489,-0.0127,-0.015,0.0095,-0.0021,-0.0656,0.0235,0.0945,-0.0363,0.0159,-0.0365,-0.0064,-0.0619,0.0894,-0.0747,0.1395,0.1344,-0.0714,-0.059,-0.1183,0.0626,-0.002,-0.0621,0.0016,0.0641,-0.177,-0.0474,-0.0827,-0.1186,-0.1463,-0.0296,-0.0011,-0.148,-0.1497,0.076,-0.0491,-0.047,0.2019,0.1824,0.0203,0.0744,-0.0095,0.2239,0.0837,0.1201,0.1294,0.2161,0.0028,0.0599,-0.0685,0.0694,0.0,0.0512,-0.0894,-0.0919,0.0097,-0.0444,-0.0511,-0.0381,-0.0116,-0.0233,0.0362,-0.0506,-0.0897,0.0837,-0.1118,-0.0477,-0.0173,0.0438,0.0827,0.0687,-0.0826,0.0592,0.3294,0.1358,0.0388,-0.1007,-0.1102,-0.0065,-0.0207,-0.0708,-0.0973,0.0806,0.1017,-0.0502,0.0898,0.0206,0.1436,-0.1546,0.0918,-0.0588,-0.017,0.0175,-0.0166,0.1687,0.1583,0.0893,-0.1504,0.0602,0.0657,0.1117,-0.0364,0.0307,0.1452,0.0961,0.0997,-0.064,0.0431,-0.0448,-0.0934,0.0291,-0.0713,0.181,0.0783,0.0281,-0.1198,0.0897,-0.0473,-0.0706,-0.0484,-0.0676,-0.2378,-0.0942,0.0742,0.0255,0.1087,0.0823,0.0193,0.0413,-0.0394,-0.1301,-0.0678,-0.0286,0.0698,-0.0644,-0.1769,-0.094,-0.0286,0.0197,0.0868,0.0499,0.0149,0.0009,-0.0453,0.016,0.1169,-0.0149,-0.1282,0.0002,0.0729,0.0184,-0.068,0.0562,0.0255,0.0555,0.105,0.1091,0.1881,0.1256,0.196,0.0021,-0.0028,0.0884,0.1236,0.0716,0.1147,0.0765,0.1359,0.0762,0.089,-0.0436,0.0058,-0.0846,0.0249,-0.0088,-0.042,-0.0461,-0.0819,-0.04,-0.0945,-0.0501,0.0258,-0.0024,-0.0205,-0.004,-0.0542,-0.0457,-0.081,0.0298,-0.1182,0.0301,-0.0569,0.0204,0.0575,0.0478,-0.0218,0.0245,-0.025,0.1296,0.0827,0.0659,0.1559,0.1094,-0.089,-0.0985,-0.0838,-0.0905,-0.0864,-0.0633,0.0388,-0.0014,0.0228,0.0011,-0.0418,-0.0063,0.0124,0.0391,0.0999,0.0411,-0.0781,-0.0588,0.1138,0.0533,0.089,0.1648,0.1097,-0.084,-0.0566,-0.0951,-0.088,-0.0143,0.1205,0.0367,-0.0185,0.0432,-0.003,0.01,-0.011,0.0142,-0.0375,-0.0132,-0.0098,0.1021,0.0186,0.1187,-0.036,0.0723,-0.0654,-0.1314,-0.2297,-0.0149,-0.0281,0.0314,0.0135,0.0202,0.054,0.0775,0.1077,0.0037,-0.0486,-0.0568,0.0014,0.0431,-0.0292,0.0113,0.0737,-0.0144,0.1265,0.1223,0.1583,0.0924,-0.1811,-0.0282,-0.112,0.0994,-0.1783,-0.1153,-0.0346,0.024,0.0271,-0.026,0.0288,-0.0951,0.1099,0.0963,0.0252,0.0302,0.145,0.0812,0.0264,0.0103,-0.0065,0.0109,0.0625,0.0298,-0.0377,-0.0496,0.0176,-0.0259,-0.0317,0.0876,-0.0317,0.0627,-0.0035,0.0143,0.0873,-0.285,-0.1935,-0.2379,-0.161,-0.1576,-0.0586,-0.2161,-0.1235,0.1171,-0.1707,-0.1617,-0.0918,-0.0926,-0.1254,0.0149,-0.0101,-0.0028,0.0063,-0.0082,-0.014,-0.0539,-0.0283,0.1204,-0.0619,-0.0665,-0.0173,-0.06,0.0697,0.0648,-0.0556,0.0143,0.0868,0.006,0.051,-0.0873,-0.0353,-0.1216,0.0565,0.1836,0.1018,0.0574,0.0069,-0.0615,-0.0884,-0.0139,0.0736,0.1535,0.1078,0.064,-0.1642,0.052,-0.2068,-0.1573,0.0531,-0.0027,-0.004,-0.1961,-0.2159,-0.1688,-0.1036,-0.1162,-0.0032,-0.051,-0.0519,0.062,0.1883,-0.0669,0.0402,-0.128,0.0194,0.0707,0.0192,0.1242,0.0504,0.0062,0.0551,0.0684,-0.0817,-0.1221,0.0197,-0.012,0.0258,-0.0996,-0.0739,-0.0523,0.1408,0.1362,0.0832,0.0701,-0.0002,0.0762,0.0749,0.0119,0.0271,-0.0936,-0.032,-0.0709,-0.1888,-0.0044,-0.0297,0.059,-0.0635,-0.0619,-0.0825,0.0541,-0.087,-0.1904,-0.0154,0.076,-0.1262,-0.0941,0.0664,0.0883,-0.0021,0.1518,0.0536,0.2464,0.0525,-0.1189,0.0837,0.081,-0.0569,0.0644,-0.0158,0.0303,0.0343,0.0456,0.1085,0.0061,-0.0808,0.0179,-0.239,-0.1611,-0.1814,-0.2075,0.141,0.037,0.0838,0.1171,0.1144,0.0244,-0.0001,-0.1229,0.0956,0.088,-0.0509,-0.0332,0.0573,-0.0789,-0.0427,-0.0288,0.0082,-0.1652,0.0866,0.0874,0.0148,-0.0852,-0.019,0.0472,-0.0037,-0.0037,0.1403,0.0387,0.0682,0.0024,-0.0274,-0.0425,0.0806,-0.2137,0.2133,0.2015,-0.0334,0.0195,0.1715,0.1803,0.1402,0.0227,0.0214,0.051,0.0222,0.0037,-0.1269,-0.0294,-0.0963,0.0832,-0.074,-0.0342,-0.076,-0.0477,0.0332,0.0763,0.0192,0.0667,0.0818,0.0875,-0.0648,-0.0743,-0.019,-0.1653,-0.1005,-0.2047,-0.0102,-0.1533,0.073,0.0442,-0.0263,0.1367,-0.0209,0.151,0.1952,0.0132,0.0784,0.198,-0.0391,-0.0115,0.1782,-0.0116,0.0197,-0.0247,0.1108,0.0235,0.0814,0.0915,0.0623,-0.0214,0.0418,-0.1564,-0.155,-0.1624,-0.1456,-0.0173,-0.0365,0.0131,0.036,0.033,0.0066,0.1017,0.012,0.1252,0.0088,0.0112,-0.0306,0.0067,0.1026,0.1059,0.0018,-0.0629,-0.0057,0.0037,0.0179,-0.0333,0.0112,0.1256,0.0966,0.1699,0.0917,0.0326,0.1194,0.1275,0.0044,-0.0014,-0.0108,0.0105,-0.008,0.1076,0.1047,-0.063,0.1323,-0.0139,-0.0368,-0.0327,0.0179,0.1869,-0.007,-0.1501,0.0607,0.0279,-0.0086,0.0592,-0.1179,-0.0703,-0.0536,-0.0288,0.1708,-0.0596,0.002,-0.0931,-0.1817,-0.0742,-0.0268,0.0242,-0.0031,-0.1105,0.0852,-0.0065,0.0902,0.0479,0.1433,0.1093,0.0497,-0.045,0.0196,0.0992,0.1402,-0.0247,0.0186,0.02,0.0056,0.0815,0.0196,0.032,0.0601,-0.0589,0.0344,0.036,0.0658,0.1138,0.0946,0.0681,0.0639,0.0345,-0.0467,-0.0107,-0.0936,0.0482,0.0476,0.0322,-0.0343,-0.0337,0.1122,0.2277,-0.0564,0.006,-0.0995,0.0329,-0.0335,-0.0027,-0.02,-0.0242,0.0485,0.0107,0.0732,0.0308,0.1874,-0.0236,0.0816,-0.0238,0.007,0.0359,0.0485,0.085,0.1059,-0.1429,-0.0801,-0.0017,-0.1937,-0.0743,-0.0538,-0.056,-0.1311,0.0011,0.0299,-0.029,-0.1575,0.0601,0.0047,0.0411,0.0552,0.0685,0.0577,-0.0273,-0.0325,-0.0492,-0.1177,-0.1312,0.0875,0.0612,0.0449,-0.0743,-0.0779,-0.0728,0.1534,0.0971,0.0059,0.1142,0.0685,-0.043,-0.044,-0.0595,-0.0046,-0.1105,-0.0007,0.1385,0.0514,0.0157,0.061,0.1428,0.0873,0.0199,0.0945,0.0782,-0.099,0.0369,0.0226,0.0095,-0.0398,-0.0737,-0.1324,0.0215,-0.0333,-0.0107,0.0354,0.0878,0.0466,-0.0531,-0.0288,-0.0343,-0.146,-0.1097,-0.0661,0.0457,0.0698,0.0261,-0.2541,-0.2519,0.1763,0.1855,-0.0967,0.0493,0.0391,0.0264,0.1374,-0.0444,0.054,0.0554,0.0196,0.0227,-0.2235,0.083,-0.131,-0.0337,-0.0079,-0.0415,-0.2217,-0.077,0.0464,-0.156,-0.03,-0.064,-0.0629,-0.0206,0.0643,-0.0627,-0.0122,-0.0082,0.0212,-0.0075,0.0156,-0.0473,-0.0481,0.0826,0.0425,0.0471,-0.128,0.1323,-0.002,-0.0749,0.0683,0.065,0.0117,-0.0446,0.1035,0.0584,-0.0443,0.0389,-0.1084,0.0497,-0.0593,-0.1118,0.1002,0.098,0.0024,0.0033,0.0088,-0.1063,-0.1472,-0.1185,-0.0044,-0.0582,-0.0025,0.0051,-0.2324,0.1009,0.185,0.0219,0.1065,-0.0873,-0.0817,-0.1526,0.0668,-0.0543,-0.0231,0.0086,-0.0256,-0.0448,0.0717,-0.0193,-0.0326,-0.0642,-0.0732,-0.1339,-0.2211,-0.2048,0.0097,0.0734,0.1192,0.0355,-0.1024,-0.0465,0.0312,-0.0496,-0.0426,-0.0008,-0.128,-0.0402,0.2199,0.1243,0.0594,-0.0419,-0.005,-0.0554,-0.0222,-0.174,-0.1635,-0.0777,0.0378,0.0793,-0.0431,-0.0131,-0.0758,0.0286,0.0762,0.0533,-0.0592,0.0202,0.0059,-0.1425,0.0848,0.0725,-0.0304,-0.15,-0.017,-0.1631,-0.0205,0.0112,-0.0733,-0.0456,-0.1224,-0.1023,-0.1325,0.0095,-0.0344,-0.0155,-0.0385,0.0494,-0.0936,0.1794,0.0907,0.0656,0.1225,0.0327,-0.0622,0.0193,-0.0973,0.0452,-0.042,-0.0378,-0.0574,0.0341,0.0466,0.0411,0.002,-0.022,-0.0692,-0.1105,-0.0882,-0.1265,0.1798,0.1473,0.1336,0.0418,0.0018,0.1122,0.0891,0.0531,0.0963,0.0328,-0.0775,-0.0116,-0.0957,-0.0542,0.0307,-0.066,0.028,-0.0014,-0.0254,-0.014,0.1682,0.0101,0.1078,0.0545,0.0661,-0.0045,-0.0801,-0.1703,-0.0619,-0.0409,-0.0693,0.0646,0.2332,0.1253,0.1694,0.1177,-0.0004,0.0202,-0.0332,0.1202,0.1417,0.098,0.055,-0.0195,-0.0006,0.0,0.0601,-0.0214,0.0038,0.1367,0.0746,0.1205,-0.0266,-0.0114,0.0166,0.2719,0.0978,0.1079,0.1213,0.3166,0.0058,0.049,0.0206,0.1114,0.033,0.0274,0.0301,0.1093,0.0388,0.1444,-0.0142,-0.0179,-0.0826,-0.0006,-0.0715,0.1383,-0.0188,-0.0522,-0.1335,0.0499,0.0199,0.0477,-0.1443,0.1532,0.1589,0.1329,0.0662,0.0929,0.145,0.0968,0.0631,0.0555,0.0563,0.0362,0.0251,0.1942,-0.0136,0.0368,0.073,0.0637,0.0485,0.0406,0.1444,0.0055,0.0135,-0.0845,0.0186,0.0353,0.2532,0.1087,0.1639,0.0534,0.1826,0.1281,0.0046,-0.0948,-0.0571,0.002,0.059,0.0638,-0.144,-0.1658,-0.1552,0.3207,0.3308,0.0151,-0.0659,0.0057,0.0352,-0.0058,0.1055,0.0359,0.0194,0.0609,0.0763,0.0168,0.0861,0.1052,0.0263,0.153,-0.0542,0.0418,0.0117,-0.0822,-0.0966,0.0305,0.1072,0.1482,0.0933,0.0531,0.1802,0.0957,-0.1703,0.0663,0.1137,-0.1801,-0.1036,-0.1027,-0.1519,-0.0649,-0.1141,-0.1321,-0.0861,-0.0685,-0.0943,-0.0758,-0.0981,-0.1336,-0.2098,-0.1669,0.1849,-0.0528,-0.0609,-0.1579,0.0002,0.0601,-0.0635,0.0159,0.0227,-0.0508,-0.0865,-0.0009,-0.0287,0.0342,0.0044,0.0218,-0.0865,0.0541,-0.0762,-0.1703,-0.1794,0.0126,-0.0196,-0.0776,-0.0691,-0.0668,-0.0399,-0.0086,0.018,-0.016,0.2807,0.1136,0.1581,0.138,0.0693,0.1205,0.1609,0.0888,0.019,0.0766,0.1037,0.0564,0.0476,0.1599,0.3335,-0.0536,0.1407,0.0283,-0.0297,0.0645,-0.0312,0.1353,0.1025,0.0089,0.0447,0.0601,-0.0353,0.0442,-0.0534,-0.12,-0.0709,-0.014,0.1008,-0.0232,0.0195,0.1136,-0.0141,0.0514,0.0744,-0.0838,0.0164,0.0133,0.0764,0.1034,0.061,0.0053,-0.0231,0.0337,0.089,0.0778,-0.0076,0.0275,-0.0653,0.1379,0.0473,-0.0425,-0.0501,-0.0357,-0.0038,-0.0132,0.1324,-0.0058,0.1048,0.1313,-0.0987,-0.1908,-0.1687,0.0424,-0.2649,-0.1424,0.1467,0.073,-0.2364,-0.167,-0.0613,-0.08,-0.0623,-0.1051,0.1246,0.1195,0.0396,0.0452,-0.2958,-0.2659,-0.1734,-0.0638,-0.0826,-0.1441,-0.3034,-0.2881,-0.269,0.0078,0.008,0.0039,0.0081,-0.0087,0.0099,0.1563,0.0355,0.0067,0.0763,0.1035,0.1034,-0.0728,0.0005,-0.0061,0.0078,-0.0369,-0.1151,-0.1489,-0.0356,0.0056,-0.0123,0.0052,0.053,0.0476,0.0417,0.0306,0.046,-0.0416,0.1273,0.1933,0.1696,-0.0735,0.0177,0.0107,-0.0942,-0.035,-0.1242,-0.0913,-0.0816,-0.2285,0.0354,0.1802,0.1997,-0.0886,-0.057,0.0875,-0.1078,-0.0372,-0.1158,-0.1406,0.1012,0.0962,0.083,0.0773,-0.1615,0.1532,0.0879,-0.0155,0.0205,-0.0634,-0.0037,0.0002,-0.0733,0.0145,0.0781,0.0169,0.1098,0.1453,0.142,-0.0134,-0.0098,-0.004,-0.0313,0.0156,-0.0358,-0.1758,-0.1603,-0.0274,-0.1565,0.0648,0.0059,-0.0865,-0.1133,-0.1959,-0.1272,-0.0017,-0.0038,0.0047,-0.1181,-0.0903,0.0107,0.015,-0.0007,0.0056,0.066,-0.0315,0.0436,-0.0124,-0.0424,-0.013,-0.0483,-0.0067,-0.1138,-0.0303,-0.0887,-0.0505,0.1406,0.1158,0.0541,0.0804,0.1656,-0.0812,0.0252,0.0271,0.0238,-0.1496,-0.0462,0.2687,0.0293,-0.0574,0.1056,-0.0685,-0.025,-0.0749,-0.0917,-0.1807,-0.2727,-0.1991,-0.1039,0.057,-0.0294,-0.1215,0.1054,0.0898,0.0316,-0.0054,0.0574,-0.0287,0.026,0.0629,0.1124,0.191,0.2017,0.1465,0.077,0.0432,0.077,0.0629,0.0818,-0.0268,-0.0092,0.0793,0.0482,-0.0134,-0.2167,0.0205,-0.0391,0.0821,-0.0752,0.0156,-0.0013,-0.0501,0.1187,0.0756,-0.1301,-0.0008,0.0039,0.0023,-0.0139,-0.0543,-0.0127,0.0534,0.0201,0.0556,-0.0023,-0.0213,0.1073,-0.0227,-0.0098,-0.0541,-0.0351,0.1337,0.1092,0.025,0.0731,0.0361,0.0261,0.0997,0.0349,-0.0848,0.0164,-0.0327,0.2868,0.1067,0.1024,0.2365,0.1794,0.129,0.0988,0.0988,0.0663,0.0292,-0.0511,0.1722,0.0279,0.0227,0.0375,0.1007,0.0423,0.3875,-0.0875,0.1055,0.0259,-0.0372,-0.135,-0.0693,-0.0023,0.1423,0.1032,-0.0394,-0.0305,0.0529,-0.1124,-0.089,-0.104,-0.2162,-0.1425,0.015,-0.0535,-0.081,-0.0329,-0.0216,0.2017,0.1836,0.0447,0.1018,0.021,0.017,0.0026,-0.0802,-0.0109,0.0646,-0.0615,-0.0098,0.0905,-0.0807,0.0397,0.1923,0.0848,0.2219,0.0443,0.0825,-0.0565,0.0815,-0.223,-0.2136,-0.059,-0.1461,-0.0949,0.0313,-0.1233,0.0157,-0.1936,-0.0911,0.0182,-0.115,0.0642,-0.0746,-0.0556,-0.031,0.0131,0.0492,-0.0272,0.021,0.0011,-0.0744,0.0432,-0.0818,-0.011,-0.1168,0.0033,0.0043,-0.1958,0.0074,-0.0386,-0.0367,0.015,-0.008,-0.0374,0.0832,0.1192,0.0471,-0.0992,-0.0689,0.0144,-0.0158,0.0801,-0.0182,-0.0466,-0.0759,-0.0188,-0.0283,-0.0166,0.0228,-0.1181,0.0719,-0.0021,-0.1325,0.0248,0.0546,0.077,0.0741,0.047,0.0161,-0.0541,0.0856,-0.067,-0.0198,-0.0861,-0.0088,-0.033,-0.0738,-0.0111,0.06,0.0487,0.1255,0.084,-0.0566,-0.0183,0.0166,0.0494,0.0143,-0.1128,0.002,0.141,0.115,0.1238,0.1165,0.0263,0.0134,-0.0438,0.1321,0.1211,0.1529,0.0392,0.0875,-0.0161,-0.0569,0.015,-0.0769,0.094,0.0809,0.0156,-0.0346,0.0675,0.0266,-0.0581,-0.0622,0.1049,-0.0149,0.0043,0.0793,-0.036,-0.0576,-0.0285,-0.0255,0.0381,0.1692,0.0555,0.1439,0.1747,-0.0357,0.0911,-0.0438,-0.07,-0.0614,-0.0678,-0.0866,0.092,0.1503,-0.0339,-0.1439,-0.2482,-0.0158,0.0234,0.0381,-0.0091,0.0717,0.025,0.1153,0.0992,0.0504,-0.018,0.074,0.131,-0.0388,0.0693,0.0198,-0.0828,0.0375,-0.0443,0.1432,-0.0058,0.0468,-0.0153,0.0076,-0.0364,-0.0697,-0.0674,-0.0021,0.0578,0.0294,0.1144,0.028,0.0483,0.2427,0.0255,-0.0014,0.0156,0.0284,-0.0104,-0.018,-0.0089,0.053,-0.068,0.1647,0.0686,0.1058,0.1291,-0.0364,0.1489,0.126,0.2332,0.1057,0.0042,-0.2052,0.129,0.0413,0.0284,-0.0192,-0.0528,-0.0212,0.1113,0.1568,0.0793,0.0734,-0.0355,-0.055,0.0263,0.0174,0.034,-0.082,-0.044,-0.0269,-0.0714,0.0096,0.0171,-0.0177,-0.0261,0.0269,0.0184,0.0677,0.0238,-0.0867,-0.0071,-0.0847,0.0086,-0.1269,-0.1044,-0.0903,-0.0142,0.0279,0.1628,0.0769,0.0057,-0.1999,-0.2052,-0.1254,-0.0154,0.0132,-0.0194,-0.1805,-0.1171,-0.1034,-0.0849,0.192,0.0101,0.048,-0.0293,0.0591,-0.0333,-0.0404,-0.0182,-0.0786,-0.0374,-0.061,0.0473,-0.0677,-0.0482,0.1106,-0.1274,-0.0534,-0.0056,-0.0098,-0.0587,-0.0274,0.0213,-0.0287,0.0077,0.0317,-0.1025,-0.1025,-0.1285,0.0391,-0.0548,0.0128,0.0316,0.148,0.3453,0.3359,-0.0791,-0.0694,-0.0995,0.0308,-0.0079,0.0702,0.1234,0.1427,0.1657,-0.0582,0.0142,0.0071,0.0623,-0.0189,0.0072,0.1702,0.0393,0.1347,0.1449,-0.067,0.0918,0.0006,0.2337,0.1154,0.0431,0.0078,0.0025,-0.0588,0.0277,0.0527,0.1224,-0.1437,0.1238,-0.0459,-0.0538,-0.0564,0.0057,-0.0176,-0.0219,-0.1623,-0.1444,0.0884,0.1152,0.0751,0.0162,0.0938,0.0538,0.0989,0.2403,0.0711,0.0074,0.0545,-0.0491,0.0557,0.0063,0.0898,0.1301,0.0042,0.0295,0.1744,0.0849,-0.0159,0.0579,0.1682,-0.0863,-0.1147,0.056,-0.0331,-0.1051,-0.092,0.0119,0.0363,0.1415,0.2197,0.093,0.088,-0.0301,-0.0774,0.0118,-0.0491,0.0028,-0.1087,-0.2241,-0.1119,-0.0646,-0.1614,0.2705,0.2408,0.1126,-0.0256,0.0369,0.0511,0.109,-0.0083,-0.087,0.0821,0.0697,0.073,-0.1051,0.1076,-0.097,-0.0841,-0.0813,-0.0774,-0.0858,-0.0473,0.04,0.0386,0.0248,-0.0176,-0.1047,-0.1222,-0.0401,-0.0324,-0.1317,-0.159,-0.1822,-0.1349,0.0196,0.1009,-0.0376,-0.0242,0.0024,-0.0049,-0.0282,-0.0521,-0.0045,-0.0215,-0.0292,0.0433,0.0297,0.1813,0.1022,0.1009,0.092,-0.2143,0.0246,-0.1537,-0.1417,-0.0954,-0.015,-0.0132,-0.0696,0.0544,-0.1394,-0.1504,-0.1087,-0.1172,-0.05,-0.038,0.0733,0.0244,-0.0118,-0.0716,-0.1299,-0.109,0.0564,-0.0174,-0.0597,0.0312,-0.0126,0.021,0.0693,0.0968,-0.0199,0.0223,-0.0795,0.0957,-0.0708,-0.0292,-0.1394,-0.0298,0.0011,-0.0262,-0.0357,0.0,-0.1118,-0.195,-0.0148,-0.0544,0.0048,-0.1039,0.0547,0.1008,0.003,-0.0357,-0.1189,-0.0538,0.0865,0.0833,0.1121,0.0721,-0.0168,-0.201,0.0448,0.0116,0.139,0.1801,0.1749,0.1307,0.1114,0.0944,0.1228,0.021,0.0822,-0.0396,0.0107,0.0076,0.0427,0.067,-0.0359,0.0368,0.0789,-0.0573,-0.0698,-0.0535,0.0312,-0.1657,-0.192,-0.0748,0.0376,-0.0551,0.0119,0.0388,-0.0598,-0.0111,-0.0173,-0.1674,-0.133,0.0603,-0.0006,-0.0662,-0.0971,0.0725,0.0826,0.0592,0.0505,-0.0109,-0.0148,-0.0372,0.0273,-0.0605,0.136,0.0422,-0.1296,-0.0508,0.1977,0.0279,-0.1024,-0.0874,0.023,0.0881,0.357,0.2951,0.159,0.2409,-0.1018,0.0516,0.1076,-0.0097,-0.0253,-0.0265,-0.0103,-0.0004,-0.1569,-0.1227,-0.1902,-0.0811,-0.1098,0.0497,0.0348,-0.1243,0.0275,-0.0219,-0.0178,-0.0082,-0.1795,-0.1265,0.1117,0.2109,0.1452,0.0779,0.1433,0.0858,-0.0289,-0.018,-0.0298,0.0331,-0.0213,-0.0121,0.1244,0.029,0.1233,-0.0008,0.1356,0.1889,-0.0353,-0.054,0.0297,0.0646,0.0367,0.0382,0.0666,0.1555,-0.0227,0.1451,0.057,0.0582,0.0315,0.0482,0.0802,-0.0256,-0.0356,-0.0249,0.1051,0.0781,0.0987,-0.0131,-0.0634,-0.0914,0.0389,-0.1854,0.0732,0.108,-0.028,-0.0936,0.0189,0.0152,0.0374,-0.0255,0.0202,0.0043,-0.0962,-0.2214,-0.2219,-0.0154,-0.0484,-0.0175,-0.1227,0.0269,-0.1857,0.0297,-0.2047,-0.0111,-0.1677,-0.1678,-0.0709,-0.0002,0.0127,0.0148,-0.0082,-0.0361,-0.0369,-0.0986,-0.034,0.0233,0.0685,-0.0426,-0.128,-0.0857,0.1826,0.1434,0.1784,-0.0366,0.1047,0.0368,0.0335,-0.0233,-0.0393,0.0151,0.1027,0.1201,-0.1006,-0.0284,0.1142,-0.1434,-0.1753,-0.0295,0.0627,-0.1099,-0.2266,-0.1467,-0.0674,-0.0823,0.0776,-0.0074,-0.1567,-0.1147,0.1036,-0.1838,-0.0248,0.0033,-0.0755,-0.2595,-0.0539,0.1218,0.078,0.019,0.0014,-0.0708,0.0848,-0.0324,0.029,-0.0056,0.0126,0.1281,0.0448,-0.0908,0.0803,0.0999,-0.021,0.0039,0.0917,0.0255,0.0624,0.1047,0.0987,0.0457,0.0571,0.1436,0.1014,-0.0875,-0.1756,0.0201,0.031,0.029,-0.0459,0.0089,0.0324,0.0992,0.1051,0.0184,-0.0339,0.1584,0.1746,0.0653,0.0337,0.0959,0.1447,0.0092,0.0554,0.0853,0.1477,0.0889,0.0317,0.0364,0.0441,0.0115,0.0889,-0.065,0.0933,-0.0444,-0.1185,-0.1447,0.1107,-0.0402,0.133,0.1307,0.0639,0.0015,0.0132,-0.0128,-0.0922,-0.1176,0.0224,0.0728,-0.0796,0.0724,0.0245,-0.083,0.0645,0.0555,0.0992,-0.0572,-0.0415,-0.128,-0.067,0.2065,0.1706,-0.0452,-0.0533,0.0009,-0.1224,-0.08,0.0525,0.0822,0.1403,0.052,0.1151,0.2188,0.1022,0.1113,-0.0416,0.036,-0.0426,0.0307,-0.1295,-0.0098,-0.0292,-0.0293,-0.0408,-0.0712,-0.046,-0.0056,-0.0335,0.0597,-0.0131,0.0603,0.0291,0.0578,0.0338,0.0604,0.0125,0.0841,0.0645,0.1101,0.062,0.1086,0.0176,-0.0226,-0.0586,-0.023,-0.1011,0.0022,-0.0672,0.0239,-0.0149,-0.0342,0.0688,0.1164,0.0839,-0.159,-0.0975,-0.0956,0.056,0.0326,0.1162,0.094,-0.0209,0.0411,-0.0738,-0.112,0.1895,0.1427,-0.0133,0.1292,0.011,0.0297,-0.2896,-0.1788,0.1792,-0.0238,0.0516,0.016,0.0587,0.1648,0.1629,0.1045,-0.0708,-0.0104,0.0982,0.0148,0.117,0.0034,-0.1342,-0.007,-0.0505,0.0289,0.0112,-0.0492,0.1128,0.0305,-0.0155,0.1397,-0.0052,0.2114,-0.2201,0.1805,-0.1855,-0.0364,-0.0257,0.2273,0.2108,-0.1132,-0.1763,-0.0398,-0.188,-0.0563,-0.0927,-0.0281,0.0077,-0.1031,-0.063,-0.0483,-0.0474,-0.0475,-0.0485,-0.1161,0.0549,-0.0467,-0.1866,-0.3673,-0.1132,-0.1793,-0.2961,-0.1368,-0.1503,-0.2127,-0.1573,-0.1777,-0.0946,-0.1733,-0.1882,-0.1364,-0.1658,-0.1932,-0.2891,-0.2369,-0.1907,-0.1563,-0.1042,0.1352,0.0881,0.2169,0.0222,-0.0008,0.1818,0.1571,0.0976,-0.0405,-0.027,0.2173,0.1732,0.1223,0.0255,0.0386,0.1467,-0.0647,0.0257,0.078,0.012,0.1032,0.0228,0.0358,0.0607,0.1098,-0.0988,0.1374,0.1587,-0.0769,0.0409,0.0189,0.0045,-0.0054,0.1213,-0.0839,-0.064,0.1043,-0.1555,-0.1956,0.0126,-0.078,-0.1229,0.0892,-0.1885,-0.1911,0.0561,0.0916,-0.1054,0.0596,-0.0009,0.0892,0.0197,-0.1124,0.0483,0.0829,-0.0239,0.0071,0.0536,0.005,visual object maintenance
trm_4a3fd79d0a723,-0.1731,-0.0901,-0.1993,-0.1782,-0.065,-0.012,-0.1509,-0.0718,-0.0236,-0.1207,-0.0639,-0.0471,-0.1519,-0.0975,-0.1128,-0.0369,-0.0727,-0.1697,-0.0696,-0.062,-0.1311,-0.0166,-0.0087,0.0259,-0.0162,0.0125,0.013,-0.1873,-0.1747,-0.1037,-0.1379,-0.1343,-0.0824,-0.0815,-0.1646,-0.165,-0.0379,-0.1021,-0.1376,-0.107,-0.1306,-0.1462,-0.0492,0.0367,-0.0899,-0.1019,0.2457,-0.0959,0.035,-0.1446,-0.0299,0.0371,0.0541,-0.0305,-0.0783,-0.0603,-0.1387,-0.0415,-0.0129,-0.0761,-0.0024,0.0362,-0.1979,0.0257,0.0616,0.0911,-0.2848,-0.3306,-0.1824,0.0058,0.117,0.0308,0.1541,-0.1306,-0.164,-0.0007,-0.1306,0.0437,0.0676,-0.0078,0.0168,0.0278,-0.0276,-0.181,0.0021,0.1125,0.0602,-0.0014,-0.0081,-0.0899,-0.0721,-0.0601,0.0042,0.4755,0.4456,0.449,0.2043,0.1269,0.2405,0.1733,0.1033,-0.0029,0.092,0.1168,0.2085,-0.1824,-0.221,0.1639,-0.0433,-0.0407,-0.0264,-0.1735,0.0778,0.2032,-0.0097,0.0473,-0.133,0.1439,-0.1171,-0.122,-0.156,-0.1854,-0.2065,-0.0658,-0.136,-0.176,-0.1548,0.0601,0.05,0.0318,-0.111,-0.0668,-0.017,-0.2122,-0.0521,-0.2848,-0.0054,-0.1372,-0.0741,-0.0159,-0.1261,-0.1372,0.1047,-0.1111,-0.1024,0.1087,-0.0972,-0.0139,-0.0335,0.048,-0.1149,-0.1276,-0.1255,-0.2096,0.1211,-0.0101,0.1094,0.029,-0.0003,-0.0935,-0.0605,-0.1108,-0.257,-0.2356,-0.0178,-0.0128,-0.0516,-0.2501,-0.242,0.001,-0.0781,-0.1663,0.0247,-0.2479,-0.1817,-0.199,-0.1392,-0.1674,-0.0962,-0.0246,-0.1697,0.0625,-0.1363,-0.0137,-0.1348,-0.1002,-0.0956,-0.0956,-0.0323,-0.0184,-0.0104,-0.1413,-0.0618,-0.3198,-0.289,-0.2463,-0.2946,-0.0765,0.0149,-0.0502,-0.0335,0.4021,-0.1797,-0.1577,-0.0186,0.0165,-0.1259,-0.106,-0.1076,-0.0524,-0.2608,-0.0895,0.0407,-0.0526,0.0813,0.0011,0.0965,-0.1869,-0.0394,-0.0415,0.1448,-0.1022,-0.1883,-0.0895,0.1019,0.0324,-0.0699,0.1589,-0.0349,0.1508,0.1101,-0.1161,0.1979,-0.109,-0.1005,0.0599,-0.0402,0.0098,0.0614,0.0085,0.0657,-0.1871,-0.0107,-0.03,-0.1338,-0.129,-0.0772,-0.2058,-0.0282,-0.2133,-0.0582,0.0562,-0.0426,0.0581,0.0206,-0.2124,0.0212,-0.0301,0.1563,0.2602,0.1437,0.3637,-0.1272,0.1489,0.1931,0.3662,0.1614,-0.0467,0.0179,0.0185,0.0132,-0.054,-0.043,0.0002,0.047,0.0818,-0.0194,-0.0947,-0.0504,0.0211,0.0445,-0.0539,-0.0603,-0.2539,-0.1887,-0.0671,0.0942,0.0677,-0.1106,-0.1156,-0.119,-0.1251,-0.028,-0.0721,-0.0872,0.0955,-0.0485,0.071,-0.0557,0.121,0.0546,-0.268,-0.0669,-0.122,-0.0509,-0.0344,-0.1758,-0.054,0.0785,-0.0441,0.0151,-0.0239,-0.0949,0.0139,0.0351,-0.0555,0.104,-0.0049,0.025,-0.1873,-0.0035,-0.0151,-0.0108,-0.0702,-0.0542,-0.0938,0.0411,0.0068,-0.0623,-0.1031,-0.0134,-0.0988,-0.0195,0.0375,-0.0127,0.1828,0.0146,-0.049,0.0463,-0.1839,-0.1688,-0.0603,-0.0184,-0.0394,0.0619,0.0231,-0.2397,-0.1687,-0.1615,-0.0722,-0.0119,0.3015,-0.0267,0.0167,-0.0557,-0.033,-0.0553,-0.1139,-0.1576,-0.0611,-0.0245,-0.0188,-0.0123,0.0099,0.0179,0.0836,-0.1585,0.2072,0.0544,-0.2219,0.0085,0.0952,-0.0312,0.1141,-0.1453,0.03,-0.0426,0.0592,0.1101,0.0587,0.0731,0.0547,-0.1506,-0.0052,0.1042,0.119,-0.0457,-0.0532,0.0654,-0.034,0.0138,-0.0302,0.0088,-0.0153,0.0296,-0.0013,-0.0401,-0.1588,-0.088,-0.0769,-0.1027,-0.0271,0.0264,-0.112,0.0753,0.0593,0.0774,0.0468,-0.1371,-0.0599,-0.045,-0.1781,-0.0894,0.2178,-0.1551,-0.129,0.1695,-0.095,-0.1677,-0.059,-0.0064,-0.2472,-0.1564,-0.3931,-0.3479,-0.1209,-0.2247,-0.0199,-0.2103,-0.0819,0.0103,0.0222,0.0341,-0.0152,-0.0833,0.0222,0.0854,0.0363,-0.2674,-0.1448,0.2846,0.1456,0.0167,0.0987,-0.1068,-0.1197,0.1257,0.2297,-0.0825,-0.0901,-0.0888,0.0354,-0.1075,-0.1004,0.0223,-0.2065,0.0413,-0.0693,-0.0056,-0.0489,-0.0049,-0.0387,-0.0562,0.1118,-0.1235,-0.1299,0.0985,0.287,-0.0427,-0.0661,0.0845,0.0578,0.1254,-0.0318,0.0471,-0.0839,0.0479,0.0922,-0.0013,-0.0369,0.2366,0.0338,0.0303,0.0769,-0.0068,0.0937,0.0029,0.0826,-0.1504,-0.0544,0.192,0.1451,-0.0842,-0.1502,0.0876,0.0625,-0.0506,-0.0821,0.0405,-0.1334,-0.1071,-0.0272,0.0118,-0.1471,-0.1299,-0.0959,0.0079,0.0358,-0.0317,0.2042,-0.1775,0.0951,-0.0522,0.0199,0.0742,0.0773,-0.1665,-0.1651,0.1837,-0.0911,-0.0945,-0.0725,0.1106,0.0163,0.1012,0.0311,0.1372,0.1767,0.0529,0.1103,-0.0559,-0.038,-0.0784,-0.2274,-0.112,0.0649,-0.1407,-0.0625,-0.0511,-0.1322,-0.0706,0.0051,0.0866,-0.0609,-0.0712,0.0427,-0.0416,-0.011,0.0122,-0.0431,0.1088,-0.0797,-0.005,0.0539,0.0545,-0.1371,0.0063,0.079,0.014,0.0124,-0.0413,0.0063,-0.0493,0.1155,-0.0267,0.1247,0.0617,-0.0589,-0.0076,-0.0822,-0.0325,-0.0267,-0.0659,0.0491,0.1318,0.0694,0.0649,0.0711,0.1001,0.0816,-0.012,-0.1394,-0.0516,-0.0225,0.0548,0.052,0.0657,0.0665,0.1509,-0.0695,-0.1405,0.0204,0.0559,0.0808,0.015,-0.0812,-0.2925,-0.0897,0.1614,-0.0946,0.1097,0.0278,0.0446,0.1649,0.1443,0.1157,-0.0025,-0.2351,-0.2219,-0.0306,-0.2299,-0.0563,0.058,-0.0513,-0.2993,-0.1165,-0.0755,-0.0199,0.0237,-0.2575,-0.0481,-0.2475,0.105,-0.0209,-0.0079,0.1132,-0.1291,-0.1815,-0.0448,0.0143,0.0549,0.0804,-0.052,-0.0613,-0.0492,0.0653,0.0294,-0.0023,-0.14,0.0272,-0.0826,0.1221,0.0117,0.0566,-0.1172,-0.0562,-0.2328,-0.2053,0.1313,-0.2444,-0.0332,-0.107,0.281,-0.1033,-0.0021,0.0503,0.1214,-0.0857,-0.0902,-0.0737,-0.2073,0.1852,0.1941,0.0396,0.1616,0.156,-0.0707,-0.1304,0.0607,-0.0802,-0.0551,-0.0956,-0.0886,0.0403,-0.0613,-0.0963,0.244,-0.1331,0.034,-0.0924,0.0399,0.1213,0.1278,-0.0159,0.099,-0.1642,-0.1445,0.1018,0.0465,0.0658,0.0001,0.1433,0.1518,0.1415,-0.0393,-0.1053,0.0385,-0.0777,-0.0676,-0.0743,0.0814,0.0215,-0.1099,-0.1112,-0.0794,-0.0876,-0.1309,-0.117,-0.0755,-0.0073,0.074,-0.0997,-0.1321,-0.014,-0.0802,-0.0806,-0.1117,0.0098,-0.1151,0.0207,0.0924,-0.0723,-0.2772,-0.275,-0.185,-0.0636,-0.0539,-0.1328,0.0011,-0.0173,0.0788,-0.0344,-0.0018,0.011,0.0856,0.0199,-0.0925,0.0979,0.1141,0.1754,-0.2005,0.003,-0.0937,0.0383,0.0,-0.2032,0.0783,0.0903,-0.0104,0.055,0.0243,0.1753,-0.2169,-0.326,-0.272,-0.2085,0.0683,0.2211,-0.0516,-0.0498,0.0028,-0.017,0.0825,0.062,0.0269,0.0489,-0.147,-0.0855,-0.0054,0.1182,0.1599,0.1629,-0.0444,-0.0426,0.0171,-0.1082,0.0462,-0.1264,-0.1107,-0.0679,-0.2074,-0.2087,-0.1213,0.0878,0.0492,0.0143,-0.0147,-0.066,0.0746,0.0949,0.0242,-0.1222,0.027,0.0235,0.0611,-0.0087,0.0625,-0.0759,0.128,-0.2972,-0.2902,0.0667,0.11,0.2206,-0.0317,-0.053,0.1312,0.0535,0.1855,0.3517,0.1435,0.177,0.0599,0.1205,0.1165,0.0318,0.1909,0.1387,-0.0815,0.0688,0.0447,-0.27,-0.2166,0.014,-0.1499,-0.0161,-0.3271,-0.111,-0.2133,-0.1597,-0.2637,0.0794,0.0061,0.0773,-0.118,-0.1046,-0.0129,0.0536,0.0982,0.045,0.0918,0.1072,0.0319,0.0485,0.0217,0.0061,0.0989,0.0924,-0.112,0.1229,0.0509,0.0445,-0.1059,-0.163,-0.041,0.0732,-0.0525,-0.2491,-0.1578,0.0191,0.0601,0.0878,0.0525,-0.0496,0.1198,0.1668,-0.1326,-0.1601,0.1968,-0.1702,0.0655,-0.1195,0.2775,-0.1133,0.2012,0.0188,-0.0179,0.0218,-0.152,-0.1249,-0.1228,0.305,-0.113,-0.1719,-0.0987,0.1067,0.0215,-0.2203,-0.0862,-0.2389,0.0142,-0.0317,0.1727,0.1313,0.0545,0.0775,-0.2384,-0.0878,-0.0694,-0.002,-0.1626,-0.016,0.0269,-0.0152,0.092,0.2227,0.1125,-0.1814,-0.1427,-0.1124,-0.0475,-0.1177,-0.1008,0.0787,0.1869,0.0357,-0.0643,-0.0837,0.1582,0.139,0.0656,-0.0155,-0.0852,-0.1056,-0.1117,-0.0915,-0.0932,0.052,0.0638,-0.1495,-0.0624,0.1025,0.0708,-0.0953,-0.0621,0.0547,-0.0155,-0.0087,-0.0102,-0.1969,-0.1901,-0.2378,-0.1358,-0.2598,-0.0753,-0.094,-0.0946,-0.1621,-0.1534,-0.2036,-0.119,-0.1918,0.0079,0.0644,-0.0296,0.0869,0.0802,-0.049,0.1003,0.0014,0.0322,0.0827,0.0557,0.0302,-0.0396,-0.0642,0.0486,0.0666,-0.056,0.0886,0.0586,0.1164,0.0036,0.0122,-0.0469,0.0766,-0.0266,-0.0975,-0.0015,0.1715,0.0122,0.0894,-0.2139,-0.1255,-0.082,-0.1995,-0.1695,-0.005,0.1094,0.0428,0.1583,0.0785,0.0584,-0.024,-0.0164,0.0102,0.01,0.0549,-0.0036,-0.0446,-0.061,-0.0669,-0.0986,0.0769,0.051,-0.0716,-0.1196,-0.0888,-0.2083,-0.1033,0.1273,0.0867,0.1025,-0.0204,0.0202,-0.0485,0.0572,0.0811,-0.0344,-0.064,-0.0352,-0.0358,-0.0314,0.0112,0.0544,0.0586,-0.1476,0.0051,-0.1725,0.0369,-0.1578,0.0103,0.1645,0.3238,0.0166,0.0318,-0.0174,0.0266,0.0003,-0.0818,-0.0888,-0.1318,0.002,-0.0219,0.0228,-0.0007,-0.0686,0.0148,-0.0129,-0.0451,-0.0575,-0.0447,-0.1144,-0.1113,-0.1168,0.1554,0.0021,0.1194,-0.161,0.2771,0.1751,-0.0576,-0.0205,-0.0439,0.0316,-0.0581,0.0871,-0.0767,-0.0831,-0.018,-0.0388,-0.1323,-0.1164,-0.0055,-0.0262,-0.0089,-0.1001,-0.0024,-0.0628,0.0321,0.0197,-0.0126,0.0752,0.0418,-0.0682,0.0655,-0.164,0.0165,-0.0136,-0.0981,0.3705,0.2138,0.434,0.3015,0.345,0.1012,0.4136,0.1819,-0.2965,0.1504,0.15,0.0654,0.0675,0.055,-0.0438,0.0252,-0.0034,-0.0461,0.082,0.0037,0.0576,0.0668,-0.1144,0.1318,0.1512,-0.0478,0.0466,-0.0235,-0.1005,0.119,0.0346,-0.1425,0.0251,-0.1701,0.047,0.0099,0.1725,-0.033,-0.1548,-0.1596,-0.0842,-0.0536,0.1414,0.136,0.0339,-0.0239,-0.0807,-0.1791,-0.1077,0.155,-0.1363,0.2408,0.3484,-0.08,0.0228,0.0632,0.1663,0.216,0.0734,0.2184,0.0351,-0.012,0.0688,0.0334,-0.0135,-0.1917,-0.0608,-0.108,0.1656,0.0195,-0.0754,-0.0573,-0.1344,-0.0628,-0.0473,-0.1654,-0.0108,0.0321,0.1879,-0.1058,0.057,-0.0519,0.1447,0.08,0.0251,-0.3205,-0.3136,-0.1009,-0.1437,-0.0639,-0.1292,-0.1199,-0.0636,-0.0513,0.1676,0.0531,0.0877,0.3637,-0.0176,0.0673,-0.1301,0.0137,0.0046,0.1933,-0.0982,0.2001,0.3789,-0.0374,-0.1136,0.2724,0.2631,-0.0531,-0.1343,0.0014,-0.2304,-0.122,-0.2624,-0.0504,0.1549,-0.0569,-0.0511,0.0878,0.0282,-0.0587,-0.161,0.0036,-0.0154,-0.0685,-0.0363,0.0882,0.0135,0.1857,0.1496,0.1195,0.1662,-0.1522,-0.0572,-0.1255,-0.1565,-0.0892,-0.071,-0.0354,0.2888,-0.1758,-0.1345,0.0475,0.0249,-0.0353,0.0363,-0.0063,0.0122,-0.0144,0.0931,-0.1263,-0.1606,-0.0869,0.3005,0.0662,-0.0461,-0.0649,-0.0649,-0.1914,0.1723,0.0953,0.1106,-0.0433,-0.0194,-0.0537,0.3918,-0.3059,-0.2915,0.0282,-0.035,-0.2513,-0.2513,-0.2097,0.0024,-0.0547,-0.1173,-0.0346,0.0154,0.2719,-0.0538,0.0739,-0.0295,0.0718,-0.017,0.1088,0.0612,-0.0476,-0.0665,0.0048,-0.0649,-0.0458,-0.0289,0.0175,0.1001,0.0397,0.27,0.1551,0.1703,0.0336,0.3393,-0.142,-0.1168,-0.0056,-0.1847,-0.0075,-0.221,-0.2919,-0.0319,-0.1299,-0.2518,0.0816,-0.0416,-0.1933,0.0005,-0.0529,-0.0686,-0.1467,-0.0049,-0.1148,-0.1226,-0.0678,0.0756,-0.0975,0.2074,0.1745,0.1595,0.1805,0.0084,0.0197,-0.0249,-0.1145,-0.1117,-0.0135,-0.106,0.057,-0.1624,-0.0438,0.0425,0.0301,-0.0138,-0.1963,-0.1169,-0.0299,0.0374,0.0661,-0.0272,-0.1099,0.0046,-0.0398,-0.1018,-0.2005,-0.2816,-0.1998,-0.066,-0.1801,-0.1687,-0.0004,0.0028,0.1735,0.0733,0.0373,-0.1305,-0.1302,0.045,-0.1818,-0.0345,0.0189,-0.012,-0.0227,-0.168,0.0219,0.1561,0.0214,0.0328,0.0079,-0.0731,0.1555,0.0994,0.0031,-0.0172,-0.2596,0.1906,-0.0043,0.0256,0.2128,0.0253,0.0356,-0.0171,0.0697,0.3145,-0.1097,0.0333,-0.1432,-0.0565,-0.1788,-0.152,-0.0776,0.0876,-0.0006,-0.0962,-0.1439,-0.0417,-0.0486,0.0241,-0.1132,-0.1611,-0.0329,0.0319,-0.0725,0.0424,-0.1208,-0.0466,-0.0561,-0.1299,-0.1569,-0.1433,-0.0532,-0.0591,-0.0389,0.0438,0.1466,-0.0492,-0.0359,-0.0818,-0.0108,0.0412,0.0004,-0.166,0.1113,-0.0394,0.0757,0.0036,0.0697,0.0558,0.1062,0.1036,-0.0898,-0.0073,-0.0839,-0.0515,-0.2302,-0.0023,-0.0957,-0.0046,-0.0173,-0.0413,0.0164,-0.0286,-0.0557,0.2191,0.1346,-0.0405,0.2078,0.2069,-0.0422,0.0554,0.1343,-0.0187,-0.0424,0.0028,0.2476,0.0014,-0.0036,-0.0536,-0.0611,-0.0267,-0.1113,0.0435,0.0072,-0.0232,0.1691,0.1685,-0.0983,-0.087,0.0246,0.0769,0.101,0.0743,-0.2066,-0.1113,0.0137,-0.17,-0.1438,0.0555,0.1424,0.0498,0.0569,0.1219,0.0705,-0.2379,-0.0563,0.0565,-0.0747,-0.1882,-0.0004,0.0385,0.1044,0.0178,0.1981,0.0025,0.0042,0.0288,0.0626,0.2165,0.1688,-0.0809,0.0298,0.0622,0.016,-0.0835,-0.0,0.0843,-0.0119,0.0034,0.1795,0.0067,0.0349,-0.1003,-0.1302,0.0539,0.5512,0.5337,-0.1374,-0.1093,0.0544,-0.0852,-0.0775,-0.1059,-0.1459,-0.0029,-0.0661,-0.1111,-0.0255,-0.0044,0.2485,-0.075,0.1288,0.1071,-0.0002,0.1467,0.4207,0.0385,-0.1126,0.2564,0.1224,0.1014,0.0505,0.0317,-0.084,0.0549,-0.0338,-0.0298,0.0403,0.0729,0.0609,0.0757,0.081,-0.0429,0.147,0.0874,0.195,-0.1505,0.0207,0.0863,-0.0514,0.0016,0.0213,0.0157,-0.14,0.001,0.0915,-0.047,0.0416,-0.0409,0.0339,0.0702,0.0215,-0.0378,0.1,-0.0106,0.0129,0.0676,0.0963,0.0619,-0.0451,0.1421,0.0514,0.0331,0.3795,-0.1785,-0.1096,0.0119,-0.1399,0.0863,0.0876,0.1593,-0.0609,0.0057,0.0024,-0.104,0.0036,-0.0849,-0.1484,0.0692,0.0696,0.0737,0.0271,0.1497,0.1607,0.1681,-0.0826,-0.1035,-0.1117,-0.0393,0.0175,0.0159,-0.0435,0.0579,0.096,-0.0366,0.003,0.1152,-0.2881,-0.1634,-0.0252,0.1191,-0.0794,0.0416,0.0114,0.0494,0.0288,0.061,-0.0113,-0.1402,0.0263,0.0277,0.0019,-0.0682,-0.0953,-0.0996,0.0314,-0.0,0.0133,0.1682,-0.1587,-0.1716,-0.0671,0.2581,0.1243,0.1387,-0.0868,0.0872,0.107,0.0193,0.1814,0.3044,0.2298,-0.0501,-0.0029,-0.0231,0.0456,-0.2054,0.0187,-0.2879,-0.1178,-0.1402,-0.1382,-0.0415,0.0736,-0.111,0.0715,-0.0642,0.0559,0.0465,0.1348,-0.0176,-0.0309,-0.0508,-0.0531,-0.0334,0.0467,0.1994,0.1232,0.1304,-0.2569,-0.1776,-0.2211,-0.1289,0.0204,-0.1334,-0.1015,-0.0612,-0.1248,-0.0632,0.141,0.0206,0.1484,0.0665,0.0806,0.1279,0.067,0.0028,0.0455,0.0209,-0.124,-0.0295,-0.2005,-0.1049,-0.0924,-0.0378,0.043,0.2424,0.1309,0.0514,0.093,-0.0371,-0.3875,-0.1688,-0.2456,-0.1906,-0.0177,-0.0549,0.0086,-0.182,-0.2298,-0.2077,-0.0986,0.0328,0.0909,0.0344,-0.0722,-0.0457,-0.0562,-0.2233,-0.0237,-0.0448,0.0401,-0.0142,-0.0523,-0.318,-0.1032,-0.1595,-0.1814,-0.3059,0.1639,-0.1667,-0.0711,-0.0903,-0.1076,-0.0577,-0.0522,-0.1519,0.0102,-0.2213,-0.0505,-0.0184,0.1583,-0.0083,-0.0466,-0.1486,-0.0532,-0.0094,0.167,-0.1293,-0.085,0.0497,0.1277,-0.1052,-0.1016,-0.0137,-0.0635,-0.1331,-0.2057,-0.2196,-0.1436,-0.1541,-0.0557,-0.0552,-0.0196,-0.3302,-0.0307,-0.0194,-0.1432,-0.0968,-0.1783,-0.0327,-0.1049,-0.0041,0.0483,0.1268,-0.0197,-0.0323,-0.1644,-0.1877,-0.1823,-0.037,-0.1179,-0.0316,0.0468,0.3195,0.2946,-0.0618,-0.1271,0.0189,0.1223,0.1684,0.2371,-0.2539,-0.274,-0.0572,0.0956,-0.044,-0.0428,0.0508,-0.0625,0.0872,-0.0646,-0.0929,-0.1393,0.0295,-0.1181,-0.214,-0.108,-0.1497,0.0171,-0.0144,0.0546,0.2559,0.1834,-0.1474,-0.2636,-0.1038,-0.1702,-0.0923,-0.2694,-0.1593,0.49,-0.1533,-0.1193,0.1915,0.0848,0.053,0.1982,0.074,0.0797,0.147,0.02,0.0944,0.0243,0.0542,0.0964,0.1555,0.3401,0.4577,-0.2401,-0.0289,0.0426,0.3876,0.0077,-0.1778,0.0352,-0.0361,-0.0154,0.029,0.247,0.0041,0.0097,-0.0415,-0.0902,-0.1046,0.0471,-0.0871,-0.073,0.0998,0.1485,0.01,0.0614,0.0139,0.122,0.1843,0.0385,0.0047,-0.0218,0.0141,-0.3738,-0.1322,-0.1781,-0.1655,-0.0669,-0.1769,-0.2208,-0.1385,-0.0786,-0.1547,-0.1431,-0.0686,0.1514,-0.0789,-0.273,0.1561,-0.0505,0.0277,0.0158,-0.1199,0.075,-0.1586,-0.1298,-0.0973,-0.0958,-0.0814,0.0473,-0.1273,0.2827,0.0383,0.1549,0.0529,-0.1228,-0.0125,-0.0408,-0.1259,-0.0854,-0.0665,-0.1133,0.0151,0.0075,-0.1087,-0.089,-0.0558,0.0125,0.0571,-0.0658,-0.0583,-0.1658,-0.1051,-0.0831,-0.0867,0.0817,-0.1111,-0.0705,0.0069,0.0017,-0.1041,0.01,0.0136,-0.1255,-0.0431,-0.1679,-0.1767,0.1307,0.1966,0.2123,-0.0893,0.4939,0.2452,-0.1779,-0.1515,0.3907,0.4788,0.0254,0.3132,0.2438,0.3266,-0.1291,-0.1205,-0.1422,-0.1079,0.3793,0.2967,0.2169,0.0029,0.1415,0.1419,0.3695,0.3744,0.35,-0.0158,-0.0284,-0.0447,0.0658,0.0301,-0.0025,-0.2327,-0.1179,-0.0622,-0.1168,-0.1672,-0.1257,0.0364,-0.0004,0.0606,-0.0017,0.0572,0.1636,0.1884,0.0372,0.043,-0.0071,-0.0626,-0.0312,0.0332,-0.0466,-0.1403,-0.0691,-0.031,-0.2093,-0.2951,-0.2731,0.0606,0.0781,0.1039,0.2052,0.09,0.2695,0.0944,0.0568,0.1447,-0.0742,-0.1995,-0.2533,0.0266,0.1167,-0.0639,0.1057,0.1382,0.1563,0.1363,-0.172,-0.1585,-0.075,-0.0607,0.1112,-0.1585,-0.0691,-0.0101,-0.0915,0.0224,-0.0649,-0.0602,0.0615,0.0525,-0.1694,-0.0636,-0.1706,-0.1773,-0.2079,0.0432,-0.0883,-0.0404,-0.0076,-0.027,0.0744,0.4657,0.3857,0.1302,0.2753,0.0251,0.1632,0.0894,0.2988,0.2396,0.2723,0.0621,0.0939,0.0716,0.2752,0.2357,-0.0002,-0.0084,0.0221,0.043,-0.0471,0.0417,0.017,0.0194,0.0004,0.1027,-0.0163,0.0393,0.2504,0.0657,0.1531,0.1948,-0.1647,-0.1793,-0.1823,-0.1305,-0.2241,0.1356,-0.0516,-0.0987,-0.0212,0.1217,0.0038,-0.2676,-0.0236,0.0243,-0.0679,0.0033,0.0552,0.1712,0.1572,0.2696,0.3579,0.1983,0.1027,0.0248,-0.0509,0.171,-0.1128,-0.1553,-0.0547,0.0056,-0.0151,0.0347,0.005,-0.0948,0.0071,-0.1604,-0.2335,-0.231,-0.0473,0.0474,-0.1992,-0.0805,-0.1211,-0.0034,-0.0762,-0.0229,0.0506,-0.0476,0.0912,0.032,0.0976,-0.1666,0.0399,-0.0466,-0.0216,0.0808,-0.2331,-0.1239,0.2799,0.0112,0.011,0.0111,0.0246,-0.0047,0.0375,-0.0284,-0.0203,-0.0196,-0.0084,0.0207,-0.2048,0.0992,0.0611,0.2019,-0.0287,-0.2128,-0.1396,0.0003,-0.1342,-0.0793,-0.066,-0.1354,-0.0262,0.1416,0.0842,0.1967,-0.3489,-0.1325,-0.1418,-0.2871,-0.2267,-0.1716,-0.1915,-0.1915,-0.0349,0.0186,0.0748,-0.2094,-0.0627,0.0077,-0.0302,0.1122,-0.0543,-0.3637,0.1975,-0.1041,-0.0036,0.0237,0.3757,0.2268,0.0488,-0.2194,-0.0938,-0.0173,0.0225,-0.0092,0.2805,0.0434,0.1221,0.1924,0.1462,-0.0044,0.0091,0.1468,0.0417,-0.0353,-0.0146,-0.0466,-0.0435,-0.1214,-0.0437,0.0112,-0.0638,0.1167,-0.095,-0.0579,0.074,0.0788,-0.0956,0.0872,0.0801,-0.1951,-0.0279,-0.2351,-0.0663,-0.024,0.0808,-0.1133,0.3559,0.3226,0.1904,0.2129,0.2308,0.0453,0.058,0.0118,0.2973,0.1171,0.0337,0.1083,-0.1268,0.1184,0.0446,0.1241,-0.0046,-0.0212,-0.0085,-0.0519,0.0392,0.0213,-0.0891,0.0467,-0.0125,0.0466,-0.0182,0.064,0.1592,0.1048,0.0085,0.0067,-0.0615,0.0469,-0.0695,-0.1167,-0.1313,-0.0663,0.0807,0.0598,-0.0666,-0.0446,-0.0812,-0.0262,0.1297,0.0955,0.0359,0.0163,-0.0015,-0.0267,0.101,-0.0468,0.0505,-0.0083,0.022,-0.066,-0.1204,-0.1257,-0.0926,0.0002,0.0204,-0.0901,0.0907,0.0315,0.1171,-0.0059,0.0581,0.1563,0.0463,-0.029,-0.1168,-0.1031,-0.0438,0.0567,0.0278,0.0069,-0.0741,-0.0187,0.0609,0.1518,-0.2106,-0.1872,-0.1509,-0.177,-0.0164,-0.022,0.0053,-0.1682,-0.1318,-0.1817,-0.0595,-0.1414,0.0097,-0.0327,-0.0883,0.1823,-0.104,-0.1131,-0.1177,-0.0033,-0.0727,-0.0471,0.1497,0.0752,-0.1813,0.0754,-0.0459,-0.0353,0.0317,0.0476,0.0342,0.0526,-0.1055,-0.1488,-0.0704,-0.1899,-0.1996,-0.0798,-0.1318,0.0905,0.156,0.0816,0.0642,0.1159,-0.1403,-0.1718,0.0194,0.0739,0.1378,0.1171,0.025,0.0118,0.0187,-0.0887,0.0369,-0.1787,-0.1094,-0.0552,-0.0752,-0.1234,-0.1955,0.0683,-0.0667,-0.002,0.157,-0.0034,0.0602,-0.1792,-0.0688,0.0148,0.0073,-0.0453,0.0692,0.2141,0.0927,0.0145,-0.0782,-0.1064,-0.1264,-0.1117,-0.0093,-0.2143,-0.0228,-0.0123,-0.0194,-0.0325,-0.0013,0.076,0.0285,-0.1053,0.1513,-0.2617,-0.1375,-0.1693,-0.1847,0.0058,-0.1996,-0.1481,-0.2705,-0.1183,-0.0359,0.1107,-0.1692,-0.1502,-0.0933,0.0852,0.029,0.0453,-0.1772,-0.1842,-0.1143,-0.0465,0.0387,0.115,-0.0733,-0.0172,-0.0342,0.0738,0.0422,0.0518,0.159,-0.0517,-0.0572,0.0606,0.0011,-0.0469,-0.07,-0.0761,-0.0694,0.0198,0.0017,0.0345,0.0552,0.0981,0.1861,0.0491,-0.0259,-0.0592,-0.2243,-0.1047,-0.0475,0.2738,0.3048,0.0401,0.0129,-0.0112,0.0568,0.2211,0.185,0.1374,0.0913,-0.1506,-0.004,-0.0804,0.0431,-0.1418,0.0462,0.0533,0.096,0.0403,0.0723,0.06,-0.0408,0.057,0.0024,-0.1396,0.1837,0.0644,0.0194,-0.0704,0.1153,0.0994,0.0019,0.0733,-0.0094,-0.0008,0.1367,0.173,0.1566,-0.1023,0.023,0.1184,-0.0276,-0.1655,-0.3501,-0.3432,0.1044,0.0856,0.1355,-0.0854,0.0084,-0.1034,-0.139,-0.1285,-0.1619,0.0324,-0.1095,-0.0076,-0.0754,0.0703,0.0127,-0.2667,-0.0971,-0.1674,-0.2179,-0.0018,-0.1264,0.0003,-0.2994,-0.1186,-0.0105,-0.0217,-0.017,0.0403,0.0228,-0.0051,-0.1465,0.2942,-0.1035,0.1325,0.0486,0.0522,0.0393,0.0871,0.0519,0.2894,0.2715,-0.1815,-0.0906,-0.0706,-0.0247,-0.1957,-0.1233,-0.0831,-0.2233,-0.1445,0.0052,-0.1489,0.0522,-0.0074,-0.0295,-0.0815,-0.2007,0.0836,0.0615,-0.2148,-0.1019,-0.0641,-0.147,-0.2926,0.1338,0.1757,-0.1268,0.0414,0.083,0.1189,-0.0329,-0.0076,-0.1642,-0.2333,-0.0942,-0.1495,0.0177,0.0888,0.1011,0.0654,-0.0324,0.1443,0.3231,0.2284,0.1889,0.2832,-0.2396,-0.2085,-0.2167,-0.0766,-0.0161,-0.0539,-0.2007,0.0021,0.0598,-0.0787,-0.0831,-0.0012,0.1806,-0.1472,0.1044,0.0315,0.1526,0.1296,0.126,0.0484,-0.0387,-0.0292,-0.0192,0.0642,0.1015,0.1631,0.0725,-0.05,0.0861,0.1384,0.1583,0.0691,-0.0347,-0.1717,0.0015,-0.0313,0.0519,-0.063,-0.0228,0.0989,0.021,0.0564,0.0152,-0.0665,-0.0598,-0.2118,-0.152,-0.0944,-0.0781,0.3237,-0.0082,0.2563,0.1263,0.1098,-0.0644,-0.0814,0.1568,0.1381,0.1816,0.3142,0.1817,0.1592,0.0643,0.1135,-0.0591,-0.0696,0.0422,0.0235,0.1851,0.1742,-0.0904,-0.0506,0.0173,0.0205,-0.0387,0.0757,-0.0222,-0.1399,0.0171,-0.0202,0.0201,-0.1059,0.0766,0.1217,0.182,0.0567,0.044,0.0862,-0.0213,-0.045,0.1689,0.1697,0.0559,0.0375,-0.0026,0.1623,0.045,0.0107,0.0251,0.1,0.1331,0.0448,-0.0709,-0.0883,-0.1648,-0.0599,0.0103,0.1518,-0.1015,-0.0852,-0.1112,-0.1076,-0.104,-0.0279,-0.0836,-0.0394,-0.0026,-0.0383,-0.0879,0.0767,0.0593,0.026,0.0216,-0.0743,0.0233,-0.0635,-0.0883,-0.0085,0.2547,0.0367,-0.0322,0.399,0.3798,0.2167,0.0169,0.1617,-0.0473,-0.0546,0.0095,-0.0779,0.0299,0.1638,0.2203,-0.0249,0.0009,0.0388,0.0728,-0.096,-0.104,-0.0697,-0.0662,-0.0938,-0.0855,-0.0416,-0.0818,0.0163,-0.1378,-0.1207,0.3011,-0.0167,-0.2152,-0.0214,0.0539,0.1425,-0.0694,-0.0694,-0.3605,-0.3099,-0.1251,-0.1436,0.2778,-0.1385,-0.0774,0.1092,-0.0217,0.0927,0.0249,0.0701,0.1693,0.1558,0.2764,0.255,0.1361,-0.0287,0.01,0.0605,0.0159,0.0019,0.0051,-0.0138,0.2753,0.1903,-0.148,-0.2866,-0.1827,-0.1498,-0.2276,-0.0043,0.0113,0.0916,0.0369,0.1513,0.0171,-0.0076,-0.2657,-0.0851,-0.1828,0.0233,-0.1639,-0.2362,0.0106,0.1019,-0.0511,-0.0891,-0.0353,-0.0915,-0.0993,-0.2429,-0.0316,-0.1655,-0.0054,-0.1272,-0.0984,-0.0348,-0.0516,0.0236,0.0404,0.0569,-0.1247,-0.1603,-0.1273,0.0485,0.155,0.0375,-0.0448,0.1674,-0.0781,-0.1252,0.052,0.0835,0.0197,-0.0338,-0.0131,0.0335,0.0071,-0.0516,0.2236,0.5151,0.411,0.1735,0.1199,-0.0374,0.2397,0.0082,0.2188,0.0382,0.4663,0.0236,0.1619,0.1295,0.0694,0.0422,0.0219,0.0193,0.0645,0.1964,0.2275,0.1499,0.1118,0.0237,-0.1671,0.0382,0.1589,0.0856,-0.2148,-0.1553,-0.2337,0.0009,-0.168,-0.0208,-0.0301,0.0753,0.0383,-0.0291,-0.1778,-0.1784,0.2366,-0.0193,-0.1124,0.0789,0.2904,0.0997,-0.0698,0.1873,0.2326,0.1365,0.0621,0.1699,-0.1045,0.0577,0.2166,0.1156,-0.079,0.2265,0.0909,0.0903,0.051,0.2823,0.0632,-0.2122,-0.1199,-0.0645,-0.0572,0.0645,-0.0437,0.0495,-0.0027,-0.0585,-0.0134,-0.2504,-0.1226,0.0992,-0.0349,-0.1812,0.1178,0.011,-0.0122,0.0822,0.0059,0.047,0.0577,-0.1124,-0.1012,-0.3041,-0.2372,0.0659,0.1614,-0.0333,-0.089,-0.0571,-0.0383,-0.0265,-0.1271,-0.1528,-0.1926,0.0024,0.069,-0.0725,-0.0742,-0.1221,0.0299,-0.1394,-0.1695,-0.0308,-0.0806,-0.1029,-0.129,-0.1056,-0.0257,-0.1456,-0.0796,-0.015,0.0402,0.1278,-0.1115,-0.0069,0.1107,0.0445,-0.1873,0.1215,-0.0349,-0.199,-0.09,-0.0352,-0.0675,0.0386,0.1765,0.2334,-0.0488,-0.1536,0.2255,0.0801,0.0058,0.2395,-0.2514,-0.1012,-0.239,0.0595,0.0483,0.138,0.0695,-0.2597,-0.2494,0.0991,0.1347,-0.0155,0.1885,0.0966,-0.0141,-0.1557,-0.1537,-0.0964,-0.126,-0.3018,-0.1274,-0.1046,0.0808,0.0139,0.1259,0.0341,0.2174,-0.0496,0.0424,-0.0396,0.1123,0.159,0.0036,-0.0255,-0.0535,-0.0513,0.064,-0.0646,0.0423,-0.1016,-0.0943,-0.109,0.0145,-0.1045,-0.0362,-0.0471,-0.0134,-0.0779,-0.0818,0.0461,0.1486,-0.0123,0.0812,-0.0662,-0.0301,-0.03,-0.0533,0.0058,-0.0938,-0.1916,-0.0693,0.1748,0.0695,0.0733,0.0031,-0.0403,-0.1084,-0.1204,0.0078,-0.0831,0.1354,0.1421,-0.2026,-0.188,0.0348,-0.1789,-0.0583,-0.0971,0.2899,0.3807,-0.2487,0.1622,-0.1306,0.0154,0.0323,-0.235,-0.2881,-0.1581,0.0293,-0.101,-0.0974,-0.0063,-0.1555,-0.1174,0.1397,0.0017,0.0018,0.0763,-0.021,0.0094,-0.1796,-0.0472,0.0744,-0.1546,0.0842,-0.1849,0.3656,-0.2439,0.2131,0.074,0.043,-0.2769,-0.2522,0.0098,-0.014,-0.0584,0.0303,0.0501,0.0056,0.0104,0.0318,0.033,0.315,0.3109,0.2725,0.0812,0.1685,0.257,-0.0383,0.1288,0.3763,0.4999,0.2658,0.1592,0.2757,0.1892,0.1062,0.246,0.1999,0.3914,0.2408,0.2176,0.2788,0.1907,0.1765,0.1974,0.4126,0.1867,0.3613,0.2509,0.3363,-0.2138,-0.0703,-0.2206,-0.0995,-0.0647,-0.3222,-0.265,-0.1755,0.1115,0.0067,-0.3318,-0.2498,-0.1706,-0.0023,0.0213,-0.2226,0.278,-0.0211,-0.0866,-0.0409,-0.1026,-0.0744,-0.0703,-0.1528,-0.2185,0.1253,-0.3171,-0.3306,0.0148,0.0078,-0.0612,0.0047,0.0056,-0.1553,0.0576,0.1286,-0.1711,0.0577,0.1748,-0.0383,0.0747,-0.0282,-0.1073,0.1769,0.1768,-0.0211,-0.0738,0.103,-0.0755,-0.0015,-0.1762,-0.03,0.156,-0.1872,-0.16,-0.0553,-0.0271,-0.0408,0.0176,judgment
trm_4a3fd79d0a613,0.1092,0.1302,0.0966,0.1844,0.0062,0.0561,0.0776,0.1036,0.0707,0.1035,0.0079,-0.0182,0.1019,0.0513,0.1256,0.0909,0.0782,0.1439,0.0962,0.0017,0.0443,-0.0322,-0.0042,-0.0296,-0.0261,-0.0617,-0.0591,0.1087,0.138,0.0484,0.0982,0.1092,0.1207,0.0768,0.1311,0.0951,0.0198,0.073,0.1654,0.0514,0.1069,0.1342,0.065,-0.0915,0.1166,0.0661,-0.2434,0.0908,-0.0183,0.1146,0.0481,-0.0364,-0.0496,0.0456,0.0713,0.0543,0.0844,0.0074,-0.016,0.0129,-0.0482,-0.0624,0.1567,-0.0831,0.0341,-0.0684,0.2132,0.212,0.1438,-0.0501,-0.0447,-0.0354,-0.1449,0.0461,0.2086,-0.081,0.1279,-0.0788,-0.0007,-0.0211,-0.0513,-0.0759,0.0643,0.1203,-0.0012,-0.0546,0.0411,-0.0368,-0.0093,0.1233,0.0685,0.0372,0.0133,-0.1199,-0.1964,-0.1564,-0.1437,-0.0317,-0.1983,-0.0292,-0.0904,-0.0109,-0.0688,-0.0202,-0.0797,0.1543,0.132,-0.1779,0.0454,0.0902,0.0123,0.1101,-0.0769,-0.1537,-0.0229,-0.0042,0.0977,-0.0255,0.0423,0.0899,0.0952,0.1723,0.1135,0.0228,0.1024,0.1027,0.1189,-0.0399,-0.0696,-0.0765,-0.0006,0.0697,-0.0017,0.1575,0.012,0.1879,0.0193,0.1008,0.0447,0.0139,0.1131,0.1196,-0.0391,0.0185,0.0692,-0.0187,0.0886,-0.0067,0.0999,-0.1021,0.0858,0.0736,0.1453,0.1521,-0.1412,-0.0182,-0.0583,-0.0162,-0.0195,0.0419,0.0948,0.0644,0.2059,0.1842,-0.0004,0.0189,-0.0015,0.141,0.1343,-0.0199,0.0012,0.1098,-0.0875,0.0723,0.0691,0.101,0.0631,0.0737,0.0296,0.033,0.1187,-0.1019,0.0662,0.0466,0.0252,0.0282,0.0381,-0.0204,-0.0168,0.0952,0.0905,0.019,-0.031,0.1652,0.1474,0.2933,0.2677,-0.0139,0.0325,0.168,0.056,-0.158,0.1375,0.1328,0.088,0.0186,0.0296,0.0806,0.0896,0.0267,0.1281,0.0272,-0.0051,-0.0501,-0.0667,-0.0397,-0.1545,0.1573,0.1382,-0.0473,-0.1196,0.0831,0.1035,0.0626,-0.0378,-0.0425,0.1153,-0.1571,-0.0145,-0.0515,0.04,0.0721,-0.1879,0.1409,0.136,-0.0433,-0.0168,-0.0059,-0.0216,0.0587,0.0034,0.1573,0.0829,-0.0008,0.0935,0.0756,0.0728,0.1545,0.0701,0.0736,-0.0364,-0.0421,0.0208,-0.0382,-0.0284,0.1509,0.0358,0.1288,-0.1532,-0.3261,-0.0815,-0.2498,0.1094,-0.0963,-0.1604,-0.2477,-0.0479,0.0327,-0.0678,0.0167,0.0911,0.0053,0.0836,-0.0544,0.0209,-0.1578,0.0405,0.0682,0.0835,-0.0369,-0.1093,-0.0133,-0.0273,0.1409,0.113,0.0593,-0.0364,-0.0951,0.111,0.0881,0.1025,0.0467,0.0033,0.0413,0.0738,-0.0136,-0.0222,-0.0114,0.0628,-0.0564,-0.084,0.1505,0.1195,0.0469,0.0976,0.0928,0.1239,-0.0076,0.0061,0.0362,0.0274,0.0174,0.1854,-0.025,-0.0286,0.0975,-0.0696,-0.0581,-0.046,0.1559,0.0206,-0.0558,0.1175,0.1321,0.0883,0.0904,0.0011,0.0395,0.0774,0.1063,-0.0142,0.0587,-0.0302,-0.0286,-0.0416,-0.1051,-0.0148,0.0166,-0.0983,0.1523,0.1319,-0.102,-0.0256,0.0072,-0.0883,-0.0348,0.2063,0.1728,0.1292,0.089,0.0528,-0.1511,0.0598,0.0207,0.0386,0.0604,0.0611,0.1033,0.1208,0.112,-0.0123,0.0617,0.0666,0.0373,0.0267,-0.0637,0.1208,-0.0529,-0.0533,0.136,-0.0084,-0.054,0.0181,-0.1225,0.148,0.0405,0.1107,-0.1052,-0.2399,-0.1406,-0.2921,0.0157,0.1536,0.0526,-0.0022,-0.0214,0.0798,0.0314,-0.0043,0.053,0.055,0.0425,0.0611,0.0295,-0.0976,-0.0282,0.0818,0.1451,0.1043,0.0973,0.0758,-0.0411,-0.0064,0.0187,-0.0796,-0.0119,-0.0795,-0.0044,0.0855,0.0219,0.009,0.1523,0.0364,-0.2192,0.0546,0.03,-0.1824,0.0991,0.1567,0.0833,-0.0054,0.2406,0.1532,0.3897,0.3481,0.1681,0.1604,0.0917,0.1493,0.1757,0.0039,-0.0683,-0.0061,0.0303,-0.027,-0.0664,0.0033,-0.0283,0.2495,0.1705,-0.1034,-0.0536,-0.026,-0.0494,-0.042,0.0651,-0.0392,-0.1121,0.1147,0.17,0.124,-0.0379,0.1059,0.1055,0.0261,0.1306,-0.0609,0.1158,0.1009,0.0031,-0.0245,0.0941,0.0334,-0.0667,0.0881,0.1303,0.0065,-0.3091,0.0935,0.0303,-0.0097,-0.0693,-0.0196,0.0076,0.0075,0.0729,-0.0352,-0.0364,0.0117,0.0549,-0.0484,-0.0197,0.0533,-0.0199,-0.0567,-0.1037,0.0458,0.0114,0.0969,0.0474,-0.1631,-0.0545,0.1328,0.1495,-0.0882,-0.091,0.0866,0.036,-0.0423,0.1423,0.1327,-0.0174,0.0493,0.1276,0.1093,0.1098,-0.0082,-0.0427,0.0506,-0.1069,0.1685,0.0136,0.0268,0.0022,-0.1083,-0.0042,0.0834,0.0641,-0.1031,0.053,0.0955,0.0343,-0.1081,0.0024,-0.1057,-0.0421,-0.1152,-0.1424,-0.0765,-0.0315,0.0927,0.0491,0.0827,0.2113,0.0013,-0.0182,0.1192,0.1267,0.0495,0.095,0.0072,-0.0518,-0.0366,0.0316,0.0783,-0.0126,0.0274,-0.0409,-0.0379,-0.0236,-0.0793,0.0435,0.074,0.0415,0.0223,0.0996,-0.1092,-0.0305,-0.0891,0.0324,0.0509,0.0343,0.0759,-0.0727,0.0481,-0.1004,-0.1384,-0.0247,-0.0028,0.05,0.0706,0.0085,0.0944,-0.0408,-0.0042,0.0134,-0.0797,-0.0017,-0.1102,-0.0714,-0.0106,0.1105,0.0109,0.0528,-0.0482,-0.0019,0.1209,-0.0041,-0.0413,0.0522,0.0912,0.0674,0.0027,-0.0071,0.0982,0.0646,0.2082,0.0298,-0.1237,0.0475,-0.0355,-0.0954,-0.0691,-0.111,-0.061,-0.0228,-0.0128,0.1343,0.136,0.0277,0.1453,0.0592,-0.0249,0.0891,0.2341,0.0431,0.0722,-0.0212,-0.0263,0.2144,0.1033,0.2045,-0.05,-0.0167,-0.0008,-0.053,0.1618,0.1027,0.1295,-0.0016,-0.0431,-0.0227,0.0799,0.0535,0.1429,0.0063,-0.0067,0.0665,0.0371,0.0869,0.0849,-0.0676,0.0066,0.0725,0.1325,0.0226,0.1835,0.1242,-0.0523,0.1403,0.0839,0.1504,-0.1035,0.0766,0.0294,0.054,-0.0049,0.1184,0.045,0.1245,0.1326,-0.0346,-0.2066,0.076,-0.0509,-0.0638,0.122,0.0864,0.062,0.0536,0.0674,0.0576,0.0539,0.0401,0.0521,0.1123,-0.2154,0.0539,-0.0618,0.0401,-0.0003,-0.0588,-0.0686,-0.0581,-0.2057,0.1665,0.0945,-0.0282,0.0077,-0.0045,-0.0693,-0.0851,-0.0592,-0.1064,-0.1596,0.0671,-0.0355,0.0281,0.0849,0.0675,0.0294,0.0314,0.0204,0.0664,0.0585,0.0943,0.1204,0.1015,0.0753,-0.0273,-0.124,0.0474,0.1072,-0.0726,0.0359,0.0088,0.057,-0.0628,0.0731,-0.0443,-0.1578,0.0348,0.2508,0.2509,0.1685,0.0575,0.0378,0.1091,-0.0011,0.055,-0.1131,-0.0108,0.0368,-0.0576,-0.0444,-0.0135,0.1207,-0.0802,-0.0752,-0.1088,0.1091,0.0184,0.1096,0.0023,-0.0153,0.0774,-0.0809,-0.0829,0.0227,-0.0172,0.0032,-0.1412,0.165,0.2189,0.1821,0.128,-0.09,-0.2318,-0.0252,0.0919,0.0099,-0.0567,-0.042,-0.1108,-0.0346,-0.0206,0.0445,0.0942,0.0523,-0.0817,-0.0872,-0.1703,0.0083,0.0351,-0.0202,0.0889,-0.0578,0.0389,0.0908,0.0439,0.1337,0.1209,0.0844,-0.0658,-0.0495,0.0047,0.0311,0.0183,0.0153,-0.1048,0.0026,0.141,-0.1125,-0.0124,-0.0367,-0.0107,-0.0513,0.0664,-0.0458,0.1619,0.1587,-0.0469,-0.1344,-0.2158,0.0013,-0.0374,-0.0485,0.0054,0.0062,-0.2759,-0.0655,-0.0383,-0.1273,-0.1577,-0.063,0.0198,-0.2014,-0.1992,0.1317,-0.0055,-0.0524,0.2161,0.1201,0.106,0.1007,-0.0831,0.24,0.0823,0.1307,0.0687,0.1424,-0.073,0.0062,-0.1797,0.0633,0.0413,0.0609,-0.0071,-0.0816,-0.0246,-0.0444,-0.1027,-0.0671,0.0147,-0.0072,0.0358,-0.1036,-0.1481,0.0834,-0.124,-0.0475,-0.0024,0.0462,0.0888,0.0617,-0.0637,0.154,0.2439,0.1347,0.0228,-0.0972,-0.0966,0.0456,0.0092,-0.0253,-0.0044,0.1221,0.1184,-0.0039,0.1347,-0.047,0.1454,-0.0301,0.076,-0.1149,0.1139,0.0699,0.0987,0.1848,0.1607,0.1014,-0.2311,0.1039,0.1104,0.0944,-0.0911,-0.0036,0.1661,0.0629,0.1225,-0.0043,0.0554,-0.1063,-0.0389,-0.0396,-0.1499,0.1883,0.077,0.0555,-0.0697,0.115,-0.0198,-0.1952,-0.0553,-0.0836,-0.4192,-0.1056,0.0492,0.0742,0.1101,0.0961,0.0437,0.0384,-0.0175,-0.1248,-0.078,-0.0466,0.0986,-0.0577,-0.174,-0.0164,0.0368,0.0721,0.0259,0.1432,0.0493,0.0388,-0.0526,-0.0207,0.0771,0.013,-0.1908,-0.045,0.122,0.0112,-0.0735,-0.0051,0.0064,0.0527,0.1079,0.1142,0.1193,0.1336,0.1095,-0.0612,-0.0374,0.0196,0.101,-0.0103,0.0961,-0.0168,0.096,0.0637,0.0559,-0.007,-0.0686,-0.0704,0.04,-0.0201,0.0407,-0.0825,-0.1216,-0.0999,-0.1803,-0.0904,0.0581,0.0399,0.013,0.013,-0.0912,-0.1044,-0.1278,0.0192,-0.0562,-0.0537,-0.1654,0.0073,0.0583,0.0327,-0.0915,0.0366,-0.1032,0.1452,0.0752,0.0764,0.0727,0.0496,-0.0286,-0.0813,-0.0069,-0.0855,-0.1778,-0.184,0.0975,0.0498,0.0088,0.0382,-0.0114,0.0039,0.021,0.0539,0.1362,0.0491,-0.113,-0.1034,0.1208,0.108,0.0455,0.1854,0.0756,-0.136,-0.0794,-0.0729,-0.1206,-0.1013,0.0637,-0.0093,-0.0789,0.0253,-0.0056,0.0337,-0.0315,0.0343,-0.0005,-0.0054,-0.0115,0.1143,-0.0184,0.1058,-0.0425,0.146,-0.0153,-0.0911,-0.0938,0.1065,0.0212,0.0494,0.1063,0.0183,0.0402,0.0865,0.0911,-0.0106,0.0231,-0.0535,0.0813,0.0489,0.0334,0.0063,0.0264,0.0392,0.0606,0.1466,0.1117,0.1164,-0.1568,-0.0118,-0.1054,0.1282,-0.2321,-0.164,0.0242,-0.0083,0.0065,-0.0536,0.0373,-0.1221,0.1098,0.1238,0.0111,0.0572,0.121,0.0198,0.0392,-0.1112,-0.1177,0.0365,0.0188,0.0274,-0.0471,0.0136,-0.0352,-0.0252,-0.0171,0.0969,0.0421,0.0325,-0.0954,0.0033,0.0136,-0.5355,-0.3791,-0.3239,-0.1595,-0.171,-0.1114,-0.3244,-0.2422,0.1464,-0.3901,-0.3598,-0.2806,-0.221,-0.3301,-0.1218,-0.1358,-0.0863,-0.0086,-0.0396,-0.0034,-0.0461,-0.0216,0.076,-0.0985,-0.1188,-0.021,-0.0948,0.064,0.0914,-0.158,-0.0634,0.0789,0.0482,0.056,-0.0723,-0.0558,-0.1724,0.0619,0.1365,0.0255,-0.0563,-0.0656,-0.1473,-0.1552,0.0515,0.0743,0.1542,0.0954,0.0771,-0.3621,0.0726,-0.2918,-0.2259,0.0555,-0.0595,0.0432,-0.0314,-0.0594,-0.0162,-0.2264,-0.1258,0.0627,-0.0065,-0.0009,0.0458,0.127,-0.0323,0.0562,-0.0315,-0.0214,0.0773,0.041,0.1363,0.0356,0.0304,0.0066,0.1769,0.0124,-0.207,-0.018,-0.0024,0.0551,-0.1264,-0.0822,-0.0242,0.1571,0.1647,0.0448,0.1017,0.0356,0.0996,0.0277,0.0634,0.054,0.0026,-0.0038,-0.028,-0.1739,0.0395,0.0699,0.0848,-0.0492,0.0505,-0.0344,0.1093,-0.0306,-0.1588,0.0242,0.1197,-0.0937,-0.0784,0.0896,0.1167,-0.0459,0.1941,0.0703,0.2296,0.0274,-0.0638,0.093,0.0873,-0.0381,0.0822,-0.0257,0.0852,0.0182,0.0721,0.0746,0.0928,-0.1227,0.0165,-0.478,-0.364,-0.3272,-0.4188,0.1065,0.0318,0.1053,0.1033,0.1358,-0.0115,0.0961,-0.2529,0.0778,0.0874,-0.0827,-0.0711,0.0491,-0.0702,-0.0492,-0.0093,-0.0043,-0.0572,0.1029,0.1041,0.0892,-0.1622,0.0153,-0.0064,0.0606,0.0606,0.1432,-0.0025,0.0304,-0.0044,0.0439,-0.0781,0.058,-0.2331,0.2433,0.2261,-0.0652,0.0286,0.1797,0.1797,0.1799,0.0217,0.0396,0.0512,-0.0118,0.0292,-0.1202,-0.0459,-0.1241,0.067,-0.094,0.0108,-0.0293,-0.0424,0.0502,0.0765,0.0625,0.054,0.0325,0.0336,-0.0242,-0.0775,-0.0556,-0.0477,-0.0269,-0.0574,0.0175,-0.1396,0.0173,-0.0112,0.0066,0.1164,-0.0534,0.1604,0.2868,0.0563,0.0905,0.2121,0.0389,0.0765,0.1618,0.002,0.0778,-0.0353,0.1604,-0.0005,0.0799,0.2019,0.0093,-0.0089,0.0312,-0.3288,-0.1196,-0.0666,-0.0754,-0.0014,-0.0615,0.0331,0.0904,0.085,-0.0023,0.0773,0.0096,0.0619,-0.0146,-0.0676,-0.0334,-0.0253,0.073,0.0974,0.047,-0.0227,0.012,0.0563,-0.0063,-0.0826,0.0157,0.0854,0.0199,0.0962,0.0984,0.0126,0.1402,0.1703,-0.0197,-0.0296,-0.1195,-0.0581,0.0468,0.121,0.1038,-0.033,0.1074,-0.0066,0.0067,0.0263,0.1074,0.155,-0.0112,-0.1351,-0.0733,0.015,-0.0426,0.0316,-0.2432,-0.0241,-0.0427,-0.0307,0.184,-0.13,0.0084,-0.1934,-0.0653,-0.2151,-0.0255,0.0912,0.0565,-0.1582,0.052,-0.0673,0.0636,0.0459,0.1336,0.0721,0.0365,-0.0594,0.0646,0.0087,0.1017,-0.0051,-0.0155,0.0373,-0.0151,0.1299,0.0073,0.0272,0.0858,-0.0449,0.0425,0.074,0.0622,0.1005,0.0934,0.0833,0.0506,0.0553,-0.0305,-0.0252,-0.0803,0.0546,0.0407,0.0251,-0.0043,-0.0073,0.0624,0.1883,-0.0696,0.0999,0.0077,-0.0046,-0.0639,-0.0625,-0.0282,-0.0504,0.0712,0.0318,0.0697,0.0389,0.1828,-0.0082,0.1295,0.0319,-0.0398,0.0525,0.0639,0.1064,0.0897,-0.059,-0.0277,0.0459,-0.3523,0.0672,-0.0137,-0.0122,-0.2427,0.0056,0.0371,-0.105,-0.2323,0.0834,0.0296,0.148,0.1432,0.1006,0.0232,-0.0344,0.0269,0.0916,-0.1347,-0.2028,0.0552,0.0624,0.02,0.0049,-0.0484,-0.0717,0.2427,0.1368,0.0439,0.2159,0.19,-0.0801,-0.1315,-0.0458,0.0116,-0.0947,-0.0389,0.1783,0.0803,0.0953,0.094,0.1816,0.0458,0.065,0.074,0.1297,-0.1416,-0.0165,0.0038,-0.0317,-0.0296,-0.1362,-0.0941,0.0477,-0.071,0.0183,0.0583,0.0823,0.0294,-0.0578,-0.0091,-0.0001,-0.1454,-0.0671,-0.0508,0.0607,0.0824,0.0543,-0.29,-0.2751,0.1575,0.1431,-0.0188,0.077,0.0686,0.0508,0.171,-0.0205,0.0019,0.0278,-0.0125,0.0388,-0.149,0.0968,-0.0613,-0.0683,0.0656,-0.0128,-0.2587,0.0665,0.0687,-0.267,-0.0789,-0.031,-0.1075,-0.0682,0.0668,-0.0766,-0.0323,0.0582,0.0366,-0.0043,-0.0554,-0.0733,-0.0929,0.0456,0.0225,0.048,-0.1404,0.1309,-0.0536,-0.1556,0.0375,0.0298,-0.0477,0.0038,0.12,0.0293,-0.0668,0.0225,-0.0234,0.1057,-0.0434,-0.0881,0.0436,0.0291,-0.05,-0.0859,-0.0268,-0.1669,-0.1079,-0.1654,-0.0504,-0.1365,0.0324,-0.0123,-0.4797,0.1039,0.163,0.0829,0.0522,-0.0325,-0.0783,-0.0864,0.0402,-0.0108,-0.0257,0.0278,0.0057,0.0074,0.0471,0.0037,0.0182,-0.023,-0.0868,-0.1315,-0.2153,-0.2356,0.0411,0.1112,0.0867,0.0374,-0.0685,-0.0576,-0.0253,-0.1258,-0.0954,0.0414,-0.0928,0.049,0.1915,0.1071,-0.0529,-0.0611,-0.0083,-0.0806,-0.0383,-0.2891,-0.2338,-0.0241,0.0158,0.1201,-0.0054,-0.022,-0.0688,0.0669,0.1015,0.1359,-0.0598,-0.0022,-0.0171,-0.0893,0.0411,0.0206,-0.0846,-0.039,-0.0001,-0.1483,-0.0296,-0.0163,-0.0661,-0.0518,-0.1223,-0.1599,-0.2164,0.0279,-0.034,-0.0379,-0.0178,0.1022,-0.0095,0.188,0.0958,0.0295,0.1061,0.0008,-0.1168,0.1034,0.0519,0.0657,0.0223,0.0166,0.0359,0.0215,0.0722,0.0102,0.0067,0.0971,0.0115,-0.1415,-0.0165,-0.038,0.1991,0.1296,0.1439,0.0198,0.0481,0.1272,0.0819,0.0099,0.116,0.0517,-0.1005,0.0104,-0.0974,-0.0575,-0.0176,-0.0419,0.0087,-0.0296,-0.0369,0.0533,0.1898,-0.0165,0.1118,0.0613,0.0364,-0.0262,-0.0713,-0.2804,-0.1845,-0.0784,-0.0439,0.1169,0.2654,0.1312,0.1917,0.1234,-0.021,0.0153,-0.0405,0.0882,0.1472,0.1801,0.082,-0.0115,-0.0558,0.0463,0.0632,0.0133,0.0099,0.1615,0.1001,0.0758,-0.0409,-0.0111,0.0189,0.2218,0.1367,0.1334,0.1169,0.2853,-0.0467,-0.0297,0.0475,0.0874,0.0751,0.0674,0.0062,0.1739,0.0344,0.0577,-0.0165,-0.1081,-0.0225,-0.0238,-0.0684,0.1476,0.0474,0.0141,-0.0679,0.0671,0.0459,0.0663,-0.1338,0.1204,0.1304,0.0924,0.0778,0.063,0.144,0.0697,0.0756,0.0517,0.0734,0.0395,0.0408,0.223,-0.0202,0.092,0.1149,0.1017,0.0902,0.0209,0.1519,0.1079,-0.0012,-0.2289,0.0135,-0.016,0.2072,0.0985,0.1132,0.0737,0.1713,0.1035,0.005,-0.1166,-0.1143,0.0475,0.0837,-0.0208,-0.2042,-0.2027,-0.1699,0.2442,0.2449,0.067,-0.0424,-0.006,0.1294,0.0039,0.0291,-0.0452,0.058,0.0969,0.0666,-0.0027,0.0746,0.1105,0.0051,0.1128,0.046,0.0175,0.0928,-0.1346,-0.1629,0.0942,0.1233,0.1331,0.1512,0.0777,0.1967,0.1047,-0.4262,0.0911,0.118,0.0006,0.0144,0.0609,0.0151,0.0289,0.0045,-0.0508,0.0599,-0.0406,-0.0009,0.1101,0.0071,-0.0009,-0.124,-0.2971,0.1824,-0.0288,-0.0949,-0.3873,0.0004,0.0051,-0.0454,-0.0057,0.0093,0.0076,-0.1684,-0.0076,-0.0629,0.1262,0.1018,0.1285,0.0303,0.0828,-0.0889,-0.1671,-0.1813,-0.0885,-0.1055,-0.0725,-0.1477,-0.1108,-0.0654,0.0057,-0.0252,-0.0497,0.2385,0.0979,0.1764,0.0969,0.001,0.1509,0.1,0.067,-0.014,0.0512,0.2058,0.0814,0.0675,0.0964,0.2472,-0.0342,0.1787,0.0388,-0.0433,0.1024,-0.0155,0.1596,0.077,0.0358,0.0882,0.0637,-0.0151,0.1206,-0.1051,-0.0677,-0.0978,-0.0027,0.1176,-0.0143,0.0187,-0.0146,-0.0858,-0.0122,0.0325,-0.0558,0.0044,0.0407,0.1765,0.0774,0.0323,0.0324,-0.065,0.027,0.1164,0.1131,0.0134,0.0761,-0.1022,0.1367,0.0349,-0.0148,0.0007,-0.0023,-0.0175,-0.0814,0.2281,0.0084,0.1273,0.1204,-0.0771,-0.1363,-0.1494,0.0362,-0.4632,-0.3221,0.1811,0.1158,-0.4728,-0.2034,-0.0492,-0.1634,-0.1895,-0.1467,0.1527,0.1477,0.0865,0.1049,-0.5762,-0.4908,-0.3585,-0.0968,-0.1892,-0.2736,-0.5016,-0.4986,-0.4378,-0.0297,-0.0047,0.0656,-0.0366,0.0421,-0.0016,0.1395,0.0678,0.0007,0.0307,0.1325,0.1059,-0.099,0.0339,-0.0019,0.0559,-0.1054,-0.0732,-0.1178,0.0391,0.0446,0.1211,0.0042,-0.0157,0.0192,0.079,0.0742,0.0654,-0.0,0.1143,0.2024,0.1855,0.017,0.0902,0.0162,-0.2291,-0.0276,-0.1416,-0.086,-0.0813,-0.2464,-0.0097,0.1882,0.2157,0.031,-0.063,0.0145,-0.1513,-0.1146,-0.1521,-0.0375,0.1325,0.1283,0.0953,0.0852,-0.0341,0.2501,0.1964,-0.0134,0.0296,-0.0862,0.0606,-0.0208,-0.0525,0.0199,-0.0526,-0.0757,0.0074,0.0972,0.1398,0.0016,-0.0409,0.0629,0.0821,0.0932,-0.0654,-0.1236,-0.0992,-0.0182,-0.1609,0.053,0.0118,-0.0725,-0.0284,-0.1583,-0.1098,-0.0618,-0.0462,0.0078,-0.1242,-0.1389,0.087,0.0954,0.0569,0.0446,0.0626,-0.0382,-0.0036,0.0395,-0.0024,-0.0417,-0.0692,-0.0125,-0.1659,0.0035,-0.1798,-0.1884,0.1355,0.15,0.0898,0.1415,0.1826,-0.1522,-0.0113,0.0629,0.0843,-0.1612,0.024,0.1898,0.1034,-0.0655,0.0432,-0.0514,-0.0467,-0.1272,-0.1635,-0.2999,-0.4414,-0.1202,0.0033,0.0707,0.0131,-0.0464,0.118,0.1234,0.0781,-0.0268,0.0602,-0.0457,0.0319,0.0854,0.027,0.148,0.1682,0.1161,0.0792,0.0162,0.0771,0.1547,0.1066,0.0325,0.0087,0.0572,0.0686,0.0592,-0.1203,-0.1161,-0.0402,0.0401,-0.1783,-0.1243,0.0795,-0.15,0.1809,0.119,-0.0327,0.024,0.0282,0.0142,-0.0108,-0.0284,-0.0129,0.077,0.044,0.0129,-0.0006,-0.0473,0.1004,-0.0959,-0.0274,-0.0789,-0.0262,0.145,0.1123,0.0559,0.0767,0.0946,0.0692,0.0938,0.0055,-0.0441,0.0379,-0.0687,0.2368,0.1152,0.1457,0.1984,0.1718,0.14,0.1018,0.1018,0.0326,0.0306,-0.0446,0.1889,0.0062,0.0999,0.099,-0.0086,-0.0137,0.3021,-0.1168,0.1647,0.0057,-0.0192,-0.1312,-0.0956,-0.0102,0.1151,0.1276,-0.0322,-0.0784,0.0214,-0.1001,-0.0253,0.0277,-0.0729,-0.0424,-0.0032,-0.0208,0.0345,0.0583,0.0168,0.1457,0.1177,0.048,0.0938,0.0303,0.0293,0.0233,-0.0428,0.0289,0.0144,-0.0513,-0.1578,0.0295,-0.1415,-0.0628,0.2618,0.086,0.2937,0.0375,0.1206,0.0451,0.0669,-0.0716,-0.0765,0.0064,-0.0814,-0.0649,-0.0493,-0.1624,-0.0512,-0.3447,-0.1848,0.0028,-0.1105,0.129,-0.0647,-0.0446,-0.0766,-0.0088,0.0452,-0.0381,0.0394,0.0074,0.0802,0.075,0.0886,0.0925,0.029,0.024,0.1523,-0.3814,-0.0043,-0.0765,-0.1055,0.0339,-0.0393,0.0244,0.0171,0.1599,0.0946,-0.0951,-0.0799,0.0848,0.0436,0.0602,-0.0123,-0.0538,-0.1597,-0.0042,0.0125,-0.0251,0.0683,-0.0992,0.1096,0.0191,-0.0084,0.0189,0.0204,0.0497,0.1045,0.0576,0.0385,-0.0328,0.1105,-0.1245,0.0235,-0.1641,-0.0075,-0.0163,-0.0914,-0.0051,0.0926,0.0569,0.099,0.0694,0.0148,-0.0637,0.0227,0.0785,-0.0175,-0.0834,-0.0305,0.1277,0.1045,0.1739,0.1392,-0.0599,0.0161,0.0005,0.1058,0.0733,0.0882,0.0516,0.0978,-0.0091,-0.0223,0.1092,-0.1515,0.076,0.0664,0.0663,-0.0095,0.1368,0.0286,-0.1105,-0.0501,0.196,-0.0643,-0.0324,0.0817,-0.099,-0.0986,-0.0104,-0.0493,0.0726,0.0958,0.0803,0.1498,0.1554,-0.0176,0.1333,-0.0351,-0.0427,-0.0831,-0.0803,-0.0985,0.1191,0.0856,-0.021,-0.1339,-0.2297,-0.0268,0.0334,0.0049,0.0215,0.1199,0.0217,0.1151,0.0953,0.0756,0.0567,0.0802,0.1632,-0.2099,0.0051,-0.0032,-0.2301,-0.0283,-0.0612,0.1292,0.0128,0.0112,-0.0752,0.0897,0.0288,-0.0038,-0.0052,0.0594,0.062,0.0643,0.1153,0.0194,0.0422,0.1904,0.0206,0.0192,0.028,0.0335,-0.0303,-0.0066,-0.0175,0.0724,-0.1408,0.1755,0.0882,0.1062,0.1609,0.0022,0.1539,0.105,0.254,0.1309,0.0791,-0.0564,0.1726,0.0233,0.0879,-0.0791,-0.0658,-0.066,0.1281,0.1467,0.076,-0.0042,-0.0564,-0.0895,0.0595,0.012,0.063,-0.0688,-0.0637,-0.037,-0.1351,0.0008,0.0701,-0.0339,-0.0116,0.0211,-0.0641,0.003,0.0427,0.0347,0.0228,-0.1511,0.0191,-0.1646,-0.1412,0.0326,0.0019,-0.0152,0.1674,0.0532,0.0178,-0.147,-0.2244,-0.1026,-0.0571,-0.0135,0.0062,-0.1341,-0.1487,-0.0837,-0.0742,0.1779,0.0376,0.055,-0.1531,0.0248,-0.0295,0.0118,0.0248,-0.0471,-0.0158,-0.0845,0.0469,-0.0861,0.0046,0.1122,-0.1129,-0.1238,-0.0454,0.0063,-0.0932,-0.1396,-0.0277,-0.0658,-0.0475,0.0913,-0.0441,-0.1328,-0.1288,-0.0231,0.0204,-0.1391,0.0441,0.126,0.3124,0.3031,-0.0552,-0.0709,-0.056,-0.0126,-0.0088,0.0526,0.0961,0.0456,0.0949,-0.0628,0.0059,0.0205,0.0479,-0.0639,0.0036,0.1523,0.009,0.1321,0.1454,0.003,0.0341,-0.0265,0.2264,0.1091,-0.0105,-0.0049,0.0233,-0.1069,0.033,0.125,0.092,-0.2105,0.1254,-0.0564,0.0072,0.0089,-0.0161,-0.1256,0.1243,-0.1806,-0.1816,0.0807,0.0717,0.0863,-0.0401,0.0713,0.1135,0.1342,0.1907,0.0669,-0.0095,0.0291,-0.0692,0.0105,0.0271,0.1098,0.1608,-0.1959,-0.1706,0.1629,0.0507,0.0523,0.0795,0.1792,-0.2638,-0.1399,0.104,-0.0245,-0.1373,-0.0569,0.1512,0.1615,0.1665,0.2222,0.0829,0.096,-0.0602,-0.0475,-0.0406,-0.0447,0.0594,-0.0503,-0.4129,-0.202,-0.1071,-0.3733,0.2503,0.1883,0.115,-0.0135,0.0182,0.0353,0.0898,-0.0163,-0.0333,0.169,0.1512,0.0419,-0.2939,0.0931,0.0405,0.0334,-0.0684,-0.0989,-0.1457,0.0359,0.1,0.097,0.0787,-0.0261,-0.103,-0.0704,-0.0688,-0.0243,-0.0076,-0.0433,-0.0523,-0.0277,0.0121,0.1133,-0.0067,-0.0035,-0.0117,0.0079,-0.006,-0.0297,-0.0023,-0.0203,-0.0206,0.0035,0.0246,0.1769,0.1364,0.0604,0.1601,-0.3509,-0.0306,-0.2681,-0.09,-0.0462,-0.0465,-0.0608,-0.0832,0.0251,-0.1099,-0.1805,-0.0659,-0.0598,-0.0573,-0.0436,0.0708,0.0438,0.1241,-0.0118,-0.2923,-0.1746,0.0698,0.0098,-0.0031,0.0673,-0.0238,-0.0543,0.0831,0.0957,0.0044,0.1486,-0.0707,0.0636,-0.1184,-0.0893,-0.1239,-0.0043,0.0286,0.0128,0.0172,0.0282,-0.0784,-0.1654,0.0045,-0.0418,0.081,-0.1327,0.088,0.1234,0.0353,-0.1432,-0.0587,0.0139,0.1544,0.0505,0.1067,0.0902,-0.0092,0.0069,0.0356,-0.0106,0.0948,0.1188,0.0895,0.0649,0.0942,0.044,0.0564,0.0016,0.0561,0.0106,0.1514,0.158,0.1366,0.0572,-0.0092,0.0785,0.0881,-0.0985,-0.1569,-0.0351,0.0624,-0.2639,-0.2858,-0.1529,0.0331,-0.086,-0.0441,0.0716,-0.0116,0.0401,-0.0509,-0.1924,-0.2463,0.0071,-0.0169,-0.1196,-0.0523,0.0909,0.0279,0.0001,-0.006,0.076,0.06,0.0452,0.1022,-0.0013,0.1589,0.1371,-0.1134,-0.0262,0.199,0.0021,-0.0706,-0.1109,0.0402,0.0789,0.3231,0.2849,0.1241,0.2044,-0.2664,0.0339,0.0468,-0.082,0.0097,0.0695,0.1029,0.039,-0.3095,-0.1506,-0.3016,-0.1336,-0.0813,0.1189,0.0915,-0.0342,0.0279,-0.0127,0.0024,0.0331,-0.2847,-0.1723,0.1021,0.209,0.0769,0.1195,0.158,0.0476,0.0784,-0.0748,-0.0754,-0.0339,0.0144,0.0111,0.1546,-0.0099,0.1058,-0.005,0.1577,0.1711,0.0106,-0.1268,0.0677,0.0381,0.0521,0.1305,0.0821,0.1583,0.0739,0.103,0.056,0.0167,-0.0157,0.0297,0.0599,-0.0382,0.0071,-0.0061,0.1117,0.0651,0.1337,-0.0327,-0.0979,-0.0346,0.0706,-0.1118,0.0952,0.0729,-0.0976,-0.0448,-0.0302,-0.0007,-0.0047,0.0237,0.0389,-0.0182,-0.1824,-0.2763,-0.2565,-0.0442,-0.1261,-0.0032,-0.0983,0.1084,-0.1442,0.0131,-0.1835,-0.0246,0.028,0.0476,-0.0753,0.0319,0.0213,0.0035,-0.0278,0.0549,0.0472,-0.0805,-0.0682,-0.0003,0.1041,-0.0752,-0.0729,-0.0473,0.166,0.1198,0.1733,0.0112,0.1385,0.117,-0.011,-0.0142,-0.0196,0.024,0.1062,0.106,-0.0403,-0.0375,0.118,0.0214,-0.2059,-0.0356,0.0535,-0.1332,-0.1313,-0.0864,-0.0435,-0.1015,0.1086,0.0372,-0.2495,-0.0486,0.0748,-0.1934,-0.024,0.0132,-0.0558,-0.1649,-0.0655,0.1112,0.1182,0.101,-0.0791,-0.1786,0.0462,-0.0877,0.0139,0.0122,0.022,0.0715,-0.0252,-0.2041,0.0658,0.1086,-0.0816,0.0282,0.1089,-0.0073,0.0503,0.0729,0.0752,0.0832,0.0796,0.1657,0.1139,-0.0833,-0.19,0.0542,0.0403,0.0495,-0.0476,0.0056,0.0879,0.1155,0.1705,-0.0542,-0.0336,0.1528,0.1495,0.0856,0.0464,0.083,0.1339,0.003,0.1234,0.0792,0.1619,0.0273,-0.0002,0.0893,0.0421,-0.01,0.052,-0.0707,0.0803,-0.0214,-0.1101,-0.0909,0.1415,0.0185,0.1043,0.1223,0.063,0.043,0.0453,-0.0546,-0.1142,-0.1717,0.0327,0.0746,-0.0633,0.0513,0.0408,-0.1071,0.1625,0.0645,0.1306,-0.0744,-0.0444,-0.1154,0.0377,0.2111,0.1588,0.0607,0.0395,-0.0154,-0.1262,-0.1488,-0.0074,0.0843,0.0924,0.0794,0.1433,0.2558,0.1075,0.1065,-0.008,0.0332,-0.0378,0.0108,-0.1224,0.0165,-0.0297,-0.0058,-0.087,-0.1195,-0.0442,0.0091,-0.0343,0.1107,0.0233,0.0943,0.0712,0.0444,0.0199,0.0475,0.029,0.1138,0.0842,0.0673,0.0275,0.0692,0.0348,0.0097,-0.1699,0.0099,-0.129,-0.0478,-0.0653,0.0011,-0.0717,0.0047,0.0653,0.1333,0.0531,-0.1397,-0.0272,-0.0182,0.0865,0.0806,0.1233,0.0757,-0.0238,0.0434,-0.0589,-0.1204,0.1885,0.1344,0.0013,0.1158,0.0647,0.0388,-0.5017,-0.3958,0.1066,-0.0751,0.0541,0.0021,0.0634,0.1448,0.1778,0.1334,-0.0658,0.0234,0.0948,0.0103,0.1394,0.0631,-0.1512,-0.0069,-0.0604,0.0191,-0.0044,-0.0265,0.1305,0.0093,-0.1334,0.1252,-0.0457,0.1496,-0.1353,0.1668,-0.4121,0.0324,0.0043,0.1791,0.1655,-0.0097,-0.0524,0.0396,-0.0693,0.0064,-0.0763,0.044,-0.0563,-0.0761,-0.1526,-0.1282,-0.2138,-0.173,-0.2686,-0.3253,0.0606,-0.0659,-0.3806,-0.6502,-0.2596,-0.2315,-0.5155,-0.3117,-0.2814,-0.3872,-0.2109,-0.3464,-0.2885,-0.1955,-0.3318,-0.2051,-0.3292,-0.285,-0.3295,-0.2617,-0.2833,-0.1352,-0.2102,0.1743,0.1449,0.147,0.0946,0.0287,0.1968,0.2064,0.0763,0.0474,0.0604,0.2224,0.1896,0.1366,-0.0007,-0.0002,0.1356,-0.1877,0.0152,0.1265,0.0411,0.1169,0.0907,0.1029,0.0249,0.1172,-0.0839,0.1721,0.193,-0.0928,0.0356,0.0812,-0.0227,-0.0268,0.1032,-0.0093,-0.0172,0.0938,-0.136,-0.2939,0.0536,-0.104,-0.0999,0.1094,-0.0682,-0.069,0.0205,0.077,-0.1496,0.0037,-0.0387,0.1092,0.0337,-0.1625,0.0566,0.0791,0.0188,0.0295,0.0655,0.0507,inhibition
trm_4a3fd79d0b64e,-0.0328,0.0111,-0.0537,0.0305,-0.0241,0.0193,-0.0175,-0.0594,-0.0395,0.0082,-0.0104,-0.0232,0.0018,0.0232,0.0579,0.0432,0.0007,0.0679,0.0029,0.0563,0.0221,-0.009,0.0134,0.0262,-0.0309,-0.0307,-0.0269,0.0281,0.0397,-0.0429,0.0213,0.0601,0.0265,-0.0382,0.0634,0.0357,-0.0338,-0.0018,0.0503,0.0333,-0.0015,0.0437,0.0215,0.0143,0.0084,0.0387,-0.0438,0.005,-0.0079,0.0091,0.0128,-0.075,-0.0448,0.0045,0.0321,0.0121,0.0078,0.0298,0.0081,0.0041,-0.0404,-0.0667,0.0614,-0.0409,0.0157,-0.1044,0.0749,0.0825,0.0624,-0.0333,0.0219,-0.0516,-0.0391,0.0463,0.0593,0.0382,0.008,-0.0059,0.0269,-0.0087,-0.0125,-0.024,0.0732,0.0471,-0.0092,-0.0696,0.0055,-0.0655,0.0189,-0.0267,0.0006,-0.0934,0.0107,-0.1412,-0.1062,-0.1146,-0.0479,-0.0161,-0.1693,-0.1222,-0.0379,0.0408,-0.0715,-0.1138,-0.0226,0.0775,0.0651,0.0108,0.0092,0.0037,0.0227,0.049,-0.0104,-0.0484,-0.0013,0.0415,0.0299,-0.0681,0.0353,0.0177,0.0918,0.0775,0.1023,0.0305,0.0166,0.0624,0.0793,-0.0486,-0.0567,-0.0797,0.0535,0.0194,0.0174,0.0823,0.0236,0.0441,-0.0396,0.0585,0.0434,-0.0331,0.0251,0.0166,0.0605,0.0444,0.0006,-0.0006,-0.0433,0.0233,0.0481,0.0217,0.0006,0.0414,0.0173,0.081,-0.0122,-0.0456,-0.043,0.009,0.0097,0.0044,0.01,0.0382,0.0761,0.053,0.0108,0.0304,-0.0013,0.069,0.0672,0.0373,-0.0215,0.0468,-0.0799,0.0911,0.0347,0.0585,0.0392,0.06,0.0457,-0.0602,0.0356,-0.026,0.0518,-0.0037,-0.0635,-0.0216,-0.0053,0.0437,0.0644,0.0393,0.0369,0.0211,-0.013,0.0816,0.0785,0.0746,0.08,0.0364,0.0923,0.0049,-0.0356,-0.1454,0.0595,0.0264,0.0751,-0.0284,0.0918,0.0253,0.0141,0.0213,0.098,0.0613,-0.0245,-0.0446,0.049,-0.0031,-0.0094,0.0221,-0.0921,0.0265,-0.0311,0.0459,0.0541,-0.0096,-0.0498,-0.0123,0.0595,-0.0503,0.0401,0.0573,-0.1245,0.0247,-0.0348,0.0447,0.0363,-0.0719,0.0081,0.0454,-0.0132,0.0017,-0.0355,0.0307,0.0015,-0.0294,0.0128,0.0182,0.0775,0.051,-0.0012,0.0949,-0.029,0.0059,0.0172,0.0075,-0.0465,0.038,-0.02,0.0226,0.0192,-0.049,-0.0332,-0.0365,0.0489,-0.021,-0.0294,-0.0042,0.0465,0.0548,0.0175,0.0286,0.0348,-0.0503,0.0623,-0.0069,-0.0323,-0.0468,-0.0488,0.0168,-0.0323,-0.0223,-0.0453,0.0235,0.0079,0.0988,0.0943,0.0201,0.044,0.0074,-0.0336,-0.0083,0.036,0.0122,-0.0201,0.0498,-0.0105,-0.0122,0.0297,-0.0012,0.0245,-0.0267,-0.047,0.0984,0.0047,0.0339,-0.0791,-0.0904,-0.0063,-0.0415,-0.0532,0.0527,0.0114,-0.0127,0.0557,0.0399,0.0416,0.0253,0.0124,-0.0202,0.0123,0.0481,0.0021,-0.0164,0.0543,0.0935,0.0056,0.0285,0.0351,0.0597,-0.0207,-0.0027,-0.0193,-0.0002,0.0195,0.0163,0.0513,-0.0821,0.0112,0.0763,0.0185,0.0615,0.043,0.0163,-0.0904,-0.0732,0.0189,0.0055,0.0056,-0.004,-0.0131,0.0064,-0.0121,-0.0545,-0.0987,-0.0735,-0.0082,-0.0634,-0.0042,0.0355,0.0262,0.0241,-0.0394,0.0154,-0.0148,-0.084,-0.0807,-0.0882,-0.0085,0.0075,0.0228,0.0387,0.0402,-0.0453,0.0172,-0.0698,0.0632,-0.0051,0.0557,-0.0089,0.0435,-0.0097,0.0252,-0.1343,0.045,0.0246,-0.0065,0.0094,-0.0027,-0.0216,0.0272,-0.0175,-0.0391,0.028,-0.1092,0.0478,-0.2122,-0.2361,-0.1146,0.0041,-0.027,0.0318,0.0466,-0.02,-0.0375,-0.0282,-0.0336,0.0416,-0.0031,0.0599,0.0381,-0.0043,-0.0237,0.0416,0.0382,0.0242,0.0437,0.0467,0.0496,0.0791,0.0895,0.019,-0.0176,0.0159,0.0064,0.1015,0.1262,0.0221,0.0151,-0.0684,0.0332,-0.0207,-0.0197,-0.0327,-0.0103,-0.0378,0.0675,0.0235,-0.0234,0.0153,0.0349,0.0143,-0.013,-0.051,-0.031,0.0048,-0.0466,-0.0017,-0.0359,-0.0417,0.0884,0.0934,0.0758,-0.02,0.0334,0.0481,-0.0495,0.0968,-0.036,0.0211,0.0607,-0.0384,-0.0428,-0.0038,0.0383,0.0431,0.0344,0.0643,0.0377,0.0151,0.0172,-0.0215,-0.0342,-0.0516,-0.0758,0.0076,0.0281,0.0404,-0.0731,-0.0489,0.0056,-0.0087,-0.0901,-0.0677,-0.0729,-0.0812,0.0182,-0.007,0.011,-0.0083,0.0949,-0.0001,-0.0408,-0.0779,0.0796,0.0645,-0.0022,0.0257,0.0758,-0.0279,0.0212,0.0793,0.0775,0.0147,0.0145,-0.0096,0.0204,0.038,0.0514,0.0462,0.0423,-0.0605,0.0478,-0.0369,0.0276,0.0109,-0.0257,0.017,0.0204,-0.0045,-0.1069,-0.0106,-0.0042,-0.0311,-0.01,0.0059,-0.0217,0.0022,-0.0289,-0.056,-0.0339,0.0195,0.0168,-0.0254,-0.0423,0.0615,0.0174,0.004,0.056,0.0229,0.0136,0.0274,0.0579,0.0031,-0.0414,-0.0137,-0.0088,-0.0513,0.0403,-0.0035,0.004,-0.0059,-0.0707,0.075,0.019,-0.074,0.0144,0.0486,-0.0606,0.0034,0.0023,-0.0495,0.0525,0.0579,0.0682,-0.0448,0.0508,-0.0126,-0.0271,0.0904,-0.0034,0.0281,0.0367,0.0636,-0.0478,-0.0119,-0.2392,-0.2421,-0.0339,-0.0278,-0.0292,0.029,0.0003,0.0376,0.0359,-0.0174,-0.0438,-0.0059,-0.0235,0.0194,-0.0485,0.008,0.03,-0.0024,0.0248,0.0062,-0.0056,-0.076,0.0524,0.0094,-0.0902,0.0388,0.038,-0.0388,-0.0164,-0.006,-0.0291,-0.2229,0.0526,0.039,0.0387,0.0212,-0.0433,-0.0318,0.0017,0.0591,0.0341,0.0293,0.0232,0.0084,0.0479,0.0647,-0.0027,0.0199,-0.0328,0.0005,-0.0193,-0.0908,0.0505,0.0731,-0.0211,-0.0161,-0.0275,-0.1492,0.0585,0.0402,0.0443,-0.045,-0.0103,-0.0254,0.021,-0.0221,0.0006,-0.0458,-0.0522,-0.1737,0.0612,-0.0141,0.0969,0.0673,-0.0761,0.058,0.0446,0.0251,-0.0598,0.0589,0.0112,-0.0458,-0.1801,0.0016,-0.0143,0.033,0.0711,-0.1578,-0.1066,-0.1339,-0.0741,-0.0528,-0.0711,0.0564,-0.0876,-0.0715,-0.0157,0.0146,-0.0133,0.0055,-0.0149,0.0614,-0.1052,0.0291,0.0055,0.0038,0.0426,0.0049,0.027,-0.0213,-0.0602,0.0506,0.0291,0.0769,0.0427,-0.0484,-0.1054,0.0045,-0.0424,0.0241,-0.0497,0.0866,-0.0269,0.012,0.0138,0.0409,-0.0163,0.0364,0.0074,0.0489,0.0309,-0.0081,0.0375,0.0288,0.0091,0.0109,0.0262,0.078,0.0818,0.0146,0.1047,0.0559,-0.0554,0.0302,0.0548,-0.0449,-0.044,-0.0222,0.1107,0.1016,0.0755,0.0346,0.0199,0.0414,0.0171,-0.0335,0.0017,0.0043,-0.0309,-0.0497,-0.0307,0.0058,0.0045,-0.0303,0.0012,0.0091,0.0824,0.0038,-0.0091,0.0234,0.0608,0.0142,0.0244,-0.0263,0.0391,-0.0104,0.0333,-0.0306,0.083,0.1379,0.1153,0.0787,-0.0052,-0.0007,0.0037,-0.0271,0.013,-0.0869,-0.0143,-0.0139,-0.0307,-0.0463,0.0317,0.0145,-0.0451,0.0094,-0.0121,-0.0681,-0.0467,-0.0086,-0.0462,0.0297,-0.0249,0.0308,0.0514,0.0476,0.069,0.0714,0.0793,-0.0213,0.0468,0.0281,0.0147,-0.0236,0.0096,0.0218,-0.0413,0.0442,0.0264,0.0102,-0.0359,-0.0226,0.0139,0.0729,-0.0023,0.081,0.061,-0.0166,0.0501,-0.0458,0.0444,0.0223,0.002,-0.0033,0.0217,-0.1189,-0.0526,-0.0639,-0.0575,-0.0045,-0.0409,0.0259,-0.0403,-0.0489,0.0291,-0.0345,0.004,0.0528,0.063,-0.0075,0.0166,0.0367,0.1171,0.0323,0.0681,0.0474,0.0738,0.0299,0.0216,0.0092,-0.0054,-0.072,0.0643,-0.039,-0.0604,0.0403,0.0291,0.006,-0.03,-0.0007,-0.0516,0.0504,-0.0323,-0.0601,0.0317,-0.0803,-0.0453,-0.0124,0.0288,0.0046,0.0406,0.0103,0.0508,0.1087,0.0635,0.0352,-0.0364,0.0363,0.0833,0.0254,-0.0372,-0.1137,0.0377,0.029,-0.0761,0.0678,0.022,0.042,-0.2318,0.0462,-0.0713,0.0395,0.0685,0.0218,0.0848,0.0974,0.0499,-0.0497,0.0531,0.053,-0.0003,-0.0332,0.0134,0.0746,0.045,0.0392,-0.0267,0.0046,-0.0173,-0.0301,0.0381,-0.0583,0.0486,0.0561,0.0263,-0.0287,0.0246,-0.0411,-0.0147,-0.017,-0.0021,-0.0393,-0.018,0.0552,-0.0006,0.0623,0.0519,0.0352,0.0485,0.0237,-0.024,-0.0508,0.0084,0.0247,0.0126,-0.0319,-0.0624,-0.0188,0.0375,-0.0132,-0.087,-0.0318,-0.0444,-0.1025,0.0415,0.0515,-0.0386,-0.0676,-0.0129,0.0123,-0.009,0.0102,-0.006,0.0036,0.0028,0.0031,0.0057,0.1034,0.0926,0.1099,0.031,-0.0038,0.0401,0.0204,0.0458,0.0464,0.0894,0.0883,0.0305,0.0485,-0.0187,0.0212,0.0029,0.0607,-0.0019,0.0287,0.0051,-0.0256,0.0761,-0.0021,0.0087,0.0378,-0.013,-0.0264,-0.0256,0.0238,-0.0131,-0.0266,0.0058,0.0206,0.004,-0.0121,0.0022,0.0208,-0.0097,0.0441,0.0331,0.0081,0.0478,0.0785,0.0381,0.1176,0.1035,-0.0623,-0.0497,-0.089,-0.0201,0.0112,-0.0099,0.0113,0.011,0.0112,-0.044,-0.012,-0.0201,-0.0123,-0.04,0.0121,-0.0083,0.0095,0.0219,0.0108,-0.0176,0.0448,0.0577,0.0586,-0.0326,-0.0497,-0.0392,0.0046,0.0152,0.0611,0.0551,0.0118,0.046,-0.0135,0.0089,0.0155,-0.0078,-0.0945,-0.0296,0.044,0.0192,0.0055,0.0363,0.0148,-0.0153,-0.0688,-0.1819,-0.2114,0.0488,0.0237,0.0351,0.0427,0.0362,0.027,0.0816,0.0362,-0.0457,-0.0013,-0.0576,0.0159,-0.012,0.0143,0.0044,0.0426,-0.0788,0.0724,0.0446,0.08,0.0485,-0.0525,-0.0179,-0.0737,0.0583,-0.0726,-0.0223,-0.0145,0.016,0.0552,0.0424,0.0268,-0.0643,0.0308,0.0682,0.0415,0.0309,0.102,0.0808,0.0345,0.0007,0.0245,-0.0121,0.0549,-0.0291,-0.0189,-0.1569,-0.008,0.0021,-0.0098,-0.0045,-0.061,0.0234,0.0148,0.0002,0.0054,-0.0934,-0.1128,-0.1694,-0.1515,-0.1196,-0.1077,-0.1746,-0.06,0.0763,0.0688,0.0506,0.0565,0.0328,0.0765,0.0569,0.0245,0.0357,0.0767,0.055,0.0173,-0.0248,-0.0087,0.0348,-0.0697,-0.0773,0.0614,-0.0185,0.0431,0.0494,0.0371,0.0547,0.0775,0.0142,0.0317,-0.0291,-0.0385,-0.0693,0.062,0.066,0.0598,0.0572,0.0302,0.0701,0.0226,-0.1326,0.0308,0.0829,0.0746,0.0469,0.0523,-0.0158,-0.1881,-0.1169,0.0267,-0.0318,-0.0871,-0.2846,-0.2357,-0.2301,-0.0689,-0.0533,0.0227,-0.0324,0.0055,-0.0229,0.06,-0.0394,0.0076,-0.0886,-0.014,-0.004,-0.0239,0.0445,0.0278,-0.0065,0.0281,-0.0686,-0.2054,0.0472,0.0278,0.0191,0.0455,0.0285,-0.0781,-0.0491,0.0757,0.0809,0.0923,0.02,-0.0792,-0.0107,0.0424,-0.0005,0.0479,0.0073,0.0079,-0.0346,-0.1381,-0.0115,0.0346,0.0573,0.0243,-0.0339,0.0043,0.0544,-0.0043,-0.0673,0.0137,0.0646,0.0216,0.0189,0.0349,0.0373,-0.0451,0.0457,0.0154,0.0667,0.0209,-0.0928,0.038,-0.0028,-0.0605,0.0118,-0.0591,-0.0127,-0.0088,0.0168,0.0255,-0.0327,-0.0263,0.0238,0.0521,0.0403,-0.0153,0.0599,0.0645,0.0101,0.0628,0.0267,0.0683,0.0261,-0.0901,-0.0353,0.0727,0.088,0.0334,-0.0661,0.0561,-0.0036,-0.0111,-0.0389,-0.029,-0.1103,0.1096,0.0961,0.044,-0.0364,0.0127,0.063,-0.0677,-0.0677,0.0635,0.0561,0.0306,0.0149,-0.0668,0.0136,0.0375,-0.2046,0.099,0.1018,0.0414,0.0343,0.0468,0.0525,0.0202,-0.0468,-0.034,0.0501,-0.014,-0.0032,-0.1707,-0.0168,0.0318,0.0092,0.0417,-0.0716,-0.0111,0.0028,0.0002,0.081,0.0497,0.0462,0.0388,0.0453,-0.0408,-0.029,0.0073,-0.2459,-0.2004,-0.1926,0.0255,-0.163,0.0632,0.0203,0.0077,0.0452,-0.044,0.0862,0.0208,0.0001,0.0591,0.0838,-0.0849,-0.0531,0.0721,-0.0127,-0.0447,0.0066,0.0192,0.0248,-0.0055,-0.0161,0.0625,-0.0398,-0.0095,-0.0281,-0.0721,-0.1556,-0.0928,-0.0348,-0.0649,0.0205,0.0114,0.0134,0.0135,0.076,0.0431,0.0652,-0.0137,-0.0373,-0.0193,0.0234,0.0392,0.0721,-0.0221,-0.0585,-0.0377,0.0065,0.0259,-0.0287,0.0224,0.0226,0.0728,0.1024,0.0634,0.0367,0.0613,0.062,0.0009,-0.0026,-0.0409,-0.053,-0.0267,0.031,0.0397,-0.0899,0.0383,0.029,-0.0262,-0.0697,-0.0815,0.0741,0.0278,-0.0522,0.0802,0.0391,0.0201,0.056,0.0641,-0.0006,-0.0894,-0.09,0.0765,-0.0109,0.0077,-0.0866,-0.1521,0.0011,-0.0087,-0.0368,-0.0532,-0.0949,0.0009,-0.0414,0.0486,0.0248,0.0869,0.0781,0.0698,-0.0222,-0.0013,0.0334,0.0905,0.0054,0.0641,0.0258,0.0569,0.0158,0.0451,0.0359,0.024,-0.0314,0.0379,0.0121,0.0504,0.0658,0.0271,0.0021,0.0378,-0.0029,-0.053,0.0034,-0.0203,0.0367,0.0381,-0.0231,-0.059,-0.0675,0.0915,0.1032,-0.0156,-0.1239,-0.2208,0.0138,0.0565,0.0359,-0.0086,-0.0185,0.0018,0.0336,0.0631,-0.0067,0.1011,-0.029,-0.0141,0.0077,0.017,0.0141,0.0071,0.0526,0.0883,-0.0025,0.02,0.0346,0.0569,-0.0408,0.0502,-0.0463,0.0272,0.0067,-0.0046,0.0169,-0.0138,0.052,0.0341,0.0427,0.0023,0.0339,0.0263,0.0292,-0.0817,-0.0759,-0.1255,-0.0974,0.0352,0.0088,0.0128,-0.013,-0.0272,0.0221,0.0074,0.0009,-0.0187,-0.0062,-0.009,0.0011,-0.0517,0.0103,0.0087,-0.0674,-0.0142,0.0245,0.0523,0.0102,0.0111,-0.0105,0.0687,0.0767,0.0642,-0.0048,-0.0102,0.0178,0.0135,-0.0135,-0.0111,-0.013,-0.0325,-0.0165,0.0557,-0.0851,-0.0114,-0.0002,0.0567,-0.0239,-0.006,0.0406,-0.0582,-0.1019,-0.0671,0.0424,0.0299,-0.0013,-0.0916,-0.0829,0.0946,0.0518,-0.0143,0.0451,-0.0126,-0.0132,0.0304,0.0278,-0.0202,0.022,-0.036,-0.0035,-0.1137,0.0767,-0.0791,0.0046,-0.0496,-0.0179,-0.0497,-0.2004,0.0613,0.0034,-0.033,-0.0263,-0.0425,-0.005,0.0336,0.071,0.0715,-0.0486,-0.0278,0.0678,0.0217,0.0816,0.0147,0.0948,0.0509,0.0756,-0.055,0.0718,-0.0259,0.0391,0.0711,0.0774,-0.0069,-0.021,0.0474,0.0564,-0.0321,-0.0102,0.0066,0.0465,0.0384,0.0257,0.0345,0.0649,-0.0182,0.0415,0.0065,-0.0449,-0.1069,-0.0473,0.0472,0.0201,-0.0088,0.001,-0.0119,0.0608,0.0906,0.0561,0.0601,-0.0318,-0.0055,-0.0604,-0.0022,-0.003,-0.0168,-0.0043,0.0009,-0.0283,0.0264,-0.0344,0.0083,-0.0414,-0.0237,-0.0446,-0.0311,-0.0211,-0.028,-0.0326,0.0429,0.0187,-0.011,-0.0088,0.0578,-0.0059,0.0241,0.0432,-0.0998,-0.155,0.0762,0.0305,0.0006,0.0233,-0.0661,-0.0364,-0.035,-0.0515,-0.0619,-0.0092,0.0225,0.0576,-0.0181,0.025,-0.0168,-0.0152,-0.0031,-0.0121,-0.0084,-0.0142,0.0047,-0.0657,0.0443,0.0658,0.0372,-0.1151,0.004,-0.1545,0.0161,0.031,-0.0533,-0.0565,-0.1309,-0.0439,-0.049,0.0024,0.0121,0.0728,-0.0584,0.0124,-0.0879,0.0605,0.0505,0.0519,0.0495,0.0266,-0.0025,-0.0111,-0.2079,0.0549,-0.0769,-0.0672,-0.1006,-0.0082,0.0118,-0.0297,-0.014,-0.0536,-0.0305,-0.0539,-0.0524,-0.0241,0.0948,0.0849,0.0765,0.0108,0.0667,0.0836,0.0431,0.0575,0.0267,0.0295,0.0667,0.0274,-0.039,0.0392,0.0451,-0.0919,-0.0398,-0.0026,-0.0538,-0.0138,0.0234,-0.0598,0.0582,0.0069,0.0544,0.0515,-0.0029,0.0626,0.1058,0.0338,0.0391,0.0161,0.1078,0.058,0.0774,0.0654,0.0253,-0.0524,-0.082,0.0797,0.0722,-0.0064,-0.0023,0.0546,0.0226,-0.028,0.0345,-0.0004,-0.0522,0.014,0.0278,0.0575,0.0121,-0.0275,0.0169,0.1322,0.0378,0.0416,0.0687,0.1338,0.0121,0.0579,-0.0923,0.0546,0.0053,-0.004,-0.018,0.0665,0.0296,0.0767,0.095,0.0385,-0.0386,0.0729,-0.0316,0.1302,0.0725,0.0131,-0.0282,0.0075,0.011,0.0226,-0.048,0.0699,0.0722,0.0793,-0.0459,0.052,0.0783,0.051,0.0083,0.0288,0.0513,0.0406,0.0434,0.0812,0.013,0.0569,0.0314,0.0159,0.037,0.0854,0.0656,0.0654,0.0084,-0.0038,-0.0032,0.0731,0.0702,-0.0026,0.0885,-0.0218,0.0949,0.0898,-0.001,-0.1259,-0.0726,0.0325,-0.0139,0.0271,-0.0792,-0.0195,-0.0527,0.0816,0.0907,-0.0447,-0.0508,-0.0069,-0.0365,0.0227,0.0047,0.0482,-0.0075,0.0382,0.0403,-0.0422,0.03,0.0471,0.0175,0.0603,-0.0162,-0.0438,0.015,-0.1254,-0.0827,-0.051,0.0529,0.0528,0.054,0.0367,0.1037,0.0742,-0.0685,0.0345,0.0512,-0.2663,-0.1572,-0.2466,-0.1876,-0.159,-0.1914,-0.0844,-0.112,-0.1001,-0.0476,-0.1401,-0.2025,-0.2723,-0.2711,-0.1229,0.1002,-0.1136,-0.0229,-0.1025,0.0308,0.0575,-0.0609,0.0214,-0.0087,-0.1113,-0.0785,0.0069,0.0245,-0.0993,-0.0643,-0.0638,-0.1305,0.0232,0.0029,-0.0448,0.0024,0.0345,-0.0057,0.0187,0.0224,-0.0425,0.0434,0.0234,-0.0064,-0.0188,0.1462,0.0544,0.0637,0.0931,0.083,0.0686,0.0534,0.027,0.0304,0.0387,-0.0344,-0.1069,-0.0168,0.0091,0.1056,-0.0679,-0.0007,-0.0166,-0.0024,0.0174,-0.0484,0.0346,0.0381,0.054,-0.0017,0.0412,-0.0202,-0.0257,-0.0569,-0.0969,-0.0502,-0.0543,0.0195,0.0403,0.0407,0.0886,0.0407,0.0398,0.0387,-0.0127,0.0173,0.0418,-0.0212,-0.0116,-0.0178,-0.029,-0.0522,0.0053,0.0219,0.0414,-0.0716,-0.0456,-0.0125,0.0738,0.0035,-0.0373,0.0181,-0.0006,0.0627,-0.0149,0.0061,-0.0755,0.015,0.0475,-0.0194,-0.0144,-0.0157,-0.0431,-0.0395,-0.005,0.0607,0.0131,-0.0023,-0.1302,-0.0107,-0.0218,0.019,-0.0586,0.0803,0.0788,0.0166,-0.0334,-0.012,-0.0423,0.0172,0.0216,-0.0123,0.0066,-0.032,-0.0223,-0.0301,0.0246,-0.0143,-0.0273,0.0011,-0.0419,-0.0191,0.0843,0.0388,-0.0032,0.0404,0.013,0.0122,0.0061,0.0001,-0.0524,-0.0068,0.0129,-0.0325,0.0081,-0.088,-0.0374,-0.0766,-0.0072,0.0266,0.0168,0.008,0.022,0.0494,-0.0323,0.051,0.0961,0.0896,-0.0715,-0.0353,-0.0037,-0.0048,0.005,-0.0274,-0.0728,0.0161,-0.0267,-0.0207,0.0757,0.1145,-0.1301,0.0444,0.0492,-0.0399,-0.0528,-0.108,-0.1192,-0.0101,-0.015,0.0086,-0.0021,-0.2197,-0.0121,-0.0129,0.0051,0.0468,0.0473,-0.0677,-0.0068,0.0314,0.0308,0.0417,0.0268,0.0405,0.0201,0.0394,-0.0396,-0.0167,-0.0378,-0.0286,-0.018,0.0195,-0.0774,-0.0791,-0.0049,-0.0692,0.0824,-0.0525,-0.0284,-0.055,-0.1255,-0.0226,0.0084,0.0008,-0.0044,-0.0873,-0.0219,-0.0184,-0.0075,-0.0447,-0.0374,-0.0177,0.0023,0.0167,-0.0279,-0.0365,-0.0153,-0.0055,-0.0038,-0.1132,-0.0437,0.0212,-0.0104,0.0933,0.0339,0.0062,0.0314,0.0984,-0.0458,-0.0095,0.0241,0.0254,-0.0637,-0.0835,0.0729,-0.0028,-0.0684,0.0758,-0.0342,-0.0184,-0.0612,-0.0177,-0.073,-0.0669,-0.1587,-0.0528,-0.0063,-0.0696,-0.1202,0.0447,0.0227,-0.0216,-0.006,0.0007,-0.0924,-0.0027,-0.0045,0.076,0.0824,0.1017,0.0511,0.042,-0.0082,-0.0013,0.1033,0.014,-0.0552,-0.0301,0.0079,-0.0176,-0.0034,-0.0594,0.0378,-0.0303,-0.032,0.0268,0.0884,-0.0174,-0.0081,0.0613,0.043,-0.0713,-0.0299,-0.0298,-0.0432,0.0394,0.0047,0.0105,0.0001,0.0115,0.0813,0.0146,0.0276,0.0356,-0.0595,0.0149,-0.0311,0.017,0.062,0.0853,0.0417,0.0569,0.0324,0.0207,0.074,0.019,-0.0482,0.0304,-0.0376,0.1149,0.0439,0.0208,0.1115,0.0745,0.0548,0.0016,0.0016,0.0464,-0.019,-0.0299,0.0536,0.0351,-0.0817,-0.0481,0.0248,0.0271,0.1353,-0.0323,0.0023,0.0153,0.0391,-0.0798,-0.0033,0.0246,0.0664,0.0105,-0.0366,-0.0202,0.0299,-0.062,-0.0928,-0.1216,-0.1531,-0.0636,0.0199,-0.0034,-0.1716,-0.1053,-0.0397,0.0979,0.1122,-0.0037,0.0823,0.0139,-0.0068,-0.0037,-0.0732,0.0111,0.0061,-0.0696,-0.0078,0.045,-0.0115,0.0168,0.1414,0.0376,0.1528,0.0129,0.0391,0.001,0.0491,-0.2713,-0.2871,-0.1071,-0.1343,-0.0192,-0.047,0.0104,0.0245,-0.0201,-0.0298,-0.0189,-0.0929,0.0342,-0.0396,0.0528,-0.0052,-0.0284,0.0644,-0.0002,0.008,0.0097,-0.2021,0.0019,-0.2187,-0.0909,-0.193,-0.0719,-0.0961,-0.1119,-0.0637,0.0189,0.0507,-0.0237,-0.0335,0.0322,0.0256,0.0794,0.0383,-0.0665,0.024,0.0708,0.0515,0.0121,0.004,0.0657,-0.0078,0.0633,0.0485,-0.0361,-0.0222,-0.0816,-0.0152,0.0098,-0.1128,-0.0268,0.0364,-0.0097,0.0345,-0.0327,-0.0417,-0.0565,0.0344,-0.0916,-0.0832,-0.072,0.0028,0.0239,-0.011,-0.0425,0.0383,0.007,0.0461,0.0394,-0.0408,0.0134,0.0155,0.0629,-0.0149,-0.04,-0.0002,0.0766,0.0634,0.0716,0.0811,-0.0118,-0.0159,-0.0026,0.0707,0.0409,0.0566,-0.0083,0.0342,0.0129,0.02,-0.0917,-0.0115,0.0438,0.0329,0.0268,0.0279,0.0337,0.0434,-0.0808,-0.0927,0.0519,0.0305,-0.0355,0.0002,-0.0128,0.0011,-0.0269,0.0106,-0.0229,0.0624,-0.0638,0.0221,0.0605,-0.1239,0.0681,-0.0867,-0.1355,-0.0456,-0.0494,-0.0421,0.021,0.0799,0.0645,0.0355,-0.0036,0.0166,-0.0327,0.019,0.0292,0.0396,0.0735,0.0489,0.0473,0.0438,0.0177,0.0119,0.061,0.0912,0.1019,0.045,0.0463,0.0536,0.0503,0.1291,0.005,-0.0248,-0.0616,-0.0519,0.0163,-0.0138,-0.0653,0.0083,0.0404,0.0132,0.0281,0.014,0.0272,0.0895,0.0269,-0.0095,0.044,0.0634,-0.0141,-0.0347,0.0103,0.0321,-0.0525,0.0263,0.0059,0.065,0.0598,-0.0453,0.0453,0.0468,0.1267,0.0415,-0.0596,-0.1379,0.0627,0.0169,0.0154,-0.0319,0.0302,0.0338,0.0198,0.0615,0.0726,0.0256,0.036,0.0214,-0.0342,-0.0088,-0.0101,-0.0144,-0.0393,0.0024,-0.0433,0.0104,0.0169,0.0246,-0.0249,0.0663,0.0137,0.052,0.0115,-0.142,0.0345,-0.0291,-0.0035,-0.0543,-0.0453,-0.1326,0.033,0.0424,0.0624,0.0084,0.0214,-0.1271,-0.0659,-0.0653,0.001,0.0462,-0.0325,-0.0403,-0.0453,-0.0414,-0.0444,0.1198,0.0323,-0.0011,-0.0555,0.0306,-0.018,-0.0694,-0.0603,0.023,-0.0138,-0.0149,0.0129,-0.0091,-0.0188,-0.0014,-0.0355,-0.0423,0.0096,0.019,-0.0132,-0.0209,0.0237,-0.0457,0.0072,0.0444,-0.1084,0.0093,-0.0101,0.0538,0.0221,0.0348,0.0065,-0.0188,0.0742,0.0895,-0.11,-0.0194,-0.1,0.0146,-0.0035,0.1206,0.1061,0.0741,0.0873,0.026,-0.0261,-0.0019,0.0473,-0.0386,-0.0356,0.0684,-0.011,0.0346,0.0605,-0.1619,0.061,0.0261,0.1212,0.0589,0.0079,-0.0932,0.0042,0.0194,0.0399,-0.0633,0.0448,-0.0228,0.0592,-0.0212,0.0233,0.0144,-0.0013,-0.0293,-0.1279,-0.1328,-0.1419,0.0677,0.0837,0.0567,0.0376,0.0746,0.0173,-0.0154,0.0747,0.0425,0.0055,0.0909,0.0036,0.0427,-0.028,-0.0097,-0.0027,0.0245,0.0525,0.1241,0.0385,-0.0814,0.0038,0.0689,0.0809,-0.0678,0.0269,-0.0409,-0.0074,-0.0145,-0.1249,-0.0986,0.0506,0.0396,0.0244,0.0135,-0.0246,-0.0499,0.0243,0.0298,-0.0043,-0.0589,0.0098,-0.0408,0.0275,-0.0324,0.0713,0.086,0.0518,0.0762,0.0305,0.05,0.0661,0.0224,0.0009,-0.0069,-0.004,0.0342,0.03,0.1006,-0.2253,-0.2306,-0.1316,-0.0398,0.031,-0.1338,0.0786,0.0699,0.0482,-0.0214,-0.0686,-0.0994,-0.0173,-0.0229,-0.1714,-0.091,-0.2108,-0.0504,0.0087,0.0439,0.0112,-0.0862,-0.0266,-0.0016,-0.0409,0.0538,0.0511,-0.0191,-0.0323,-0.0242,0.0203,0.0516,0.0457,0.0537,0.0208,-0.0152,0.0256,-0.0435,-0.0626,-0.035,-0.0329,-0.0274,-0.0096,-0.0372,0.0095,-0.0514,-0.0369,-0.0524,-0.0755,-0.0125,-0.0165,-0.0258,-0.1185,-0.0765,-0.0607,-0.0362,-0.0717,-0.0895,-0.0228,0.0691,-0.0084,-0.0177,0.0481,0.0049,-0.0321,-0.1027,-0.0517,0.0527,-0.0032,0.0139,-0.1544,0.0295,0.0502,0.0128,-0.0696,-0.0254,-0.086,-0.0866,-0.0929,-0.0313,-0.0396,-0.0945,0.0682,0.0907,0.0105,-0.029,-0.0759,-0.0525,-0.0419,-0.0118,0.0471,0.0089,-0.0336,-0.218,-0.0246,-0.0101,0.036,0.062,0.1221,0.0662,0.0791,0.0404,0.0586,0.0317,0.0178,0.0647,-0.1445,-0.1208,-0.1051,0.042,-0.0243,-0.005,0.0351,0.0239,0.006,-0.0133,-0.0693,-0.0602,-0.0737,-0.0276,-0.0221,-0.0227,-0.0469,0.0058,0.0093,0.0306,0.0421,-0.0371,-0.0045,0.0609,0.0764,-0.0376,-0.0231,0.0019,0.0224,0.003,0.0053,-0.0299,-0.0227,-0.0496,0.0239,-0.055,0.0492,-0.075,-0.1049,-0.032,0.0602,0.0601,-0.0192,-0.053,0.0275,0.0126,0.0988,0.0916,0.0143,0.0475,-0.0797,0.024,0.0764,-0.0177,-0.0212,-0.0976,-0.0973,-0.0638,-0.0061,-0.0523,-0.088,0.0211,-0.0421,0.0677,0.065,-0.0157,0.0894,0.0674,0.0092,0.0189,-0.0857,-0.0749,-0.0215,0.0698,0.0504,0.003,0.0453,0.0761,-0.125,0.03,-0.0082,0.0308,0.0308,0.033,0.0469,0.0217,0.0431,0.0164,0.0806,0.027,0.0128,-0.0265,-0.014,0.015,-0.0308,-0.072,-0.0092,0.0515,-0.0853,0.0672,-0.0172,0.0747,0.0733,0.0424,-0.008,0.0131,0.0012,-0.0433,0.0627,0.0206,0.0416,-0.0571,-0.0022,-0.0366,0.0013,-0.0317,0.0833,0.1128,0.0075,-0.0471,0.0347,0.0484,0.0471,-0.0423,0.0096,0.0018,-0.0556,-0.0747,-0.0472,-0.0131,-0.022,-0.0198,-0.0668,0.0148,-0.1326,-0.0518,-0.1274,-0.0079,-0.2183,-0.2071,0.0005,0.0111,-0.0084,-0.0014,-0.0159,-0.089,-0.0854,-0.0572,-0.0009,0.0065,0.0273,-0.0606,0.0006,-0.0019,0.0601,0.0604,0.0862,-0.0299,0.0202,0.053,0.0358,0.022,-0.0563,-0.0197,0.026,0.05,-0.1313,-0.0253,0.037,-0.25,-0.091,-0.0418,0.027,-0.0594,-0.0657,-0.1243,-0.0139,0.002,-0.0174,0.0218,0.0126,-0.0604,0.0113,-0.0139,0.0135,0.0345,0.0072,-0.109,-0.0589,0.0436,0.0012,0.0167,0.0535,0.0641,0.0594,0.0477,-0.0182,0.0237,0.002,0.0961,0.052,-0.0128,0.0806,0.0581,0.0244,-0.0298,0.0202,0.0404,0.0456,0.0549,0.0547,0.0073,0.0501,0.0693,0.0557,0.0249,0.0076,-0.0039,-0.0295,0.0671,-0.0139,-0.0384,0.0214,0.0007,-0.0247,0.0611,0.0229,0.1145,0.1043,0.0147,0.0183,0.0464,0.1044,-0.0456,0.007,0.0325,0.051,0.0412,0.0549,-0.026,-0.0521,-0.0563,0.0045,-0.0379,-0.0127,-0.0635,-0.0349,-0.2076,0.0392,-0.1018,0.0924,0.017,0.0084,-0.0363,-0.0413,0.0048,-0.049,-0.0369,-0.0393,-0.0077,-0.1008,0.0903,0.0374,-0.073,0.0007,0.028,0.0411,-0.0145,-0.0039,-0.0767,-0.0987,0.0934,0.0727,-0.0799,-0.1026,-0.0041,-0.1505,-0.0029,0.0351,0.0486,0.0772,0.0213,0.0567,0.0616,0.0437,0.0286,0.024,0.0194,0.0284,0.0123,-0.0334,0.0277,-0.0228,-0.0055,0.0081,0.0423,0.0166,0.0236,0.0039,-0.0279,0.0068,0.0452,0.0482,-0.0046,0.0032,0.0218,0.0551,0.0306,-0.0137,0.0581,0.0185,0.0565,-0.0112,0.0104,0.029,-0.0659,-0.0068,0.0192,-0.0054,0.0379,0.0108,0.0112,0.0489,0.0212,0.0644,-0.069,-0.0066,-0.1413,0.0446,-0.0234,0.0583,0.0617,-0.0862,-0.0024,-0.0602,-0.0684,0.0537,0.0624,-0.0711,0.0436,-0.0034,0.0155,-0.0621,-0.1224,0.0765,0.0033,0.0135,-0.0034,-0.0442,0.0924,0.044,-0.0183,-0.0572,-0.0069,0.0042,0.0188,0.073,0.0542,-0.0235,-0.0564,-0.0311,0.0281,-0.0155,0.0174,0.0795,0.0432,-0.0143,0.0616,0.027,0.0586,-0.2305,0.0765,0.0168,0.0317,0.0429,0.1014,0.0897,-0.0304,-0.0224,0.0058,-0.0822,-0.0124,-0.1581,0.0241,0.0434,-0.1256,-0.0522,-0.0245,0.0124,0.018,0.0294,0.0149,0.0183,0.0332,-0.0372,-0.1064,-0.0418,-0.0417,-0.1009,-0.0295,-0.0281,-0.1084,-0.1217,-0.0898,-0.0428,-0.0036,-0.0033,-0.0656,-0.0665,0.0249,-0.1857,-0.0219,-0.1008,-0.1535,-0.0446,0.0628,0.0406,0.0877,-0.0471,0.0321,0.0594,0.0633,0.0218,-0.1363,-0.0915,0.1051,0.1033,0.0606,-0.0394,0.057,0.091,-0.017,0.018,0.0314,-0.0095,0.0239,0.0043,0.0125,0.0214,0.0276,-0.0399,0.09,0.0763,-0.0637,0.0163,0.0025,-0.0002,-0.006,0.0406,0.0047,0.0164,0.0622,0.0458,0.0328,0.0773,0.0126,0.0455,0.0444,-0.0238,-0.0248,0.033,0.0542,0.0052,0.0568,0.0189,0.0144,-0.0154,-0.0361,0.0004,0.0415,-0.0321,-0.0079,0.022,-0.0445,risk seeking
trm_557b499fac085,0.0534,-0.0594,0.0345,-0.0149,0.0087,-0.0432,0.0367,-0.0025,0.02,-0.005,0.01,0.0338,0.0111,-0.0014,-0.0013,-0.0334,0.0247,-0.0104,-0.0015,-0.0002,0.0091,-0.0115,0.0264,0.0485,0.022,0.0126,0.0175,0.0225,0.0064,0.0272,0.013,0.0017,0.0005,0.0055,0.0221,0.0242,0.0384,-0.0086,-0.0259,-0.0236,0.0104,0.025,0.0398,0.0107,-0.0482,-0.0224,0.0328,0.0216,0.0014,0.009,0.0154,0.039,0.0478,-0.0197,-0.01,-0.0052,0.0345,0.0032,0.0196,0.0205,0.0222,0.0318,0.001,-0.0314,-0.0794,0.0227,0.0187,0.0269,0.008,0.0156,-0.0495,0.015,-0.0168,0.0259,0.0009,0.0353,0.0323,0.0122,-0.0222,-0.0079,0.0707,0.0144,0.0054,0.034,-0.0195,-0.0456,-0.0507,-0.0256,0.0006,0.0274,-0.0143,0.0738,-0.0201,-0.0249,0.0255,-0.0247,0.033,-0.0071,-0.0287,-0.009,-0.0267,-0.0378,-0.0046,0.0115,-0.0042,0.0078,0.0077,0.0274,-0.0096,-0.03,0.0214,-0.0056,0.0038,-0.0119,0.0046,-0.0186,-0.0082,-0.0016,0.0233,0.0058,-0.0246,0.0092,-0.0031,-0.0009,0.0119,0.0116,-0.0208,0.0049,0.0035,0.0204,0.0679,-0.0126,0.038,0.0512,0.0164,0.0121,0.0246,0.0112,-0.0098,-0.0198,0.0179,-0.0084,-0.0206,0.0149,-0.0292,-0.0757,0.031,-0.044,0.0295,0.024,0.0052,-0.0164,0.0381,0.0278,-0.0344,0.0025,-0.0329,-0.0333,-0.0025,0.0269,0.0135,-0.0019,0.0087,0.0354,0.0021,-0.0349,0.0142,0.004,0.0036,0.0127,0.0489,-0.0002,-0.0041,0.0666,0.0418,0.0475,0.0578,0.0265,0.0522,-0.0137,0.0213,0.0121,0.034,0.0005,0.0558,-0.0284,0.0488,0.0737,0.0304,-0.0478,-0.0443,0.0763,0.0619,0.0716,0.0675,-0.0098,-0.0046,0.041,-0.0299,-0.0256,0.022,-0.0262,-0.0215,-0.0194,-0.0779,0.0498,0.0708,-0.0109,0.008,0.0128,0.0218,0.0482,0.0495,0.0018,0.0219,0.0289,-0.0137,0.0471,0.0066,0.0054,-0.0082,0.0304,0.0172,0.0189,-0.0341,0.0172,-0.038,0.0191,0.0206,-0.0631,0.0086,0.0392,-0.0278,-0.0176,-0.0261,0.0341,0.0251,-0.0217,0.0067,0.0157,-0.0208,0.0452,-0.0095,0.032,-0.0093,0.0128,0.0099,0.0209,-0.0331,-0.0002,0.0698,0.0079,0.0101,-0.0219,0.0392,0.0382,-0.0259,-0.0066,0.0022,-0.0356,-0.0655,-0.0803,-0.0041,-0.0748,-0.0556,-0.0801,-0.064,0.0071,0.0347,-0.0497,-0.0236,0.0416,-0.0248,0.0181,0.0171,0.0376,0.0269,0.0351,-0.0004,-0.0135,0.0286,-0.0007,0.026,-0.011,-0.0117,0.0189,-0.0121,0.0429,0.0155,0.0207,0.0059,0.0203,0.03,0.0037,0.0223,-0.0493,0.0325,-0.0176,-0.0456,-0.0487,0.0403,0.0247,0.0103,0.021,0.0041,-0.0022,0.0148,0.0047,0.0154,-0.0065,0.0031,0.0202,-0.0547,0.0062,0.0072,0.0282,-0.0379,0.0049,-0.0123,-0.0114,-0.0082,0.0101,-0.0904,-0.1041,-0.0019,0.0153,-0.0189,0.0,0.0416,0.0132,-0.0259,0.0149,0.028,0.0334,-0.011,-0.0197,0.0117,0.0013,0.0248,-0.0004,0.0015,0.0267,-0.011,0.0142,-0.0151,-0.0077,0.047,0.0435,0.0457,-0.0053,0.0485,0.0373,0.004,0.0166,0.0276,-0.0257,0.0187,0.0083,0.0298,-0.0251,0.0036,0.0169,0.0205,0.0064,0.028,-0.0385,0.0146,-0.1083,-0.0199,0.0545,-0.0385,-0.0126,-0.029,-0.0167,0.0365,0.0311,-0.0016,0.0045,0.0473,0.0049,0.0375,0.0211,-0.0107,-0.0383,-0.0359,-0.0285,-0.0233,0.0205,-0.0312,-0.0124,0.0222,-0.0257,-0.0271,-0.0341,0.0387,0.0273,0.0405,0.0413,0.0138,0.0007,-0.0096,-0.0068,0.0165,0.0141,-0.0052,-0.0344,0.0362,-0.014,0.0493,0.0404,0.0027,0.0296,0.0251,-0.013,0.0314,0.0023,0.0225,-0.0371,-0.0372,-0.0331,-0.0292,0.0498,0.0141,-0.0234,-0.0261,-0.0168,0.0,0.0243,-0.0045,-0.0114,-0.0303,0.0182,-0.0306,-0.0078,0.0529,-0.0194,0.0184,0.0035,0.0393,0.0256,-0.0137,0.0021,0.0095,-0.0128,0.0685,0.0173,-0.0338,-0.0272,-0.0333,-0.0866,-0.0708,0.0344,-0.0409,0.0023,-0.0235,-0.0131,-0.0303,-0.0129,-0.0773,-0.0199,-0.0106,0.0168,-0.0208,-0.0323,0.043,-0.0134,-0.0294,-0.0439,0.007,0.0401,0.0087,0.025,-0.0183,0.0025,0.0229,-0.0097,-0.0044,-0.0155,-0.0062,-0.0216,-0.0184,0.0109,0.0055,-0.0455,-0.0214,-0.0465,-0.0006,-0.0133,-0.0189,-0.0064,0.0334,-0.0157,-0.0725,-0.0446,-0.0219,0.0224,-0.0057,0.0196,-0.0458,-0.0041,-0.0107,-0.0238,-0.0242,0.0009,0.0306,0.0072,-0.0194,0.0407,-0.0167,-0.0009,0.0227,-0.0052,-0.0014,0.0022,0.0208,-0.0427,0.0382,0.0547,-0.0386,0.0277,0.0026,0.0344,0.0182,-0.0121,-0.0088,0.0143,-0.0035,0.0213,0.0127,-0.0567,0.0116,-0.0437,0.0116,-0.034,0.0398,0.0026,-0.0432,-0.0611,0.0032,0.0428,0.0058,0.0048,0.0335,-0.0211,-0.0196,0.0186,-0.0342,0.0013,0.0227,0.034,0.0411,0.0134,-0.0577,-0.004,0.0109,0.0427,0.0432,0.0108,0.048,0.0228,-0.027,-0.04,-0.0436,0.0045,0.0037,0.0219,0.0212,-0.0056,-0.0297,-0.0022,-0.0585,-0.0114,0.0184,0.0192,0.0167,0.0148,0.0279,-0.0577,0.0003,-0.0122,0.0226,0.0226,0.0045,-0.0034,-0.0908,-0.0464,-0.0536,-0.088,-0.0269,0.0039,0.0291,-0.0801,-0.0502,-0.0538,-0.0593,0.0184,0.0344,-0.0086,0.0187,0.0225,-0.0257,0.0165,0.018,-0.0116,-0.0265,0.022,-0.0125,0.0556,0.0545,-0.0662,0.043,-0.0108,-0.0017,-0.007,0.0392,0.0503,0.0091,-0.0595,-0.0144,0.0052,-0.0143,0.0003,-0.0181,-0.0077,-0.0039,0.019,0.0113,0.0525,0.0175,-0.0262,-0.0396,-0.0219,-0.0426,-0.0229,-0.0355,-0.0244,-0.0159,-0.0451,0.0091,-0.0541,0.0153,-0.031,-0.0378,0.0056,-0.0567,0.02,-0.0241,0.05,-0.061,0.0092,-0.0318,-0.0437,-0.0805,-0.1031,-0.0107,0.0141,-0.0178,0.014,0.0122,-0.003,0.0243,0.0087,0.0162,0.0273,-0.0016,-0.0483,0.0286,0.0349,-0.0334,-0.0054,-0.0054,0.0201,0.0166,-0.0698,-0.0285,0.0327,0.031,0.0172,0.0135,0.0325,-0.0292,-0.0217,-0.0694,0.0008,0.0093,0.0174,0.0486,0.0027,-0.0049,-0.008,0.0358,-0.0686,-0.0883,-0.0192,-0.0313,-0.0202,-0.0085,-0.0103,0.0335,-0.0175,-0.0447,-0.0447,0.043,0.026,0.0313,-0.0006,-0.0184,-0.0568,-0.0084,-0.0332,-0.0108,-0.003,-0.0141,0.0457,-0.0058,0.0067,-0.0037,0.0461,0.0156,-0.0023,-0.0107,0.0271,-0.0727,-0.073,-0.0175,-0.0003,-0.0044,-0.0079,0.001,0.0016,-0.0036,0.0101,0.0176,-0.0116,-0.0085,0.0147,0.0311,-0.0438,-0.0641,-0.055,0.0132,-0.018,-0.0164,0.0401,0.0222,0.0563,-0.0326,0.007,-0.0146,-0.0274,-0.0138,0.0045,0.0361,0.0427,0.0278,0.0225,0.0106,0.0029,-0.0167,0.0064,0.0068,0.0099,0.0002,0.03,0.004,-0.0013,0.0462,-0.0104,-0.0301,-0.039,-0.035,0.0075,0.001,-0.0001,-0.0111,0.0263,0.0335,-0.0094,0.0132,0.0046,0.0402,0.0169,0.0109,0.0098,-0.01,-0.0183,0.0042,0.0371,-0.0264,-0.0145,-0.0212,-0.0064,-0.0301,-0.0199,-0.0225,-0.0269,0.0028,-0.0339,-0.0593,0.0668,0.064,-0.0063,-0.0252,0.0189,-0.0006,-0.0112,-0.0199,0.0163,-0.063,0.0134,0.0371,-0.0361,0.0246,-0.0059,0.0342,-0.0109,0.0155,0.0214,-0.0052,0.0147,-0.0103,-0.0126,-0.0052,-0.0208,0.0059,0.0432,0.0141,-0.0074,0.0292,0.0071,0.0554,-0.0076,-0.0023,0.0487,-0.0197,0.0195,-0.0283,-0.0183,0.0119,-0.0458,-0.0428,-0.0394,0.0002,-0.0863,-0.0373,-0.0462,-0.0022,-0.0204,-0.0049,-0.0434,-0.019,0.0081,-0.0102,0.0054,0.023,-0.0239,-0.0429,-0.022,-0.0064,0.0327,-0.0107,-0.0651,-0.0713,-0.0263,0.0236,0.0133,-0.0038,0.0092,-0.0668,-0.0099,-0.0717,0.0142,-0.0152,0.0092,-0.0705,-0.0851,-0.0378,-0.0846,-0.0374,-0.0376,0.03,-0.0227,-0.0303,0.014,0.0166,-0.0343,0.0132,0.0213,0.0165,0.0414,-0.0058,0.0114,-0.0272,-0.0082,0.0222,0.005,-0.0038,-0.0016,0.0177,0.0359,0.0074,-0.0091,0.0302,-0.0057,-0.0416,0.0254,0.0128,0.0373,0.034,0.0132,-0.0038,0.0422,-0.0027,0.0223,0.0027,0.0097,0.072,0.0293,-0.0421,-0.0529,-0.0129,0.0273,-0.0683,-0.024,0.0333,0.0388,0.0267,0.0542,0.0178,0.047,0.0397,0.0476,0.012,-0.0314,0.011,-0.0231,0.0416,0.0004,0.0089,0.0536,0.0487,0.0508,-0.0109,0.0559,0.0255,0.0414,0.0096,0.0085,0.0383,0.0486,0.0579,0.0506,-0.0012,0.0145,-0.0009,0.0141,-0.0257,-0.0314,-0.0128,-0.0166,-0.0212,0.0363,-0.0237,0.0312,-0.0126,-0.0069,0.0152,-0.0309,-0.0205,-0.0312,-0.0024,-0.0004,0.0301,0.0246,0.0556,0.0197,-0.0066,0.0307,0.0326,-0.0329,-0.0461,-0.0514,0.0602,-0.004,-0.0313,-0.0247,-0.0241,0.0327,-0.0108,-0.0038,-0.0201,-0.0075,0.0155,-0.0176,-0.0124,0.036,0.0079,-0.0026,0.0009,0.0283,0.0568,-0.0434,-0.0116,0.023,0.0234,-0.0181,-0.0054,0.0292,0.0304,0.0073,-0.0474,-0.0027,-0.0255,0.0021,0.0119,-0.0387,-0.0548,-0.0339,-0.006,-0.0029,0.0073,0.0078,0.0156,0.0746,0.0112,-0.0985,-0.0314,0.0033,-0.0139,-0.0075,-0.0183,-0.0215,0.0188,-0.0499,-0.11,-0.0584,-0.0607,-0.059,-0.0016,-0.0041,0.009,0.0021,0.002,-0.0144,0.052,-0.0706,-0.0149,-0.0306,0.002,-0.0013,0.0315,0.0397,-0.0118,-0.0313,-0.0046,0.0038,-0.0279,-0.0285,0.015,-0.0043,0.035,0.0008,0.0284,-0.0244,0.0203,0.02,0.0296,0.0191,-0.0226,0.0173,0.0012,0.0232,0.0169,0.0322,0.0538,0.0726,0.0074,-0.0118,0.0195,0.027,0.0338,-0.0021,0.0311,-0.0451,-0.0461,-0.0837,0.0481,-0.0089,0.0154,0.0408,0.0562,0.0757,-0.0132,-0.0347,-0.045,0.0081,-0.0012,0.0466,0.0661,0.0763,0.0588,0.0375,0.0418,0.0829,0.0759,0.0413,0.0717,-0.0025,-0.022,-0.0123,-0.0004,-0.0515,0.0351,0.0244,0.0381,0.0318,0.0075,-0.0406,-0.0569,0.0109,-0.0101,-0.0176,-0.0276,0.0565,-0.0038,0.0491,-0.0376,-0.0149,-0.0418,0.0728,0.0822,0.0638,0.0029,0.0004,0.0275,-0.0086,-0.0119,0.042,-0.0037,0.0548,0.0657,0.0002,-0.0112,0.0247,0.0053,-0.0154,0.0099,-0.0041,0.0175,0.0107,0.0435,-0.0517,-0.0559,-0.06,0.0387,-0.0072,0.0177,0.0452,0.0094,-0.0229,-0.0247,0.0051,-0.003,-0.0165,0.0427,0.0504,0.0245,0.0245,0.0022,0.0471,-0.0067,-0.0303,-0.0366,0.0176,0.0155,0.0701,0.0696,0.0027,0.0171,0.034,0.0038,-0.0068,0.0046,0.0034,-0.0805,-0.0546,-0.0335,-0.0396,-0.0098,-0.0538,-0.009,-0.0124,-0.0126,-0.1427,0.0168,-0.0877,-0.101,-0.0322,0.0256,-0.1467,-0.1148,-0.0565,0.0025,0.0376,0.0278,-0.002,-0.0396,0.0102,-0.0489,-0.0542,-0.0561,0.0053,0.0147,0.0459,0.0236,0.0048,-0.012,-0.0283,-0.0264,-0.007,-0.0216,0.0714,0.0504,0.059,0.0695,-0.0055,0.0092,0.0049,-0.0059,-0.0508,0.0322,-0.003,0.0167,0.039,0.0291,-0.0293,0.0022,-0.0213,0.0183,0.0088,-0.0341,0.0244,-0.0166,0.0186,0.0223,0.0137,0.0064,-0.0405,-0.0108,0.0114,0.0114,0.0435,-0.0774,-0.0634,-0.0482,0.0091,0.0337,-0.0319,-0.0191,0.0769,0.0703,-0.0094,0.0199,0.052,0.055,0.0055,-0.0629,0.0299,-0.0154,0.006,0.0148,-0.0431,0.0443,0.0255,-0.0389,0.0017,0.0025,0.0038,0.0178,0.0108,-0.0491,-0.0205,0.0126,-0.0449,-0.0477,0.0389,0.0205,0.0038,0.0041,0.0223,0.0019,-0.0095,0.01,0.0599,0.0312,-0.0094,0.0077,0.0362,0.0106,0.0077,0.0044,0.0327,-0.008,-0.0129,0.0158,0.0284,0.0154,0.0048,0.0164,0.0458,0.0469,0.0188,0.017,-0.0061,-0.0371,0.0199,-0.0046,0.0405,0.0327,0.0061,0.0469,0.0189,0.0359,0.0335,0.0362,0.0249,0.0243,-0.0182,-0.0065,0.0333,-0.0096,-0.0302,-0.0006,0.0713,0.0112,-0.0283,-0.0247,0.0085,-0.0058,0.0545,-0.0192,0.0071,0.0011,0.0409,0.0478,0.0175,-0.0164,-0.0152,-0.0297,0.0159,0.0187,0.0412,0.0511,-0.0469,0.0235,-0.0106,-0.0022,0.0273,0.0043,-0.0255,-0.009,0.0052,-0.0623,-0.0142,-0.0165,0.0245,-0.0499,-0.0055,0.0015,0.0111,-0.0026,0.0143,0.0346,0.0132,0.0187,-0.0173,0.0553,-0.0081,0.0566,-0.0359,-0.0147,-0.0264,-0.0201,0.0406,0.0359,0.0184,0.0359,-0.0031,-0.006,0.0084,-0.0245,-0.0175,-0.0109,0.0123,0.0034,0.0277,-0.0338,0.0276,0.0284,-0.0004,-0.0048,0.0029,0.0234,0.0397,-0.0199,-0.0329,-0.0043,0.0085,0.0108,-0.0148,-0.0073,0.0297,0.0239,0.0127,-0.0017,0.0131,0.0053,-0.0086,0.0022,-0.0615,-0.0815,0.013,0.03,0.0125,0.0193,0.0018,-0.024,-0.0305,0.0076,-0.0003,0.0344,0.0097,0.0185,0.0279,0.0013,0.0373,0.038,0.0163,-0.0185,-0.0572,-0.0182,-0.0229,-0.0621,-0.0238,-0.0071,0.0274,-0.1446,0.0116,0.0139,0.0591,-0.0124,-0.0043,0.049,-0.0475,-0.0866,-0.0173,-0.0549,-0.0311,-0.0248,0.0659,-0.0197,-0.0022,0.0185,0.0577,0.0569,0.0202,0.0153,0.0063,-0.0562,-0.052,-0.0114,0.0268,0.0272,-0.0031,0.0296,0.007,0.0051,-0.0065,0.0216,-0.0459,0.0328,0.008,0.0491,-0.0115,-0.0264,-0.0184,0.0237,-0.079,-0.0557,-0.0872,-0.0548,-0.0227,0.029,0.0044,0.0026,-0.0662,-0.0031,-0.0306,0.0456,-0.0034,-0.0341,-0.0701,0.0124,-0.0079,-0.0017,-0.0076,0.0262,0.0349,-0.0061,0.0205,0.0412,0.0328,-0.1003,-0.0973,-0.1003,-0.0258,-0.0317,-0.0451,0.0103,0.0404,-0.0065,0.0404,0.016,0.0082,0.0274,-0.0217,-0.0227,-0.0246,-0.0264,-0.0159,-0.0075,-0.0266,-0.0872,-0.0632,0.0287,-0.0083,-0.0394,0.0173,0.0122,0.0432,-0.0124,0.0057,-0.051,-0.0479,0.0102,0.0001,-0.039,0.0077,-0.05,-0.0151,-0.0352,-0.0965,-0.0963,-0.0102,0.024,0.0201,-0.0408,0.0282,-0.0048,0.004,0.0201,0.0062,-0.0261,0.0146,0.0355,0.0274,-0.0057,0.044,0.0373,-0.0356,-0.0257,-0.0057,0.0458,0.0391,-0.0023,0.0195,0.0268,0.0205,-0.0153,-0.0437,-0.0233,0.0288,0.037,-0.0922,-0.0799,0.0437,0.0072,0.0211,-0.0102,0.0431,0.0174,0.0177,0.0189,0.0055,0.0495,0.0114,-0.0304,-0.0113,0.0059,0.0021,0.0103,-0.0304,-0.0027,0.0354,0.0273,0.0364,-0.0158,0.0498,0.0624,-0.0274,0.0436,0.0227,-0.0336,0.0346,0.0386,0.0416,0.0239,0.0778,-0.012,0.0235,0.0113,-0.025,0.0136,0.0109,-0.0075,-0.0207,-0.0012,0.0111,-0.0344,0.0054,0.0352,0.0488,0.0331,-0.021,-0.0205,-0.0268,-0.0779,0.0165,0.0369,0.0136,-0.0868,-0.072,-0.0051,0.0551,0.01,-0.0015,0.0394,0.0108,-0.0777,-0.0672,0.0394,-0.0029,-0.0094,-0.0041,0.0755,0.0181,0.0506,-0.0253,-0.0213,-0.0615,-0.0029,0.0026,-0.0097,0.0168,-0.0129,-0.0202,-0.0146,0.0012,0.0081,-0.0159,0.0013,0.0262,-0.0046,-0.0459,-0.0464,-0.074,-0.0729,0.0509,0.0352,0.0161,0.0221,-0.0707,-0.0179,0.0321,0.0587,0.0083,-0.0042,-0.0307,-0.0216,-0.0538,-0.0087,-0.0207,-0.0002,-0.0035,0.0187,-0.0159,0.0188,0.0115,0.0091,0.0585,0.0068,0.0066,0.0048,-0.01,0.0086,0.0052,-0.0229,-0.054,0.0227,0.0844,0.0416,0.0675,0.0502,-0.0041,-0.0043,0.0301,0.0066,0.031,0.0029,-0.0448,0.0078,-0.0231,-0.0135,0.0002,0.0249,0.0354,0.0416,-0.0151,0.014,-0.0303,0.0385,0.0091,-0.0336,-0.0624,0.019,0.0223,-0.0261,-0.0771,0.0189,0.055,-0.0083,-0.0266,-0.0381,0.0072,-0.0182,0.011,-0.0219,-0.0881,0.0264,-0.1252,-0.0056,0.0131,-0.0945,-0.0599,-0.0408,-0.1049,0.0067,0.0357,-0.0558,0.0221,-0.045,-0.0386,-0.0613,0.0072,0.0492,0.0291,0.0345,0.007,0.0374,-0.011,0.0063,-0.0226,0.0614,0.0486,-0.0287,0.0242,0.0026,0.034,0.0086,0.0109,-0.0792,0.0078,0.0137,0.0253,0.0374,-0.029,-0.0207,-0.0125,-0.0128,-0.064,-0.0916,-0.0113,0.0129,0.0006,-0.0338,0.0458,-0.0398,-0.0171,-0.0474,-0.0365,-0.0749,-0.0475,-0.0046,-0.0172,0.0157,-0.029,-0.0131,-0.0107,-0.0174,-0.0222,-0.0065,0.0314,-0.003,0.0163,0.0183,0.0053,0.0201,-0.0014,-0.0315,-0.0756,0.0223,0.0197,0.0402,0.0525,-0.0052,0.0311,0.051,0.0659,0.0224,0.0176,0.0181,0.0107,0.0134,0.0058,0.0313,-0.0041,0.0234,0.0223,-0.0066,0.0285,-0.0351,0.0127,0.0153,0.0204,0.0211,0.0185,0.0018,-0.0275,0.05,0.0332,0.0199,0.0194,0.0463,0.0172,-0.0035,0.0147,0.0214,0.0347,0.0253,0.0283,0.04,0.0346,0.0228,-0.0022,0.0324,0.0121,0.0634,0.0237,0.0187,0.0224,0.001,-0.065,0.0183,0.0229,-0.0845,0.0408,0.0047,0.0284,0.0353,-0.0324,0.0128,0.0076,0.0392,0.0067,-0.0022,0.0216,0.0211,0.037,-0.0104,-0.1274,-0.0671,-0.0097,-0.0581,-0.1101,-0.0671,0.0056,0.0403,0.0114,-0.0166,-0.0151,-0.0271,0.0365,-0.0139,-0.0334,0.0249,-0.0056,0.0408,0.0389,0.0341,0.0322,0.0092,-0.0211,0.0579,0.0546,0.0151,0.0212,-0.0204,0.0129,-0.0062,0.0095,-0.0076,-0.0464,-0.0674,0.0657,0.042,0.0371,-0.0283,0.0506,0.0215,-0.0145,-0.0157,-0.0212,0.0009,0.0066,0.0137,-0.0157,0.0126,-0.0061,0.0272,0.0226,0.0335,-0.0501,-0.0544,-0.063,0.0364,0.0003,0.0404,0.0086,-0.0345,0.0248,0.0262,0.0205,-0.0286,-0.0187,0.0202,-0.002,-0.0042,-0.0037,-0.0282,0.0338,0.0517,0.0271,-0.0283,-0.0012,0.0225,0.0146,0.0098,0.0597,-0.0017,-0.0022,0.0019,0.027,-0.0057,-0.0033,0.0437,0.0236,0.0376,-0.0494,-0.0179,-0.0315,0.0048,-0.0346,-0.0262,0.0299,-0.0201,-0.0278,-0.0673,0.0283,-0.0009,0.0085,-0.0189,-0.0276,-0.0547,0.0076,0.0545,0.006,0.0304,0.0361,0.0466,0.0417,-0.0658,0.0371,-0.0036,0.0312,-0.0426,-0.1145,-0.0275,0.0214,0.0378,0.0123,0.0166,0.007,0.0618,-0.0558,0.033,-0.0607,0.0237,-0.0214,0.0044,0.0507,0.0445,-0.0052,-0.0033,-0.0307,0.0283,0.018,0.0099,0.0175,0.0045,0.0114,0.005,-0.0501,-0.0673,0.0536,0.019,0.041,0.0546,0.0243,-0.0332,0.0253,0.0272,-0.0567,-0.0054,0.0134,-0.1783,-0.1568,-0.0537,-0.0655,-0.0773,-0.0899,-0.0436,-0.1173,-0.0547,-0.1339,0.0083,-0.0573,-0.0314,-0.0431,-0.0165,-0.0208,-0.0217,0.0217,-0.0009,0.0284,0.002,0.0066,-0.0282,0.0181,-0.0001,0.0175,-0.0158,-0.0022,0.0513,0.0182,0.0446,-0.0295,-0.0067,-0.0027,0.0012,0.0365,0.0433,0.0429,0.0384,-0.0014,0.0087,-0.0307,-0.0279,-0.0154,0.0422,-0.0028,0.0494,0.006,0.0126,-0.0047,0.0787,0.0331,-0.0519,-0.0852,-0.0425,-0.004,-0.0196,-0.0106,0.0388,-0.0012,0.0117,-0.0553,-0.0137,0.0046,0.0191,-0.0393,-0.0221,0.0284,0.0277,0.0049,-0.0283,0.0748,-0.052,0.0043,0.0178,0.0067,0.028,-0.0172,0.0387,0.0398,0.0084,0.0302,0.0421,0.0054,0.0028,-0.0012,0.0008,0.0255,-0.0015,-0.0835,0.0454,0.046,0.0473,-0.0253,0.0181,-0.0037,-0.0362,0.0133,0.0287,-0.0201,0.0451,0.0669,0.0266,-0.0224,-0.0755,0.0159,0.0362,0.0254,-0.0351,0.018,-0.019,-0.0071,0.031,0.0215,0.0205,-0.0555,0.0194,0.0488,0.002,-0.0016,0.0398,-0.0118,-0.0062,0.0501,0.0501,0.0155,0.0119,-0.0314,0.0203,-0.0146,0.0325,0.0316,-0.059,0.0373,-0.0511,-0.0216,0.0223,-0.0362,0.0202,-0.1197,0.0112,-0.0052,0.0353,-0.031,0.0358,-0.0116,-0.0156,-0.0796,0.0249,-0.0126,-0.0167,-0.0149,-0.0473,-0.0053,0.0159,0.0167,-0.0125,-0.226,-0.0898,0.024,0.0567,-0.0016,0.0299,0.0298,-0.0146,0.0256,0.0322,-0.0241,0.0278,0.0029,0.0197,0.0334,-0.092,-0.0434,-0.0958,-0.0188,-0.0715,-0.0942,0.0075,-0.0035,0.0063,-0.007,-0.034,-0.041,0.0473,0.0098,0.0304,-0.0142,0.0146,0.0105,-0.0256,0.0223,-0.0131,-0.0295,-0.0245,0.0303,-0.0429,-0.021,-0.0109,-0.0388,0.0525,0.0332,0.0352,0.0346,0.032,0.0301,-0.0001,0.0648,0.023,0.0032,0.0321,0.0113,0.0304,0.0146,0.0111,-0.0038,0.0116,0.0278,-0.0349,-0.0289,-0.0182,0.0481,0.002,-0.0122,0.0034,-0.0743,-0.0384,0.002,-0.0078,0.0349,-0.0055,0.0121,0.0271,0.0334,0.0286,-0.0146,0.0287,0.0469,-0.0167,0.0374,0.019,-0.0007,0.0269,0.0226,-0.0016,-0.0564,-0.0316,-0.0409,-0.0685,-0.0104,0.0094,-0.0089,-0.0117,-0.0164,0.0303,-0.0187,0.0253,0.0433,0.0277,-0.01,0.0065,-0.0101,-0.0129,0.0026,0.0054,-0.012,0.011,0.0233,0.0125,0.0013,-0.0081,0.0155,-0.0184,0.0253,-0.0745,0.0558,0.0535,0.037,-0.0542,-0.0607,-0.0241,-0.0046,-0.0303,0.024,-0.0195,-0.0137,-0.0185,0.018,0.0124,0.009,0.0206,0.0166,0.0505,0.0158,0.0396,0.0277,0.0542,0.0248,-0.0006,-0.0323,-0.0137,-0.0113,-0.0066,0.0107,0.0343,-0.0308,0.0159,0.0447,-0.0124,0.0291,-0.0227,-0.0767,-0.0184,-0.1022,-0.035,0.0259,0.007,-0.0053,-0.0282,0.0228,0.0075,-0.011,-0.0072,0.0321,0.0416,0.0047,-0.0449,0.0283,-0.0194,0.0382,0.0169,-0.0013,-0.0976,-0.0245,-0.0174,0.0276,-0.0083,0.0154,0.0519,0.0072,-0.0394,-0.008,-0.0045,-0.0112,0.0124,-0.0038,-0.002,0.0083,-0.0449,0.0116,0.0253,0.0472,0.0548,-0.0204,0.0298,0.0314,0.0308,0.0247,0.0059,0.003,0.0017,-0.0295,0.0333,-0.0397,0.03,-0.0426,-0.0808,-0.0273,0.0315,-0.0257,-0.005,-0.0095,-0.0536,-0.0152,-0.0044,0.0165,0.0224,-0.0307,-0.0292,-0.0111,0.0044,-0.03,-0.0069,-0.0027,-0.043,-0.025,-0.0209,0.0133,0.0249,0.011,0.0585,-0.0117,0.041,0.0286,0.0065,0.0219,0.0278,0.02,0.0394,-0.0139,-0.0178,0.0155,0.0321,-0.0265,-0.0145,-0.012,-0.0669,-0.0032,-0.0567,-0.0303,-0.0004,0.0189,-0.0118,0.0107,0.0815,-0.0307,-0.0162,-0.0301,0.0133,-0.0236,0.0092,0.0039,0.0204,-0.0815,0.0529,-0.0422,0.0,-0.0294,-0.0629,-0.0335,-0.0306,0.0075,0.0547,0.0222,-0.0525,-0.0359,-0.0299,-0.0264,0.0769,0.0057,0.0047,0.0097,-0.0064,-0.0313,-0.0342,0.0164,0.037,0.0345,0.0498,-0.0434,-0.074,-0.0276,-0.0635,-0.0319,0.0052,0.0302,0.0019,-0.0451,-0.0273,-0.0037,0.0239,0.0278,0.0375,-0.001,0.0323,0.0364,0.0282,-0.0012,-0.0065,-0.0098,0.0341,0.0072,0.0078,-0.0814,0.0039,0.0308,-0.0092,-0.0721,-0.0528,-0.0711,-0.0646,0.0138,0.0046,0.0008,-0.0546,-0.0359,0.0392,-0.0257,-0.0487,0.0158,0.0171,0.0218,0.0287,-0.0075,-0.0138,0.0222,0.0053,0.0217,-0.0152,-0.0116,0.0386,0.0379,0.0172,0.0182,-0.0072,-0.0046,0.0519,0.0146,0.0265,0.0376,-0.0368,0.0027,0.0269,0.0135,-0.0078,0.0065,0.0142,0.0174,-0.0096,0.0188,0.0271,0.0331,-0.0401,-0.0351,-0.0827,-0.0323,-0.0873,0.0281,-0.0157,-0.0331,0.0025,-0.0287,-0.0356,0.0407,0.0234,0.0039,-0.0004,-0.0121,0.0166,0.0233,-0.0041,0.0099,-0.0085,0.0482,0.0603,0.0325,0.0417,0.0181,-0.025,-0.0205,-0.0025,-0.0159,-0.0241,0.0015,0.0227,-0.0267,-0.0797,-0.0262,0.0338,-0.0106,-0.0347,-0.0103,0.011,-0.0092,0.044,0.012,0.0333,-0.0149,0.0609,-0.0124,-0.1036,-0.055,-0.0185,-0.0127,0.038,0.0217,0.0107,0.0415,0.0046,-0.0092,-0.0209,0.0256,-0.0392,-0.0303,-0.0498,0.0334,0.0277,-0.0529,-0.0002,-0.1242,-0.0678,0.0336,0.005,-0.012,-0.0355,-0.0162,0.0509,0.001,0.0416,0.0277,0.0446,0.022,0.0434,0.0021,-0.0136,0.0292,0.0307,0.0107,0.0041,0.0378,0.0299,0.0459,-0.0333,0.0492,-0.0303,-0.0203,0.0043,-0.0172,0.0153,0.0294,0.0073,0.0074,0.0492,0.0192,0.0175,0.0316,0.0233,-0.0574,-0.0529,0.0083,-0.007,-0.0431,0.0174,0.0182,0.0269,0.0354,-0.0213,-0.0165,0.0072,0.0237,0.0151,-0.0208,-0.0011,-0.002,-0.0091,-0.013,-0.0335,0.0214,0.0064,-0.0117,-0.0778,0.0239,0.0299,-0.0109,-0.0336,0.0092,0.0253,0.0024,0.0309,-0.0157,0.0227,0.0188,-0.0882,-0.0688,-0.0454,-0.0247,-0.0135,0.0446,0.0383,0.0344,0.0367,0.0505,-0.0031,-0.0356,0.017,-0.0254,0.0313,-0.0291,0.0051,0.0401,0.0292,0.0276,0.0445,0.0174,0.0233,0.0012,0.0405,-0.0162,0.0361,-0.0603,0.0519,-0.0023,-0.0192,-0.0354,-0.0144,0.0218,0.0023,-0.0282,-0.015,-0.0203,-0.0191,0.0284,0.0525,0.046,0.0001,0.0419,0.0229,0.0231,0.0168,0.0564,-0.0062,-0.0099,-0.0981,-0.0538,-0.0341,-0.0284,-0.007,-0.0062,-0.0395,-0.0583,-0.0384,-0.0161,-0.0096,-0.0007,0.0369,0.013,-0.0019,0.0189,-0.0403,0.0573,-0.0145,0.0361,-0.0212,-0.0249,-0.0069,0.0882,0.0238,0.0639,0.0812,0.0294,0.0507,-0.0048,0.0639,-0.0194,0.0173,-0.0164,0.0487,-0.0034,0.0356,0.0333,0.0225,-0.0285,0.0388,0.0306,-0.013,-0.0418,-0.035,-0.0641,-0.0247,0.0033,0.0376,-0.0129,0.0528,-0.005,-0.0235,-0.0092,-0.0321,-0.0202,0.0,0.0393,0.0016,0.0334,0.0108,-0.0331,-0.0425,-0.0403,0.0398,-0.014,-0.0494,-0.0566,0.0175,0.05,-0.0048,0.0056,-0.0336,-0.0363,-0.0064,-0.0726,0.047,-0.0178,-0.0088,-0.0141,-0.0439,0.0386,-0.004,0.0288,-0.0436,-0.0573,0.0145,-0.0154,-0.0148,0.002,-0.0301,-0.0435,-0.0487,0.0313,0.0038,-0.0084,-0.0213,0.0723,-0.0147,-0.0226,-0.0151,0.0219,0.0262,0.069,0.0575,-0.0056,0.0384,-0.0209,0.0081,-0.0655,-0.0034,0.0136,-0.086,-0.0937,0.007,0.0045,-0.0583,-0.0248,-0.0437,-0.0003,-0.0852,-0.0284,-0.0353,-0.0516,-0.0635,0.016,-0.075,0.0167,0.0617,0.022,0.0234,0.0659,0.042,-0.0128,0.0095,0.0404,0.0635,-0.0068,0.0561,0.0349,0.0389,-0.0025,0.0479,0.0401,0.046,-0.0238,-0.0618,-0.0848,-0.0512,-0.0557,-0.0104,-0.051,0.0655,0.0474,0.0171,0.0181,-0.0082,0.0355,0.0159,0.0027,0.0141,0.0512,0.0263,0.0225,0.0166,-0.0137,-0.0502,-0.0633,-0.003,0.0482,0.0437,-0.0218,0.0214,-0.0114,-0.0103,-0.1122,0.0364,0.0172,0.0637,0.0179,0.0317,-0.0748,-0.0349,0.0136,0.0099,-0.0005,0.0406,0.0253,0.0148,-0.0884,0.0598,0.0414,0.0173,0.0104,-0.0538,0.0304,0.0411,0.0241,0.0356,0.012,-0.0968,0.0231,0.0164,0.048,0.0506,0.0589,0.0217,0.0199,0.0037,0.0496,0.0223,0.0218,0.0016,-0.0001,0.024,0.0159,-0.0256,-0.0168,0.0444,0.0149,0.0083,0.0224,0.0472,0.0309,-0.0288,-0.0421,-0.004,-0.0782,0.0187,-0.0142,-0.0341,0.0255,0.0147,-0.0295,-0.0072,0.0058,-0.0195,0.0032,0.0051,-0.0572,-0.0363,-0.054,-0.002,-0.0492,-0.0079,0.0038,-0.0362,-0.0501,0.0039,0.0085,0.0502,-0.0066,-0.0035,0.0317,0.0406,0.0345,0.0144,0.0354,0.0279,0.0697,-0.0195,0.0105,0.0475,0.013,-0.0198,-0.0631,0.0243,-0.0179,0.0213,-0.0077,0.0195,-0.0096,0.0323,0.0056,-0.0114,-0.0274,0.0417,-0.0159,0.0388,0.0077,0.0181,0.0419,0.0357,0.0516,-0.0858,0.0403,-0.0137,-0.0023,0.0245,0.0437,0.0409,0.0541,0.0009,0.026,-0.006,0.0139,0.0295,-0.0137,0.0075,-0.0075,-0.0104,-0.0073,-0.0114,0.0352,0.0068,0.029,-0.0186,0.0045,-0.0191,0.0239,0.022,0.042,-0.0494,-0.0619,0.0163,0.014,0.0335,-0.0187,-0.0038,-0.0068,0.0445,0.036,-0.0829,-0.0182,0.0406,-0.0038,-0.0019,0.0333,0.0098,0.0568,0.0672,-0.0138,-0.0922,-0.0262,0.036,-0.0506,0.0192,0.073,0.0578,0.024,0.0177,0.0308,0.0186,0.0543,-0.0459,0.0224,-0.0205,0.0227,0.0217,-0.0197,0.0327,-0.055,-0.0417,-0.0717,0.0353,-0.0001,0.0064,0.0501,0.0373,0.0713,0.0572,0.0265,-0.0574,0.0088,0.0579,0.0588,0.0106,0.0109,-0.0159,0.034,0.0273,-0.0249,-0.0204,-0.0758,0.0233,0.0461,0.0282,0.0331,0.0713,-0.0452,0.0832,0.0826,0.0071,-0.0149,-0.0073,0.011,0.0117,0.0092,-0.0692,-0.101,0.0154,0.0163,0.0304,-0.0065,0.0521,0.0385,-0.0147,-0.122,-0.121,-0.023,-0.0223,0.0386,0.0063,-0.0137,-0.0081,0.0104,0.0231,0.0061,0.0066,-0.0032,-0.0507,-0.0463,0.0296,resistance to distractor inference
trm_55ef1fd2bc418,-0.108,-0.1037,-0.0845,-0.1373,-0.0005,-0.0321,-0.0498,-0.0645,0.0005,-0.0726,-0.0027,-0.0022,-0.0732,-0.0147,-0.1178,-0.0809,-0.1055,-0.1238,-0.0522,-0.0649,-0.0888,-0.0054,-0.03,0.0513,-0.0414,-0.0081,-0.0077,-0.0806,-0.1198,-0.0632,-0.0942,-0.0715,-0.0744,-0.0962,-0.0712,-0.1017,-0.0234,-0.0139,-0.139,-0.0708,-0.0944,-0.0909,-0.0448,0.0499,-0.1019,-0.0768,0.1021,-0.1037,-0.0021,-0.0978,-0.0711,0.0005,0.032,-0.0458,-0.0625,-0.0432,-0.0947,0.0111,0.02,-0.0384,-0.0326,-0.0013,-0.1227,0.054,-0.0131,0.0255,-0.1873,-0.2143,-0.1435,0.0228,0.0523,0.0255,0.1171,-0.0368,-0.1308,0.0809,-0.0789,0.0053,0.0487,-0.0063,0.0746,0.0431,-0.0229,-0.095,0.0094,0.0259,-0.0121,0.0161,0.0332,-0.1264,-0.0423,-0.0347,0.0327,0.102,0.1289,0.1067,0.0855,0.0095,0.1247,0.0571,-0.0049,-0.0056,0.0549,0.0131,0.0264,-0.094,-0.1295,0.1816,-0.0518,-0.036,-0.0124,-0.1009,0.0746,0.1119,0.0253,0.0226,-0.0957,0.0342,-0.0273,-0.0545,-0.1135,-0.1234,-0.0877,0.0252,-0.0749,-0.0986,-0.1105,0.022,0.0749,0.0642,0.0353,-0.083,0.0168,-0.0871,-0.0356,-0.1694,-0.035,-0.0657,-0.0116,-0.017,-0.089,-0.1135,0.0985,-0.0485,-0.0903,0.0105,-0.0862,-0.0212,-0.0711,0.091,-0.049,-0.0805,-0.072,-0.1257,0.0635,-0.0245,0.0766,-0.0386,0.0386,-0.0168,-0.0923,-0.0998,-0.195,-0.1826,0.0157,0.051,0.0189,-0.1324,-0.1273,0.0131,-0.0081,-0.1154,0.0684,-0.0103,-0.0607,-0.0574,-0.0378,-0.0342,0.013,-0.0138,-0.0985,0.1121,-0.0623,-0.0015,-0.068,-0.0552,-0.038,0.0566,0.0759,-0.1196,-0.1072,-0.0851,-0.0412,-0.1602,-0.1412,-0.2126,-0.1939,-0.0444,-0.0109,-0.1082,-0.0508,0.1045,-0.0976,-0.1193,-0.0736,-0.0266,0.0217,-0.0867,-0.0864,-0.0287,-0.1001,-0.0163,0.0474,0.0381,0.0534,0.037,0.1142,-0.0842,-0.1006,-0.0023,0.0849,-0.0789,-0.0711,-0.0382,0.0284,0.0213,-0.1116,0.091,0.0128,0.051,-0.0079,-0.0317,0.1029,-0.1228,-0.1155,0.0389,0.0213,0.0333,-0.0072,-0.0224,-0.0624,-0.1252,-0.0737,0.0051,-0.0853,-0.0499,-0.0313,-0.1173,-0.0591,-0.0693,0.0368,0.0477,0.025,0.0693,-0.0256,-0.1234,0.0191,-0.0602,0.132,0.1415,-0.0005,0.0692,-0.1053,0.0028,0.0756,0.1499,0.0194,-0.0335,0.0499,-0.0083,-0.0706,-0.0695,-0.0509,0.0264,-0.0441,0.0991,-0.0443,-0.0651,-0.0852,-0.0121,0.0706,0.017,0.0239,-0.1299,-0.0993,-0.0694,0.0718,0.1251,-0.1076,-0.0698,-0.033,-0.0437,-0.0415,-0.0558,-0.0932,-0.0439,0.0136,0.0076,-0.0543,0.0466,0.0333,-0.1282,-0.0812,-0.0405,-0.0752,-0.0729,-0.1034,-0.0342,0.0245,0.0204,0.0069,-0.0026,-0.158,0.0317,0.0361,-0.0784,0.0619,0.0571,0.0477,-0.1304,0.0203,0.027,-0.0463,-0.088,-0.0363,-0.0922,-0.0053,-0.052,-0.0351,-0.0699,0.0214,-0.0614,-0.0219,0.0161,0.048,0.0179,0.1013,-0.0298,0.0489,-0.1221,-0.1148,-0.0015,0.0027,-0.0036,0.0398,0.0141,-0.1597,-0.0962,-0.1107,-0.0723,-0.0506,0.1147,-0.0511,0.0072,0.007,-0.0512,-0.0585,-0.0532,-0.127,-0.0818,-0.0034,-0.0321,-0.0455,-0.0327,-0.0268,0.0628,-0.1184,0.0179,0.0486,-0.1192,-0.041,0.0117,-0.0276,0.1161,-0.1017,-0.0437,-0.0922,0.096,0.2196,0.1423,0.2593,0.0064,-0.1442,-0.0629,0.0511,0.0645,-0.0354,0.0099,0.0109,-0.0439,-0.03,-0.067,-0.0849,-0.0637,0.0173,-0.0029,-0.0548,-0.0853,-0.0792,-0.0745,-0.0325,0.0209,-0.006,-0.0091,0.0104,0.0355,0.0659,-0.0485,-0.0775,-0.0296,-0.0836,-0.0908,-0.0699,0.1935,-0.0527,-0.0234,0.2092,-0.0406,-0.1204,-0.0569,-0.0073,-0.1539,-0.1135,-0.29,-0.2345,-0.1298,-0.1705,-0.0609,-0.1126,-0.1175,-0.0324,0.089,0.0205,0.0145,0.0195,0.0509,0.036,0.0234,-0.2229,-0.1193,0.0347,0.0691,-0.0704,0.0945,-0.0318,-0.0601,0.0571,0.086,-0.093,-0.1347,-0.0809,-0.0002,-0.106,-0.1128,-0.0098,-0.1222,0.0646,-0.1048,-0.0506,-0.0175,-0.0011,-0.0773,0.0017,0.0549,-0.0955,-0.1207,0.0089,0.2355,-0.0816,-0.0059,-0.0137,0.0449,-0.0153,0.0069,0.0491,-0.0671,0.0208,0.0248,0.0066,-0.0654,0.0508,-0.029,-0.0125,0.0563,0.0392,0.0968,-0.0014,-0.0418,-0.0637,-0.0355,0.1026,0.0938,-0.1177,-0.1197,0.0299,0.0292,-0.0603,-0.0565,0.0012,-0.1251,-0.1198,0.0146,-0.1049,-0.1217,-0.1018,-0.0312,0.0423,0.0512,-0.0434,0.0693,-0.1407,0.0153,-0.0141,-0.0156,0.0716,0.0258,-0.0942,-0.0615,0.0769,-0.0488,-0.0756,-0.0861,0.0583,-0.0395,0.1121,0.0366,0.0777,0.1338,0.0987,0.0486,-0.0465,-0.0102,-0.0229,-0.1651,0.0066,-0.0082,-0.136,-0.1172,-0.0408,-0.068,-0.0144,0.0352,0.0159,-0.0145,-0.0608,-0.01,-0.021,0.0369,0.0465,-0.0802,0.0831,-0.0311,-0.0274,-0.0017,-0.0161,-0.0923,0.1163,0.0441,0.0981,-0.084,-0.0514,0.0301,-0.0731,0.0003,-0.0433,0.0641,0.0637,0.0416,-0.0245,-0.0076,-0.0816,0.003,-0.1355,-0.032,0.0714,0.0771,0.082,0.012,0.0326,0.0366,0.0203,-0.1163,-0.0181,-0.0565,0.0212,-0.0231,-0.1014,0.0092,0.0304,-0.0342,-0.0611,-0.0586,0.0089,0.0155,-0.1056,-0.0546,-0.1812,0.0153,0.1059,-0.0335,0.0408,0.0608,0.047,0.0712,-0.0103,0.032,0.0023,-0.1213,-0.1192,-0.0238,-0.1145,-0.0487,0.0079,-0.0092,-0.1856,-0.0658,-0.0926,0.0069,-0.0199,-0.174,-0.0874,-0.1894,0.0879,0.0344,-0.0271,0.062,-0.0984,-0.0348,-0.1001,-0.0053,0.0425,0.0089,-0.0353,-0.0337,-0.1024,0.0148,0.0082,-0.0703,-0.0503,-0.0475,-0.0522,0.0454,0.0184,0.0489,-0.1185,-0.0496,-0.0959,-0.0798,0.0644,-0.1276,-0.0293,-0.0794,0.0135,-0.121,0.0032,-0.0795,0.061,-0.0675,-0.0016,-0.1287,-0.0903,0.0324,0.1236,0.0155,0.024,0.0147,-0.0772,-0.1197,-0.0363,-0.043,-0.0192,-0.0182,-0.0511,-0.0391,-0.0416,-0.0856,0.1539,-0.0845,0.0184,-0.0409,0.0131,0.0609,0.0049,-0.0264,0.0918,-0.1477,-0.0649,0.0067,-0.0192,-0.0145,-0.0083,0.0486,0.0429,0.0277,-0.0411,-0.0216,0.0419,-0.0267,-0.0569,-0.0473,-0.0044,-0.0129,-0.0448,-0.0193,-0.0533,-0.0174,-0.1285,-0.1203,-0.1087,0.0371,0.0635,0.0264,-0.0583,0.1105,0.0197,-0.0127,-0.0486,0.0572,-0.0881,0.0263,0.155,-0.0422,-0.2117,-0.2139,-0.1241,-0.0397,-0.0277,-0.0986,0.0006,-0.0503,0.1067,0.0347,-0.0664,-0.0063,0.0365,-0.0164,-0.1268,0.0847,0.0437,0.1219,-0.0876,0.0062,-0.087,0.0421,0.0156,-0.108,0.0521,0.0875,-0.0517,0.0265,0.014,0.0887,-0.0964,-0.1607,-0.1361,-0.0962,0.0159,0.1411,0.0056,-0.0892,0.0383,-0.0055,0.0261,0.047,0.0181,0.0069,-0.0436,-0.0733,-0.0423,0.0437,0.055,0.0853,-0.0307,-0.0406,0.0225,-0.0585,0.0225,-0.0481,-0.1257,-0.0388,-0.1052,-0.0915,-0.0441,0.0815,0.0867,0.0491,0.0222,-0.0132,-0.027,0.0674,-0.0225,-0.074,0.0904,-0.0104,0.0315,0.0063,0.0437,-0.047,0.0375,-0.1485,-0.1541,0.0166,0.1064,0.0887,-0.0216,0.0619,0.0399,-0.0247,-0.0205,0.1228,-0.02,0.0368,0.1252,0.172,0.0542,0.0058,0.1563,0.1581,-0.0648,0.0556,0.0667,-0.1693,-0.1213,-0.0346,-0.0602,0.1311,-0.2019,-0.0824,-0.1091,-0.0996,-0.1157,-0.0118,-0.0122,0.1312,-0.0751,-0.0499,-0.0682,0.0491,0.0163,0.0348,0.037,0.0306,0.0393,0.0134,-0.011,-0.0366,0.0129,0.0606,-0.0951,0.0829,0.0482,-0.034,-0.0222,-0.0688,-0.0583,0.0416,-0.112,-0.2008,-0.0989,-0.0103,0.0613,0.0598,0.0155,0.0022,0.0661,0.0722,-0.0969,-0.0907,-0.0038,-0.0658,-0.0007,-0.0796,0.0766,-0.086,0.0355,-0.0631,-0.0431,-0.0583,-0.1372,-0.1184,-0.075,0.1053,-0.0823,-0.077,-0.0826,0.0347,-0.0472,-0.1288,-0.0591,-0.1077,0.023,-0.0314,0.1157,0.0829,-0.0163,0.054,-0.1339,-0.0474,-0.0165,0.0781,-0.0576,0.0051,0.087,0.0229,0.0409,0.2622,0.0835,-0.0224,-0.0442,-0.0478,-0.0952,0.0197,-0.0088,0.0963,0.1533,0.0381,0.0464,-0.0975,0.0555,0.1436,-0.012,-0.0189,-0.03,-0.0476,-0.0634,-0.0176,0.0073,0.0333,-0.0136,-0.0838,-0.0068,0.1413,0.0121,-0.0792,-0.0228,0.0645,-0.0432,-0.0322,-0.0418,-0.1058,-0.116,-0.0502,-0.0695,-0.0408,0.0565,0.0285,-0.0311,-0.069,0.0402,-0.0534,0.0519,-0.021,-0.0602,-0.0362,0.0113,0.0165,0.0408,-0.0054,0.0205,-0.0091,0.0454,0.0608,0.0858,0.1176,0.0837,-0.0284,-0.0487,-0.0508,-0.0043,0.0698,0.0393,0.044,-0.0188,0.1013,0.0232,0.1004,-0.0089,-0.0455,-0.0603,0.0044,-0.0404,-0.0004,-0.1294,-0.0848,-0.0924,-0.079,-0.0591,0.0865,0.0642,0.0302,0.0616,0.145,0.1147,-0.0851,-0.0124,-0.0164,-0.0382,0.0091,-0.0061,-0.0222,-0.0709,-0.0908,-0.0376,0.1116,0.092,-0.0902,-0.0748,-0.0657,-0.1102,-0.045,0.0806,0.0198,0.072,0.1068,0.0726,-0.0909,-0.0137,0.0293,-0.0428,-0.0123,-0.0009,0.0492,0.0023,0.0105,-0.0024,-0.0234,-0.1003,-0.0219,-0.0779,0.0203,-0.1044,-0.0132,0.0477,0.1169,-0.0616,0.0106,-0.0469,-0.0737,-0.0218,-0.0016,-0.0484,-0.0794,-0.0107,0.0146,0.0312,-0.0276,-0.0355,-0.0049,0.0039,0.0017,-0.0221,-0.0514,-0.0808,-0.0887,-0.0686,0.1578,0.0049,0.0839,-0.0855,0.1645,0.1205,-0.0237,0.0276,-0.034,0.08,-0.0093,0.061,-0.09,-0.0661,0.0397,-0.0571,-0.0865,-0.0292,-0.0135,0.0953,0.1351,-0.0227,-0.0055,-0.053,0.0777,0.0429,-0.0087,0.0443,0.0048,-0.0755,0.0114,-0.0323,0.0076,-0.0054,-0.0414,0.3402,0.2124,0.1158,0.0274,0.05,-0.0257,0.0888,0.1132,-0.1437,0.4266,0.3974,0.3115,0.2255,0.3623,0.1598,0.1369,0.1146,0.0292,0.0826,0.0122,0.0567,0.0046,-0.1001,0.0657,0.0588,0.0583,0.0663,-0.0349,-0.0367,0.1681,0.0692,-0.0557,-0.04,-0.0972,0.0866,0.0488,0.109,-0.0636,-0.1424,0.0211,0.0767,0.0971,0.093,0.1374,-0.031,-0.0632,-0.0735,-0.0469,-0.04,0.3989,-0.0992,0.0725,0.0538,-0.0181,0.0459,-0.0251,0.1107,0.1103,0.085,0.0741,0.1015,-0.0489,-0.0038,0.0381,-0.0655,-0.1358,-0.0194,-0.0418,0.087,0.0193,-0.0738,-0.0615,-0.076,-0.0071,-0.0017,-0.0161,-0.0968,0.0383,0.1918,-0.0077,-0.011,-0.0456,0.1521,0.0349,0.0152,-0.1593,-0.1569,-0.0162,-0.1119,-0.0462,-0.0793,-0.077,0.0069,-0.0081,-0.0258,0.0002,-0.0065,0.0651,-0.0352,-0.0215,-0.0728,0.0386,-0.0049,0.0114,-0.0588,-0.0141,0.104,-0.0482,-0.0756,0.0607,0.0474,-0.0461,-0.0637,-0.0202,-0.1331,-0.0686,-0.1904,-0.023,0.0703,-0.1138,-0.0395,0.0225,-0.0758,0.0187,-0.0619,-0.0263,-0.043,-0.0989,-0.0771,0.0552,-0.0167,0.4575,0.4049,0.2735,0.3968,-0.1255,-0.0194,-0.0731,-0.0653,-0.1252,-0.0394,-0.0747,0.135,-0.039,-0.0568,0.068,0.0354,-0.0411,0.1065,0.0091,0.0217,0.0128,0.088,-0.0704,-0.059,-0.0584,0.1186,-0.0308,-0.0043,-0.047,-0.047,-0.1344,-0.004,-0.0081,0.0108,-0.0487,0.0737,-0.0742,0.1813,-0.2274,-0.2089,0.0579,-0.0018,-0.1705,-0.1731,-0.1528,-0.0287,-0.0124,-0.0046,-0.0198,-0.0088,0.0299,0.033,0.1121,-0.0532,0.085,-0.0514,0.025,0.0816,-0.0267,-0.0466,-0.019,-0.0451,-0.0376,-0.0665,0.0137,0.0385,0.0537,0.0901,0.0346,0.1193,-0.0356,0.1001,0.0287,0.0154,-0.0208,-0.059,0.0072,-0.112,-0.1726,-0.0179,-0.0372,-0.1426,0.0043,-0.0158,-0.1287,-0.0088,-0.0473,0.0024,-0.1312,-0.0137,-0.0976,-0.1256,-0.0111,-0.0117,-0.0262,0.1445,0.065,0.0108,0.0212,0.0008,-0.0031,0.0105,-0.0721,-0.0687,-0.0025,-0.0874,-0.029,-0.0812,0.0224,0.0283,0.0098,-0.0232,-0.0719,-0.1025,-0.0233,0.072,-0.0302,-0.0113,0.0127,-0.0136,0.0067,-0.0871,-0.0478,-0.1058,-0.0795,0.0195,-0.1303,-0.1318,-0.0045,-0.0025,0.0129,-0.0558,-0.0247,-0.0921,-0.0945,0.0164,-0.0917,0.0213,0.0642,-0.0325,-0.0392,-0.1172,0.0416,0.126,0.0307,0.0143,0.0113,-0.0325,0.2382,0.0155,0.0379,0.0174,-0.137,0.1006,-0.0423,0.107,0.0336,0.1681,0.015,-0.0591,-0.0434,0.0766,-0.0634,-0.0172,-0.0353,-0.0009,-0.1118,-0.0646,0.0061,0.0008,-0.0274,-0.0819,-0.0799,0.0393,0.0287,-0.0309,0.0362,-0.0917,0.0054,-0.0261,-0.0768,0.053,-0.0288,-0.0695,-0.0575,-0.0878,-0.0809,-0.0649,-0.0265,-0.043,0.0205,0.0239,0.0839,-0.0113,-0.0499,-0.0736,-0.003,0.0018,-0.0561,-0.1476,0.0716,-0.0311,0.0792,0.0143,0.1068,0.0174,0.0198,0.0298,-0.0666,0.0211,-0.0248,-0.0213,-0.1324,-0.0017,-0.0652,0.0284,0.0236,-0.0306,-0.0378,-0.085,-0.0542,0.0683,0.0345,-0.0333,0.3468,-0.0125,0.0492,-0.0251,0.184,0.0107,-0.0306,0.1044,0.1538,-0.0782,-0.0166,-0.0774,-0.0925,-0.0851,-0.0503,0.0483,-0.048,-0.0472,0.0938,0.1395,-0.0828,-0.0534,-0.0434,0.0176,-0.0058,0.0567,-0.1593,-0.084,-0.018,-0.1605,-0.1058,0.107,0.0061,0.0387,0.0276,0.0969,0.0349,-0.1496,-0.0883,-0.0187,-0.036,-0.1385,-0.0601,-0.0149,-0.048,-0.0796,0.0991,0.0115,-0.0092,0.068,0.0172,0.0798,0.0609,-0.0297,0.0685,-0.0266,-0.028,-0.0841,0.0043,0.0402,0.004,0.0548,0.1318,0.0194,-0.0015,-0.0442,-0.0338,-0.056,0.1541,0.1452,-0.1511,-0.1485,0.0188,-0.0332,-0.0571,0.0133,-0.1207,0.0524,-0.0518,0.003,-0.0042,-0.0153,0.1117,-0.0534,-0.0,0.0711,-0.0204,0.0095,0.118,0.0223,-0.0586,0.1452,0.0339,0.0303,0.0851,0.0634,-0.0655,0.0801,0.0374,-0.0634,-0.0269,0.0718,0.0294,0.0964,0.0419,-0.0316,-0.0434,-0.0377,0.1128,-0.0843,0.0363,0.1217,-0.0116,-0.0245,-0.005,-0.0067,-0.089,-0.026,0.0726,-0.0529,0.0746,-0.0473,0.0645,0.1018,-0.0767,-0.0367,-0.0195,0.0564,-0.0049,0.1059,0.0754,0.1051,0.0434,0.1233,-0.0413,0.0096,0.3409,-0.0617,-0.1182,-0.0344,-0.0545,0.0512,0.0439,0.1059,-0.0804,0.0286,0.0183,-0.0443,-0.0209,-0.0083,-0.0335,0.0062,-0.0121,0.0456,0.0937,0.1253,0.1805,0.1894,-0.0388,-0.0808,-0.0696,-0.0363,0.0848,0.0914,0.0033,0.0709,0.0654,-0.0111,0.1151,-0.036,-0.1567,-0.103,-0.0223,0.0388,-0.0239,0.0608,0.0037,0.1088,0.0888,0.0336,-0.03,-0.0561,0.0076,0.0031,0.057,-0.0788,-0.0782,-0.093,0.0819,-0.0511,-0.0272,0.051,-0.0762,-0.0317,0.0273,0.0143,-0.0051,0.0519,0.0427,-0.0072,0.0641,0.0169,0.0972,0.0364,0.0715,-0.0496,0.0349,0.0612,-0.0173,-0.0868,0.0418,-0.1282,-0.0816,-0.0632,-0.123,-0.0424,0.0849,-0.107,0.0768,-0.0448,-0.0124,-0.0107,0.0243,-0.0747,-0.0141,-0.016,0.0273,-0.0311,-0.0015,0.0721,-0.0218,0.0149,-0.1618,-0.1148,-0.1127,-0.0003,-0.0104,-0.0796,-0.0797,0.0229,-0.0727,-0.0545,0.1168,-0.0256,0.0594,0.0691,-0.007,0.0446,-0.0442,-0.0025,-0.0145,-0.0401,-0.1766,-0.0574,-0.0773,-0.0804,-0.0202,0.0347,0.0809,0.2737,0.1926,0.0376,0.0819,-0.0731,-0.2468,-0.1221,-0.184,-0.1204,-0.0248,0.0184,0.019,-0.079,-0.1235,-0.1074,-0.0439,0.0506,0.0475,-0.0304,-0.0748,0.0471,-0.0064,-0.1489,-0.1062,-0.055,0.0336,-0.0187,-0.0244,-0.1722,-0.1078,-0.0843,-0.0792,-0.1897,-0.0175,0.0016,-0.0081,-0.0862,-0.0601,-0.0561,-0.0405,-0.1132,-0.0331,-0.0566,-0.0162,0.0982,0.0034,0.0568,0.043,-0.0938,-0.0054,-0.0082,0.0347,-0.0429,-0.0078,-0.0948,0.052,-0.1159,-0.0912,-0.0648,-0.0856,-0.0517,-0.1068,-0.0817,-0.0897,-0.0047,-0.0578,0.0208,0.0142,-0.1587,0.0211,-0.0305,-0.0878,-0.0375,-0.0758,-0.0535,-0.1255,-0.0575,-0.0222,0.0714,-0.024,-0.0092,-0.1708,-0.093,-0.1202,-0.0466,-0.1214,-0.0917,0.0143,0.0682,0.0439,0.0101,-0.0449,-0.0237,0.0677,0.1528,0.0891,-0.207,-0.2197,-0.0724,0.0209,-0.0013,-0.0513,0.0272,-0.0646,0.026,-0.0588,-0.0598,-0.0315,-0.0237,-0.0573,-0.0806,0.0055,-0.0984,0.0162,-0.0931,-0.0289,0.0476,0.0478,-0.0617,-0.0729,-0.0633,-0.1267,-0.051,-0.1779,-0.0779,0.1904,-0.0491,-0.0678,0.0614,0.0439,0.0591,0.039,0.0098,0.0195,0.105,0.0311,0.0085,0.0378,-0.0081,0.0522,0.0256,0.0916,0.1076,-0.1011,-0.0125,0.0555,0.1246,-0.0096,-0.0224,0.0691,-0.0094,-0.0173,0.0103,0.0307,0.0259,0.0702,-0.0618,-0.0631,-0.068,0.0157,-0.0844,0.0719,0.1618,0.1883,0.022,0.0753,0.0815,-0.0037,0.0148,0.1008,0.0203,-0.0045,0.0254,-0.1647,-0.0731,-0.1228,-0.0482,0.0304,-0.0982,-0.0887,-0.0495,0.0481,-0.0728,-0.1072,-0.0652,-0.0715,-0.133,-0.2038,0.0145,-0.1563,-0.0433,0.0446,-0.1188,-0.0027,-0.128,-0.0455,-0.0055,-0.0545,-0.076,-0.0096,-0.0678,0.0369,0.0884,0.0554,-0.0084,-0.0655,0.0133,0.0242,0.0369,0.1098,0.0164,-0.0303,0.0564,-0.0228,-0.0281,-0.1169,-0.0897,-0.0229,-0.0293,0.0165,-0.0021,-0.0684,-0.0796,-0.0349,-0.0291,0.089,-0.1064,-0.0409,0.078,0.0354,0.0037,0.0289,0.0316,-0.1549,-0.0558,-0.1312,-0.0937,0.0294,0.0874,0.0918,-0.1058,0.3318,0.2307,-0.1576,-0.0843,0.3682,0.1395,0.0699,0.0895,0.1457,0.1184,-0.1271,-0.1249,-0.042,-0.0816,0.3505,0.3206,0.2412,0.0519,0.03,0.2357,0.3879,0.3989,0.3694,0.0376,-0.013,-0.0417,-0.0076,-0.0489,-0.0118,-0.0924,-0.0317,-0.0625,-0.0461,-0.0959,-0.0975,0.096,-0.0137,-0.0344,-0.059,0.0715,0.0422,0.0928,-0.0045,-0.0143,-0.0714,-0.0349,-0.0587,-0.0238,-0.0586,-0.0533,-0.0219,0.008,-0.1022,-0.142,-0.1251,-0.036,-0.0729,-0.0124,0.1148,0.0331,0.0346,0.0586,0.063,0.2652,-0.0466,-0.1244,-0.1716,0.0262,0.0584,-0.0157,0.0716,0.0179,0.0614,0.0355,-0.1081,-0.1116,-0.0762,-0.071,0.0831,-0.1656,-0.1135,-0.0169,0.0294,0.1074,-0.047,0.0155,0.059,-0.0095,-0.0453,0.0095,-0.0857,-0.1059,-0.1075,-0.0255,-0.0004,-0.0251,-0.0181,-0.069,0.0382,0.0356,0.0491,0.0065,0.0622,-0.0479,-0.063,0.0303,0.0263,0.101,0.0472,0.0033,-0.0047,-0.0545,-0.014,-0.0149,-0.0285,-0.0318,-0.0304,-0.0143,-0.0484,0.0363,-0.0065,-0.0069,-0.0108,0.0243,0.0352,0.04,0.1057,0.0622,0.165,0.0996,-0.1058,-0.1054,-0.0879,-0.104,-0.1583,0.074,-0.0144,0.005,-0.0249,0.127,0.0157,-0.1701,-0.0362,0.0474,-0.0083,0.029,0.052,0.0897,0.1077,0.2249,0.2912,0.1216,-0.0069,-0.065,-0.0472,0.044,-0.0726,-0.0852,-0.0881,0.0036,-0.0799,-0.0323,-0.0541,-0.0399,-0.0556,-0.1314,-0.1278,-0.1032,-0.0477,-0.0935,-0.1018,-0.0622,-0.1133,-0.0216,-0.008,-0.0357,-0.0567,-0.0649,0.143,0.0685,0.0749,-0.0635,0.1328,0.1254,-0.0707,0.0583,-0.1162,-0.0783,-0.0084,-0.04,-0.0482,0.0021,0.0334,0.0678,-0.0039,-0.0825,-0.0256,-0.0194,-0.0072,0.0313,-0.0386,0.0136,0.0006,0.0009,0.0638,-0.0957,-0.0922,-0.0533,-0.0773,-0.0456,-0.0296,-0.057,-0.0207,0.0826,-0.0124,-0.0306,-0.1819,-0.0906,-0.1089,-0.1396,-0.1257,-0.1012,-0.1023,-0.1023,-0.0249,-0.0491,0.0049,-0.1283,0.0259,-0.0457,-0.0433,-0.0391,0.0418,-0.2407,0.0777,-0.0934,-0.0147,0.0571,0.049,0.0785,0.0069,-0.0759,-0.1139,0.0732,0.0936,-0.0069,0.0159,0.0535,0.006,0.1167,0.067,0.0112,0.0442,-0.0001,-0.0087,0.0268,-0.2025,-0.1129,-0.0431,-0.0906,-0.0329,-0.0336,-0.0293,0.022,-0.0159,-0.0563,0.0044,0.0631,-0.0164,0.1103,0.035,-0.1631,-0.104,-0.1849,-0.0557,-0.076,-0.0035,-0.0322,0.0939,0.0846,-0.0008,0.0644,0.041,-0.0111,0.126,0.0224,0.2137,0.135,0.0179,0.0625,-0.0721,0.0395,0.0493,0.0632,-0.0415,-0.0105,0.038,0.001,-0.0289,0.0212,-0.0703,0.0449,-0.022,0.0698,-0.0382,-0.0239,0.147,-0.014,0.0965,0.1135,-0.0119,0.0151,0.0252,-0.0987,-0.0852,-0.0309,0.0762,0.0517,-0.0087,-0.024,-0.0626,-0.0037,0.0469,0.0851,0.0074,0.04,0.0312,-0.0468,0.0708,-0.0613,0.0172,0.0316,-0.0359,-0.0778,-0.0774,-0.0616,-0.0538,-0.035,0.0095,-0.073,0.0563,0.0351,0.1247,-0.0207,0.0113,0.0609,-0.0377,-0.0662,-0.0541,-0.138,-0.1048,-0.0163,0.0179,0.0227,0.0075,0.0203,0.1032,0.0361,-0.0858,-0.0601,-0.1227,-0.1038,0.0178,0.021,0.0679,-0.0993,-0.0735,-0.1086,-0.0376,-0.0687,-0.0177,0.0138,-0.0731,0.0318,-0.0486,-0.0414,-0.0128,0.0134,-0.1085,0.0309,-0.0082,0.0108,-0.1178,0.055,0.0102,-0.0856,0.0141,0.0752,-0.0135,0.0157,-0.0816,-0.0789,-0.0727,-0.1109,-0.1073,-0.0454,-0.082,-0.0478,-0.0253,0.0362,0.034,0.0618,-0.095,-0.0777,0.0636,0.1614,0.2601,0.0339,-0.0076,-0.015,-0.0623,-0.0679,-0.0179,-0.1136,-0.059,-0.0714,0.0115,-0.1004,-0.1375,0.2109,-0.009,0.0386,0.2275,0.0399,0.1054,-0.1051,-0.0044,-0.0353,-0.0552,-0.0089,0.014,-0.0004,0.0525,-0.0124,-0.0486,-0.0227,-0.0594,-0.0186,-0.0373,-0.1288,-0.0019,0.0026,-0.0049,0.0006,-0.0013,-0.0011,0.0056,-0.0482,0.0694,-0.1682,-0.0321,-0.1094,-0.1373,0.0039,-0.1209,-0.0872,-0.1646,-0.0927,-0.0354,0.0346,-0.1332,0.0015,-0.0856,0.0445,0.0314,-0.0007,-0.1239,-0.1414,-0.0766,-0.0271,0.0645,0.0556,-0.0357,0.0112,-0.0471,0.0586,0.032,0.0061,0.0253,0.0336,-0.0423,-0.0198,0.0236,-0.046,0.0276,-0.0304,-0.0204,0.0351,-0.0179,0.1159,-0.0486,0.166,0.1413,0.0267,0.0209,-0.0046,-0.1028,-0.0864,0.0256,0.1691,0.2022,0.1476,0.0531,0.0527,-0.016,0.095,0.095,0.0628,0.0209,-0.117,-0.0134,-0.0745,0.0388,-0.0178,-0.0393,-0.0063,-0.0177,0.0624,0.0532,0.0655,-0.042,0.0892,0.0203,-0.0891,0.0588,0.0428,0.0089,0.0046,0.1002,0.0984,0.0403,0.0388,0.0293,-0.0707,0.019,0.1221,0.1104,0.0605,0.0111,0.0866,-0.0072,-0.1365,-0.2952,-0.2867,0.0607,0.074,0.0053,0.0025,0.0049,-0.0303,-0.0793,-0.1019,-0.1265,0.0632,-0.0158,-0.004,-0.0525,-0.015,-0.0184,-0.1105,-0.0258,-0.1098,-0.1075,-0.0018,-0.024,-0.0049,-0.2204,-0.0802,0.0003,-0.0297,-0.0364,0.0363,-0.0456,-0.0631,-0.0774,0.1239,-0.1188,0.0336,0.0033,0.0174,0.0144,0.0315,-0.0006,0.0264,0.0265,-0.0055,-0.0378,-0.0344,0.0411,-0.0471,-0.086,-0.1143,-0.1773,-0.081,-0.0264,0.0025,0.0676,-0.042,-0.0599,-0.0918,-0.1264,0.0334,0.0609,-0.1311,-0.0414,-0.0307,-0.0822,-0.1544,0.2616,0.0668,-0.0462,-0.0097,0.0633,0.0874,-0.0443,-0.0558,-0.1477,-0.1831,-0.09,-0.0909,0.0582,0.0335,-0.0261,0.048,-0.08,0.0239,0.3343,0.0699,0.1003,0.2865,-0.1807,-0.1281,-0.0532,0.0697,0.0158,-0.0253,-0.0621,0.0134,0.0632,-0.1262,-0.0856,-0.0221,0.1824,-0.058,0.0357,0.0531,0.0296,0.074,0.138,-0.0078,-0.0666,-0.0716,-0.0412,0.0545,0.0447,0.0517,0.0609,0.0709,0.0039,0.0291,0.0367,0.0397,-0.0008,-0.0795,0.029,-0.0233,-0.0198,0.0053,0.0253,0.0423,-0.0064,-0.0324,0.0172,-0.0617,-0.0229,-0.1701,-0.0937,-0.0448,-0.0909,0.2531,0.0205,0.2178,0.0463,0.0228,0.0116,0.0186,0.0703,-0.0623,0.0535,0.1164,0.0749,0.056,0.0563,0.0168,-0.09,-0.0246,-0.0064,-0.015,0.0774,0.1072,-0.0634,0.067,0.0467,-0.0023,-0.0058,-0.0005,-0.0309,-0.0721,0.0047,-0.0492,0.1061,-0.0482,0.1274,0.0465,0.0888,0.0182,0.0022,0.0165,-0.0168,-0.0063,0.0436,0.1271,0.03,0.0357,-0.0504,0.0933,-0.0506,-0.0668,-0.032,0.057,0.0714,-0.0067,-0.0966,-0.0466,-0.0956,-0.084,0.0037,0.0846,-0.0093,-0.039,-0.1096,-0.1225,-0.0294,-0.0496,-0.0452,-0.0308,-0.0361,0.0285,-0.0895,0.0094,-0.0363,-0.0075,-0.0655,-0.0519,-0.0121,-0.0767,-0.0798,0.0565,0.002,-0.0012,-0.0645,0.0476,0.1201,-0.0107,-0.0731,0.0346,-0.01,-0.036,0.037,-0.0106,0.0537,0.1946,0.1815,-0.0146,0.0203,0.0572,0.0387,-0.0849,-0.0162,0.0041,-0.0102,-0.0584,-0.0524,-0.0123,-0.0946,0.0266,-0.131,-0.0548,0.0376,0.0441,-0.1687,-0.0181,0.0592,0.091,-0.0123,-0.0774,-0.2995,-0.2551,-0.1284,-0.1854,0.1678,-0.0455,-0.0368,-0.0028,-0.0181,0.0148,-0.0621,0.0053,0.2417,0.1113,0.198,0.0558,0.0636,-0.0503,-0.0139,0.0306,0.0289,0.0084,-0.0183,-0.0088,0.1534,0.0634,-0.0944,-0.169,-0.1012,-0.1046,-0.1166,-0.0082,-0.0092,0.0283,0.0338,0.0157,-0.0045,-0.0104,-0.118,-0.0275,-0.1376,0.0059,-0.1331,-0.1717,0.0183,0.0802,-0.0464,-0.0146,-0.0771,-0.1019,-0.0913,-0.1146,0.0132,-0.0763,-0.0788,0.0071,0.0406,-0.0581,-0.1107,0.0367,-0.0234,0.0063,-0.0802,-0.0675,-0.099,0.0173,0.087,0.0262,-0.0494,0.1151,-0.0499,-0.0444,0.033,0.0337,0.0536,0.0096,-0.0366,0.024,-0.0495,0.0171,0.0597,0.1523,0.1265,0.0492,0.0687,0.0361,0.0159,-0.086,0.1121,-0.0747,0.0868,-0.0009,0.0524,0.0634,0.07,0.0012,-0.0443,0.0011,0.0208,-0.0351,-0.0203,0.0838,0.0551,-0.0076,-0.0677,0.0268,0.0612,0.0013,-0.1692,-0.1024,-0.1547,-0.0097,-0.1188,-0.0786,-0.0068,0.034,0.0314,-0.0114,-0.0812,-0.1014,0.038,0.045,-0.123,0.0457,0.1122,0.0387,-0.0155,0.0462,0.1533,0.0821,0.035,0.0798,-0.0649,-0.0298,0.1504,0.046,-0.0548,0.137,0.0083,0.0066,0.06,0.1376,0.0288,-0.0911,-0.0613,-0.0471,0.0388,0.1609,-0.0443,0.0765,-0.0242,-0.0032,-0.0425,-0.0655,0.0186,0.1012,-0.086,-0.0591,0.0608,-0.0482,-0.0708,-0.0321,-0.0742,-0.1082,-0.0814,-0.0988,-0.0938,-0.1581,-0.1011,0.0804,0.17,-0.0134,-0.0634,-0.019,0.087,-0.0355,-0.0761,-0.1254,-0.1303,0.0445,0.042,-0.105,-0.0954,-0.0509,0.0326,-0.1223,-0.0919,-0.0383,-0.0462,-0.0707,-0.1423,-0.0472,0.0137,-0.0473,-0.0938,-0.0025,-0.0552,0.0501,-0.0752,-0.0092,0.1015,0.0358,-0.1127,0.0112,-0.0915,-0.1178,-0.0757,-0.078,-0.0673,0.0157,0.0687,0.1465,-0.0575,-0.1123,0.0629,-0.0537,-0.0274,0.0125,-0.1283,-0.08,-0.1289,0.0735,0.0383,0.0947,-0.0194,-0.1812,-0.1272,0.0096,0.0221,-0.028,0.024,0.0981,-0.063,-0.0661,-0.0771,-0.0647,-0.093,-0.1584,-0.0844,-0.0916,-0.0215,-0.0185,-0.0045,-0.0115,0.1596,0.0088,0.0308,-0.0195,0.0388,0.0829,0.0733,0.0174,0.0225,-0.1079,-0.0051,-0.0836,-0.0486,-0.0634,-0.0527,-0.0196,-0.0161,-0.0856,-0.0467,-0.0774,-0.0205,-0.0237,-0.0045,-0.0056,0.1803,-0.0099,0.1312,0.036,0.036,0.0215,0.075,0.001,-0.0595,-0.073,-0.0366,0.1109,0.0119,0.01,-0.048,-0.0247,-0.0917,-0.0748,0.0034,-0.0263,0.0495,0.1116,-0.1438,-0.132,-0.0076,-0.0804,-0.0328,-0.0507,0.2435,0.1723,-0.0625,0.0098,-0.011,-0.071,-0.048,-0.064,-0.1336,-0.1122,0.0738,0.0257,-0.0676,-0.0098,-0.0997,-0.0439,0.1452,-0.0031,0.0167,-0.0249,-0.0151,0.0634,-0.0986,-0.0093,0.1305,-0.1037,0.0414,-0.1144,0.1379,-0.1125,0.3418,-0.0274,-0.0173,-0.1048,-0.0913,0.0602,0.0476,-0.0362,0.0349,0.036,-0.0135,-0.052,0.0299,-0.0084,0.0297,0.0521,0.1164,0.1206,0.1749,0.2838,-0.0339,-0.0394,0.1935,0.3833,0.0925,0.172,0.2959,0.1514,0.1417,0.1827,0.1286,0.1671,0.1603,0.1262,0.226,0.0902,0.2172,0.2811,0.2422,0.2671,0.1225,0.0774,0.031,-0.1189,-0.1343,-0.1023,-0.0725,0.0082,-0.1774,-0.165,-0.0975,-0.0201,-0.023,-0.2005,-0.1685,-0.1163,-0.0172,-0.0076,-0.0866,0.098,-0.019,-0.0973,-0.0178,-0.074,-0.0461,-0.0761,-0.0259,-0.0996,0.1057,-0.1687,-0.195,0.0441,-0.0352,-0.045,0.0051,0.0036,-0.1062,-0.0135,0.0055,-0.0674,0.1849,0.2839,0.0282,0.1395,0.1591,-0.0878,0.0331,0.035,-0.0343,-0.0809,0.1448,-0.0374,0.0136,-0.0807,-0.0013,0.1768,-0.0828,-0.0859,-0.0273,-0.0015,-0.043,-0.0419,visual string recognition
trm_55ef687f48a9d,-0.0325,-0.0658,-0.0282,0.0696,0.0706,0.0355,-0.0327,0.0007,-0.0043,-0.0036,0.0258,0.027,-0.0492,-0.0581,-0.0105,-0.0215,-0.0369,0.0284,-0.0074,-0.0166,0.0097,0.0404,-0.0271,-0.0058,-0.0363,-0.0046,-0.0083,-0.0193,-0.0559,-0.0566,-0.0521,0.0208,-0.0885,-0.027,-0.079,-0.0368,-0.0455,0.0008,-0.0356,0.0384,-0.0656,-0.0719,-0.0678,0.061,-0.0041,-0.0228,0.0274,-0.0456,0.0468,-0.0111,-0.0088,-0.02,0.0361,0.1076,0.0537,-0.0463,-0.0749,-0.0083,0.0158,-0.0338,-0.0231,0.0455,-0.0338,0.0762,0.0549,-0.0254,-0.0221,-0.041,-0.0012,-0.038,0.0801,0.0128,0.1022,-0.056,0.0527,-0.0085,-0.1117,0.0683,0.0632,-0.1139,-0.0391,0.1157,-0.0331,-0.0487,0.0709,0.0278,-0.01,-0.0217,-0.0238,-0.2575,-0.0707,-0.0782,-0.0231,0.0067,-0.0642,-0.0324,0.011,-0.0009,0.1196,-0.0056,0.0082,0.0342,0.0728,-0.03,0.0237,-0.0498,-0.0935,-0.0225,-0.0157,0.0183,0.0276,-0.011,0.0831,0.0598,0.0319,-0.0269,0.0419,-0.0588,0.037,-0.0204,0.0078,-0.042,0.0199,-0.0291,-0.0151,-0.0533,0.0272,0.0293,0.0372,-0.0194,-0.0625,0.0032,-0.0671,-0.1303,0.0093,-0.0628,-0.0146,-0.0335,-0.0247,-0.0432,-0.0504,0.011,0.0073,0.0099,0.0151,0.0741,-0.0206,0.0867,-0.055,0.0543,-0.0088,-0.024,-0.0797,-0.0464,0.0853,-0.0445,0.0616,0.0408,0.0737,-0.0121,0.0075,-0.0135,-0.0337,-0.0761,-0.0055,-0.0242,0.0124,-0.0987,-0.0899,0.0077,-0.0713,-0.0281,0.0279,-0.1231,-0.049,-0.1025,-0.0979,-0.0276,-0.0406,-0.0193,-0.1174,0.001,0.0202,0.0666,-0.078,-0.0146,-0.1295,-0.0787,-0.0586,0.011,0.0126,-0.0662,-0.0629,-0.0741,-0.0629,-0.0258,0.0423,-0.0493,-0.0101,-0.0606,0.0108,0.0867,-0.0677,-0.0809,0.2269,-0.1457,-0.1519,0.0284,0.0092,0.0414,-0.0294,-0.0315,-0.0752,0.0363,-0.0096,0.0165,0.0678,-0.0448,-0.0812,0.0374,0.0121,-0.0423,-0.0568,-0.0279,0.0455,-0.0176,-0.0093,-0.0347,-0.0175,0.221,-0.138,-0.0804,0.0678,-0.0726,-0.0694,-0.0341,-0.0306,0.0722,0.0479,-0.0841,0.0205,-0.1053,-0.005,-0.0219,0.0017,-0.044,0.0022,-0.048,-0.0385,0.0151,0.0056,-0.0119,-0.0382,0.038,-0.0363,-0.0832,0.0209,-0.0289,-0.0017,0.1112,0.0631,0.1735,0.0198,0.1273,0.1476,0.236,0.1498,0.0122,-0.0116,-0.0327,-0.018,-0.0509,-0.1301,0.0008,-0.1462,-0.1361,-0.1932,-0.2099,-0.1604,-0.0417,-0.0891,-0.0658,-0.0289,-0.0946,-0.0746,-0.0657,-0.0209,-0.0288,-0.0542,-0.0722,-0.0311,0.0001,0.0131,-0.0149,-0.0704,0.0041,-0.0306,0.1069,0.0594,0.144,0.0013,0.02,-0.07,-0.0693,-0.0127,-0.0002,-0.0549,-0.0391,-0.0663,0.0154,-0.002,0.0076,0.0437,0.0975,0.0663,-0.0233,0.1036,-0.0086,0.1107,-0.0423,0.0467,0.0445,-0.0553,-0.0353,-0.0355,0.0112,0.0011,-0.0972,-0.0125,-0.0941,0.0335,-0.0313,0.027,0.0192,0.0744,0.0201,0.0394,0.054,-0.1017,0.0068,0.0146,0.0136,-0.0226,-0.015,0.0159,0.0278,-0.1344,-0.0986,-0.0961,-0.0695,-0.1229,-0.1008,-0.086,-0.0787,-0.0879,-0.0369,0.0191,-0.0926,-0.0837,-0.0715,0.0289,-0.018,-0.0013,0.0356,-0.0239,0.0608,-0.0591,0.2539,-0.0178,-0.0856,0.0121,0.0788,-0.009,0.0742,-0.0515,-0.0776,-0.0586,0.0452,-0.0136,0.047,0.0157,-0.0173,0.0392,0.1101,0.0141,0.036,-0.0365,-0.0167,0.0647,0.0032,-0.0092,-0.0247,-0.0253,0.0102,0.0543,-0.0141,-0.0959,-0.1014,-0.055,0.0197,-0.0073,0.0218,-0.0101,-0.0212,0.0311,0.1324,0.0089,0.0367,-0.0164,-0.0337,-0.0046,-0.084,0.0135,0.0652,-0.0764,0.0109,0.129,0.1584,0.1246,0.1058,0.0391,-0.1061,-0.0526,-0.0517,-0.0387,0.0033,-0.0744,-0.0601,-0.0084,0.0044,-0.0218,-0.024,-0.0113,-0.0288,-0.0067,0.0727,-0.095,-0.0169,-0.1272,-0.0675,-0.1038,0.0243,-0.0068,0.0341,-0.0792,-0.0407,-0.0196,0.0406,0.0061,0.1815,0.2326,0.0498,-0.0475,0.0031,0.0758,-0.0241,-0.0348,0.0279,0.0904,0.0217,0.0977,-0.0018,-0.0133,0.0502,-0.1119,-0.0494,0.0294,0.2161,-0.0837,-0.0813,0.0268,-0.0023,0.0947,-0.0655,-0.1412,0.0328,-0.011,-0.0189,-0.0146,0.0079,-0.0158,0.0274,-0.0297,0.0647,0.1813,0.1078,-0.0208,0.0208,0.0158,-0.015,-0.0742,0.0492,0.024,0.0119,0.0796,-0.054,-0.1254,0.0693,0.0459,0.0393,0.0388,0.039,-0.0325,-0.0331,-0.0494,-0.0664,0.0128,-0.0437,0.0192,0.0505,-0.073,-0.0171,0.0049,0.0507,0.0356,0.0661,-0.0247,-0.0082,0.0167,-0.0139,-0.0167,-0.0578,0.0273,0.2125,0.1439,0.0383,0.0701,0.0323,-0.0394,0.0541,-0.0285,-0.0469,-0.0545,-0.0524,-0.0596,-0.0306,-0.0703,0.025,-0.0093,-0.0914,0.0197,0.0243,-0.0502,-0.0369,-0.0082,-0.0664,0.0728,0.0377,-0.003,0.0056,0.0148,0.0131,0.0165,-0.0566,-0.0303,-0.1032,0.0388,0.0298,0.0075,-0.0718,-0.0438,0.024,-0.0619,-0.0117,-0.0748,-0.065,0.0355,-0.0231,0.0228,0.0091,-0.0149,0.0498,-0.043,-0.0019,-0.0943,-0.0599,-0.0373,0.0096,0.0091,0.0506,-0.0418,-0.0232,0.0062,0.0077,0.1708,0.103,0.1493,0.0622,0.0533,0.026,-0.0659,0.0998,0.1645,0.0909,0.0552,-0.0252,-0.0575,0.0378,0.0888,-0.0326,-0.0399,0.0114,0.0666,0.0094,-0.0075,-0.0457,-0.018,-0.089,-0.0856,0.2062,-0.0697,-0.0453,0.1145,0.0068,-0.1021,-0.0391,-0.0249,0.1109,0.0069,-0.0857,-0.0149,-0.0582,-0.0079,0.004,-0.0415,0.0096,0.0388,-0.0711,-0.0256,0.0709,0.0427,0.0236,-0.0344,0.101,0.1924,0.0247,0.1156,-0.0135,0.0122,0.0029,-0.012,0.0712,0.0344,-0.0916,-0.0188,-0.023,-0.0437,-0.0321,0.1328,-0.0729,0.1825,-0.0947,0.1326,-0.0886,-0.0096,-0.053,-0.0326,-0.0123,0.028,-0.0281,-0.0442,-0.0775,0.0467,-0.0812,-0.0047,0.0701,-0.1167,-0.0847,-0.021,0.0122,0.0085,-0.0486,-0.0535,-0.0299,0.0036,-0.0201,-0.0028,-0.041,-0.0329,0.0078,0.0875,0.0081,0.0333,0.0208,0.0209,-0.0551,-0.0441,0.0156,0.0259,-0.0177,0.0593,0.1567,0.111,0.0442,0.129,0.0417,0.015,-0.0244,-0.0281,0.1114,0.076,0.0456,-0.0586,-0.067,-0.045,-0.0225,-0.0743,-0.0835,-0.0823,0.0733,0.0716,0.1768,0.1678,-0.0284,0.1536,0.0387,0.0316,-0.0408,-0.0601,0.0046,-0.0068,-0.0538,-0.0853,-0.0791,-0.1041,0.0145,0.0046,0.0219,0.0719,-0.0435,0.0268,-0.0058,-0.0314,0.1036,0.101,-0.0448,-0.0929,0.1394,0.1285,0.213,-0.0914,0.0089,-0.0246,-0.0454,0.0205,-0.0778,0.0832,-0.0352,0.001,0.0298,0.0521,-0.0204,-0.0318,-0.0622,-0.0588,-0.0236,0.0072,0.0686,0.0192,-0.093,-0.0586,0.0139,0.038,-0.0009,0.0137,-0.0063,-0.0274,-0.024,-0.024,0.0972,0.0411,0.0213,-0.0517,0.0398,0.0077,-0.0397,0.0402,-0.0015,-0.0813,0.0066,-0.0538,-0.0635,-0.014,0.0156,0.0607,0.0365,0.0473,-0.0312,0.053,0.1518,-0.0216,0.0003,0.034,-0.0063,0.0006,0.012,0.0554,-0.0321,0.1015,-0.083,-0.0825,0.1339,0.0583,0.059,-0.0076,-0.03,0.0291,-0.0088,0.0356,0.0868,-0.0502,0.0428,0.0484,0.0792,-0.0476,0.0342,0.064,0.1008,-0.0826,0.0128,0.0224,-0.0713,-0.0672,-0.0163,-0.0603,-0.0275,-0.003,0.0457,-0.0449,-0.0197,-0.0609,-0.0257,0.0172,0.0046,-0.0122,-0.0198,0.0998,0.0127,0.0415,0.0473,0.0434,0.1294,-0.0247,0.0583,0.0524,0.0179,0.0755,0.1047,-0.0789,0.1352,0.0472,-0.0609,-0.0159,-0.0219,-0.0424,0.1376,0.2346,-0.1128,-0.0227,-0.0209,0.0402,0.1315,0.1096,0.0875,-0.0802,-0.0619,0.0526,0.006,0.1239,0.0974,0.1129,-0.0785,-0.0438,-0.0076,0.0494,0.3404,0.1347,0.3272,-0.0578,-0.0766,-0.032,0.1298,-0.0153,-0.0186,-0.0596,0.052,-0.0165,-0.0069,-0.0145,-0.0657,0.0086,-0.0767,-0.0936,-0.0024,-0.0223,0.0733,0.0065,-0.0183,-0.0034,0.0078,-0.0291,0.0412,0.0685,0.0585,0.0849,0.1574,0.1444,-0.0356,-0.0197,-0.0172,-0.0126,-0.0369,-0.0114,0.0082,0.0746,0.0454,-0.0311,-0.0617,0.0783,0.1244,0.0686,-0.0139,0.03,-0.0066,-0.1484,-0.0227,-0.0199,-0.0677,0.0012,-0.0854,-0.012,0.0287,-0.0448,-0.0448,0.0097,-0.0118,-0.0596,-0.0304,-0.0854,-0.0644,-0.0566,-0.1324,-0.0202,-0.1233,0.0193,-0.0012,-0.0347,-0.0408,-0.0134,-0.1234,-0.0459,-0.1329,-0.1265,-0.1395,0.0114,0.0287,0.1026,-0.0252,0.0584,0.0136,0.0131,-0.0179,0.1111,0.1213,0.1109,-0.0209,0.0047,0.0033,-0.0265,0.0387,0.0777,0.0315,-0.0558,0.015,-0.0818,0.0344,-0.0733,-0.0634,-0.047,0.0029,-0.0342,0.0362,-0.0713,0.0002,-0.0009,0.0257,0.0255,0.0103,0.0729,0.0226,0.0093,0.1057,0.0437,0.1669,0.116,-0.0393,-0.0095,0.0005,-0.023,-0.0079,-0.0271,-0.0722,0.0393,0.0687,0.0555,-0.0729,-0.0191,-0.0235,-0.054,-0.0276,0.1015,0.0365,0.1031,0.0533,0.0405,-0.0246,-0.027,0.0633,-0.0037,-0.0444,-0.0644,-0.0015,-0.058,-0.1424,-0.0318,0.0797,0.0462,-0.0276,-0.0037,0.0565,-0.0161,0.0741,-0.0134,0.0701,0.2683,0.1465,0.1449,0.1429,0.0257,0.0634,0.0047,-0.0074,-0.0402,-0.0027,-0.0316,0.0305,0.0366,0.1088,0.01,-0.0548,-0.0194,-0.1569,-0.1018,-0.0976,-0.0746,0.1039,0.0476,0.0234,-0.0413,0.0481,0.015,0.0033,-0.0687,0.0167,0.0127,-0.0051,0.0192,-0.0591,-0.0166,-0.0217,0.0229,-0.0796,-0.0109,-0.0753,-0.0629,-0.0971,-0.0264,-0.0943,-0.0903,-0.0317,-0.0807,-0.0434,-0.0253,0.026,-0.0452,0.0794,0.0052,0.0363,-0.0097,-0.0664,0.1331,0.0978,0.0848,0.0881,0.0735,0.0047,0.0751,0.008,-0.058,-0.0278,-0.0265,-0.0166,0.0147,-0.0119,-0.1284,-0.0789,-0.1195,-0.0013,-0.0074,0.0412,0.0119,0.015,-0.0732,-0.0387,-0.0486,-0.0065,0.0327,0.0004,-0.005,0.0015,0.0218,0.0214,0.0143,-0.0444,0.071,-0.0141,0.0716,0.0068,-0.0716,-0.0864,-0.0639,-0.0408,0.0538,-0.0166,-0.0484,-0.0827,-0.1745,-0.0865,-0.0038,-0.014,-0.0586,0.11,0.0424,-0.0254,-0.072,-0.0883,-0.0246,0.0407,-0.0172,0.0686,0.0518,0.069,0.0761,0.0649,-0.0689,-0.0092,0.0263,-0.0346,-0.0088,-0.0079,-0.0117,-0.0267,-0.0696,-0.0548,-0.0508,-0.0148,-0.1351,-0.0568,-0.0185,-0.0383,0.0056,0.0757,0.0972,-0.0452,-0.0052,-0.0623,-0.0718,-0.0499,0.0111,-0.0665,-0.1128,-0.0093,-0.0285,0.0239,0.1682,0.1494,0.0714,0.0946,-0.0151,0.0151,0.0868,0.1408,-0.0313,0.2286,-0.0488,0.2291,0.2626,0.1411,-0.0969,0.2862,0.2054,0.1247,-0.0987,-0.0402,-0.0268,0.0129,-0.0455,-0.0098,0.042,0.0155,0.0251,-0.0332,-0.043,-0.0657,-0.0277,-0.0516,0.0043,-0.0001,0.1009,0.0408,-0.0084,0.0203,-0.0196,0.036,0.008,0.0304,0.0631,0.043,0.0388,0.0946,-0.0617,-0.0002,-0.0088,-0.0354,0.0076,0.0731,-0.0373,0.0653,0.0584,0.0071,-0.0046,-0.0322,0.0178,0.0609,0.0422,0.0202,-0.08,0.0416,0.0329,0.0193,0.0193,-0.0905,0.0969,0.0337,0.0461,-0.0439,0.0858,-0.0319,0.032,-0.1434,-0.1149,0.0453,-0.0499,-0.1124,-0.1081,-0.0688,-0.0141,-0.0662,0.039,0.0533,-0.0272,0.0524,-0.1228,-0.0721,-0.0743,0.0257,-0.0394,-0.0082,-0.0345,-0.076,0.016,0.0239,-0.054,-0.0041,-0.0105,-0.1446,-0.041,-0.0181,-0.0657,-0.0918,-0.0244,-0.0042,-0.0231,-0.0946,-0.0229,0.0811,0.0246,-0.0415,-0.0533,-0.0779,0.0225,0.0056,-0.0201,-0.064,-0.0504,-0.0898,-0.005,-0.0762,0.0634,-0.1963,-0.1303,-0.0454,-0.0999,-0.0237,0.055,-0.012,0.1254,-0.0602,-0.0322,-0.003,-0.0631,-0.0015,-0.0644,-0.2099,-0.2095,0.041,-0.0536,-0.0158,0.0261,-0.0349,0.0397,0.0515,0.021,-0.1045,-0.0153,0.0538,-0.0106,-0.0758,0.0003,-0.0265,0.0454,-0.0495,-0.0806,-0.0272,-0.0669,0.0321,-0.0793,-0.049,-0.0578,0.0063,0.003,-0.1064,-0.0415,0.0179,-0.0039,0.0277,0.0342,-0.1196,0.0546,-0.0193,0.0724,-0.1278,0.0217,0.0086,0.0415,-0.061,-0.0245,-0.0268,-0.0166,0.0825,-0.0065,-0.0183,-0.0361,-0.0806,-0.0486,-0.0231,-0.0337,0.0033,0.0169,0.0021,-0.0909,-0.0265,0.0072,-0.0103,-0.0502,0.0101,0.0244,-0.0163,-0.0498,0.042,0.1316,0.0053,0.0216,-0.0446,0.0019,-0.0221,0.0142,-0.0529,-0.0693,-0.0221,-0.0034,-0.0523,0.0358,-0.022,0.0101,-0.0534,0.0805,-0.0107,-0.0099,0.0454,-0.0274,-0.0389,-0.0329,0.0383,-0.0114,0.0357,0.0165,0.0365,0.0358,0.055,0.0104,0.0339,-0.062,-0.04,0.0479,0.0218,0.0788,0.0459,0.0303,-0.0789,-0.0649,-0.0585,-0.0348,-0.108,-0.0001,-0.1549,-0.0458,-0.0421,-0.0334,-0.0016,-0.0473,-0.0029,0.077,-0.0088,0.0166,0.0216,0.1661,0.0889,0.0239,0.0065,0.0255,-0.0356,0.0204,0.0971,0.0641,0.0582,0.0697,-0.0087,0.0062,-0.0572,0.0168,-0.0063,0.0191,-0.1061,-0.0867,-0.0383,-0.0184,-0.0424,0.043,0.083,0.0676,-0.1562,-0.0449,-0.0528,-0.1261,-0.1017,-0.0386,0.0307,-0.0236,0.036,-0.1203,0.002,-0.069,0.0637,-0.0289,-0.0302,-0.1372,-0.0033,0.0481,-0.1188,-0.0259,0.0707,-0.0536,0.0021,-0.0731,0.033,0.0042,0.2133,-0.0146,0.0641,-0.0345,0.0647,-0.0671,-0.0028,-0.0373,0.0132,-0.0316,0.0186,0.0925,0.0333,-0.0319,-0.0649,0.1119,0.2348,0.2423,-0.0759,-0.012,0.07,-0.0651,-0.0919,0.0129,-0.109,0.0129,-0.0251,-0.0339,0.0411,0.0131,0.0906,0.1195,0.1009,0.0018,0.0377,0.1132,0.2589,-0.1197,-0.0052,0.1357,-0.0839,0.0296,-0.0095,-0.0065,-0.031,0.1865,0.1488,0.0096,-0.0616,0.0271,0.0039,0.1117,0.0501,0.0628,-0.073,-0.0345,0.0124,-0.0377,0.0459,0.0998,-0.0245,-0.034,-0.0179,-0.0642,-0.0691,-0.0302,-0.0035,-0.0619,-0.0721,-0.1151,-0.0438,-0.0105,0.0119,0.0241,0.0311,-0.0113,-0.0245,0.109,0.0157,0.0541,0.0472,0.1521,0.1146,0.0688,0.0846,0.039,0.0323,0.2381,-0.1775,-0.03,-0.0652,0.0132,-0.0147,0.0097,0.0024,-0.0044,-0.0047,0.0735,0.0375,0.0387,-0.0204,0.0141,0.0158,0.0099,0.1211,0.1317,-0.0374,-0.1009,-0.0589,0.0258,-0.0396,-0.061,-0.0064,-0.0351,-0.0124,0.0597,0.0243,-0.1313,-0.1514,-0.0194,-0.0556,0.0738,0.0046,-0.0128,0.0861,0.1388,0.1428,-0.0723,-0.0067,0.0359,-0.0102,0.0215,0.0765,-0.188,-0.1879,-0.2264,0.0127,0.0137,0.0636,0.2594,-0.0557,-0.0251,0.0163,0.114,0.1116,0.0913,-0.044,-0.0599,-0.0976,-0.021,-0.011,0.0454,0.0997,-0.0016,0.0687,0.0756,0.0293,-0.073,0.0936,-0.1422,0.084,0.0663,-0.0328,0.0101,-0.0424,0.0179,-0.086,-0.0201,-0.0105,-0.0126,-0.0277,-0.0817,0.0256,-0.0144,0.0036,-0.0307,0.0902,0.1309,0.1319,0.2294,-0.0441,-0.0208,-0.0299,-0.032,0.1574,0.1359,-0.0791,-0.1018,-0.0679,-0.0438,0.0995,0.0793,0.1222,0.038,0.0031,-0.0492,-0.0736,0.003,-0.027,-0.0014,-0.1253,-0.055,-0.0289,0.0468,-0.043,-0.0015,0.0473,0.1335,0.0684,0.1427,0.0584,-0.0869,-0.1206,-0.0876,-0.1124,-0.0682,0.0877,-0.0194,0.0147,-0.0655,-0.0444,-0.0435,-0.009,-0.0614,-0.0693,-0.0131,-0.0071,-0.0052,-0.0073,-0.0753,-0.1111,-0.0638,0.0664,0.0232,0.0188,-0.0469,0.0956,0.0258,-0.0277,-0.1307,0.0038,-0.008,-0.1193,-0.0382,0.0254,0.0298,0.0245,-0.0042,-0.1108,-0.0346,0.2854,0.0552,0.2196,0.0991,0.1332,0.0886,0.1938,0.1614,0.2305,-0.029,-0.009,-0.0151,0.0559,-0.1322,-0.1597,-0.1371,-0.0232,-0.0144,-0.0342,-0.0168,0.0004,-0.0778,-0.0033,0.0793,0.0704,-0.0867,0.0095,0.0319,-0.0056,-0.0811,-0.0212,-0.0624,-0.1067,0.1316,-0.0143,0.0458,-0.0696,-0.1414,-0.1319,-0.0323,-0.054,-0.0463,-0.1302,-0.1339,-0.0231,-0.0957,-0.0519,0.0125,0.0072,0.0508,0.0363,0.0957,0.0264,-0.0736,-0.1,-0.014,0.0324,-0.0461,-0.0152,0.0769,-0.0625,-0.0109,-0.0055,-0.003,-0.0813,-0.0449,-0.0567,0.0116,0.0577,-0.0177,0.0099,-0.0232,0.1738,-0.0205,0.0113,-0.063,-0.0133,-0.1207,-0.0763,-0.0946,-0.1268,-0.0696,-0.0208,0.0285,0.0102,-0.0638,-0.0236,-0.1339,-0.0651,-0.0538,-0.0286,0.0997,-0.0627,0.061,0.0212,-0.1193,-0.0375,-0.1065,-0.0639,0.0318,-0.0317,-0.0267,0.0267,0.0902,-0.123,-0.0066,-0.0187,-0.0915,0.0481,0.0461,-0.1205,-0.0377,-0.0603,-0.1835,-0.1388,-0.1259,-0.0098,-0.0026,0.0674,-0.0171,0.0229,-0.1032,-0.0891,0.0354,0.0907,0.0079,0.0623,0.0624,0.0315,0.0051,-0.0726,-0.0564,-0.0316,-0.0765,-0.0221,-0.0701,-0.0212,-0.0214,0.0761,-0.0084,-0.1639,-0.1144,0.0442,-0.0157,-0.1186,0.0606,0.0588,0.0197,0.0466,-0.0594,-0.0426,-0.0495,-0.0304,0.0477,-0.0782,0.0566,0.0287,-0.0804,-0.0325,0.0735,-0.0169,-0.0692,-0.0519,0.0756,-0.0212,-0.0844,-0.0153,-0.0386,-0.0036,0.1145,0.0175,0.1063,-0.0734,-0.0851,-0.0021,0.0566,-0.1373,-0.118,-0.064,0.0167,0.0053,-0.0313,0.0191,-0.0734,-0.0135,0.0379,-0.0538,-0.0297,0.0381,-0.0173,-0.0708,0.0054,-0.0014,-0.0463,0.1925,0.2666,0.2098,-0.0164,0.0846,0.018,-0.0418,-0.0108,0.0701,-0.0602,0.0101,-0.0543,-0.0607,-0.0819,0.0278,0.0316,0.0092,-0.0386,0.1292,0.1402,0.0784,0.0391,0.0712,0.0206,0.1127,0.1062,0.0259,-0.0007,-0.0207,0.016,-0.0469,-0.0385,-0.0493,-0.0301,-0.0717,0.0322,0.0248,-0.011,-0.006,0.0887,0.0604,0.017,-0.1115,0.0358,0.116,0.2024,-0.1096,-0.0783,-0.118,0.0038,-0.0089,-0.0358,0.0382,-0.0622,0.0636,-0.0827,-0.042,-0.0122,0.0006,0.0508,-0.1103,0.005,0.0652,0.0532,0.0916,0.0563,0.0538,0.0693,-0.01,-0.0039,0.008,-0.1071,0.0488,-0.0805,0.0807,0.0149,0.0492,-0.0407,-0.0949,-0.0953,-0.0665,-0.0578,-0.0104,-0.1596,-0.0754,0.0063,0.0232,0.0608,0.0193,-0.026,0.0922,0.0569,-0.0466,0.0032,-0.0697,-0.0685,-0.0994,0.0285,0.0305,-0.0384,0.1057,0.0321,0.0587,0.2711,0.2908,0.141,0.1268,-0.0745,0.0106,0.0853,0.1366,0.1298,0.2488,0.0131,0.0903,-0.0153,0.0514,0.0592,0.0228,0.0238,-0.1042,-0.0783,-0.0316,-0.0262,-0.039,0.0354,0.0618,-0.0462,0.0521,-0.0253,0.0009,-0.1952,-0.0319,-0.0565,-0.0085,-0.068,-0.01,-0.0166,-0.0099,-0.0296,-0.0544,-0.0645,0.0075,0.087,0.0021,-0.0921,-0.0127,-0.0773,-0.1019,-0.0414,-0.0748,-0.0916,-0.0094,-0.1337,0.104,0.1466,0.2547,0.0774,0.0215,0.0136,-0.0312,-0.104,0.0248,0.0081,-0.0143,-0.0639,-0.1153,-0.0191,-0.0752,-0.087,-0.0244,-0.056,-0.0206,0.0056,-0.0843,0.1753,-0.0051,-0.0076,0.0129,-0.0886,-0.115,-0.0703,0.0412,-0.0199,-0.1388,-0.0338,0.0213,-0.006,-0.1265,-0.0008,-0.037,-0.0109,0.1377,-0.226,-0.2245,-0.0923,0.0248,-0.0145,-0.0025,0.0281,-0.0144,-0.0565,-0.0093,0.0057,-0.1126,-0.0269,-0.0107,0.0951,-0.0001,-0.1452,0.0191,0.0334,0.0163,0.0475,0.0404,-0.0926,-0.0072,-0.0697,0.0038,-0.0423,-0.1291,-0.0436,-0.0856,-0.0707,-0.0442,-0.0524,-0.055,-0.055,-0.0704,-0.0282,0.0785,-0.12,-0.0834,-0.1205,-0.1087,-0.1176,-0.096,-0.1281,0.0045,-0.1681,0.0894,-0.0754,0.2109,-0.2318,-0.1211,-0.045,0.0012,-0.026,0.0164,-0.0238,0.144,-0.0387,0.0512,0.1382,0.1302,0.0042,0.0528,-0.08,-0.0743,-0.0059,-0.0477,-0.0449,-0.0312,-0.0437,0.0108,0.0555,0.082,0.0236,-0.0057,-0.0817,0.0416,0.0008,-0.004,0.0382,-0.0572,0.2302,0.1026,0.1871,0.0947,0.1023,0.2471,-0.0354,-0.0447,-0.0669,-0.0826,0.0558,0.0956,-0.0982,0.0758,-0.0068,0.0851,-0.0057,-0.0273,0.0705,-0.0457,0.0303,0.1102,-0.0047,-0.0657,-0.0026,0.0882,-0.0018,-0.0381,-0.173,-0.1914,-0.1377,-0.1219,-0.055,-0.0915,-0.1614,0.1283,-0.0336,-0.0055,-0.0168,0.041,-0.0694,0.0458,-0.0056,-0.0261,0.0249,0.044,0.1234,0.0672,0.129,-0.0384,0.0807,0.0895,0.0168,0.1915,0.0965,0.0036,-0.0342,-0.0518,-0.0712,-0.1057,-0.1187,-0.0164,-0.0439,-0.0459,-0.026,-0.1105,-0.0323,-0.027,-0.0228,-0.0189,-0.0779,-0.1033,0.1025,0.0916,0.0481,0.057,0.0146,-0.0342,-0.026,-0.0319,0.042,0.0199,-0.0549,-0.0002,-0.0173,-0.1028,-0.2377,0.0169,0.0223,-0.0112,-0.0192,-0.0754,0.003,0.0548,-0.0312,-0.0561,-0.0345,-0.0294,0.0267,-0.0317,0.0273,-0.0704,0.0678,-0.0979,-0.0781,-0.0409,0.057,0.0124,-0.0325,0.0617,0.0064,-0.1317,0.0248,0.0021,-0.022,-0.0127,0.0188,-0.0263,0.0481,0.0019,-0.1024,-0.0228,-0.078,-0.1078,-0.0254,-0.0369,0.0333,0.0361,0.1008,0.111,0.0816,-0.0611,-0.0826,-0.0318,0.0693,0.0232,-0.0326,-0.0586,-0.0028,0.0718,0.0341,0.1575,-0.0114,-0.0751,0.0195,0.0386,-0.0085,-0.0145,0.0757,0.1074,0.0507,-0.0005,-0.0281,-0.0111,0.05,-0.0784,-0.0268,-0.0529,-0.0851,0.0016,0.1007,0.0162,-0.0075,-0.0505,0.0186,-0.0361,-0.0044,-0.0303,-0.08,-0.0419,-0.0251,-0.002,0.0367,-0.0017,0.0246,0.0422,0.014,0.0064,-0.0687,-0.0723,-0.0723,-0.0562,-0.0397,-0.03,-0.0376,-0.0773,-0.0321,-0.1024,0.1088,-0.0536,0.0413,-0.0154,0.0569,0.1527,0.1269,0.0094,-0.05,-0.0134,-0.0316,-0.02,0.0739,-0.0338,-0.109,-0.0467,0.0078,0.0504,0.0433,0.0706,0.0637,0.0105,0.0373,-0.0474,0.0964,0.0731,0.0438,-0.0525,-0.0616,0.0215,-0.0331,0.0372,-0.0845,-0.0583,-0.0101,0.0135,-0.0386,-0.036,-0.0934,0.0111,-0.043,0.0191,0.0282,-0.0486,-0.0003,-0.0259,0.2195,0.0946,0.0962,0.1508,-0.0953,0.0075,-0.0068,-0.011,-0.055,0.0822,-0.0142,0.0026,-0.0268,0.0468,-0.0027,-0.0509,0.0294,0.1011,-0.073,0.1447,0.0383,0.0241,0.1145,-0.0069,-0.0145,0.0004,-0.0967,0.0222,0.095,0.1159,0.1198,0.2152,-0.121,-0.0007,-0.084,-0.0373,-0.0688,-0.1053,-0.085,-0.0617,0.0245,0.0394,-0.0581,0.0514,0.1335,0.0209,-0.0378,-0.0509,-0.0209,-0.0823,-0.0408,0.126,0.0346,-0.0602,0.007,-0.0201,-0.0643,0.0536,-0.0344,-0.1182,0.0305,0.0163,0.0567,-0.027,-0.0702,0.0386,0.0635,0.0613,0.0492,0.0332,0.0858,-0.0272,0.0695,0.2069,0.1889,-0.0193,-0.0031,-0.1027,0.099,0.0627,-0.0975,0.0016,0.0572,0.0112,-0.0263,-0.0423,-0.1868,-0.0725,-0.0393,-0.0022,-0.0628,-0.0385,-0.0287,-0.025,-0.0882,-0.103,-0.0379,-0.03,-0.0294,-0.0621,0.0411,-0.0395,-0.0583,-0.0585,0.0927,-0.0742,0.0541,0.079,0.0253,-0.1468,-0.1678,-0.0551,-0.052,-0.0095,-0.0032,-0.0426,0.0735,0.0138,0.1397,0.0688,0.2189,0.0435,0.1149,0.0375,-0.0198,-0.1053,-0.0733,-0.0371,-0.0209,0.0078,-0.0184,-0.0499,-0.029,0.0103,-0.0724,-0.0982,-0.0907,-0.0298,-0.1053,-0.1478,-0.1223,-0.1151,0.0098,0.0242,-0.0625,-0.0822,-0.0278,-0.1303,0.0297,0.0535,0.0813,0.0343,-0.0246,0.0498,0.0956,0.0131,0.044,-0.0181,0.0251,0.014,-0.0481,0.0197,-0.023,0.0342,0.1118,0.0708,0.0774,0.0453,0.0053,-0.0154,-0.0883,-0.1124,-0.0646,-0.0448,0.1833,0.009,0.1025,0.093,0.0769,-0.0328,-0.0245,0.0888,-0.0801,0.2231,0.0745,-0.0384,0.0661,0.0162,-0.0216,-0.0312,-0.0697,-0.124,0.0178,0.0697,-0.0251,-0.0594,-0.0336,-0.0096,0.0323,0.0504,-0.0677,-0.0517,-0.0402,-0.0648,-0.1816,-0.1248,0.0561,-0.0084,0.0849,0.0212,0.0354,-0.0223,-0.1059,-0.0591,-0.0187,0.0625,0.0093,-0.0832,0.006,-0.0965,-0.0934,-0.0125,0.0634,-0.0002,0.0452,0.0073,-0.0929,-0.0579,-0.0128,-0.0632,-0.0526,0.0565,-0.0081,-0.0668,0.0073,-0.0102,-0.0587,-0.1455,-0.1233,-0.0833,-0.1053,-0.0891,-0.1001,-0.045,0.1799,-0.2108,-0.1889,-0.1428,0.0506,-0.1509,-0.2443,-0.0522,-0.0359,0.0218,0.0385,-0.1451,0.1625,0.1108,0.0719,0.0685,-0.0733,-0.0107,-0.2041,-0.0694,-0.0958,-0.0383,0.0342,0.0638,-0.0205,0.0225,-0.0031,0.0591,-0.1628,-0.0584,-0.0432,-0.0121,-0.2448,-0.1608,-0.189,-0.1279,0.005,-0.0784,-0.0978,0.0778,-0.1538,-0.0915,0.0145,0.1173,0.0463,-0.054,-0.0624,-0.147,-0.0803,-0.0084,-0.1676,-0.0429,-0.0659,-0.0486,0.0014,-0.1812,-0.0851,-0.1338,-0.0722,-0.0202,0.0041,0.0762,0.1127,0.1893,0.024,0.0438,0.1371,0.0012,0.1693,0.1342,0.096,0.0311,0.0513,-0.083,-0.1128,-0.0368,0.0436,0.015,-0.011,-0.1294,0.0049,-0.0386,-0.0425,0.1485,0.1124,-0.1034,0.0215,-0.0664,-0.0711,-0.0919,-0.1659,-0.004,-0.2427,0.0591,-0.047,0.001,-0.141,-0.0558,-0.0557,-0.1213,-0.0474,0.009,-0.0317,-0.0124,-0.0032,-0.0068,0.0655,0.1112,0.0231,0.0229,-0.0504,-0.0799,-0.0682,0.0272,0.0484,-0.0245,0.1924,0.1041,0.033,0.0211,-0.002,-0.0482,-0.0413,0.0017,0.0695,-0.0233,-0.0182,0.0042,-0.0222,0.2431,-0.219,-0.2196,0.0367,-0.1792,0.0594,0.0744,-0.1296,0.1337,-0.2975,-0.0142,-0.0281,0.0504,0.0051,-0.0493,-0.017,-0.0398,-0.1148,-0.1057,-0.0015,-0.0925,-0.0513,-0.0334,0.0598,0.1287,0.1705,-0.0814,-0.0896,-0.023,0.0075,-0.1282,-0.0822,-0.0024,0.0445,0.0189,-0.0311,-0.0996,-0.1111,-0.0698,-0.0106,0.0255,-0.0396,0.1221,-0.031,-0.0451,0.1017,0.322,0.1116,0.075,0.1102,0.0069,0.0371,0.1039,0.1958,-0.0528,0.1378,0.1218,0.1152,0.0356,0.2389,0.0217,-0.0686,-0.0753,-0.036,-0.234,-0.1355,-0.1044,-0.0979,-0.2142,-0.2028,-0.0246,-0.1249,-0.1094,0.0089,-0.0536,-0.155,-0.2972,-0.2245,0.0174,-0.1182,-0.118,-0.1303,-0.1108,0.0178,0.0122,-0.0928,-0.0615,0.0994,0.1475,-0.0185,-0.0068,0.1053,0.0318,-0.0418,-0.0136,-0.0756,-0.0897,0.0251,0.0781,-0.112,-0.1652,-0.0381,-0.0315,-0.0711,-0.0508,0.0101,-0.0252,-0.0182,-0.0076,-0.0252,-0.0365,-0.0584,-0.0019,-0.0516,-0.0414,0.0741,-0.0652,0.0538,0.1487,0.0003,-0.1151,-0.0677,-0.1295,-0.0721,-0.0879,-0.0858,-0.1058,0.0901,-0.0013,0.0017,0.0044,-0.0029,-0.1002,-0.0733,0.0467,0.0677,-0.0808,-0.0744,-0.0819,-0.0296,0.0498,0.0316,-0.0943,-0.0554,-0.02,-0.0224,-0.0346,0.0075,0.0341,0.0545,0.0139,-0.0143,-0.0378,-0.0026,-0.0626,-0.0977,-0.0183,0.0095,0.0915,0.0164,0.2038,-0.068,0.0269,0.0549,0.0406,0.0247,0.0265,0.0589,0.0359,-0.0013,0.0239,0.0055,0.0977,0.1235,0.0373,0.0267,0.0164,0.008,0.0118,-0.0081,-0.0232,-0.0163,-0.0743,-0.1272,0.0461,-0.0249,-0.0317,-0.0899,-0.0743,-0.0122,0.0507,-0.0338,-0.0603,0.0474,0.0468,-0.1017,-0.0545,0.0953,0.1486,-0.0702,-0.0463,-0.0684,-0.0878,-0.0193,0.0078,-0.1048,0.0348,-0.032,-0.0745,-0.0977,0.0155,-0.0452,0.0024,-0.0087,0.209,0.0523,-0.1253,0.0517,-0.0185,-0.0243,-0.0769,-0.0125,-0.0437,-0.1047,-0.0075,0.0262,-0.0491,0.0275,-0.023,-0.0542,0.0764,0.0232,-0.0111,0.009,-0.0249,0.0224,-0.0891,-0.0387,-0.001,-0.0634,0.0691,-0.1126,-0.0643,-0.0151,0.0904,0.2055,0.2177,-0.0661,-0.0527,-0.0093,0.179,0.0197,0.1668,-0.1211,-0.0022,0.1532,0.0803,0.0294,-0.0921,-0.0917,-0.1047,0.0056,-0.0215,-0.0586,-0.0253,0.1026,0.101,0.1583,0.0943,0.0172,0.1525,0.0665,0.1008,0.1257,0.0846,0.0252,-0.0239,0.1392,0.0946,0.0809,0.0614,0.0417,0.0851,0.084,0.1254,0.0696,0.1479,-0.0961,0.0327,-0.0583,-0.2228,-0.1523,-0.1352,-0.0884,-0.0489,-0.0513,-0.083,-0.1521,-0.1152,-0.0866,-0.0612,-0.0339,-0.045,-0.0405,-0.0227,0.0015,0.0291,-0.015,-0.0501,0.019,0.01,-0.0974,0.0383,-0.0817,-0.0844,0.025,-0.0121,0.0181,0.0025,0.0081,-0.0907,0.1967,0.1391,-0.0517,0.0615,0.0338,0.0757,-0.0327,-0.0147,-0.0554,0.3622,0.3633,-0.0527,0.0374,-0.0385,-0.0465,-0.0352,-0.0503,-0.0469,-0.0345,0.0444,-0.0063,0.096,0.0325,0.0068,-0.027,auditory recognition
trm_557b48e337218,-0.0449,-0.0554,-0.0199,-0.0954,0.0113,0.0183,-0.0084,-0.0733,-0.0716,-0.0472,0.011,0.0446,-0.0389,-0.0335,-0.033,-0.0539,0.0087,-0.0341,-0.0502,0.0516,0.0312,0.058,0.0776,0.0328,0.0425,0.054,0.0559,-0.0753,-0.0577,-0.0061,-0.0439,-0.0086,-0.0457,-0.0148,-0.0685,0.0066,0.0634,-0.0096,-0.0879,-0.0192,-0.0008,-0.0681,-0.0232,0.0599,-0.0594,-0.0475,0.2641,-0.0435,-0.0118,-0.0755,0.0046,-0.0498,-0.0227,-0.0795,-0.0975,-0.0212,-0.0153,0.0319,0.0158,0.0128,0.1047,0.0908,-0.0869,0.0296,-0.0472,0.0042,-0.0466,-0.0287,-0.0423,0.0614,-0.0015,0.0742,0.0334,0.0179,-0.1848,-0.0072,-0.0575,0.0818,-0.0384,0.0447,0.0371,0.0334,-0.0499,-0.0797,-0.0432,0.0314,-0.0676,0.043,0.0243,-0.0106,0.0074,-0.0158,0.0079,0.0207,0.0995,0.0657,0.0657,0.0075,0.0318,-0.0274,0.0609,0.0076,0.0166,-0.0169,0.018,-0.0124,-0.0387,0.0403,-0.0133,-0.1031,0.0136,-0.0521,0.0111,0.0277,-0.0237,-0.0328,-0.023,0.0144,-0.0354,-0.0068,0.0025,-0.0831,-0.0178,-0.0562,-0.0683,-0.0067,-0.0572,0.0244,0.0486,0.0448,-0.0019,0.0096,0.0145,-0.0435,0.0015,-0.0343,-0.0054,-0.0114,-0.0247,0.0543,-0.0199,-0.0413,-0.0041,0.001,-0.0342,-0.0266,-0.0441,-0.0029,-0.0226,0.0256,-0.0477,0.037,-0.0087,-0.0627,0.0554,0.0157,0.0042,0.0339,0.0297,0.0458,-0.0341,0.0493,-0.0191,-0.0553,0.0085,-0.0511,0.0566,-0.0296,-0.0306,-0.0375,0.1237,0.015,0.0901,-0.0092,-0.0306,-0.0318,0.0065,-0.0361,-0.0354,-0.0408,-0.0648,0.0634,-0.0001,-0.0664,0.0152,0.0693,0.0335,0.0493,0.0093,-0.0454,-0.0669,0.0455,0.0425,-0.0111,-0.0102,-0.2024,-0.193,0.0434,0.0024,-0.1823,-0.0533,0.1065,-0.0419,-0.045,-0.1075,0.032,0.0306,-0.0375,-0.0778,-0.0269,-0.0138,0.0168,-0.0366,0.0685,0.0354,0.0416,0.1207,-0.0761,-0.0545,0.0415,0.0846,-0.0194,0.0008,-0.0135,-0.0136,0.0771,-0.1008,0.1021,0.0277,-0.0534,0.0365,0.0025,0.1494,-0.0105,-0.0076,-0.0385,0.0041,-0.0762,0.0324,-0.0213,0.0381,-0.0502,-0.0254,-0.0129,-0.0365,-0.0223,-0.0331,-0.0888,-0.053,0.0075,0.0027,0.0284,-0.0389,-0.0346,0.0554,-0.0447,-0.0735,-0.1144,0.0522,0.2451,0.0748,0.1898,-0.0265,0.0837,0.0872,0.1272,-0.0226,-0.0227,0.0754,-0.0046,-0.0504,0.0156,-0.0427,0.0519,-0.006,0.1363,0.0133,0.0566,-0.01,0.0521,0.0598,0.044,0.0414,-0.0343,-0.0436,-0.0306,0.0184,0.0418,-0.0592,-0.0195,-0.0131,-0.0349,0.0164,-0.0006,0.0019,0.0549,0.0397,-0.0881,-0.0305,-0.085,-0.0273,-0.0303,-0.0483,0.0701,-0.0859,-0.0891,-0.0191,0.0079,0.0087,-0.053,-0.0436,0.0048,-0.134,-0.0433,0.0067,-0.0702,-0.0316,0.0048,0.0158,-0.1094,-0.0687,0.0559,-0.0472,-0.109,-0.0081,-0.0706,-0.0254,0.0076,-0.0266,0.0077,-0.0359,-0.0204,0.0731,0.0583,0.0401,0.0739,-0.1008,-0.0283,0.0764,-0.046,-0.0327,0.1682,0.0082,-0.0059,0.0265,0.0016,-0.0107,-0.0187,0.0042,0.0038,0.0086,0.1231,0.0151,-0.0038,-0.0169,0.0125,-0.0199,-0.0488,-0.0358,-0.0467,0.0004,-0.057,-0.1103,-0.0282,-0.0499,0.0107,-0.0143,-0.0542,0.0421,-0.0105,-0.0044,0.0015,0.0193,0.0457,-0.0527,-0.0704,-0.0485,0.0363,0.0975,0.0312,0.1059,-0.0514,-0.1406,-0.1014,-0.0409,-0.047,-0.0445,-0.0099,0.0333,-0.021,-0.031,-0.01,0.0033,-0.0028,0.0193,-0.0059,0.0083,0.0067,0.0069,-0.0677,-0.0579,0.0134,-0.0164,0.0201,0.094,-0.0371,-0.007,0.044,0.0301,0.0065,-0.0042,-0.0315,-0.0121,0.0239,0.0635,0.0001,-0.0119,-0.1193,-0.1195,-0.0925,0.0006,-0.1039,-0.0627,-0.2196,-0.2,-0.0891,-0.05,-0.0497,-0.093,-0.1117,0.0486,-0.0009,-0.0187,-0.0516,0.0365,0.0574,-0.0275,-0.0172,-0.0203,-0.0756,0.0579,0.0115,0.0806,-0.0308,0.1042,0.0141,0.0305,0.076,-0.0571,-0.1899,-0.1878,-0.0051,-0.0533,-0.062,-0.0698,-0.0371,0.017,-0.0803,-0.1048,0.0101,0.0121,-0.0146,0.0015,0.0534,0.0199,-0.0712,-0.0297,0.1159,0.0037,-0.0012,0.0417,0.0739,-0.105,-0.0156,-0.0096,-0.0506,-0.0034,-0.0182,0.0186,-0.0303,0.0637,-0.0144,-0.0545,-0.0544,-0.0544,-0.0026,-0.0148,0.0384,-0.0041,-0.0394,0.1144,-0.0627,-0.0658,-0.0622,0.048,0.1045,-0.1017,-0.0069,0.0254,-0.0668,-0.0704,0.0305,0.0413,-0.04,-0.0765,-0.0377,-0.0633,-0.0027,-0.0106,0.0612,-0.0841,-0.0273,-0.0502,0.0342,0.0946,-0.084,-0.0392,-0.0324,0.0185,-0.0273,-0.0862,0.0439,0.1017,-0.1078,-0.0442,0.0432,-0.0096,0.0588,0.011,-0.0027,-0.0791,-0.0248,-0.0179,-0.0736,0.0517,-0.0091,-0.0004,-0.0851,-0.0185,0.0206,-0.019,0.0287,-0.0006,-0.0147,-0.0314,0.0329,-0.0607,-0.0065,0.0244,0.118,0.0161,-0.066,-0.107,-0.0578,0.0143,-0.0086,0.0453,-0.0411,0.0504,0.0368,0.0016,-0.0485,-0.0498,0.0566,-0.017,0.0939,0.1126,-0.0164,-0.0039,-0.0802,-0.0379,-0.0657,0.0221,0.0724,0.0709,0.0171,0.0291,-0.0441,0.0388,-0.027,-0.029,-0.0336,-0.0054,-0.0165,-0.0617,-0.0117,-0.1579,-0.0378,-0.0101,-0.021,0.0,-0.0923,-0.0919,-0.0763,-0.0849,-0.0167,-0.042,-0.0037,0.0336,0.0207,0.0373,0.0641,0.0418,0.0827,0.083,0.0131,-0.0178,-0.0006,-0.0105,-0.1231,-0.0542,-0.0323,-0.0129,-0.0856,-0.0657,-0.0016,-0.029,-0.0296,0.0428,-0.0644,-0.0469,-0.0375,0.0393,0.0323,0.088,0.0675,-0.1606,-0.049,-0.0985,-0.0331,0.0137,-0.0037,-0.0516,-0.0731,-0.1854,-0.0082,-0.0442,-0.042,0.0094,-0.1222,-0.0496,0.0554,0.0052,-0.0202,-0.0782,0.0025,-0.0871,-0.0384,-0.0202,-0.0064,-0.1285,-0.0405,0.131,-0.0127,0.0022,0.022,-0.049,-0.0847,-0.0133,-0.0539,-0.0097,0.0722,0.1355,-0.0281,0.0098,0.0384,-0.0845,0.0952,-0.0293,-0.0904,-0.0295,-0.0232,-0.0119,-0.0153,-0.0464,-0.0472,0.1156,0.004,0.0547,-0.0174,-0.0258,0.0334,0.0233,0.0593,0.1405,-0.0647,-0.0173,0.0103,-0.0242,-0.0036,0.0096,-0.0194,-0.0232,0.0434,0.2061,-0.0324,0.0367,0.0201,-0.0289,-0.0929,-0.0961,-0.0877,0.017,-0.0156,-0.0001,-0.0772,-0.0264,0.0163,0.0419,-0.0613,0.0663,-0.1003,-0.0773,-0.0173,-0.0877,-0.0517,-0.0125,0.0368,0.0687,0.0059,0.0421,0.0012,-0.0609,-0.0511,-0.0425,-0.0292,-0.047,-0.033,-0.0155,-0.0478,0.1418,0.0177,0.0316,0.0083,-0.0181,0.0325,-0.0144,0.0075,0.0154,-0.1121,-0.0068,0.004,-0.0672,-0.0008,0.0357,0.0342,0.0063,0.0452,0.0319,-0.0102,0.016,0.0819,-0.0642,-0.0455,-0.0289,-0.0104,0.0955,0.1779,0.026,-0.008,-0.0275,0.0405,0.0124,0.0827,-0.0003,0.0218,-0.019,-0.0512,0.0066,-0.0045,0.0868,0.1247,0.0284,0.0045,0.0003,-0.0133,0.0115,0.0366,0.0193,-0.0164,-0.0408,-0.0078,-0.023,0.0049,0.008,-0.0199,-0.0349,0.0177,-0.014,0.0257,-0.0077,-0.0873,0.0488,-0.014,0.0002,-0.0003,-0.0399,-0.0748,-0.0644,-0.0252,-0.0171,0.0687,0.0921,0.2243,-0.0025,0.036,-0.0174,-0.0379,0.0261,0.2166,0.0824,-0.0065,0.0419,0.0722,0.0514,0.0017,0.1219,0.1296,-0.0337,0.0002,-0.0257,-0.0605,-0.032,-0.0496,-0.0031,0.064,-0.056,-0.0141,-0.0085,0.0342,-0.0378,0.1322,0.0499,0.148,-0.0263,-0.0002,-0.0758,-0.0784,0.0047,-0.0062,-0.0277,0.0834,0.054,-0.0768,-0.0403,-0.0936,0.0433,0.0886,-0.024,0.0397,-0.0093,0.0647,-0.0422,-0.0384,-0.0427,0.0011,-0.202,-0.0383,-0.0911,-0.0392,0.0525,-0.0316,-0.127,-0.0636,-0.034,0.003,-0.104,-0.0898,-0.037,-0.1484,0.0328,-0.0552,0.016,-0.0453,0.0437,-0.2229,-0.1132,-0.1856,-0.132,-0.1231,-0.0411,0.2083,-0.0489,-0.0399,-0.0525,0.0667,0.0716,-0.0681,-0.0197,-0.0111,-0.0646,-0.0091,0.0902,-0.0293,-0.003,0.1347,-0.0989,-0.0462,-0.0223,0.0175,-0.0537,-0.0005,0.2417,0.0411,0.0348,0.3284,0.0749,-0.0018,-0.0149,-0.0644,-0.028,0.0841,-0.025,-0.0547,-0.0022,0.0606,0.0575,-0.0062,0.0379,0.0546,-0.021,-0.0421,-0.0876,0.0412,-0.0631,0.0076,0.0012,0.0889,0.0222,-0.013,-0.0177,0.0942,0.02,-0.0812,-0.0117,-0.0099,0.0703,0.0616,-0.0022,-0.0066,-0.0102,-0.0428,-0.1378,-0.0057,0.0737,0.0336,0.0554,-0.0447,0.0532,-0.0256,0.0554,-0.0039,-0.0249,-0.054,-0.019,0.0516,0.016,-0.0208,0.0156,-0.0335,0.0669,0.0755,0.0622,0.0788,0.0032,-0.0229,-0.0097,-0.0157,-0.0849,-0.0223,0.0056,0.0648,-0.028,-0.0796,0.1087,0.1441,0.0293,-0.0516,-0.0092,0.0775,-0.0048,0.1213,-0.0583,-0.0059,-0.0252,-0.0646,-0.0465,-0.0154,-0.0359,-0.0402,0.0514,0.1319,0.1755,-0.1565,-0.1311,0.0258,-0.0611,-0.003,0.0182,0.0318,0.0374,-0.0168,0.0206,0.0272,0.0251,-0.0572,-0.0564,-0.0147,-0.1012,-0.0388,-0.0434,0.0393,-0.1031,0.0523,0.0885,-0.046,-0.0207,0.0243,-0.0312,0.0024,-0.0389,0.0117,-0.0164,0.0733,-0.0054,-0.0221,-0.0486,0.0327,-0.0534,-0.0034,-0.063,0.0013,0.1026,0.0202,-0.1961,-0.1047,-0.0698,-0.1463,0.026,-0.0405,-0.0744,-0.0348,0.0091,-0.0222,0.0041,-0.1002,-0.0552,-0.0719,0.0036,-0.0121,-0.0337,0.0036,-0.0788,-0.0491,-0.0894,0.0136,0.0445,0.1182,-0.0289,0.1441,0.071,-0.0153,0.0124,0.0086,0.0273,-0.0332,0.0954,-0.0088,-0.0777,0.0202,-0.0532,-0.0574,0.0141,-0.0023,0.093,0.0729,-0.0202,0.0049,-0.0134,0.0313,0.039,0.0312,0.0432,-0.0506,-0.0234,-0.0576,0.0201,0.0984,0.0384,0.065,0.3476,0.2529,0.2262,0.0877,0.1153,0.1117,0.2523,0.1807,-0.0068,0.1509,0.1533,0.1205,0.1166,0.1579,0.0687,0.1087,0.0526,-0.0064,0.0258,0.0047,0.0035,-0.0156,0.0185,0.0674,0.0989,-0.0266,0.0511,-0.0683,-0.0955,0.0262,0.0084,-0.0246,-0.018,0.0218,0.0059,0.0664,0.0955,-0.0263,-0.0057,-0.0036,0.069,0.057,0.1285,0.0729,-0.0343,-0.0273,-0.0484,-0.0314,-0.041,0.135,-0.0072,0.275,0.2069,-0.0228,0.034,-0.0058,0.013,0.0155,-0.0214,0.1983,0.087,-0.0604,-0.0462,-0.0631,0.0864,0.0102,-0.0732,0.0198,0.0243,-0.0079,-0.0268,-0.0191,-0.0527,-0.0138,0.0196,0.0268,-0.0738,-0.0067,0.0607,0.0377,0.034,-0.0589,-0.0018,0.104,0.0171,0.0048,-0.0136,-0.0307,-0.088,0.0472,0.0276,0.0598,-0.0536,-0.0658,-0.1387,-0.0907,-0.0332,0.0975,-0.0801,-0.172,-0.0656,-0.0273,-0.118,-0.0463,-0.1056,-0.0714,0.018,-0.0428,-0.1155,-0.0351,-0.0048,-0.0797,-0.0574,0.0262,-0.0523,-0.0099,-0.079,0.0162,-0.0061,-0.0613,-0.0376,0.0054,-0.0226,-0.0327,-0.0366,0.0212,-0.0431,-0.0125,-0.1157,0.071,-0.0021,0.1949,0.143,0.1539,0.1598,-0.0018,-0.0216,-0.0653,-0.0295,-0.1062,0.0825,-0.0916,0.2139,-0.0112,-0.0295,-0.0326,0.0957,-0.0333,0.0024,0.0479,-0.0038,0.0202,-0.0605,-0.0361,-0.0607,-0.1178,0.0801,-0.0315,0.0392,-0.0404,-0.0404,-0.0154,0.0071,-0.0368,-0.0016,-0.011,0.0648,0.0029,0.1605,-0.0517,-0.0382,-0.0614,0.0096,-0.0272,-0.0249,-0.0696,-0.0296,-0.0081,-0.0141,0.0297,-0.0434,0.0839,0.0358,0.0083,-0.0694,-0.0046,0.0332,-0.0654,-0.0426,-0.0456,-0.0498,-0.0827,-0.0432,-0.0058,0.0156,0.0352,0.0619,0.0313,0.0557,0.043,-0.0047,0.0107,0.1172,0.0566,0.0996,-0.0069,-0.0334,0.1063,-0.0696,-0.1335,-0.0375,-0.0245,-0.0612,-0.0162,-0.0333,-0.0535,-0.022,-0.0223,0.0507,-0.0785,0.0096,-0.0021,-0.1013,0.0126,-0.0124,0.0389,0.3079,0.0773,0.0351,0.0013,0.043,0.0527,-0.0112,0.0372,0.0401,0.0235,-0.0152,0.0268,0.0139,0.0483,0.0609,0.0135,0.0105,0.0398,-0.0263,-0.0286,-0.0611,0.0044,-0.0404,0.0231,0.0983,0.0536,-0.0083,0.005,-0.0119,-0.0345,0.0223,0.0095,-0.0191,0.0439,0.0557,0.1773,0.0988,-0.0595,-0.0241,-0.0336,-0.0326,-0.0268,0.0328,-0.0439,0.0069,-0.0043,-0.0744,0.011,0.0709,0.0833,-0.0021,0.0557,-0.0017,0.0848,-0.0786,0.02,0.0098,-0.0518,0.0969,0.0019,0.1728,0.0774,0.1492,-0.0084,-0.0623,-0.0117,0.1363,0.0083,0.0701,-0.017,-0.0491,-0.0704,-0.0125,-0.0546,0.0206,-0.0798,0.0608,-0.0701,-0.025,0.0408,-0.0066,0.0166,-0.0441,-0.0077,-0.0559,0.0223,0.0207,0.0733,0.0011,-0.0062,-0.0521,-0.0765,-0.0781,-0.0331,-0.0165,-0.0018,0.0066,-0.0255,-0.0603,-0.0279,0.0557,-0.0039,0.0091,-0.0415,-0.0844,0.0557,-0.0173,0.0079,-0.0058,0.026,0.025,0.0134,0.007,-0.0277,-0.0628,-0.0342,-0.0278,-0.0636,0.0493,-0.0167,-0.0043,0.0927,0.007,-0.0698,-0.0517,-0.0861,-0.1265,-0.1281,-0.1155,0.1577,-0.1271,-0.072,0.0041,0.1022,-0.0211,-0.0166,0.0743,0.0892,-0.0823,-0.0699,-0.1286,-0.0852,-0.0747,0.03,0.0237,-0.005,-0.0593,0.1052,0.1507,0.0001,-0.0047,-0.0057,-0.0871,-0.022,0.0238,-0.1455,-0.1263,-0.0414,-0.0955,-0.1116,0.0224,0.0735,0.0408,-0.0363,0.0505,-0.0169,-0.0288,-0.001,-0.0744,-0.0993,-0.0559,0.0101,-0.0445,-0.0288,-0.0438,0.099,0.0225,0.0004,0.0367,0.0271,0.0789,-0.0366,0.0449,0.0108,0.0089,-0.0472,-0.0022,-0.0353,0.0544,0.0048,-0.014,0.0592,0.0181,0.0412,-0.008,-0.0318,-0.0707,0.1511,0.1424,-0.0223,-0.041,-0.0395,-0.0567,0.0416,-0.0257,-0.0414,-0.0118,-0.0362,-0.0159,0.0101,-0.0668,-0.0286,-0.1064,-0.0289,0.0331,-0.073,-0.0733,0.165,0.0121,-0.0186,0.1459,0.0478,-0.0311,0.0328,0.0256,-0.0082,-0.0244,-0.0464,-0.0482,0.0337,-0.0937,0.05,-0.045,0.0187,-0.0761,-0.0156,-0.0311,0.059,-0.066,0.0725,0.042,-0.0253,-0.0465,0.0428,-0.0033,-0.0215,0.0004,0.0186,0.0179,-0.1145,-0.1,-0.0623,-0.0525,-0.0072,-0.0051,0.053,0.0813,0.0482,0.1451,0.0787,0.1561,0.0621,-0.0172,-0.1071,-0.0515,0.2937,-0.0306,-0.0748,-0.1757,-0.0212,0.0045,0.0253,-0.0382,0.034,-0.0053,0.0227,-0.0207,0.0026,-0.0098,-0.045,-0.0173,-0.0277,0.0232,0.0882,0.0672,0.0443,0.0909,0.0376,0.0155,-0.0438,-0.0171,-0.0885,-0.01,0.0274,0.0908,0.0348,-0.0876,0.0014,0.0321,-0.0412,-0.0199,0.0577,0.0109,0.0802,0.1158,0.0378,0.2381,0.1835,-0.0917,0.0094,-0.1098,-0.0277,0.0064,-0.0132,-0.0011,-0.0325,-0.0558,0.0586,0.0439,0.0289,-0.0586,0.0134,-0.0172,0.0665,-0.0204,-0.0772,0.0389,0.1183,0.1112,0.0891,0.1,0.0829,0.1846,0.1823,0.0148,0.0321,-0.0254,-0.0343,-0.018,-0.0764,-0.056,-0.0882,0.0049,0.0111,0.0262,0.0865,-0.0733,0.0057,-0.0029,0.0111,0.0107,0.0339,0.1363,-0.0325,-0.0403,-0.0646,-0.0781,-0.1077,0.0579,-0.0441,-0.0932,-0.0299,-0.0511,-0.0181,0.0068,-0.102,-0.0776,-0.015,0.0011,-0.0423,-0.0314,-0.0192,-0.0393,0.0068,-0.0148,0.0058,0.0278,0.0515,0.0557,0.0537,-0.0218,-0.0388,0.0217,-0.0245,-0.0119,0.0146,0.0401,-0.0052,0.1146,0.0419,0.0199,-0.0093,-0.0758,-0.0471,-0.0121,-0.0095,0.0151,0.0728,0.0024,0.0832,-0.0205,-0.0176,-0.074,-0.0591,-0.0814,0.0491,0.0003,0.0551,0.0489,0.0831,0.0053,0.01,0.0192,-0.0101,-0.018,0.0436,-0.109,-0.1578,-0.0918,-0.0231,-0.1169,0.0196,0.0248,0.0233,-0.0271,-0.0667,-0.0766,-0.0055,-0.0782,0.1089,-0.0231,-0.0963,0.045,-0.0691,0.023,-0.0076,-0.1816,-0.1039,-0.111,-0.0506,-0.0539,-0.0529,-0.0123,0.1036,-0.0576,-0.0451,-0.0572,0.0068,-0.0568,-0.0484,0.0279,0.0254,0.0036,-0.0512,-0.0561,-0.0718,-0.0428,-0.0009,-0.1053,-0.0298,-0.095,-0.0677,-0.064,-0.0568,-0.1584,-0.0658,0.2265,0.0071,-0.0282,-0.0549,-0.0396,-0.0313,0.0213,-0.077,-0.0453,-0.033,0.1196,0.1447,-0.0479,-0.0351,0.0049,0.1573,0.1206,0.0516,-0.055,-0.0269,-0.0371,-0.0115,0.0057,-0.0651,-0.0534,0.0034,0.0519,-0.0391,-0.0722,-0.0401,0.0453,-0.053,-0.089,-0.0502,-0.059,-0.0991,0.0359,-0.157,0.1024,0.136,-0.0727,-0.0449,-0.0573,-0.0636,-0.021,0.0123,-0.0229,0.3283,-0.1052,-0.1031,-0.0226,-0.0242,-0.0287,-0.0255,-0.0205,0.0284,-0.0934,-0.0571,-0.0052,-0.0241,-0.0938,-0.0018,0.0274,0.0944,0.25,-0.0842,0.0331,0.1229,0.3459,-0.0178,-0.0013,0.0056,0.06,0.0168,-0.0088,0.2051,0.0363,0.054,-0.0466,-0.0389,-0.0577,-0.0524,0.0044,0.0286,0.0126,-0.0159,0.1203,0.0798,0.0064,0.1111,0.1639,0.044,-0.0477,0.0052,0.0446,-0.0596,-0.0498,-0.0601,-0.0411,0.0218,-0.0664,0.0051,0.0087,0.0388,-0.0289,-0.0792,0.0138,-0.1124,-0.0316,-0.0404,-0.0077,-0.1262,-0.0391,0.0095,-0.0248,0.0081,-0.034,-0.0556,-0.0584,-0.0212,0.0178,0.0183,-0.0191,0.1417,0.0417,0.0807,0.0198,-0.0588,-0.0065,-0.0116,0.0665,0.0784,0.0263,0.0101,0.0179,0.0113,-0.0148,-0.1071,-0.0278,0.0066,-0.0219,0.1135,0.0186,-0.0141,-0.0701,-0.0041,-0.0314,0.1037,-0.1069,-0.0003,-0.0902,-0.0903,-0.0686,-0.0347,0.0397,-0.1431,-0.0384,-0.1228,-0.0819,0.009,0.0263,0.0612,0.0177,0.2668,0.2224,-0.0676,-0.0245,0.2607,0.1188,-0.0221,0.111,0.1012,0.0775,-0.0792,-0.0771,-0.0299,-0.0208,0.4247,0.3761,0.2438,0.1142,0.1834,0.1341,0.2617,0.2535,0.2019,0.0486,0.0083,-0.0401,0.0725,-0.0175,-0.0082,-0.0338,-0.0389,0.0364,0.0142,-0.0832,-0.0542,0.0122,-0.004,0.0006,0.0699,0.1271,-0.0185,-0.001,-0.0423,-0.0494,-0.0945,0.0605,0.0472,0.0387,-0.0541,-0.0222,-0.0434,0.0179,-0.014,-0.0822,-0.0822,-0.0466,-0.0288,0.0292,0.2149,0.045,0.0576,0.1079,-0.0017,-0.0088,0.1011,-0.1087,-0.113,-0.0494,-0.0058,0.0263,0.091,0.0407,0.0522,-0.0182,0.0082,0.0052,-0.0002,-0.0005,-0.0234,-0.1285,-0.1184,-0.0035,-0.0186,-0.0686,-0.0404,0.0406,-0.0753,-0.0551,0.0805,0.0564,0.035,0.0028,-0.0489,0.0215,0.055,0.0196,-0.0984,-0.0352,0.0338,0.0387,0.0247,-0.0321,0.0912,-0.0087,0.0385,0.044,-0.0245,0.0526,-0.0373,0.1088,0.0393,0.0237,0.1359,0.1863,-0.0457,-0.0512,-0.0764,-0.0494,0.0334,0.0505,0.0287,-0.0232,-0.0284,0.0205,0.0276,-0.0012,0.1103,0.0064,0.0818,0.161,-0.0569,-0.0485,-0.0242,-0.0622,-0.0477,0.1204,0.0777,-0.0124,-0.0726,0.0584,-0.0452,-0.031,-0.0309,0.0927,-0.0138,0.0242,0.0022,0.0628,0.0783,0.2099,0.2721,-0.0314,-0.0942,-0.0774,-0.0427,-0.0076,0.0081,-0.0944,-0.062,0.0479,0.0043,0.1106,-0.0386,-0.0294,0.0108,-0.0786,-0.0424,-0.0096,-0.0596,0.0422,0.0159,-0.1796,-0.0416,-0.0232,-0.0132,-0.0463,-0.0194,-0.021,-0.0747,0.1188,0.0707,0.0508,0.0425,0.0306,0.002,0.0942,-0.072,-0.0536,-0.0139,0.0385,0.0396,0.0555,-0.0239,0.0416,-0.0325,-0.0336,0.0119,0.0028,-0.0162,0.0177,0.0023,0.1073,0.0189,0.0623,0.0281,-0.0507,-0.0394,-0.0543,-0.0469,-0.037,-0.0329,-0.0169,0.0768,0.0052,-0.0327,0.0483,-0.0279,-0.049,-0.0184,-0.0298,-0.0637,-0.0457,-0.0059,-0.0059,-0.0063,0.0119,-0.0072,-0.0481,0.0284,0.0348,0.0127,0.0497,0.0365,-0.1075,0.014,-0.0349,-0.0615,-0.0602,0.1155,0.0204,-0.0208,-0.0244,-0.0808,0.0523,0.1069,-0.0329,0.1192,0.0466,-0.1138,-0.1178,-0.0978,-0.0277,-0.0091,-0.0286,-0.0556,-0.0051,-0.023,-0.0655,-0.0066,-0.0378,-0.0427,-0.0187,-0.0553,0.0179,-0.0265,0.0511,0.0404,0.1279,-0.0329,0.0476,0.0625,-0.2522,-0.0857,-0.2417,-0.0397,-0.1281,-0.1506,-0.0218,0.0073,0.0177,-0.0146,0.0224,0.0154,0.092,0.0372,0.0247,0.1834,0.0912,-0.0056,0.0478,-0.0933,0.0509,-0.0515,0.0195,0.0762,-0.0449,-0.0118,-0.0297,-0.0055,0.0221,0.0531,-0.0427,-0.0232,0.006,0.0187,-0.0385,0.3538,-0.0009,0.0424,0.0408,-0.0168,0.013,-0.0438,0.0491,-0.0951,-0.0949,0.1094,0.0048,-0.0812,-0.069,0.0181,-0.0093,-0.0197,0.1402,-0.119,-0.0758,-0.0312,0.0141,0.0394,-0.0264,-0.0244,-0.0443,-0.0299,0.0296,0.0254,-0.0638,-0.0102,-0.0038,-0.0087,-0.0543,0.0823,-0.0461,0.107,-0.0074,-0.0398,0.0393,0.0047,-0.043,0.0167,-0.0449,-0.0418,-0.0215,0.0299,0.0134,-0.0344,0.0103,-0.0184,-0.0198,-0.0273,-0.0549,-0.0866,-0.0583,0.0935,-0.0327,-0.0761,-0.0419,-0.0182,0.0275,-0.0941,-0.0627,-0.0104,0.0134,-0.0578,0.0852,-0.029,-0.0016,-0.0274,-0.0429,-0.1121,-0.0498,0.12,0.008,-0.0826,0.0435,0.0842,-0.016,0.0855,0.032,-0.0015,0.0298,0.0045,-0.0289,-0.0244,-0.0518,-0.0674,0.0118,-0.0399,0.0685,0.059,-0.008,-0.0044,0.0403,-0.0626,-0.0119,-0.0697,-0.024,0.0092,0.0263,0.0293,0.0245,-0.0179,-0.1516,-0.0819,-0.1263,-0.0262,-0.0252,-0.069,-0.0092,-0.0688,0.0416,-0.0465,-0.0143,0.08,0.0038,-0.0438,-0.0988,0.0662,0.0187,0.1021,-0.0444,-0.0693,-0.0822,-0.0573,-0.0991,-0.0362,-0.0642,-0.027,0.0027,0.0072,-0.0497,0.0029,0.0027,-0.0107,-0.031,-0.0046,-0.024,0.0006,-0.0487,0.0883,0.0143,0.0155,0.0071,-0.0047,-0.0205,-0.0933,-0.0659,-0.1551,-0.0938,-0.0354,-0.0452,-0.0219,-0.0286,-0.0503,0.0841,-0.0352,0.0562,-0.0305,-0.0324,-0.0404,0.0775,0.0358,0.0311,-0.038,0.0214,-0.0381,0.0197,0.0231,0.0152,0.0601,-0.0139,-0.061,0.0003,-0.0106,-0.0221,0.0567,-0.0011,-0.0068,-0.0338,-0.0204,0.0744,-0.0132,0.057,0.0679,-0.0383,-0.0385,-0.0001,-0.0848,0.028,0.0319,0.0977,0.0771,0.035,0.0401,0.0164,-0.0133,-0.025,0.07,0.013,-0.0016,-0.0663,-0.0193,-0.0463,0.1576,0.0223,-0.0361,0.0123,-0.028,0.0097,0.0005,0.0253,-0.0085,0.0611,-0.076,-0.003,0.0072,0.0584,0.0379,-0.015,0.0011,0.0588,-0.0025,0.0387,0.0072,-0.1228,-0.0384,0.0373,-0.0011,-0.0054,-0.026,0.1333,-0.0282,0.0236,-0.0374,-0.0386,0.0601,0.0358,0.0323,0.0242,-0.0228,-0.1531,-0.0904,0.035,0.0107,-0.0041,-0.0139,-0.0207,-0.0165,0.0513,0.0089,-0.103,-0.0025,-0.0302,-0.1027,-0.0101,0.0175,0.0541,-0.0806,-0.0569,0.0211,0.0134,-0.0425,-0.0029,-0.0287,-0.0848,-0.0191,0.1224,-0.0097,-0.0096,-0.0642,-0.0862,0.0248,0.1275,-0.0449,0.1369,0.137,-0.0085,-0.0027,-0.088,0.0477,0.0117,-0.0409,-0.0561,-0.0197,0.0229,0.0937,0.0413,0.0017,0.0112,0.001,-0.0875,-0.0243,0.1845,0.1363,-0.0843,-0.0113,-0.026,0.016,-0.0277,0.1199,0.0959,-0.0232,-0.0163,0.1167,-0.0574,-0.0543,-0.0654,-0.0647,-0.0612,0.003,-0.0512,0.0472,-0.0109,0.0464,-0.0259,-0.0308,-0.0519,0.253,0.1675,0.0123,0.2207,-0.0873,-0.0413,-0.072,-0.1151,-0.0696,-0.0294,-0.1016,-0.0395,-0.0709,-0.0744,-0.0592,-0.0275,0.1877,-0.0494,0.0024,0.0214,0.1396,0.095,0.0918,-0.0116,-0.1488,-0.1084,-0.1212,-0.0296,0.0492,0.058,0.033,-0.0069,-0.0225,-0.0211,-0.0183,-0.0247,-0.0053,-0.0615,-0.0005,0.0053,0.0015,-0.0225,0.002,-0.1124,-0.0578,0.0257,-0.0074,0.0096,-0.0076,-0.0407,-0.0474,-0.0121,-0.0763,0.2492,0.0769,0.1544,-0.013,0.0149,0.0244,0.0462,0.0096,-0.0019,0.0126,0.1004,0.0191,-0.0035,-0.0012,0.0189,-0.0107,-0.007,-0.0426,-0.0418,0.3043,0.0609,-0.035,-0.0414,-0.0064,-0.1359,0.0076,0.0946,-0.0414,-0.043,-0.01,-0.0598,0.0222,-0.0003,0.0452,0.035,0.0992,-0.0813,0.016,-0.0248,0.025,0.03,0.0672,0.0923,0.0355,0.0814,-0.0491,0.1116,-0.1132,-0.1073,-0.0524,0.1253,0.0235,0.0095,-0.0701,-0.0277,0.004,-0.0194,-0.0087,-0.1016,0.0019,0.0372,-0.0108,-0.0027,-0.0232,-0.0233,-0.0431,-0.0146,-0.0033,0.0048,0.0259,-0.0599,-0.012,-0.0373,-0.031,-0.0223,0.0451,0.0198,-0.0236,0.1225,0.2171,0.022,-0.0147,0.2487,0.2309,0.1463,-0.0007,0.1271,0.0752,-0.0315,-0.0564,-0.0235,0.0134,0.0689,0.1431,0.0333,-0.0311,0.0715,-0.023,0.0309,0.0255,0.0326,0.0244,-0.032,-0.012,-0.0319,-0.0361,0.0158,-0.0203,-0.0717,0.0645,-0.0029,-0.0213,0.0158,0.0351,0.0568,-0.0324,-0.0147,-0.0638,-0.0595,-0.0246,-0.0528,0.1778,0.0847,0.0047,0.073,0.0336,-0.0117,0.0497,0.0634,0.1892,0.0733,0.1819,0.099,-0.0123,-0.1589,-0.1572,-0.0903,-0.0482,-0.0419,-0.082,-0.0987,0.2056,0.1735,0.0071,-0.0526,0.0333,-0.1062,-0.1048,-0.0155,-0.0173,0.0283,0.0616,-0.0321,-0.0936,-0.0635,0.0238,0.1031,0.0457,0.0486,-0.0177,-0.0378,-0.0109,0.0979,-0.041,0.0263,-0.0295,-0.0721,-0.0422,-0.0463,-0.0319,-0.0343,-0.0259,-0.0177,0.0075,-0.0001,0.0023,0.0084,-0.0568,-0.0364,-0.0525,-0.0439,-0.0505,0.0456,0.0133,-0.0469,-0.0361,-0.0381,-0.1285,-0.121,0.0429,0.026,0.0524,0.0532,0.0127,-0.0427,-0.0631,0.0099,0.1381,0.1649,0.1463,-0.0057,0.0912,0.014,0.0883,-0.0488,0.0494,-0.0206,0.1234,0.0481,-0.0927,-0.1145,-0.0098,-0.0616,-0.0286,0.0285,0.0431,-0.0402,-0.0407,0.1271,0.0735,0.0491,-0.0395,0.0158,-0.0201,-0.0377,-0.0205,-0.0376,-0.0414,0.0048,-0.0005,-0.1529,0.0451,-0.076,0.0017,-0.0264,-0.0267,0.006,0.1105,0.0119,-0.0735,-0.0638,0.1142,0.0155,-0.01,0.0913,-0.1131,-0.0299,-0.0733,-0.0161,-0.0986,-0.0296,0.1113,-0.0189,0.0209,0.0457,-0.0272,-0.0627,0.0156,-0.0565,0.0516,-0.024,-0.006,-0.0149,0.0628,0.0666,0.0043,0.0592,-0.0177,0.004,-0.0493,-0.0153,0.0541,0.1617,-0.0178,-0.0235,0.0474,0.0396,-0.0395,0.0201,-0.0077,-0.0361,-0.0471,-0.0494,-0.0204,-0.0152,-0.0014,0.0018,0.0225,-0.0523,-0.0055,-0.0596,0.0259,0.0414,-0.042,-0.0581,-0.1445,0.002,-0.0601,-0.0872,-0.0592,-0.0162,-0.0237,0.0847,-0.0686,0.0209,-0.0462,-0.0529,-0.063,-0.0102,-0.022,-0.045,0.0443,0.0215,-0.0329,0.0078,-0.0082,0.0051,0.0102,0.0593,-0.0339,0.0681,-0.0438,0.0075,-0.0077,-0.0042,0.0267,0.0229,0.0872,0.1166,0.0085,0.0114,0.138,-0.0227,-0.04,0.0812,-0.0329,0.0046,0.0095,0.0446,0.0116,0.0517,0.0066,-0.0548,-0.0428,0.0213,0.0305,0.065,0.1141,0.1021,0.026,-0.0361,0.0122,-0.0122,-0.0235,-0.097,-0.0114,-0.0523,-0.025,-0.0113,-0.0838,-0.0037,0.014,-0.0277,-0.0588,0.0067,0.06,-0.0061,-0.0016,-0.0163,0.052,-0.076,-0.0434,-0.0707,-0.0777,0.0169,0.0317,-0.0414,-0.0408,-0.0435,-0.0459,-0.0335,0.0214,0.002,0.0038,-0.047,0.0663,0.0878,0.0988,0.0057,0.0213,0.0102,0.0677,-0.0467,-0.0211,-0.0467,-0.0174,0.0493,-0.0402,0.0589,-0.0535,-0.0572,-0.0427,-0.0345,0.0715,0.0284,-0.0545,0.0627,-0.0556,-0.0061,-0.0014,-0.02,-0.0402,0.0255,0.4329,0.3041,-0.0175,0.0503,0.0435,0.0677,-0.018,-0.0484,-0.0095,-0.0191,0.0639,-0.0429,-0.054,-0.0195,-0.0684,0.0015,0.063,0.0294,-0.0046,0.0125,-0.02,0.0039,-0.0413,0.0453,0.0577,-0.0546,-0.026,-0.0058,0.0475,-0.0813,0.2447,-0.0953,-0.0565,-0.0442,-0.0452,-0.0865,-0.1067,-0.0839,-0.0763,-0.1029,0.0323,-0.1,0.0516,0.0189,0.1337,0.0847,0.139,0.1024,0.214,0.1928,-0.0383,0.0617,0.3471,0.4428,0.2099,0.1225,0.4093,0.2884,0.221,0.34,0.1361,0.2501,0.2136,0.1243,0.2502,0.1712,0.2526,0.0687,0.1892,0.0902,0.2028,0.1137,0.1937,-0.0374,-0.1209,-0.0169,-0.0271,-0.0165,-0.0109,-0.0334,0.0098,-0.0347,0.0087,-0.0054,0.0083,-0.0171,0.0518,-0.0136,-0.0591,0.1204,-0.001,-0.0768,-0.0909,-0.0733,0.0012,-0.0379,0.0443,0.0138,0.0243,0.0149,0.0039,0.0872,0.0013,-0.0688,0.0474,0.0479,0.0312,-0.0354,-0.0361,-0.0645,-0.0924,0.0815,-0.1203,0.0126,-0.0772,-0.0422,-0.0932,-0.0947,0.0446,-0.0463,0.0116,0.0387,0.0339,-0.0134,-0.022,0.0854,-0.0169,-0.0391,-0.0335,-0.0063,-0.0156,-0.0648,negative feedback processing
trm_557b4b8cd05ca,-0.1366,-0.1311,-0.1275,-0.0871,0.0042,-0.042,-0.0986,-0.0441,0.0009,-0.0582,0.0116,-0.0001,-0.1244,-0.0177,-0.1217,-0.0732,-0.1264,-0.0693,-0.0489,-0.0159,-0.0721,-0.0083,-0.0614,0.0465,-0.0384,-0.0025,-0.0032,-0.0683,-0.1237,-0.0814,-0.0963,-0.0668,-0.1038,-0.0878,-0.0756,-0.1285,-0.1161,-0.0616,-0.1251,-0.0345,-0.1254,-0.1137,-0.0832,0.0523,-0.0531,-0.0476,0.0849,-0.0922,0.0319,-0.0923,-0.0373,0.035,0.0835,0.0781,0.0179,-0.046,-0.1347,-0.0178,0.0143,-0.0657,-0.0512,-0.0152,-0.1087,0.0929,0.0726,0.0033,-0.1792,-0.1885,-0.0857,-0.023,0.1006,-0.0133,0.2088,-0.0771,-0.0903,0.0809,-0.1321,0.0202,0.0714,-0.0897,0.024,0.096,0.004,-0.096,0.06,0.0317,0.0275,-0.0349,0.0153,-0.2699,-0.1251,-0.0997,-0.0394,0.1108,0.1055,0.0975,0.1035,0.027,0.1443,0.0008,0.03,-0.0041,0.0825,-0.0675,0.0553,-0.1737,-0.123,0.1813,-0.0703,-0.0292,0.0064,-0.0712,0.1066,0.1364,0.0301,0.0629,-0.0457,-0.0577,0.0187,-0.0753,-0.0644,-0.1158,-0.0683,0.0197,-0.0311,-0.0787,-0.0596,0.0116,0.0538,-0.0104,0.0194,-0.0678,-0.0533,-0.1448,0.0079,-0.1563,-0.024,-0.0714,-0.0581,-0.051,-0.0855,-0.0829,0.0942,-0.0152,-0.065,0.0457,-0.0956,0.0447,-0.0768,0.1148,-0.0393,-0.0918,-0.1469,-0.0962,0.137,-0.0802,0.0583,-0.024,-0.0005,-0.0968,-0.0465,-0.1025,-0.1506,-0.2249,-0.0009,-0.0099,-0.0322,-0.1217,-0.109,0.0589,-0.1408,-0.1182,-0.0286,-0.0529,-0.0723,-0.0991,-0.0724,-0.0324,0.0128,-0.0442,-0.1352,0.0413,-0.0792,0.0384,-0.1205,-0.0637,-0.1505,0.0043,0.0685,-0.0204,0.0035,-0.0992,-0.0654,-0.1427,-0.116,-0.1728,-0.142,-0.0453,0.0277,-0.1102,-0.0701,0.0806,-0.0881,-0.1636,0.0991,-0.0974,-0.0129,-0.0444,-0.0789,0.0037,-0.0963,-0.0372,0.0091,0.0156,0.0852,0.0438,0.0735,-0.1442,-0.2101,-0.0048,0.0627,-0.0955,-0.1562,-0.0858,0.0608,-0.0116,-0.0543,0.0691,-0.0253,0.2479,-0.1525,-0.1002,0.1013,-0.1722,-0.1734,0.0003,0.0053,0.1397,0.0171,-0.0458,-0.0538,-0.1522,-0.063,-0.0148,-0.0598,-0.0605,0.001,-0.1127,-0.0796,-0.0326,0.0446,0.0275,-0.0074,0.0876,-0.0356,-0.1072,0.0173,-0.045,0.1487,0.1815,0.0622,0.1856,-0.0582,0.1021,0.123,0.267,0.122,0.0227,0.0112,0.0171,-0.0389,-0.0993,-0.043,0.0338,-0.136,-0.0428,-0.2196,-0.2737,-0.2375,-0.075,-0.0247,-0.0137,0.0004,-0.1119,-0.0759,-0.1147,0.0475,0.096,-0.127,-0.113,-0.0764,-0.046,-0.0426,-0.0462,-0.1204,-0.0357,0.0073,0.1057,-0.014,0.1539,0.0806,-0.0868,-0.1359,-0.1328,-0.0904,-0.0846,-0.1379,-0.045,-0.0822,0.0464,0.0055,-0.0054,-0.0842,0.1386,0.0546,-0.0378,0.1288,0.026,0.0959,-0.075,0.0637,0.0596,-0.0347,-0.0255,-0.0956,-0.063,0.021,-0.0716,-0.0766,-0.1807,0.0477,-0.0636,0.0149,0.0294,0.0778,0.0438,0.1117,0.0473,0.0471,-0.0402,-0.0377,-0.0223,-0.0691,-0.0393,0.0465,0.0507,-0.2618,-0.1984,-0.1936,-0.128,-0.1201,0.0323,-0.1589,-0.0778,-0.0735,-0.1333,-0.0513,-0.0918,-0.1693,-0.0729,0.0211,-0.0257,0.0286,-0.0538,-0.0563,0.0355,-0.1578,0.2413,0.0088,-0.1515,0.021,0.102,-0.0544,0.0833,-0.0777,-0.0368,-0.0858,0.0898,0.1714,0.0688,0.1696,-0.0601,-0.0457,0.058,0.0656,0.0924,-0.0393,-0.0218,0.057,-0.0377,-0.0716,-0.0658,-0.1463,-0.0137,0.0692,-0.0256,-0.1679,-0.1834,-0.1287,-0.0459,-0.0146,0.0277,-0.0103,-0.0714,-0.0062,0.1111,0.1066,0.0027,-0.1256,-0.0672,-0.0659,-0.129,-0.0426,0.2511,-0.0935,-0.0028,0.2731,0.0418,-0.0249,0.0281,-0.0109,-0.2209,-0.167,-0.2835,-0.2339,-0.1173,-0.1932,-0.1135,-0.1042,-0.1217,-0.022,0.0499,0.0296,0.0058,-0.0087,0.0794,-0.032,0.0045,-0.2832,-0.0982,0.017,0.0678,-0.072,0.0854,-0.1012,-0.1202,0.0443,0.0324,0.0345,0.1246,0.1232,0.0713,-0.0801,-0.0374,0.0605,-0.0579,0.0186,-0.0053,0.0718,0.0149,0.0462,-0.0671,-0.0389,0.0685,-0.1099,-0.1463,0.0199,0.326,-0.1255,-0.1116,-0.0156,-0.0181,0.08,-0.0176,0.0254,-0.0333,0.0021,-0.0152,-0.0201,-0.0366,-0.0134,-0.0277,-0.0637,0.0998,0.1268,0.1374,-0.0567,-0.0389,-0.0418,-0.0493,-0.0031,0.0947,-0.1103,-0.1357,0.0371,0.0151,-0.0061,-0.0527,0.0309,-0.0241,-0.0157,0.0551,-0.0911,-0.1236,-0.0701,-0.0816,0.1061,0.0873,-0.0373,0.0507,-0.1408,-0.0206,0.0283,0.0002,0.0238,0.0739,-0.0748,-0.0693,0.014,-0.044,-0.0245,-0.0853,0.0813,0.1284,0.2163,0.0505,0.1107,0.103,0.0274,0.0842,-0.0481,-0.0411,-0.1257,-0.1736,0.0074,0.0023,-0.1298,-0.0958,-0.0567,-0.1218,-0.0064,0.022,0.0129,-0.0781,-0.0527,-0.0381,0.0444,0.0597,0.0153,-0.0894,0.0557,0.0142,0.0179,-0.0611,-0.0298,-0.127,0.0826,0.1007,0.0282,-0.0835,-0.0601,0.0247,-0.0299,0.0049,-0.0506,-0.0019,0.052,0.0669,0.02,0.022,-0.008,0.0666,-0.1598,-0.0282,-0.1712,-0.1195,0.0072,0.0148,0.0694,0.1109,0.0386,-0.1017,0.0157,-0.0609,0.116,0.067,0.0318,0.0681,0.046,-0.0104,-0.1317,0.0426,0.116,0.1521,-0.0365,-0.0612,-0.1609,0.0169,0.1222,-0.0857,0.0192,0.0641,0.0625,0.0607,-0.0048,-0.0904,0.0266,-0.1624,-0.1515,0.141,-0.1527,-0.0757,0.1039,0.0051,-0.2142,-0.0468,-0.0592,0.0832,-0.006,-0.2095,-0.0641,-0.2135,-0.0142,-0.0045,-0.1027,0.0124,-0.0625,-0.0705,-0.0769,0.0319,0.0244,0.0323,-0.0303,0.0676,0.0742,-0.0197,0.0807,-0.0742,-0.0263,0.0089,-0.0734,0.0175,-0.0163,-0.1421,-0.0816,-0.0436,-0.0529,-0.0591,0.1083,-0.1621,0.1249,-0.1233,0.0957,-0.1235,0.0238,-0.0902,-0.0362,-0.084,-0.0623,-0.0771,-0.1229,-0.1139,0.1366,-0.1117,0.01,0.0519,-0.1537,-0.1597,-0.1228,-0.0076,-0.0539,-0.049,-0.0987,-0.1155,-0.0365,-0.0595,0.0912,-0.1058,0.006,-0.0427,0.0734,0.0194,0.0796,-0.0132,0.0354,-0.1085,-0.1084,0.0523,0.0308,-0.0247,0.098,0.1543,0.1185,0.0649,-0.0591,0.0356,0.0301,-0.0515,-0.0553,0.0606,0.0765,0.0589,-0.0592,-0.0443,-0.0233,-0.0347,-0.1364,-0.1783,-0.1893,0.0781,0.1183,0.1001,0.0207,0.082,0.1286,0.0494,-0.0376,0.0118,-0.1246,0.028,0.093,-0.0411,-0.2166,-0.2245,-0.1398,-0.0071,0.0214,-0.0551,0.1194,-0.0475,0.0125,-0.0059,-0.0964,0.0352,0.0632,-0.0214,-0.1854,0.1437,0.1341,0.3125,-0.0776,-0.0038,-0.0794,0.0083,0.0334,-0.1312,0.1186,0.0471,-0.0387,0.044,0.0337,0.0589,-0.0702,-0.1444,-0.1184,-0.0772,0.0147,0.1412,-0.0022,-0.1681,-0.0027,-0.0449,0.0641,-0.0276,0.0313,-0.0299,-0.0457,-0.0711,-0.1121,0.1344,0.0395,0.0559,-0.1161,-0.0361,0.0223,-0.0698,0.0038,-0.0658,-0.1234,0.0121,-0.0933,-0.1255,-0.0691,0.0876,0.1034,0.059,0.018,-0.0487,0.0392,0.1472,-0.0476,-0.0327,0.0789,-0.0122,0.0153,-0.0316,0.1,0.0037,0.1773,-0.1433,-0.1423,0.063,0.133,0.0851,-0.0184,-0.0055,0.075,-0.0035,0.0146,0.0969,-0.0317,0.0477,0.0768,0.1166,-0.0002,-0.0238,0.1033,0.16,-0.1888,0.0489,0.0957,-0.1681,-0.0959,-0.0588,-0.1155,0.0621,-0.1211,-0.0261,-0.1106,-0.11,-0.1242,-0.0168,-0.0304,0.0925,-0.0693,-0.0705,0.0819,0.0376,0.0794,0.0721,0.0674,0.1049,0.0024,0.0737,0.0173,0.0251,0.0659,0.1117,-0.0976,0.1217,0.0931,-0.081,-0.0378,-0.0674,-0.0171,0.1453,0.0985,-0.2178,-0.0525,-0.0046,0.0635,0.1667,0.1118,0.1,0.0352,-0.0405,-0.0411,-0.0676,0.0426,0.0007,0.0533,-0.0755,-0.0631,-0.059,0.097,0.2209,0.106,0.1994,-0.0569,-0.0372,-0.0583,0.1098,-0.0506,-0.0561,-0.11,0.0406,-0.0538,-0.0948,-0.0312,-0.121,0.0415,-0.0845,0.0417,0.0752,0.0483,-0.0015,-0.1128,-0.0112,-0.0326,0.0942,-0.0664,0.0049,0.0295,0.042,0.1025,0.2067,0.0823,-0.0605,-0.049,-0.0549,-0.0098,-0.1394,0.0088,0.0681,0.1573,0.0258,-0.0163,-0.1086,0.0986,0.1767,0.0097,-0.0454,0.0051,-0.0478,-0.2521,-0.1318,-0.0906,-0.0841,0.0108,-0.1263,-0.0752,0.1013,-0.0117,-0.0681,-0.0261,0.0524,-0.0627,-0.0494,-0.0635,-0.118,-0.121,-0.0693,-0.0244,-0.0674,0.0436,0.0228,-0.0564,-0.0806,0.0108,-0.0808,0.0178,-0.0795,-0.0817,-0.0285,0.0071,0.0754,0.0809,-0.0569,0.0422,-0.0617,0.0463,0.0146,0.1127,0.1736,0.1217,-0.0371,-0.0652,-0.0148,0.0212,0.1032,0.1113,0.0692,-0.0279,0.1187,-0.0523,0.0909,-0.0515,-0.0653,-0.0844,0.0082,-0.0541,0.0198,-0.1243,-0.0386,-0.0288,-0.0015,0.0039,0.0329,0.1036,-0.0021,0.0943,0.122,0.0718,0.0411,0.0657,-0.0471,0.0018,0.0214,-0.0257,-0.0732,-0.0718,-0.156,-0.0319,0.1262,0.1162,-0.1474,-0.0944,-0.0318,-0.1226,-0.0095,0.1469,0.0286,0.1664,0.0717,0.0674,-0.0356,0.0543,0.1129,-0.0116,-0.0226,-0.019,0.045,-0.0377,-0.1692,-0.0126,0.0923,-0.08,-0.0322,-0.082,0.0693,-0.1312,0.0066,-0.0299,0.065,0.1805,0.1538,0.0814,0.0754,0.0148,0.0535,-0.0079,-0.0317,-0.0252,0.0064,-0.0385,-0.0135,-0.0474,0.0812,-0.0349,-0.053,-0.1173,-0.1252,-0.1412,-0.0815,-0.0818,0.1709,-0.0191,0.0163,-0.1284,0.1276,0.1125,0.0094,0.003,-0.0045,0.0824,0.0002,-0.004,-0.1175,-0.0405,-0.0077,-0.0049,-0.0558,-0.0486,-0.0457,0.0335,0.0864,-0.0316,-0.0496,-0.0616,0.0185,-0.135,-0.053,-0.0039,0.0513,-0.1269,0.017,-0.0332,0.0418,-0.0425,-0.0706,0.2933,0.1347,0.1544,0.0935,0.1098,-0.0275,0.1295,0.0833,-0.1173,0.3584,0.2968,0.2505,0.1766,0.2947,0.0799,0.0395,0.0612,0.042,0.0545,0.0605,0.0441,0.0394,-0.1111,0.0161,0.0191,0.0188,0.0308,0.0029,0.0069,0.1665,0.0956,-0.0275,-0.0029,-0.0676,0.0933,-0.0417,0.1065,-0.0401,-0.1378,-0.0236,0.0362,0.0496,0.0838,0.0706,-0.1471,-0.0776,-0.1321,-0.0985,-0.0493,0.3158,-0.0834,0.0837,0.0597,-0.0039,-0.0216,-0.1412,-0.0855,0.0059,-0.0515,0.0887,0.0552,0.031,0.0814,0.072,-0.1465,-0.139,0.0471,-0.0531,-0.0261,0.003,-0.0778,-0.0667,-0.1005,-0.0494,-0.0856,-0.0456,-0.202,-0.1022,0.1598,-0.0023,-0.0091,0.0231,0.1878,-0.0417,-0.0106,-0.1527,-0.1392,-0.0387,-0.0634,-0.1878,-0.2366,-0.0773,0.0023,0.0405,0.1962,0.1272,0.0408,0.1285,0.0038,0.1025,0.083,0.1178,0.0047,0.1798,-0.0189,0.2005,0.2653,0.0477,-0.0249,0.2435,0.1831,0.0626,-0.0605,-0.0261,-0.1199,-0.0503,-0.1836,-0.0309,0.0365,-0.1109,-0.078,0.0115,-0.0982,-0.0402,-0.0654,-0.0912,-0.0639,-0.0249,0.067,0.074,-0.0438,0.3586,0.3178,0.2103,0.3016,-0.06,-0.0379,-0.0378,-0.0464,-0.0112,-0.1098,-0.0859,0.1209,-0.0294,-0.0233,0.0806,-0.125,0.0229,0.0795,0.0292,-0.0265,-0.0343,0.0341,0.0192,0.0013,0.0326,0.0891,0.0581,-0.02,-0.0585,-0.0585,-0.122,0.083,0.0252,0.0458,-0.0883,0.0824,-0.1029,0.0757,-0.2283,-0.2023,0.1313,-0.0415,-0.1836,-0.1778,-0.175,-0.0311,-0.1095,0.0063,0.019,-0.0462,0.0446,-0.0611,0.0758,-0.0825,0.1003,-0.0636,0.125,0.0552,-0.0532,-0.0008,0.0311,0.0126,-0.0031,-0.022,-0.1264,0.015,0.0553,-0.0864,-0.081,-0.0031,-0.0162,0.0038,-0.0267,-0.0275,0.0416,-0.0295,-0.0949,-0.1277,-0.2082,-0.0054,-0.0248,-0.1249,-0.1006,-0.0805,-0.1363,0.0269,-0.1446,0.0285,-0.189,-0.1029,-0.1093,-0.2093,-0.024,0.0576,-0.048,0.1433,0.0272,-0.0239,0.0594,-0.1107,-0.0593,-0.0333,-0.2591,-0.2583,0.052,-0.0745,-0.0218,-0.0567,-0.0834,0.0226,0.0559,0.0183,-0.1279,-0.04,0.0013,0.0731,-0.0773,-0.0199,-0.0158,-0.0029,-0.0584,-0.1184,-0.0166,-0.0929,-0.0373,-0.0627,-0.1612,-0.1641,-0.0077,-0.0122,-0.0713,-0.0511,0.0297,-0.0755,-0.049,0.0581,-0.1315,0.0081,0.0065,-0.0411,-0.2234,-0.1344,0.0544,0.1137,0.012,-0.0391,-0.0103,-0.0444,0.2521,0.126,0.0383,0.006,-0.1518,0.0422,-0.0202,0.0183,-0.0502,0.1344,0.0369,-0.1043,-0.0537,0.0822,-0.0929,-0.0575,-0.0103,0.0308,-0.0466,-0.0301,0.055,0.1014,-0.0221,-0.0653,-0.0153,0.0287,0.0143,-0.0172,-0.0014,-0.1217,0.0087,0.0132,-0.1254,0.0696,-0.0952,-0.063,-0.0818,-0.0147,-0.0606,-0.0612,0.0062,-0.056,-0.0104,0.0073,0.0942,-0.0192,0.0084,-0.066,-0.0128,-0.037,-0.0108,-0.1668,0.0477,-0.1526,-0.1151,0.0572,0.0869,0.082,0.0545,0.0562,-0.085,0.0176,-0.0638,-0.0551,-0.1207,-0.0362,-0.2387,-0.0529,-0.0701,-0.0816,0.0189,-0.051,0.0069,0.2121,0.1375,0.0333,0.2789,0.1076,0.1081,-0.0037,0.1776,-0.006,-0.0566,0.068,0.2047,0.0267,0.0173,-0.0271,-0.0983,-0.0381,-0.0611,0.0522,-0.0469,-0.0365,-0.016,0.0229,-0.1193,-0.0791,-0.0571,0.059,0.076,0.1109,-0.2625,-0.1313,-0.0618,-0.2505,-0.2123,0.0768,-0.002,-0.0091,0.0559,-0.0337,0.0469,-0.1228,0.0178,-0.0427,-0.0507,-0.2559,0.0184,0.0439,-0.0141,-0.1081,0.1262,-0.0107,0.0275,-0.0089,0.0527,0.0524,0.204,-0.0709,0.094,-0.0452,0.0207,-0.1368,0.0469,-0.0145,-0.0141,-0.0011,0.1234,0.0326,-0.0022,-0.0529,-0.0835,0.0226,0.2917,0.2873,-0.189,-0.1311,0.0427,-0.0625,-0.1409,-0.0176,-0.1585,0.0073,-0.0113,-0.0422,0.0038,-0.0142,0.1773,0.059,0.0818,0.0655,0.0123,0.0996,0.2706,-0.2008,-0.0352,0.2019,-0.0088,0.0426,0.0854,0.0437,-0.0846,0.1873,0.1556,-0.0186,-0.098,0.1493,0.056,0.2091,0.1366,0.092,0.0443,0.021,0.0855,-0.0792,0.0144,0.1654,0.0164,0.0318,0.0014,-0.0272,-0.1492,-0.0415,0.0791,-0.0512,0.101,-0.0356,0.0994,0.1251,-0.0253,-0.0064,0.016,-0.0004,-0.0235,0.0892,0.0383,0.0517,0.0474,0.2153,0.0981,0.0406,0.2926,-0.0466,-0.039,0.1646,-0.0883,0.029,0.0463,0.1027,-0.0983,-0.0035,0.0281,-0.0526,-0.0308,0.0073,0.0076,0.0001,0.0107,0.065,0.0654,0.0986,0.2204,0.226,-0.0854,-0.1715,-0.0617,0.012,0.0767,0.0328,0.0543,0.0308,0.0746,0.0258,0.0787,-0.1598,-0.2215,-0.0844,-0.0364,0.0812,-0.1165,-0.0989,0.0282,0.0729,0.0675,0.0772,0.0128,-0.003,0.0419,-0.0114,0.0802,-0.1879,-0.172,-0.2258,0.0548,-0.0191,0.0568,0.275,-0.0325,-0.0118,0.0576,0.0947,0.1111,0.1284,-0.1032,-0.0902,-0.06,-0.0459,0.0593,0.0283,0.1045,-0.05,0.0762,0.1297,0.0087,-0.092,0.0779,-0.2075,-0.005,-0.0432,-0.1577,-0.0486,0.0162,-0.0783,-0.1512,-0.06,-0.0677,-0.0599,-0.0775,-0.1926,-0.0243,-0.0148,0.0036,-0.0689,0.0736,0.1212,0.0624,0.1899,-0.1438,-0.0879,-0.0881,-0.0607,0.0932,0.0002,-0.0864,-0.0564,-0.1231,-0.0282,0.186,0.0737,0.1034,0.0684,0.0138,-0.0577,-0.095,-0.0122,-0.0521,-0.0475,-0.2376,-0.057,-0.0743,-0.0274,-0.0373,-0.0006,0.0518,0.2886,0.2192,0.1614,0.1116,-0.1246,-0.2242,-0.1186,-0.1988,-0.1461,-0.0014,-0.0475,-0.0327,-0.0519,-0.1214,-0.1458,-0.0517,0.0476,0.0056,-0.0647,-0.1041,-0.0447,-0.0929,-0.1625,-0.143,-0.0724,0.0627,0.0192,-0.0324,-0.1048,0.0255,-0.0622,-0.0732,-0.1504,0.0095,0.004,-0.18,-0.1103,-0.0415,-0.0096,-0.0233,-0.0798,-0.1962,-0.0365,0.2467,0.0948,0.1899,0.1148,0.1172,0.0501,0.1618,0.154,0.2177,-0.077,-0.0141,0.0172,0.0518,-0.0658,-0.0844,-0.0436,-0.1027,-0.0498,-0.0916,-0.0995,-0.0854,-0.1216,-0.0442,0.0356,0.0366,-0.1978,0.0393,0.0358,-0.0633,-0.0844,-0.0776,0.0229,-0.154,0.093,0.0647,0.0587,-0.0427,0.0253,-0.2064,-0.0736,-0.072,-0.1083,-0.0722,-0.0511,0.0019,0.019,0.0449,-0.0568,-0.061,0.036,0.017,0.1113,0.0834,-0.2191,-0.245,-0.0981,0.0262,-0.0562,-0.0682,0.0723,-0.0742,0.0328,-0.0518,-0.0321,-0.0977,-0.0876,-0.0783,-0.0737,0.0203,-0.1125,-0.0043,-0.0644,0.0646,0.0466,0.0651,-0.0693,-0.0617,-0.0646,-0.1412,-0.0686,-0.1867,-0.0602,0.1618,-0.0098,-0.0629,-0.1079,-0.0371,-0.1879,-0.067,-0.0722,-0.0777,0.1735,-0.0649,0.0149,0.0208,-0.1485,-0.0979,-0.1566,-0.0402,0.0981,-0.0575,-0.0435,0.0023,0.1326,0.0167,-0.0065,0.0189,-0.0628,-0.0095,0.0097,-0.0947,-0.0399,0.0062,-0.2114,-0.1511,-0.1607,-0.051,-0.0563,0.0999,0.0954,0.1799,-0.056,0.0093,0.0564,0.0703,-0.0183,0.1008,0.048,0.032,0.0331,-0.1502,-0.0576,-0.1087,-0.0371,0.0505,-0.0763,-0.0888,-0.0694,0.0307,-0.0392,-0.2543,-0.2177,0.0159,-0.1354,-0.2253,0.0609,-0.0927,-0.0085,0.0281,-0.1133,-0.0226,-0.1176,-0.0487,0.0601,-0.0859,-0.0176,0.0475,-0.1447,0.052,0.0427,-0.0025,-0.098,-0.0693,0.1262,0.0063,-0.0072,0.071,0.0003,-0.0294,0.0712,0.0003,0.05,-0.1921,-0.0953,-0.0552,-0.0108,-0.1371,-0.1092,-0.1248,-0.0252,-0.0096,-0.069,0.0379,-0.0836,-0.0484,0.0813,0.0412,0.025,0.0333,-0.0181,-0.1892,-0.0084,-0.066,-0.0933,0.1653,0.2504,0.2332,-0.0797,0.2972,0.1816,-0.1388,-0.0941,0.308,0.1002,0.0902,0.0913,0.1321,0.0717,-0.0298,-0.0239,-0.0539,-0.1006,0.3151,0.2515,0.2068,0.0204,0.0802,0.1968,0.3429,0.3516,0.3184,0.0425,-0.0436,-0.0419,-0.0538,-0.0588,-0.1083,-0.0693,-0.0832,-0.0615,-0.0606,-0.0767,-0.0707,0.1127,0.0149,-0.0264,-0.1656,0.0029,0.1622,0.2082,-0.1215,-0.0123,-0.16,-0.0826,-0.0925,-0.0468,-0.0161,-0.0897,0.0066,-0.0599,-0.0925,-0.1047,-0.0915,-0.0122,-0.1159,-0.0173,0.1282,0.0647,0.148,0.0026,0.0958,0.2538,-0.1225,-0.0964,-0.1039,-0.0954,0.1003,-0.0733,0.1267,0.0734,0.067,-0.0099,-0.1986,-0.1928,-0.1288,-0.1165,-0.0382,-0.2981,-0.2148,-0.0005,-0.0073,0.171,-0.0585,-0.0813,0.0959,0.0359,-0.0641,-0.0013,-0.0941,-0.1415,-0.1517,-0.0385,-0.0253,-0.0993,0.0636,-0.0354,0.0668,0.2159,0.2337,0.1116,0.1536,-0.0068,-0.0252,0.0958,0.1049,0.1292,0.23,-0.0005,0.0631,-0.0328,0.0269,0.0076,-0.0365,-0.0326,-0.0291,-0.0123,-0.0676,-0.0108,-0.0239,0.004,0.0505,-0.0095,0.0305,0.0303,0.0631,-0.1039,0.1344,0.0482,-0.0422,-0.1481,-0.0485,-0.0777,-0.1183,0.0018,-0.0706,-0.0578,0.0027,0.1374,-0.0506,-0.2155,-0.0674,-0.1012,0.023,0.0246,-0.0154,0.0163,0.0757,0.0557,0.2497,0.1648,0.1878,0.0385,-0.0084,0.0394,-0.1207,-0.1106,-0.0759,-0.0022,-0.1056,-0.1307,-0.0594,-0.0726,0.0052,-0.0675,-0.0822,-0.0965,-0.0153,-0.0371,-0.1299,0.119,-0.0799,-0.0698,-0.0257,-0.0967,-0.1317,-0.1004,0.1788,0.0376,-0.0384,-0.1283,0.1383,0.1166,-0.2074,0.0605,-0.12,-0.0767,0.0769,-0.2256,-0.2237,-0.0864,0.0412,0.0178,0.0139,-0.0498,-0.0459,-0.0272,0.0029,0.0324,-0.1304,0.0036,0.0096,0.0705,0.0286,-0.0949,-0.0301,0.0078,-0.0284,-0.0391,-0.0164,-0.0906,-0.0544,0.0145,-0.0019,-0.0143,-0.2043,-0.0801,-0.1524,-0.1357,-0.1019,-0.0956,-0.1113,-0.1113,-0.0558,-0.046,0.0462,-0.1728,-0.0593,-0.2158,-0.1917,-0.0577,-0.0354,-0.2558,0.1325,-0.2693,0.063,0.0754,0.1496,0.0324,-0.0008,-0.12,-0.1044,-0.0336,-0.0284,-0.0398,0.1084,-0.03,0.0503,0.1957,0.1732,0.0419,0.0569,-0.0648,-0.0505,0.0007,-0.1338,-0.0706,-0.07,-0.096,-0.0162,0.0243,0.0273,0.0273,-0.0157,-0.0835,0.0186,0.0386,-0.0215,0.1211,-0.0176,0.1141,0.0182,0.0613,0.0369,0.0268,0.1958,-0.0196,-0.0135,-0.0336,-0.045,0.0433,0.0564,-0.0853,0.156,0.0314,0.2633,0.0934,-0.0123,0.0438,-0.1187,0.0204,0.1305,0.0647,-0.1169,0.0286,0.0785,-0.0114,-0.0001,-0.2903,-0.2614,-0.1997,-0.2008,-0.114,-0.1631,-0.2537,0.0997,-0.008,0.0558,0.116,-0.0512,-0.0039,0.0403,-0.1078,-0.045,0.0124,0.002,0.1437,0.0318,0.0915,-0.1285,0.0041,0.1527,0.0605,0.1722,0.0873,0.0301,-0.1274,-0.0088,-0.1187,-0.0485,-0.0714,0.0239,-0.0894,-0.0765,-0.0246,-0.1129,-0.0654,0.0225,-0.0818,0.0329,-0.0649,-0.0052,0.046,0.1107,0.0637,0.0385,-0.04,-0.1155,-0.1206,-0.0625,0.0463,0.0232,-0.0393,-0.037,-0.0184,0.0379,-0.0004,-0.0601,-0.0402,-0.0845,-0.0903,-0.0799,-0.004,0.0888,-0.0594,-0.0791,-0.1215,-0.0376,-0.0345,-0.0393,-0.016,-0.1554,0.0993,-0.0838,-0.0883,-0.0887,0.1107,-0.0326,0.0358,0.0113,-0.0189,-0.1784,0.0645,-0.0492,-0.085,-0.0036,0.0663,-0.0423,0.042,-0.1014,-0.1111,-0.1078,-0.1401,-0.1626,-0.0669,-0.09,-0.0296,-0.0353,0.0952,0.0972,0.0914,-0.1073,-0.0944,0.1075,0.2161,0.2556,0.0191,-0.0919,-0.0033,0.0086,0.0098,0.1431,-0.0435,-0.0495,-0.0533,0.0342,-0.107,-0.1,0.2383,0.0717,0.0535,0.2237,0.0088,0.1271,-0.0222,-0.1334,-0.1021,-0.0998,-0.0982,0.0153,0.1234,0.0504,0.0259,-0.0659,-0.0014,-0.0843,-0.0035,-0.0608,-0.1243,-0.0404,-0.0193,-0.0522,0.0277,-0.0094,0.047,0.0402,-0.0206,0.0768,-0.2191,-0.1245,-0.1179,-0.167,0.0085,-0.0713,-0.0715,-0.1378,-0.0399,-0.1583,0.1239,-0.1619,0.0052,-0.0802,0.0447,0.1477,0.1242,-0.0871,-0.1084,-0.0347,-0.0617,0.0433,0.1122,-0.0761,-0.0581,-0.0332,0.0547,0.0286,0.033,0.0812,0.0368,-0.0223,0.0503,0.0125,0.0613,0.0747,0.015,-0.0707,-0.0551,0.0219,0.0531,0.0217,0.0795,0.0909,-0.0423,0.0407,-0.0182,-0.0889,-0.1778,-0.0297,0.0556,0.1676,0.0607,0.0232,0.0102,-0.0059,0.2214,0.1458,0.1153,0.1378,-0.0975,0.0024,-0.0564,-0.023,-0.0569,0.055,-0.0593,-0.0327,0.0463,0.0233,0.0324,-0.0501,0.053,0.0979,-0.1473,0.1679,0.0499,-0.0031,0.0829,0.0925,0.0816,0.047,-0.0201,-0.0026,0.0464,0.0665,0.1842,0.2219,-0.041,-0.0078,0.0352,-0.0349,-0.2116,-0.3257,-0.302,0.0032,0.0321,0.0145,-0.0885,0.0409,0.1247,-0.0193,-0.0941,-0.1154,0.0503,-0.0863,-0.047,0.047,-0.007,-0.0081,-0.0868,-0.0471,-0.1293,-0.0656,-0.0552,-0.0733,-0.0293,-0.1162,-0.0459,-0.0528,-0.0826,0.0329,0.1203,0.033,-0.0545,-0.0609,0.1666,-0.1095,0.108,0.1393,0.1425,0.006,0.0327,-0.2079,0.1162,0.079,-0.0735,-0.0557,-0.019,0.0371,-0.0438,-0.0979,-0.2311,-0.1766,-0.0839,-0.0443,-0.0323,0.0689,0.0109,-0.065,-0.0863,-0.1716,0.0125,0.0243,-0.0787,-0.0818,-0.0119,-0.0849,-0.1427,0.1848,0.094,-0.0905,0.0272,0.0905,0.1382,-0.2536,-0.2713,-0.1085,-0.2075,-0.0741,-0.0949,-0.0354,0.105,-0.0113,0.136,-0.0244,0.1573,0.2724,0.1045,0.1512,0.2247,-0.2003,-0.1234,-0.0645,0.1244,0.0448,-0.0158,-0.0194,0.0473,0.1212,-0.2223,-0.1823,-0.0613,0.1186,-0.1029,-0.1875,-0.1816,-0.1755,0.0207,0.0843,-0.1252,0.0255,0.0125,-0.006,0.0696,0.0448,0.0407,0.0245,-0.0027,-0.03,0.0712,-0.0239,0.0795,-0.0151,-0.0485,-0.0273,-0.077,-0.0098,-0.0181,-0.0064,0.1408,0.0542,0.0268,0.0318,-0.0369,-0.0267,-0.1658,-0.1143,-0.0525,-0.1144,0.255,-0.0243,0.2048,0.1146,0.0711,0.0047,0.0001,0.0893,-0.1009,0.1801,0.1485,0.058,0.1174,0.0428,0.0241,-0.0972,-0.0941,-0.2048,-0.0155,0.0547,0.0873,-0.1499,-0.0402,-0.0061,0.0532,0.0152,-0.0862,-0.0725,-0.1179,-0.0152,-0.2595,-0.0265,-0.0538,0.074,0.0513,0.0094,0.0494,-0.0449,-0.0224,-0.1264,-0.07,0.0532,0.0569,-0.1116,-0.0517,-0.1061,-0.0059,0.0131,0.0455,-0.0164,0.0965,0.0321,-0.0722,-0.1519,-0.0421,-0.143,-0.1106,0.0221,-0.0019,-0.0786,-0.0347,-0.116,-0.1257,-0.0015,-0.0215,0.0036,-0.0213,-0.0243,0.0154,-0.0948,0.1409,-0.3206,-0.2694,-0.2667,-0.0053,-0.1666,-0.2569,-0.1411,-0.068,0.0304,0.0141,-0.2042,0.1321,0.1737,0.0494,-0.0355,-0.063,-0.0608,-0.1246,-0.001,-0.0814,0.0686,0.1285,0.1857,-0.0124,0.0502,0.0401,0.0681,-0.2445,-0.048,-0.0254,-0.017,-0.1901,-0.1466,-0.16,-0.1658,-0.0366,-0.1895,-0.1659,0.0869,-0.0577,-0.2174,-0.0237,0.0962,0.0703,-0.0461,-0.0562,-0.3265,-0.2466,-0.1229,-0.2186,0.1176,-0.097,-0.0353,0.0285,-0.1521,-0.1439,-0.287,-0.1312,0.1236,0.086,0.1043,0.1368,0.1362,0.0136,0.0443,0.1501,0.0353,0.1111,0.1196,0.0727,0.0953,0.0635,-0.1708,-0.2256,-0.1167,-0.0578,-0.095,0.0148,-0.1436,0.0374,0.0216,0.0562,0.1164,0.0821,-0.1771,-0.0579,-0.1304,-0.018,-0.1652,-0.2333,0.0041,-0.0047,-0.0234,-0.0625,-0.0502,-0.1776,-0.0936,-0.1462,-0.1083,-0.0972,-0.0319,-0.0253,0.0579,-0.0444,-0.0635,0.0742,0.0805,0.0084,-0.0342,-0.0735,-0.1307,-0.0586,0.1363,0.0407,-0.0296,0.223,0.0618,0.0343,0.053,0.0155,0.0088,-0.0269,0.0021,0.0317,0.0123,0.0072,0.1133,0.1771,0.274,0.0019,0.0088,-0.0061,-0.035,-0.0027,0.1321,-0.1066,0.1534,-0.146,-0.0461,-0.0555,0.1227,0.0654,-0.0177,-0.0475,-0.031,-0.1065,-0.0925,0.0026,0.0114,-0.0779,-0.0854,0.02,0.1499,0.1343,-0.1502,-0.1139,-0.1063,-0.0111,-0.1826,0.0124,-0.0118,0.0701,0.034,-0.0313,-0.0962,-0.1256,-0.1593,0.0686,-0.0406,-0.0836,0.1337,-0.0379,-0.0382,0.09,0.3374,0.1173,0.1084,0.2014,-0.051,0.0354,0.178,0.1643,-0.0594,0.2162,0.0941,0.0972,0.0953,0.2861,0.0202,-0.1343,-0.1673,-0.0917,-0.0473,0.0964,-0.0559,0.0038,-0.1053,-0.0893,-0.0197,-0.0859,-0.0406,0.0917,-0.0247,-0.0733,-0.0214,-0.2237,-0.0371,-0.0215,-0.0663,-0.0536,-0.0239,-0.0505,-0.0246,-0.1518,-0.1105,0.1692,0.258,-0.0189,-0.0772,0.0782,0.0608,-0.071,-0.0284,-0.1753,-0.1867,0.0717,0.1264,-0.0403,-0.0562,-0.0951,-0.0102,-0.1382,-0.045,-0.0355,-0.0717,-0.0287,-0.0796,-0.0344,0.0372,-0.129,-0.1513,-0.0977,-0.1119,0.0905,-0.1344,-0.0034,0.1561,-0.0102,-0.1451,-0.1201,-0.0507,-0.1399,-0.0718,-0.1575,-0.1939,0.0823,0.0175,0.0642,-0.0628,-0.0777,-0.1404,-0.0002,0.0246,0.0414,-0.1495,-0.0645,-0.1541,0.0182,0.0631,0.0738,-0.1076,-0.1327,-0.0853,-0.0777,-0.0802,-0.0356,0.0107,0.0835,-0.0229,-0.0482,-0.0831,-0.0724,-0.0975,-0.1796,-0.0897,-0.0659,0.0466,-0.013,0.172,-0.0472,0.1411,0.0053,0.0676,-0.0049,0.0663,0.1321,0.0975,-0.0073,-0.0186,-0.0471,0.0527,0.0063,0.0461,-0.0641,-0.0712,-0.0035,0.0641,-0.0806,-0.0722,-0.0556,-0.0419,-0.0852,-0.0515,-0.0062,0.1582,-0.1233,0.0205,0.0005,0.0376,-0.026,-0.0053,0.0715,0.0068,-0.1388,-0.0424,0.1035,0.1417,-0.0765,-0.0674,-0.0926,-0.1624,-0.0508,-0.0244,-0.1165,0.1111,0.0707,-0.1784,-0.1523,-0.0245,-0.1123,-0.0349,-0.0701,0.2069,0.1406,-0.0908,0.0938,-0.0577,-0.0369,-0.1189,-0.0949,-0.1666,-0.1751,-0.0154,-0.0257,-0.1136,0.0403,-0.061,-0.1119,0.1448,-0.0038,0.0327,-0.0259,0.0078,0.019,-0.0775,-0.0458,0.0811,-0.1152,0.1185,-0.1806,0.0215,-0.1009,0.2749,0.1506,0.1431,-0.1223,-0.1173,0.0992,0.2181,0.0088,0.2037,0.0371,-0.0133,0.1223,0.0737,0.0648,0.0164,0.0351,0.0938,0.1141,0.1497,0.21,-0.0187,0.0382,0.1464,0.3234,0.1126,0.1011,0.2139,0.107,0.095,0.159,0.1118,0.1451,0.0802,0.1834,0.2008,0.0714,0.1267,0.2699,0.1856,0.2334,0.173,0.0276,0.1566,-0.1713,-0.019,-0.1298,-0.2184,-0.0743,-0.2175,-0.1811,-0.1081,-0.1266,-0.1369,-0.2374,-0.1744,-0.177,-0.1079,0.0256,-0.0797,0.0885,-0.0224,-0.047,-0.0062,-0.1066,-0.0764,-0.0414,-0.0702,-0.1492,0.1109,-0.1715,-0.1839,-0.0239,-0.0276,-0.0201,-0.0039,-0.0022,-0.1792,0.1651,0.1473,-0.0565,0.2442,0.2578,0.1017,0.1034,0.1465,-0.1084,0.3214,0.3215,-0.0527,0.0106,0.137,-0.0318,-0.0008,-0.1319,-0.0047,0.0938,-0.0357,-0.0707,0.0369,-0.0132,-0.0375,-0.0287,visual tool recognition
trm_5678a999f1c19,0.0239,0.0275,0.0091,0.0118,-0.0312,-0.0118,-0.0079,0.0101,-0.0038,0.0216,-0.0205,-0.0055,0.0023,0.0058,0.0429,0.0366,0.0191,0.0147,-0.022,0.0162,0.0238,-0.0182,-0.013,-0.0148,0.0146,0.0146,0.0146,0.014,0.0364,0.0278,0.0141,0.0011,0.0138,0.0014,0.0162,0.0093,-0.0358,-0.0223,0.0545,0.014,0.0027,0.0402,0.0074,0.0015,0.0152,0.0363,-0.013,0.0309,-0.003,0.0034,0.028,0.0272,0.0084,0.0257,0.0065,-0.0089,0.0015,0.0069,-0.0286,0.0272,0.0082,-0.0132,0.0091,0.0227,0.0092,-0.0017,0.038,0.0526,0.0322,-0.0125,-0.0234,-0.0573,-0.0219,-0.0177,0.036,-0.0017,0.0196,-0.0079,0.0149,-0.0131,-0.0323,-0.0223,0.0133,0.0052,0.0003,-0.0025,0.0106,-0.0204,-0.0034,0.0296,0.0049,0.0021,-0.0765,-0.0048,0.0053,0.0035,0.0007,0.0348,-0.0069,-0.024,0.029,0.0026,-0.0091,-0.0189,0.0124,-0.0064,0.0455,-0.0079,0.0368,0.0074,-0.0078,0.0227,-0.0183,0.0157,0.0121,-0.009,-0.0055,-0.0212,0.0426,0.0118,-0.0036,0.0017,-0.0065,-0.0095,0.0091,0.015,0.0041,-0.0133,-0.0254,-0.0365,0.008,0.0256,0.0057,-0.0145,0.0169,0.0409,0.0208,0.0139,-0.0063,0.0115,0.0202,0.0114,-0.018,0.0092,0.0179,0.0063,0.0223,0.0083,0.0265,-0.0203,0.0094,0.0175,-0.0341,0.002,0.0151,-0.0307,-0.0437,0.0267,-0.0368,-0.0568,0.034,0.0197,0.0196,0.0198,-0.0089,-0.0118,-0.0176,0.0416,0.041,0.0117,-0.0468,0.0204,-0.0522,-0.017,0.0166,-0.0029,0.0031,-0.0194,-0.0066,-0.0276,0.0227,-0.0372,-0.0058,-0.0291,0.027,-0.0033,0.0005,-0.0141,0.0155,0.0424,0.043,0.003,0.0039,0.0449,0.0457,0.058,0.0419,0.0284,0.0116,0.0285,0.0045,-0.0253,0.0113,0.0353,0.0145,0.01,0.0103,0.0319,-0.0028,0.0018,0.0095,-0.0087,-0.0008,-0.0321,0.0177,-0.0037,-0.0317,0.0117,0.0019,0.0076,-0.0073,0.0189,-0.0203,-0.0129,0.0022,-0.0189,0.023,-0.0092,-0.0126,-0.0071,-0.0428,0.0035,-0.0186,-0.0266,-0.0321,0.0268,0.0068,0.0076,0.013,0.0204,-0.028,0.0263,0.0043,-0.0047,0.0095,0.0187,-0.0119,0.0168,0.0262,0.0161,0.0215,-0.0022,-0.003,-0.0141,0.0094,0.0294,0.0117,0.0181,0.0301,-0.0013,0.0157,0.0092,0.0076,0.0007,-0.0004,-0.0073,0.0032,0.0154,-0.0396,0.0209,0.0236,0.047,0.0194,0.0096,0.0237,-0.0055,0.0043,0.0138,0.0046,-0.0165,-0.0193,0.0036,-0.0028,0.0172,0.0174,0.0149,0.0012,-0.0071,0.0355,-0.0106,-0.0272,0.0079,0.0191,-0.0053,-0.0089,-0.006,0.0148,0.0332,0.0212,0.0241,0.0314,0.0073,-0.0188,-0.0299,0.0017,0.0009,0.0025,0.0225,0.0092,0.0351,-0.0146,-0.0061,0.0315,0.0167,-0.0098,0.026,0.0219,-0.0029,-0.0006,0.0248,-0.0072,0.0093,-0.0024,0.0009,-0.0186,0.0319,0.0138,0.0248,-0.0152,-0.0556,-0.0044,0.0054,-0.0064,-0.0101,-0.0061,0.0008,-0.0119,0.0009,0.0143,0.0065,-0.0023,-0.0082,-0.0036,-0.0102,0.024,0.0029,-0.0067,-0.0153,-0.0037,-0.0111,0.0138,-0.0055,-0.0219,-0.0188,-0.0241,-0.0155,-0.0072,0.0096,0.0287,0.0113,0.0025,0.025,0.0269,-0.0124,-0.0116,-0.0354,0.0303,0.038,0.0027,0.0298,0.0212,-0.0114,-0.01,-0.0232,-0.0048,0.0275,0.0289,-0.0002,-0.0276,-0.0243,-0.025,-0.0185,0.0278,0.0071,-0.0017,-0.0108,-0.0024,-0.0062,0.0254,0.0007,-0.0038,0.0175,-0.0225,0.0245,0.0037,-0.018,-0.0046,-0.0184,0.017,-0.0105,0.0134,-0.0091,0.0174,-0.0098,0.0005,0.0045,0.0123,0.0501,-0.0284,-0.0124,0.0237,0.0028,0.0184,0.0271,0.0011,0.0173,0.0136,0.0024,0.0286,0.0284,-0.0109,0.0164,0.0154,0.0524,0.0469,0.03,0.0516,-0.0148,0.0173,-0.0162,0.035,-0.0181,0.0188,-0.0138,-0.0464,-0.0043,0.0017,-0.0246,0.019,0.0157,-0.0219,-0.0163,-0.0104,-0.0184,0.0098,-0.0212,-0.0235,-0.0116,0.0446,0.0525,0.0407,0.0239,0.0184,0.0349,-0.0079,0.0373,-0.0034,0.036,0.0403,-0.006,-0.0079,0.0157,-0.0021,-0.0433,0.0276,0.0113,-0.0167,-0.0135,0.0089,0.0019,0.022,-0.035,0.0197,-0.0143,-0.0092,0.0189,-0.005,0.0003,-0.0052,0.0243,-0.0139,0.0179,-0.0006,0.0163,-0.0141,-0.0292,0.0018,-0.0006,0.0121,-0.0031,-0.0444,-0.0495,-0.0115,-0.0015,-0.0284,0.015,0.032,-0.0039,-0.0016,0.0322,0.0291,0.0255,0.0201,0.0115,0.0185,0.0118,0.0313,-0.0017,-0.0123,-0.0049,0.0109,-0.0394,0.0134,-0.0064,-0.0343,0.0099,0.0179,-0.0066,-0.0252,0.0214,0.0078,0.0144,0.0057,0.0334,0.0056,-0.0054,-0.0069,-0.0233,-0.0237,0.0122,0.0031,0.0309,-0.043,0.016,-0.0172,0.0223,0.0239,0.0122,-0.0085,-0.0039,-0.0029,-0.0009,0.0057,-0.0054,-0.019,-0.0054,0.0169,0.011,-0.0074,-0.0012,-0.0209,0.0044,0.0027,-0.0103,0.0148,0.0303,-0.0509,0.0021,-0.063,0.0302,0.0149,-0.0035,0.0431,0.0206,0.0193,-0.0137,-0.017,0.0018,0.0042,0.0129,0.0153,0.0101,-0.0238,0.0114,-0.1042,-0.0838,-0.0087,-0.0105,0.0118,0.0081,0.0089,0.0195,0.0141,0.0161,-0.003,0.0039,0.0298,0.0045,-0.0157,-0.0218,-0.0145,0.0119,0.0156,0.0464,0.0055,0.0031,0.0297,-0.0191,-0.0123,-0.0077,0.0082,-0.0073,-0.0092,-0.0053,0.0138,-0.0529,0.0498,0.0258,0.0298,0.0209,0.0042,0.0265,-0.0006,0.0172,0.031,0.0213,0.0342,0.0135,0.0131,0.0284,0.006,0.0133,-0.0626,-0.0061,-0.0118,-0.0456,0.0279,0.0118,0.0133,0.0263,-0.02,-0.0058,0.021,0.042,0.0477,0.001,0.0133,-0.0093,0.0064,0.0258,0.0101,-0.0187,0.0126,-0.0834,-0.0037,0.026,0.0227,0.0203,-0.0263,0.02,-0.013,-0.0005,0.0051,0.0117,0.0014,-0.0015,-0.025,-0.0078,-0.0273,0.0272,-0.0074,-0.0389,-0.0198,-0.038,-0.0011,0.0072,-0.0001,0.0159,-0.0194,0.0101,-0.0293,-0.0192,-0.0173,-0.0226,0.0206,0.0232,-0.0319,0.0282,-0.0062,-0.0039,-0.0067,-0.0118,0.0286,0.0116,-0.0336,0.0263,0.0147,0.0374,0.0201,0.0156,0.021,0.016,0.0021,0.0291,-0.0331,0.0154,-0.0244,0.0345,0.0187,0.0454,0.0081,0.0172,0.0142,-0.0361,0.0276,-0.0072,0.0394,0.0197,0.0164,-0.0131,0.0233,-0.0086,-0.0139,-0.0219,-0.027,0.0244,-0.03,-0.0031,-0.0214,0.0084,-0.0566,0.0086,0.0369,0.0331,0.0249,0.0209,0.0274,0.0045,0.0295,0.0148,-0.0416,0.0046,-0.0188,-0.0142,-0.0139,0.0279,0.0194,-0.0077,0.031,0.0181,0.0307,-0.0206,0.0086,-0.0108,0.0,0.0086,0.0276,-0.0088,0.0012,-0.0227,-0.0049,-0.0224,-0.0021,0.0251,0.0052,-0.0086,0.0169,-0.0145,-0.0482,0.0161,-0.0085,0.0006,-0.0113,-0.0201,-0.0086,-0.0145,-0.0024,0.033,-0.0377,0.016,-0.0086,-0.0278,0.0046,-0.0031,-0.0137,0.0132,-0.0172,-0.0006,0.0144,0.0342,0.0378,0.0216,-0.0229,0.0037,-0.0139,-0.0057,-0.0092,-0.0114,-0.0049,0.0324,0.0032,-0.0,-0.0201,-0.0082,-0.01,-0.0039,0.0197,0.0465,0.0186,0.031,0.0271,-0.0174,-0.0126,-0.0349,0.0179,-0.0105,0.013,0.0219,0.0393,-0.0304,-0.0187,-0.0038,-0.0536,-0.0338,-0.0249,-0.0417,-0.0397,-0.0383,-0.0221,-0.0201,0.01,0.0263,0.0441,-0.0284,-0.0043,-0.0522,0.025,-0.0023,-0.0153,0.0072,0.0128,0.0134,-0.0235,-0.0047,-0.0132,-0.0141,0.0335,-0.0038,0.0243,-0.0008,-0.0032,0.0052,0.0031,0.013,0.0096,0.0315,0.0191,-0.0193,0.0168,-0.0142,-0.0011,0.0267,-0.0365,0.0216,0.0309,0.0148,0.053,0.0311,0.027,0.0074,-0.0072,-0.0112,-0.0006,0.0048,0.0028,-0.0461,0.004,0.0113,-0.0173,0.024,-0.007,0.0062,-0.0505,0.0131,-0.0035,0.0334,0.008,0.0288,0.0324,0.0276,0.0199,-0.0328,0.0122,0.0256,-0.0121,-0.006,0.0022,0.0265,-0.0171,0.0113,0.0116,0.0121,-0.0247,-0.0107,0.0129,-0.0306,0.0272,0.024,-0.019,0.0324,-0.0225,-0.0108,-0.0722,-0.0198,-0.0193,-0.1086,-0.0308,0.0088,-0.0315,0.0114,0.0459,-0.0561,0.0357,0.0009,-0.0016,-0.0808,-0.0403,-0.0054,-0.0262,0.0092,-0.0038,-0.0072,0.0204,-0.0013,-0.0326,-0.0203,-0.0143,-0.063,-0.0141,0.0095,-0.0187,-0.024,0.0209,0.0004,0.0036,-0.0347,0.018,-0.0193,-0.0033,0.0139,0.0138,-0.0009,0.0073,0.001,-0.0183,0.0091,-0.0012,-0.0114,-0.0361,0.0136,-0.0125,-0.0214,0.0157,0.0305,-0.0259,0.0404,-0.0149,0.0021,0.0195,-0.0269,-0.0217,0.0149,-0.0157,0.0103,-0.0108,0.0013,0.0121,0.0177,0.0098,-0.0072,0.0271,0.0067,0.0289,0.0105,-0.0156,0.0092,0.0203,0.0183,0.0144,0.0144,-0.0074,0.0038,0.0359,0.0351,-0.0057,0.0334,0.0225,-0.0452,0.0075,-0.0121,-0.009,-0.0793,-0.0273,0.0255,0.0079,0.0172,0.0224,0.0076,-0.0084,-0.0069,-0.0208,-0.015,-0.0229,-0.0273,-0.0203,0.0232,0.0057,0.0264,-0.0115,0.0083,0.0062,-0.0023,0.005,-0.061,0.0197,0.0415,0.0076,0.0136,0.0485,0.0037,0.0028,-0.0351,-0.0274,-0.0341,0.0024,0.0197,0.0209,0.0158,0.0266,-0.0238,-0.0099,-0.0235,-0.0236,-0.0531,0.0186,0.006,-0.0018,0.0133,0.0211,-0.0144,0.0073,0.0328,0.0314,-0.0235,-0.0222,-0.0026,-0.0051,0.0053,0.0018,-0.0051,-0.0186,0.015,0.005,0.0143,0.0058,-0.0433,-0.0217,-0.0726,-0.002,-0.0212,-0.0017,-0.0122,-0.0017,0.0375,-0.0447,-0.0023,-0.0461,-0.0073,0.0138,-0.048,0.0098,0.0306,0.0091,0.0083,0.0223,-0.0178,-0.0062,0.0189,0.0227,-0.0081,-0.0638,0.0184,-0.0062,0.0059,0.0277,-0.0052,-0.0137,-0.0253,-0.0035,0.0034,-0.0516,-0.0417,-0.0118,0.0122,-0.0018,-0.0028,0.0,0.0008,0.0449,-0.026,0.0005,0.0035,-0.0158,-0.0231,-0.0072,0.0085,-0.0194,0.0097,-0.0001,-0.0026,0.024,-0.0137,0.0079,0.0183,0.0239,0.0191,0.0083,0.0091,-0.0001,0.0219,0.0167,0.0242,-0.0004,0.0374,-0.0153,-0.0267,0.0076,0.0319,0.0263,-0.0116,-0.0027,-0.0196,-0.0339,0.0132,-0.051,0.0098,0.0106,0.0025,-0.02,0.003,0.0372,-0.0423,-0.0068,-0.0205,-0.0062,-0.0471,-0.0873,-0.0561,-0.0673,-0.0026,-0.0457,0.0029,0.0115,-0.0046,-0.0205,0.0177,0.0355,0.0263,-0.0745,-0.0284,0.0189,0.0305,0.0293,0.0015,-0.0133,0.0057,-0.0029,-0.0591,0.0055,0.0199,0.0017,0.0084,0.0045,-0.0254,-0.0019,0.0393,0.0448,0.0108,0.015,-0.06,-0.013,0.0085,0.0174,0.0035,0.0666,0.0347,0.0269,0.0004,0.0057,0.0454,0.0581,0.0111,0.0023,0.0198,0.0289,0.0201,-0.0148,0.0004,0.0358,0.0104,0.0024,0.0093,0.0237,0.0206,0.0089,0.0264,0.0131,-0.0061,-0.0274,-0.0022,0.0122,0.0286,0.0133,0.0019,0.0063,-0.0045,-0.0002,0.024,0.0261,-0.0191,-0.0025,-0.0183,-0.0168,-0.0115,-0.0128,0.0556,0.0037,0.0094,0.0039,0.0445,-0.055,0.0011,-0.0124,0.0143,-0.0023,0.0075,-0.0353,0.0124,-0.0267,-0.026,-0.0475,-0.0168,-0.0269,0.019,-0.0139,0.0215,0.0101,0.0242,-0.0114,-0.0294,-0.0294,0.0136,0.029,0.0204,-0.0029,-0.0212,-0.0575,0.0096,-0.066,0.0426,0.0378,0.0332,-0.0143,0.039,0.0379,0.0086,-0.0138,-0.0418,-0.0173,-0.0108,-0.0236,-0.0066,0.0128,0.0337,0.0307,0.0086,0.0072,0.0243,0.0156,0.0038,0.0243,0.0335,0.0459,0.013,0.0172,-0.0,-0.0008,-0.0076,-0.0838,-0.0286,-0.0643,0.0063,-0.0475,-0.0113,-0.0164,-0.017,0.0011,-0.0191,0.0145,-0.0198,0.0023,-0.0216,0.01,-0.0399,-0.0634,0.0274,0.0087,-0.03,-0.0259,0.0256,0.0278,0.0239,0.0209,0.0029,0.0225,-0.0008,-0.0051,0.0063,0.0076,0.0244,-0.0188,-0.0166,-0.0066,0.0072,0.0044,-0.0033,-0.0173,0.0304,0.0062,-0.0311,0.0023,-0.0099,0.026,0.0167,0.006,-0.0088,-0.0164,0.0212,-0.031,-0.0016,0.0113,-0.0449,0.0101,0.0237,0.0237,-0.0014,-0.0,0.0071,0.0041,-0.0009,-0.0043,-0.0093,0.0318,-0.0022,0.0057,0.0033,-0.0272,0.0046,-0.0215,-0.0232,0.0001,-0.0667,-0.0088,0.0106,-0.0478,0.0168,-0.0219,0.0203,0.0368,0.0236,0.0278,-0.0023,0.0215,0.0051,-0.0168,-0.0038,-0.0363,-0.0413,-0.0134,0.0156,0.0057,0.0176,0.0031,-0.0104,0.0091,-0.0054,-0.0002,0.0414,0.0226,0.0069,0.0147,-0.0022,0.009,0.0331,0.0035,-0.0015,0.0146,-0.0054,-0.0067,-0.0027,0.0194,-0.005,0.0078,-0.0137,0.0209,-0.0108,0.0186,-0.0031,-0.0202,0.0145,-0.0176,0.0133,0.0139,0.0107,0.0077,0.0311,-0.0108,-0.0244,-0.0206,0.0087,-0.0064,-0.0379,-0.0364,-0.0885,0.0263,-0.0398,0.0334,0.0275,-0.02,0.0189,-0.0057,0.0005,0.0122,0.0261,-0.0069,-0.0297,-0.0488,-0.0299,-0.0126,-0.0099,0.0235,0.0319,0.0555,0.0484,0.0304,-0.0288,0.029,0.0018,-0.0015,0.0045,-0.0219,-0.0001,0.0192,-0.0071,0.0259,0.02,-0.0122,0.0091,0.0284,0.0118,0.0097,0.0011,0.0077,-0.0268,-0.0237,0.0338,-0.005,0.0003,-0.0021,0.0062,-0.002,0.0135,0.0145,-0.0038,0.0116,-0.0041,-0.0016,0.0091,-0.023,0.0045,-0.039,-0.0053,0.0413,0.0234,-0.0232,-0.0018,0.0261,0.0353,-0.0166,0.0128,-0.0111,-0.0276,0.019,0.0221,-0.0223,-0.011,-0.0211,0.0215,-0.0162,-0.0464,0.0055,0.0115,-0.0198,0.0018,-0.0266,-0.0016,-0.0251,0.0012,-0.0202,0.0054,0.0107,0.0042,-0.0009,0.0026,0.0061,0.0052,0.0187,-0.0235,0.0262,-0.0021,-0.0309,0.0384,-0.0104,0.0315,0.0134,0.0151,0.0164,-0.0024,0.0152,-0.007,0.0186,-0.0479,0.026,-0.0012,-0.0726,0.0289,0.0092,0.018,-0.0223,-0.0015,-0.0008,0.0053,0.0134,0.0023,0.0148,-0.0267,-0.0165,-0.004,-0.0013,0.0173,0.0221,0.0291,-0.0007,-0.0543,0.0258,-0.0066,-0.0203,0.013,0.0154,0.0089,0.0115,-0.0364,0.0076,-0.0152,0.0162,0.0329,0.0234,0.0268,0.0347,0.0302,0.0016,0.0176,-0.0033,-0.0326,-0.0573,0.0039,-0.0404,-0.0084,0.0197,0.0398,0.02,-0.0274,0.0086,0.0367,0.0028,0.0385,0.0138,0.0423,0.002,0.0218,-0.0217,0.0094,0.0107,0.0061,0.02,0.0074,-0.0177,0.0233,-0.0026,-0.0029,-0.013,0.0125,0.0211,-0.0242,-0.015,0.0296,0.0113,0.0327,0.006,-0.0021,0.0158,-0.0085,0.0168,-0.0217,-0.0266,0.0219,0.0099,0.0369,0.019,-0.0277,-0.045,0.0115,-0.0516,-0.0629,0.029,0.0264,0.0249,-0.0111,0.0045,-0.0188,0.0065,0.0281,0.0201,-0.0199,0.0024,-0.0085,0.0342,0.058,0.0259,0.023,0.0108,0.0307,0.0081,-0.0388,-0.0038,-0.0146,-0.0104,0.004,-0.0043,-0.0133,-0.0004,-0.0077,0.001,0.017,0.0128,-0.0252,0.0043,0.0173,-0.0011,0.0154,-0.0206,-0.026,-0.013,-0.0961,-0.0164,-0.0196,-0.0131,-0.0424,-0.0456,-0.0097,-0.0032,0.0106,-0.0062,-0.003,-0.0277,0.0058,0.0009,0.009,0.0333,-0.0051,0.0006,0.0097,-0.0116,0.0402,0.0001,-0.0166,0.0182,-0.016,-0.0008,0.0075,-0.0054,0.0154,-0.018,0.0145,-0.0043,0.0044,0.0255,0.0352,0.002,0.0082,0.016,0.0112,-0.0272,-0.0195,-0.0521,-0.009,0.0164,-0.0095,0.0195,0.0511,0.0084,0.0326,0.0214,-0.001,-0.033,-0.061,0.027,-0.0085,0.0057,0.0067,0.023,-0.008,0.006,0.0271,-0.0655,-0.0541,0.0231,0.0059,0.0091,0.0044,0.0259,-0.0135,0.0495,0.0485,0.0025,0.0145,0.0412,0.0007,0.015,-0.0314,0.011,-0.0126,0.0201,0.007,0.0062,-0.0534,0.0174,0.0479,-0.0005,0.0369,-0.0073,0.001,0.0267,0.0172,0.0191,0.0256,-0.0169,-0.0057,0.0291,-0.0167,0.0147,0.0116,0.0129,0.014,0.0081,0.0327,0.001,-0.0256,-0.0073,0.0196,-0.0281,-0.0142,0.0079,-0.0098,0.0385,0.0279,0.0128,0.0205,0.067,0.0216,0.0406,0.0362,-0.0003,0.0252,0.0492,0.0225,0.0329,0.0321,-0.0257,0.0418,0.0266,-0.0138,0.0054,0.0235,-0.0234,0.0052,0.0182,-0.0203,-0.0549,-0.0217,0.0249,0.0362,0.0249,-0.0091,-0.0008,-0.0092,-0.0024,0.0308,0.0118,0.0176,0.0245,0.0133,0.0045,0.0254,-0.0043,-0.0106,0.0258,-0.0108,0.0087,0.018,0.0038,0.0064,0.0159,-0.0097,-0.03,0.0186,0.025,0.0297,0.014,-0.0244,0.0136,0.0077,-0.0577,-0.03,-0.0841,-0.0148,-0.0243,-0.0412,0.0038,-0.0465,-0.0096,-0.0282,-0.0137,-0.0588,-0.0549,-0.0381,-0.0146,0.0178,-0.0033,-0.0299,-0.0287,0.0481,0.0225,-0.0123,-0.0144,0.0,0.0146,0.0063,-0.04,-0.038,-0.0027,0.0046,0.003,-0.0223,0.0134,-0.0394,0.006,-0.0003,0.0067,-0.0134,-0.0287,0.0201,-0.0117,-0.0157,-0.02,0.0303,0.0099,0.016,0.0157,0.0231,0.0156,0.0127,0.0178,0.0049,-0.002,-0.052,0.0214,-0.0186,0.0048,0.0412,0.0148,0.031,0.001,0.0205,0.0185,-0.0202,0.0297,0.0355,0.0191,-0.0048,0.0062,0.0112,-0.0063,0.0288,-0.0014,0.0301,-0.0387,-0.027,-0.0244,0.002,0.0251,-0.0007,-0.0053,-0.0298,0.0016,0.0036,-0.016,0.0061,0.0076,0.0074,0.0243,-0.005,-0.0276,-0.0244,0.0109,0.0207,0.014,0.0079,-0.0098,-0.0525,0.0253,0.0015,-0.0017,0.0064,0.029,-0.0093,-0.0091,0.0298,0.0036,0.0223,0.0044,0.009,-0.0134,0.0087,0.0387,-0.048,-0.0282,0.0359,0.0103,-0.0211,-0.0022,-0.0019,0.0137,0.0172,0.0098,0.0301,0.0304,0.0035,-0.0169,-0.0539,-0.0791,-0.0213,-0.0545,-0.0301,-0.031,-0.0533,-0.0498,-0.0252,0.0155,0.0116,-0.0204,0.0201,0.0271,-0.007,0.0184,0.0087,0.0112,0.0058,-0.0045,-0.0094,-0.0216,-0.0012,-0.0077,-0.0386,-0.0582,-0.0085,0.0011,0.0028,0.0188,0.0021,-0.0133,0.0236,0.0175,0.0158,-0.0067,-0.0248,-0.0051,0.013,0.0277,0.0254,0.0049,0.0139,0.0138,-0.0009,-0.001,0.0011,-0.0344,-0.0151,-0.0079,-0.0219,0.0108,-0.0093,-0.0143,0.008,0.0208,0.0244,0.0107,0.0188,0.008,-0.0086,-0.0031,-0.01,-0.0158,-0.0462,0.0131,-0.0001,-0.0084,-0.0247,0.0255,-0.0294,-0.0214,-0.0153,0.0202,0.0266,0.0262,0.0394,-0.0044,0.0277,-0.0256,-0.0134,-0.0197,0.0134,0.012,-0.0016,0.0151,0.0115,0.0001,-0.0082,0.0241,0.0338,0.0046,0.0079,-0.0076,-0.001,-0.0135,0.0114,0.0274,-0.0255,-0.0307,-0.0339,-0.0316,0.0212,0.0188,0.0218,-0.0042,-0.0095,0.0185,0.0103,0.0094,-0.0009,-0.0194,0.0031,-0.0429,-0.0287,-0.0183,0.0206,0.0052,0.0075,0.0311,0.0339,-0.0133,-0.0059,-0.0104,0.0164,-0.0169,-0.0402,0.0277,-0.032,-0.0585,0.0443,0.0067,0.0064,-0.0244,0.0052,-0.0337,-0.035,-0.0262,0.0074,0.0051,0.0023,-0.0125,-0.0329,0.02,-0.012,0.0016,-0.0021,-0.0122,0.036,0.0119,0.0348,0.0441,0.0314,0.0056,0.0075,0.0102,0.0194,0.0113,0.0329,-0.0121,-0.0266,-0.0005,0.0155,0.0194,0.0243,0.0059,-0.0102,-0.0018,-0.0318,-0.0159,0.0186,0.0192,0.0226,0.0218,-0.0062,0.0142,0.0185,-0.0487,0.0052,-0.0241,0.0289,0.041,0.0135,0.0314,0.0038,0.0175,-0.0287,0.021,0.011,0.0018,-0.0221,0.0286,0.0137,0.0166,0.0211,-0.0133,0.0031,0.0091,-0.0157,-0.0251,0.0189,0.0093,0.0223,0.0222,0.0082,0.0043,0.0437,0.0311,0.0141,0.0141,0.015,0.0216,0.0122,0.0287,-0.0011,-0.0278,-0.0366,0.0436,0.0146,0.0487,0.0191,-0.0035,0.0205,-0.0014,-0.0186,0.0313,0.0275,-0.0276,0.0144,-0.0184,-0.0817,0.0095,0.0065,-0.0111,0.0141,0.0037,0.0266,0.0095,-0.0246,-0.0186,-0.0069,-0.03,0.0359,0.0373,-0.0043,0.0308,-0.0009,-0.0022,-0.0043,-0.0059,0.0005,0.0163,0.0191,0.0289,0.0186,0.004,0.0142,0.0476,0.0232,0.0436,-0.0069,0.0095,0.0191,0.0163,-0.0392,-0.0364,-0.0104,-0.0225,-0.0109,-0.0041,-0.0206,-0.0095,0.0115,-0.0091,-0.0539,-0.0114,0.0221,-0.0003,0.0119,0.005,-0.0122,0.0082,0.0152,-0.0249,-0.0105,-0.0842,0.011,-0.0812,-0.0299,-0.0904,-0.0122,-0.0556,-0.0484,0.0111,-0.0203,0.0037,-0.0272,-0.0018,-0.033,0.0094,0.0358,0.0119,-0.0381,0.0222,0.0159,0.0108,-0.012,-0.0141,0.0108,0.0044,0.0403,-0.0112,0.0111,-0.004,0.0047,0.0004,0.015,-0.0048,0.026,0.0226,0.0304,0.0374,0.0204,-0.009,-0.017,-0.0043,-0.0254,0.0006,-0.0254,0.0078,0.0116,-0.026,0.0246,0.0237,-0.0495,0.055,0.0534,0.0029,0.0133,-0.0054,-0.0209,0.006,0.03,0.0123,0.0133,0.0219,0.0135,0.0093,-0.0063,-0.007,-0.0253,0.0167,0.0087,0.0104,0.0076,0.0011,0.0255,-0.0042,-0.0076,0.0258,0.0066,0.0048,-0.0148,0.0068,0.0319,-0.0091,0.0246,-0.0029,0.0249,0.0241,-0.0223,0.0131,-0.0129,-0.006,-0.0034,-0.0164,0.0178,0.0194,-0.0192,0.0224,0.0088,-0.0276,0.0203,-0.0136,-0.024,0.0143,0.0153,-0.0026,0.0071,0.0131,0.031,0.0251,0.0077,-0.0153,-0.0255,-0.0275,0.0123,-0.0008,0.0164,0.0359,0.0063,0.0064,-0.011,0.0281,0.0143,0.0105,0.034,0.0229,-0.0341,0.0078,0.0074,0.0224,-0.0513,-0.0108,-0.005,-0.0284,-0.005,0.0044,-0.0217,0.0054,0.0257,0.0007,0.0047,0.0218,-0.0212,0.0143,0.0083,-0.0139,-0.0231,-0.0021,0.0132,-0.0182,0.0024,-0.012,0.0068,0.0165,-0.0227,0.032,0.0086,0.0184,0.0099,0.0163,0.0189,0.0193,-0.0153,0.0106,0.0049,-0.0075,0.02,-0.0109,-0.0016,-0.0106,0.0251,0.0369,0.0298,-0.0103,-0.024,0.0207,-0.0099,-0.0051,0.0138,-0.0153,-0.0321,0.0227,0.0207,-0.0392,-0.0066,0.0111,-0.0159,0.0157,0.0002,0.0243,0.0041,-0.0195,0.0131,0.002,0.0024,-0.0126,-0.0045,-0.0547,0.0094,-0.0075,0.0232,-0.0213,-0.0356,-0.0349,-0.0431,-0.0481,-0.0011,-0.0361,0.019,-0.0232,-0.0139,-0.0159,0.0124,0.0116,-0.0555,0.0306,-0.0026,0.0139,0.0199,-0.0131,0.0329,0.0033,-0.0585,-0.0096,0.0123,-0.0197,-0.0448,0.0056,0.0228,0.0103,0.0025,-0.0286,-0.0116,0.0058,-0.0138,0.0104,-0.002,0.0328,0.0149,-0.0064,0.0053,-0.0344,-0.0096,0.0164,-0.0014,0.0074,0.0336,0.032,-0.0214,-0.0125,-0.0108,-0.0179,0.0201,0.0356,0.0422,0.0177,0.0207,0.0005,-0.0012,-0.002,0.008,0.0233,-0.0154,0.0092,-0.018,-0.0015,0.0158,-0.0137,0.0179,0.0024,0.0278,0.0131,-0.0273,-0.0077,0.0193,0.027,0.0277,-0.0144,0.001,-0.0122,0.0144,0.0211,-0.0079,0.0063,-0.0469,0.001,-0.0467,0.0044,0.0052,-0.0239,0.0182,-0.0099,-0.0273,0.0105,0.005,0.0089,0.0338,0.0122,0.0075,0.0101,0.0027,0.0129,0.0103,0.0416,0.0148,0.0026,0.0071,0.0226,-0.0057,0.0233,0.0243,0.0455,-0.0052,-0.0083,0.024,-0.0092,-0.0245,-0.001,-0.0482,-0.0355,0.0263,0.0213,0.0187,0.0129,0.0183,-0.0253,0.0319,-0.0423,0.0125,0.0061,-0.0262,0.015,0.0105,-0.0232,0.0157,0.0158,-0.0034,0.021,0.0026,0.0182,0.0363,0.0166,0.0208,0.0061,-0.0033,-0.0136,-0.011,0.0013,-0.0688,-0.0929,-0.064,-0.0357,-0.0301,-0.0306,0.0282,0.0198,0.0177,0.0073,0.0003,-0.0439,-0.0073,-0.005,-0.0235,-0.0098,-0.0083,0.0,0.0077,-0.0038,-0.0088,0.0012,-0.0056,0.0083,-0.0103,-0.0031,0.0255,0.0391,-0.007,0.0046,0.0015,0.0187,0.006,-0.0018,0.0147,-0.06,-0.0439,-0.0429,0.0177,-0.0001,0.0164,0.0116,-0.0124,0.0245,-0.0333,-0.0191,-0.0315,0.0067,-0.0145,0.0103,-0.0022,-0.0035,-0.0508,0.0154,-0.0421,0.0213,-0.0109,-0.0517,-0.0089,-0.0048,0.012,-0.0135,-0.0079,0.0016,0.0264,-0.0342,-0.0123,0.0224,0.0017,-0.0138,-0.0351,0.0024,-0.027,0.0028,-0.0055,-0.0269,-0.0022,-0.0449,-0.0151,-0.0197,0.0213,-0.0031,0.0269,0.0159,0.0076,-0.0165,-0.0172,0.0209,0.016,0.0211,0.0089,0.0112,0.028,-0.0274,-0.0303,-0.0126,0.0239,0.0265,0.0252,0.0422,0.012,0.0025,0.011,-0.0213,0.0273,0.0191,-0.0563,-0.0569,-0.0229,0.0127,-0.0036,0.0117,-0.0014,-0.0128,-0.007,0.0172,-0.0084,0.008,0.0002,0.0068,0.0012,-0.0126,0.0002,0.0163,0.0034,-0.0005,-0.0042,-0.0447,-0.0162,0.0092,0.0271,-0.0257,-0.004,0.0034,-0.0151,-0.006,0.0008,0.0253,0.0114,0.0068,0.0166,-0.0318,-0.0275,-0.0175,0.0067,0.0043,0.0076,0.014,-0.0345,-0.0377,-0.0035,0.0088,0.0346,0.0405,0.0042,0.0327,-0.0028,0.0227,0.0304,0.016,0.0126,-0.0498,-0.0366,-0.0356,-0.0627,-0.0114,-0.0468,0.01,0.0135,0.0188,0.0093,0.0182,0.0125,0.0143,0.0372,0.0173,-0.0122,-0.007,0.0092,0.0131,0.006,0.0152,-0.0017,0.0073,-0.0244,0.0052,-0.0072,0.0314,0.0242,0.0357,-0.0026,-0.0192,0.0278,-0.0022,0.0353,0.0462,-0.012,0.0174,-0.0008,-0.001,0.0271,0.0046,0.0196,0.0104,-0.0191,-0.0021,0.0228,0.0251,0.0155,0.0249,0.0427,-0.0464,-0.0043,-0.0175,0.0161,0.015,0.0069,0.0102,0.0066,-0.0277,0.0198,-0.0202,0.0152,0.0345,0.0148,0.0007,-0.0058,-0.0401,-0.001,-0.0231,0.0559,-0.015,0.0141,0.006,0.0033,0.0065,0.0242,-0.0365,0.025,0.0183,-0.0517,0.0275,-0.0207,0.0203,-0.0358,-0.0421,0.0038,0.0089,0.0174,-0.0169,0.0168,0.011,0.0093,-0.0407,-0.0167,-0.0141,-0.0232,-0.0261,-0.0186,0.0248,0.041,0.0128,0.0207,-0.0262,0.0301,0.0303,-0.0004,0.0178,-0.0282,-0.0034,0.0099,0.0142,-0.0577,0.0081,0.0199,-0.0595,-0.0188,-0.0169,-0.0087,-0.0084,-0.0154,-0.0235,0.0253,0.0015,-0.0058,-0.0156,0.0197,-0.0273,0.0089,0.0031,0.0075,0.0003,-0.0146,-0.0061,-0.0003,0.0294,-0.0475,-0.0377,0.0324,0.0043,0.0251,-0.0045,0.0396,0.0261,0.0364,0.0424,0.0082,0.0014,0.0387,0.0204,0.019,0.0185,-0.0095,0.0269,0.032,0.0376,0.022,0.0129,0.0345,0.0287,0.0048,0.0073,-0.0116,-0.0094,0.017,0.038,-0.0187,-0.0079,0.0146,0.0093,-0.0034,0.0088,0.0098,0.0446,0.0307,0.0032,-0.0221,0.0169,0.0244,0.0281,-0.0176,0.0292,0.0293,0.0116,0.0087,0.0181,0.0032,-0.0366,-0.0112,0.0026,0.0095,0.0188,0.0029,-0.0182,0.0209,-0.0361,0.0261,0.0104,0.0163,0.0188,0.0086,-0.0219,-0.0179,-0.0454,-0.0028,0.0103,-0.0551,0.0044,0.0083,0.0127,0.0304,0.0347,0.0239,-0.0072,0.0058,0.0004,0.011,0.0257,0.0057,-0.0354,-0.0409,0.0062,-0.0166,-0.0427,0.0028,-0.0012,0.0097,0.0038,0.0062,0.0242,0.0022,0.0231,0.0143,0.02,0.0291,0.0069,-0.0355,-0.0059,0.0127,-0.0069,0.0123,0.02,-0.0151,0.0179,-0.013,0.028,-0.0142,-0.0101,0.0061,0.0054,0.0157,0.0063,-0.0061,0.0045,-0.009,0.0328,0.0138,-0.0003,-0.0291,-0.0272,0.0151,-0.0314,-0.0303,0.0129,-0.0088,0.0134,-0.0093,0.0197,0.0096,-0.0047,0.0155,-0.0087,-0.0012,-0.0297,0.0016,-0.0102,0.004,0.0078,-0.0138,-0.0128,0.0004,-0.0247,0.0146,0.0347,-0.0094,0.013,0.0084,0.0017,-0.0938,-0.0583,0.0159,0.0166,-0.0436,0.0418,-0.0154,-0.0141,-0.0006,0.0146,-0.0226,-0.0312,0.0005,0.0091,0.0099,0.0136,-0.0123,-0.0054,0.012,-0.0008,0.0317,-0.0262,0.0243,-0.0163,-0.0292,-0.0025,0.0184,0.0169,-0.0428,0.0079,-0.0429,0.0066,0.0087,0.0022,-0.0011,-0.003,0.0316,0.0363,0.0323,0.0155,-0.0166,0.0355,-0.001,0.0182,0.0031,-0.0125,-0.0016,-0.0059,0.0002,-0.0446,0.0154,-0.0085,-0.0808,-0.0549,-0.0145,-0.0494,-0.0831,-0.0392,-0.037,-0.0201,-0.0288,-0.0512,-0.0235,-0.0169,-0.0698,-0.0371,-0.0234,0.0015,-0.0527,-0.0234,-0.0131,-0.037,0.014,0.0119,0.0216,-0.0083,0.0167,0.011,0.0235,0.0194,0.0269,-0.0312,-0.0461,0.0403,0.0294,0.0209,0.0077,0.029,0.0043,0.0014,-0.0006,0.0176,0.0074,0.0083,0.0298,0.0194,-0.0054,0.0146,-0.0155,0.0226,0.0357,-0.0227,0.0189,0.0074,0.0025,0.0016,0.0194,0.0288,0.0309,0.0094,0.0231,0.0041,0.0057,-0.0063,0.0164,0.0167,0.0293,0.0288,-0.0171,0.0277,0.0123,0.003,-0.0072,-0.0022,0.0037,-0.0447,-0.0067,-0.0096,-0.0302,-0.0147,-0.0023,0.0146,numerical comparison
trm_559f0a5b4cd36,-0.1062,-0.1271,-0.1318,-0.1211,0.0112,-0.0502,-0.1111,-0.0682,-0.0592,-0.1045,-0.0034,-0.0033,-0.1315,-0.0906,-0.1389,-0.0769,-0.0887,-0.1035,-0.0731,-0.0369,-0.0737,0.0304,-0.0579,0.034,-0.0187,0.0245,0.0199,-0.1238,-0.1709,-0.088,-0.1231,-0.1179,-0.158,-0.0874,-0.1781,-0.1249,-0.0753,-0.0866,-0.1593,-0.0181,-0.1303,-0.1422,-0.0722,0.0971,-0.0957,-0.0828,0.1845,-0.079,0.0623,-0.1009,-0.0522,0.1004,0.0953,0.0758,-0.0099,-0.0803,-0.1271,-0.0525,0.0058,-0.0542,0.0108,0.0465,-0.1667,0.1176,0.049,0.0781,-0.2173,-0.2552,-0.1329,-0.0181,0.0726,0.0217,0.2113,-0.1131,-0.1504,0.0908,-0.1589,0.0593,0.0613,-0.0639,-0.0051,0.1079,-0.0622,-0.1649,0.083,0.0707,0.0026,-0.004,0.0008,-0.2372,-0.1089,-0.0439,-0.0241,0.1876,0.1735,0.1618,0.1611,0.0259,0.2702,0.1,0.0908,0.0445,0.1288,0.0634,0.1199,-0.1779,-0.1899,0.1578,-0.0294,-0.0581,0.0153,-0.1264,0.1269,0.2,0.0588,0.0208,-0.0927,0.0417,-0.0279,-0.0933,-0.0948,-0.1856,-0.1339,-0.0141,-0.0901,-0.1465,-0.0645,0.0659,0.0939,0.0268,-0.1133,-0.0966,-0.0479,-0.3127,0.0103,-0.2031,0.001,-0.1583,-0.0464,-0.0556,-0.1148,-0.13,0.039,0.0065,-0.0219,0.0907,-0.083,0.0503,-0.1071,0.0985,-0.0906,-0.0957,-0.185,-0.172,0.1855,-0.0032,0.0712,0.0388,0.0325,-0.0652,-0.0658,-0.0959,-0.232,-0.2491,-0.0377,-0.0112,-0.0306,-0.2038,-0.1896,0.0206,-0.0689,-0.1225,0.0605,-0.2733,-0.1792,-0.2399,-0.1744,-0.1439,-0.0958,-0.0342,-0.1969,0.0602,-0.06,0.0237,-0.0727,-0.0722,-0.1116,-0.1097,-0.0911,-0.0194,-0.0082,-0.0675,-0.0235,-0.1867,-0.1702,-0.2716,-0.2334,-0.0383,-0.0003,-0.1559,-0.0549,0.2456,-0.1752,-0.1726,0.0943,-0.1173,-0.1668,-0.0275,-0.0825,0.0035,-0.2166,-0.1007,0.002,0.0187,0.066,0.034,0.1026,-0.1737,-0.1639,0.0568,0.1022,-0.1315,-0.1821,-0.0724,0.0904,0.0099,-0.0509,0.1434,-0.0334,0.2605,-0.0888,-0.201,0.1892,-0.1628,-0.1551,0.0954,-0.0564,0.0985,0.0454,-0.0937,0.0046,-0.2247,-0.078,0.0115,-0.0804,-0.0987,-0.0925,-0.1361,-0.0778,-0.0915,0.0453,0.0178,0.0025,0.0627,0.0324,-0.2032,0.0071,-0.082,0.1372,0.2918,0.0902,0.3188,-0.1102,0.1413,0.2275,0.3755,0.1624,-0.02,0.0054,-0.0302,-0.0692,-0.0239,-0.1582,0.0086,-0.0896,0.0192,-0.1283,-0.2075,-0.1599,0.01,0.0561,-0.09,-0.0618,-0.2246,-0.1708,-0.1017,0.0511,0.0601,-0.1538,-0.1395,-0.1238,-0.1321,-0.0275,-0.0799,-0.1215,0.0139,-0.0082,0.156,-0.0329,0.199,0.1395,-0.1701,-0.1456,-0.1117,-0.0505,-0.0323,-0.1499,-0.0253,-0.0477,0.0015,0.0051,-0.0156,-0.1293,0.0997,0.0833,-0.0665,0.1803,0.0214,0.0851,-0.1449,-0.0077,0.0491,-0.1464,-0.1559,-0.1315,-0.052,-0.0,-0.0741,-0.0978,-0.1349,0.0523,-0.1012,-0.0045,0.0173,0.0572,0.1424,0.1057,0.0325,-0.0222,-0.1441,-0.1219,0.0433,0.0163,-0.0227,0.0955,0.0514,-0.3096,-0.2266,-0.2082,-0.1439,-0.1415,0.0272,-0.1167,-0.0561,-0.0948,-0.1015,-0.0563,-0.148,-0.1528,-0.1384,0.0097,-0.0322,0.0504,0.0077,-0.0008,0.0768,-0.1472,0.2957,0.0303,-0.1702,0.0311,0.1143,-0.0057,0.1306,-0.1658,-0.0333,-0.0969,0.1237,0.151,0.1503,0.2058,0.0353,-0.0664,0.0747,0.0314,0.0735,-0.1089,-0.0477,0.0496,-0.0433,-0.0597,-0.0246,-0.0543,-0.0322,0.1551,0.0647,-0.1002,-0.2148,-0.1084,-0.0632,-0.0737,0.0436,0.0059,-0.0473,0.0702,0.0984,0.096,0.0139,-0.1362,-0.0499,-0.0051,-0.2111,-0.0255,0.2725,-0.1406,-0.0133,0.3006,0.0131,-0.0907,-0.0241,0.0181,-0.2723,-0.1758,-0.3841,-0.3491,-0.144,-0.1916,-0.1074,-0.173,-0.1215,-0.032,0.0749,-0.0267,-0.025,-0.0148,0.0937,-0.0122,0.0186,-0.3025,-0.1778,0.0214,0.0476,0.0113,0.0597,-0.0434,-0.1081,0.0317,0.1198,-0.111,0.0277,0.0947,0.1042,-0.1282,-0.0447,0.0457,-0.1542,0.0276,-0.0533,-0.0086,0.0209,0.0833,-0.0659,-0.0685,0.0647,-0.1425,-0.1159,0.0426,0.4302,-0.1504,-0.0701,0.0222,0.0277,0.1243,-0.0542,-0.1166,-0.0512,0.0383,0.0455,-0.0459,-0.0452,0.0717,0.0441,-0.0088,0.079,0.1637,0.1698,-0.0217,0.0036,-0.0881,-0.0413,0.06,0.145,-0.1064,-0.1596,0.1362,0.0392,-0.0795,-0.0221,0.0649,-0.0951,-0.0809,0.0403,-0.0571,-0.1231,-0.1121,-0.1466,0.0578,0.0289,-0.0424,0.1355,-0.1814,0.0193,-0.0008,0.0093,0.1113,0.0963,-0.1353,-0.1181,0.1207,-0.1098,-0.0894,-0.0587,0.0998,0.1605,0.2164,0.0405,0.1948,0.1302,0.0481,0.0684,-0.0968,-0.0373,-0.1146,-0.2682,-0.1121,-0.0012,-0.1695,-0.1033,-0.042,-0.158,-0.0494,0.0289,0.0126,-0.0473,-0.1043,-0.0489,0.0364,0.039,0.0121,-0.0238,0.0865,-0.0119,-0.0197,-0.0223,-0.0281,-0.1719,0.1263,0.0565,0.0803,-0.0545,-0.0592,0.0253,-0.0866,0.0477,-0.087,0.0479,0.1101,-0.0286,0.0137,-0.0567,-0.0771,0.0081,-0.1267,0.0226,-0.0361,-0.0454,0.043,0.0329,0.108,0.1175,0.0172,-0.1068,-0.0073,-0.0525,0.1765,0.0711,0.0737,0.0609,0.0806,-0.0455,-0.1287,0.0466,0.1551,0.1357,-0.0235,-0.0238,-0.2393,-0.0731,0.1961,-0.0525,0.0203,0.0881,0.0691,0.0554,0.0735,0.0215,-0.0378,-0.1772,-0.1702,0.1312,-0.1912,-0.0639,0.093,-0.0829,-0.3055,-0.0565,-0.0772,0.0507,0.0246,-0.2423,-0.0791,-0.228,0.0446,0.0198,-0.0553,0.0387,-0.121,-0.1853,-0.1062,0.0543,0.0884,0.0733,-0.0981,-0.0007,0.0643,0.04,0.0882,-0.0553,-0.0706,-0.0433,-0.1233,0.0817,-0.0063,-0.0844,-0.1011,-0.0369,-0.2563,-0.1899,0.1484,-0.2099,0.0711,-0.1842,0.2054,-0.1209,-0.0492,-0.0696,0.0314,-0.1022,-0.0617,-0.0925,-0.2033,0.0161,0.188,-0.0559,0.0486,0.1385,-0.1393,-0.1322,-0.055,0.0008,-0.0766,-0.1043,-0.0919,-0.0615,-0.0494,-0.1043,0.2055,-0.1073,0.0287,-0.0399,0.0761,0.0517,0.0991,0.0531,0.1681,-0.1695,-0.1161,0.0401,0.0284,0.0022,0.1287,0.2108,0.1857,0.1186,0.1837,-0.0341,0.0465,-0.0783,-0.1073,-0.002,0.0661,0.0416,-0.0151,-0.1307,-0.0927,-0.0799,-0.1501,-0.1413,-0.1233,0.0757,0.1379,0.0655,-0.0227,0.0914,0.0492,0.0006,-0.0129,0.0299,-0.1342,0.0423,0.1082,-0.0827,-0.3066,-0.304,-0.2213,-0.0028,-0.0199,-0.1159,0.0401,-0.0695,0.0257,-0.0379,-0.0686,0.135,0.1272,-0.007,-0.1757,0.1466,0.1534,0.329,-0.179,-0.0393,-0.1021,-0.0369,0.0391,-0.1304,0.1427,0.0453,-0.0405,0.0225,-0.0153,0.0525,-0.2006,-0.2875,-0.2411,-0.174,0.0695,0.2208,0.0271,-0.1502,-0.0258,0.036,0.0872,0.0756,0.067,0.0186,-0.0877,-0.1094,-0.0614,0.1401,0.0979,0.1653,-0.0702,-0.0299,0.0314,-0.0955,0.0781,-0.0825,-0.1457,0.0061,-0.1771,-0.1802,-0.1029,0.0667,0.1066,0.0287,-0.0284,-0.0466,0.0237,0.1791,-0.023,-0.1322,0.0664,0.0073,0.0274,0.0124,0.1394,-0.0774,0.1753,-0.1928,-0.2005,0.1333,0.1346,0.1833,-0.0231,-0.0504,0.0701,-0.0001,0.0165,0.2308,0.0178,0.0844,0.1019,0.1628,0.0374,0.0067,0.1918,0.1997,-0.1602,0.0189,0.0792,-0.2236,-0.1635,-0.0466,-0.1477,-0.0449,-0.2662,-0.0809,-0.182,-0.1203,-0.2427,0.0175,-0.0202,0.0617,-0.0777,-0.0322,0.0446,0.0579,0.1423,0.0605,0.1046,0.1768,0.0291,0.0748,0.0479,-0.0005,0.1555,0.1715,-0.1268,0.1804,0.0751,-0.0403,-0.0655,-0.1184,-0.0578,0.1387,0.0692,-0.3147,-0.1675,-0.0604,0.0995,0.2189,0.085,0.0586,0.0287,0.0007,-0.0426,-0.0982,0.1272,-0.0677,0.0601,-0.2111,0.0703,-0.0781,0.1617,0.1785,0.0584,0.1718,-0.2269,-0.21,-0.0955,0.2516,-0.0803,-0.1042,-0.1155,0.0949,-0.0009,-0.1778,-0.0573,-0.1578,0.0909,-0.0927,-0.0136,0.0809,0.0048,0.1157,-0.1966,-0.11,-0.0664,0.1086,-0.145,0.0436,0.1188,0.0871,0.1338,0.3602,0.1504,-0.1193,-0.0791,-0.12,-0.0626,-0.127,-0.0524,0.0357,0.1624,0.0905,-0.0021,-0.1326,0.134,0.2434,0.0955,-0.003,-0.0265,-0.0419,-0.2052,-0.083,-0.0766,-0.0022,0.0599,-0.1516,-0.0567,0.1257,0.0127,-0.1095,-0.0291,0.0966,-0.069,-0.0387,-0.0856,-0.1509,-0.1482,-0.3099,-0.1726,-0.3178,-0.0187,-0.0372,-0.1108,-0.1599,-0.138,-0.2085,-0.1375,-0.2652,-0.1527,-0.15,0.0163,0.0754,0.1359,-0.0445,0.0458,-0.0103,0.0605,0.1016,0.1462,0.1935,0.1263,-0.0588,-0.0159,0.0211,-0.0012,0.1398,0.1282,0.1427,-0.0257,0.1429,-0.0618,0.1103,-0.0608,-0.0618,-0.0402,0.0964,-0.0511,0.0964,-0.1833,-0.0638,-0.0441,-0.044,-0.0189,0.0179,0.1241,0.0581,0.0987,0.1542,0.1096,0.0502,0.0467,-0.0183,-0.0054,0.0514,0.0077,-0.0254,-0.0739,-0.1329,-0.0686,0.1192,0.1012,-0.1542,-0.1036,-0.086,-0.2348,-0.1204,0.2123,0.0979,0.1786,0.0958,0.065,-0.087,-0.0131,0.0803,-0.0041,-0.0481,-0.0292,0.0313,-0.0806,-0.1064,-0.0049,0.0955,-0.1071,-0.019,-0.1079,0.0713,-0.1669,0.0557,0.1037,0.197,0.1628,0.1227,0.0648,0.057,-0.0174,-0.0183,-0.0564,-0.0937,0.0059,0.0052,0.0802,-0.0117,-0.043,0.0412,-0.0187,-0.0807,-0.0406,-0.1732,-0.2222,-0.1919,-0.14,0.2138,0.0161,0.0807,-0.1684,0.2171,0.1263,-0.0094,-0.0385,0.0246,0.0654,-0.0194,0.0981,-0.1332,-0.1207,-0.0429,-0.033,-0.1473,-0.0421,-0.1111,-0.0324,-0.069,-0.062,-0.0895,-0.0715,0.0025,-0.0625,0.0034,0.0097,0.0546,-0.122,0.0116,-0.1083,0.0751,-0.0495,-0.0833,0.4089,0.3017,0.3414,0.2339,0.2521,0.0749,0.3196,0.191,-0.1716,0.2001,0.207,0.1263,0.1071,0.1297,-0.0863,-0.017,-0.0762,-0.0018,0.0339,0.0275,0.0487,0.0439,-0.1386,0.0302,0.0453,0.0178,0.0903,-0.0277,-0.0911,0.1156,0.0693,-0.0793,-0.0028,-0.0728,0.0823,0.022,0.1791,-0.0168,-0.1847,-0.1799,-0.1054,-0.0425,0.1313,0.1105,-0.0866,-0.1139,-0.2759,-0.196,-0.1063,0.2151,-0.0839,0.2727,0.2366,-0.0724,0.0037,-0.0505,0.0521,0.1218,0.0559,0.2187,0.1047,0.0456,0.1026,0.0689,-0.1222,-0.1682,0.1107,-0.0877,0.057,-0.006,-0.0996,-0.0317,-0.1524,-0.0822,-0.0412,-0.0826,-0.2091,-0.0263,0.1874,-0.0439,0.0068,-0.0009,0.17,0.0329,0.0289,-0.1804,-0.1852,-0.0717,-0.0667,-0.0826,-0.1617,-0.0467,-0.0546,-0.0176,0.2308,0.1007,0.098,0.273,0.0117,0.0522,-0.0091,0.159,0.0017,0.2533,-0.0845,0.2477,0.3605,0.0708,-0.1161,0.3059,0.2571,-0.0172,-0.1792,0.0336,-0.1909,-0.0747,-0.2738,-0.0545,0.0895,-0.0609,-0.0851,0.0401,-0.078,-0.0139,-0.0963,-0.0724,-0.0535,-0.078,0.0261,0.1113,-0.0356,0.339,0.195,0.267,0.2932,-0.1215,-0.0353,-0.0942,-0.1177,-0.0783,-0.0523,-0.0342,0.1636,-0.1566,-0.0956,0.1222,0.0165,-0.0067,0.1043,0.1014,-0.0038,-0.0114,0.1475,-0.0555,-0.0891,0.0172,0.1146,0.0408,0.0075,-0.0306,-0.0306,-0.193,0.0878,0.0166,0.052,-0.0434,0.0935,-0.0483,0.2378,-0.3078,-0.2762,0.1101,-0.0701,-0.2442,-0.2429,-0.2043,-0.0386,-0.0834,-0.0543,-0.0026,-0.0274,0.1684,-0.0064,0.1074,-0.0924,0.1273,-0.0054,0.0869,0.0539,-0.0747,-0.0653,-0.0027,-0.0647,-0.0245,-0.0314,-0.0669,0.0622,0.0134,0.0687,0.0199,0.1228,0.0301,0.1254,-0.1789,-0.1036,0.0498,-0.1583,-0.0155,-0.1966,-0.3167,-0.0265,-0.1007,-0.2219,-0.0121,-0.0915,-0.2112,-0.0207,-0.1015,0.0394,-0.2247,-0.0721,-0.1207,-0.2238,-0.0713,0.0857,-0.0856,0.2585,0.142,0.1112,0.1652,-0.0558,0.0606,-0.083,-0.2126,-0.209,0.0285,-0.1025,-0.0239,-0.0854,-0.0416,0.0602,0.0728,0.0173,-0.1627,-0.1002,-0.0131,0.025,-0.0358,-0.0364,-0.0402,0.0829,-0.077,-0.1345,-0.0786,-0.1843,-0.1166,-0.0686,-0.1651,-0.1825,0.0216,0.0219,-0.0398,0.0157,0.0157,-0.1429,-0.1069,0.0583,-0.2099,0.0375,0.0048,-0.0111,-0.1633,-0.1559,0.013,0.1549,-0.0162,-0.0019,0.0154,-0.0521,0.1957,0.0994,0.0209,-0.0039,-0.2187,0.0648,-0.0033,0.0806,0.1291,0.0952,0.017,-0.1023,-0.0088,0.173,-0.0971,0.0181,-0.1223,-0.0167,-0.1146,-0.1017,0.0041,0.1494,-0.0384,-0.0734,-0.1372,-0.0107,-0.0172,0.0004,-0.0595,-0.1783,-0.0076,-0.0056,-0.0969,0.081,-0.0734,-0.054,-0.0627,-0.0718,-0.0922,-0.0784,-0.0575,-0.0467,0.0097,-0.0325,0.1077,-0.0536,-0.0168,-0.0248,0.0366,0.0027,-0.0344,-0.1868,0.0575,-0.1162,-0.0183,0.0119,0.0492,0.0875,0.0572,0.0682,-0.0995,-0.0582,-0.1173,-0.062,-0.2549,-0.0027,-0.2332,-0.037,-0.0796,-0.0944,-0.0441,-0.1154,-0.101,0.2266,0.1311,0.0154,0.2751,0.1341,0.1065,0.0711,0.2038,-0.0176,-0.0678,0.0261,0.2767,0.0147,0.0446,-0.0417,-0.118,-0.0636,-0.0866,0.0378,0.0164,-0.0287,0.0545,0.0992,-0.0688,-0.0732,-0.051,0.0761,0.147,0.1019,-0.3295,-0.1542,-0.0647,-0.2696,-0.2194,0.0425,0.1301,0.0354,0.0426,0.0076,0.0153,-0.1926,-0.0267,-0.0479,-0.1137,-0.28,-0.0687,-0.0211,-0.1362,-0.0919,0.1416,-0.0485,-0.0602,-0.0578,0.0157,0.1148,0.2722,-0.0554,0.0829,0.0051,-0.0299,-0.1365,-0.0662,0.0337,0.0154,-0.0164,0.1796,0.1319,0.0728,-0.0652,-0.1222,0.0526,0.4704,0.4681,-0.1946,-0.1449,0.0747,-0.0925,-0.0926,-0.0455,-0.2162,0.0636,-0.0283,-0.094,0.0083,0.0269,0.2529,-0.0338,0.1975,0.046,0.0081,0.1246,0.4266,-0.111,-0.0593,0.3064,0.0249,0.0863,0.0754,0.0652,-0.0669,0.2025,0.1535,-0.0193,-0.0798,0.0282,0.0185,0.1555,0.1324,0.0015,-0.0303,-0.0463,0.1303,-0.1447,0.0387,0.1801,-0.0697,-0.0027,0.0129,0.0082,-0.1607,-0.0358,0.0596,-0.0711,0.0832,-0.1072,0.0961,0.1574,-0.0341,-0.03,0.0397,0.0141,0.0124,0.1515,0.1116,0.1343,0.0351,0.2011,0.0968,0.0699,0.4042,-0.1523,-0.1264,0.1289,-0.165,0.0544,0.0843,0.1341,-0.0838,0.0013,0.0124,-0.0245,0.0369,0.0598,-0.0211,-0.0018,0.0264,0.0785,0.0628,0.1099,0.323,0.3005,-0.0976,-0.1898,-0.1234,-0.0178,0.1178,0.0516,-0.0118,0.0365,0.0676,0.0195,0.1009,-0.0979,-0.329,-0.1133,-0.0217,0.132,-0.0147,0.0273,0.0383,0.2863,0.225,0.0471,-0.0233,-0.0917,0.015,0.0561,0.1376,-0.1525,-0.1953,-0.2357,0.0351,0.0011,0.043,0.2999,-0.0713,-0.0492,0.0629,0.1937,0.1166,0.2256,-0.0591,-0.0266,-0.0319,0.0186,0.1348,0.1962,0.2352,-0.0351,0.0605,0.0764,0.0683,-0.1094,0.1161,-0.2759,-0.0711,-0.0303,-0.1229,-0.0154,0.064,-0.045,-0.0783,-0.0716,-0.0219,-0.0201,-0.0237,-0.1064,-0.0669,-0.0187,-0.0244,-0.0781,0.099,0.2271,0.1681,0.269,-0.2307,-0.1385,-0.1885,-0.0621,0.0949,-0.0553,-0.1571,-0.1098,-0.1686,-0.0438,0.1561,0.0571,0.2062,0.1,0.0304,0.0305,-0.0352,0.0219,0.0135,0.0013,-0.2344,-0.0059,-0.1228,-0.0259,-0.114,-0.0001,0.0994,0.3026,0.1945,0.1471,0.1033,-0.1398,-0.3166,-0.1794,-0.2495,-0.1771,0.0358,-0.0525,0.0348,-0.1231,-0.2004,-0.1711,-0.0918,0.0346,0.0117,-0.0572,-0.0809,-0.0292,-0.06,-0.2248,-0.1455,-0.1122,0.0943,0.034,-0.0331,-0.2853,-0.0486,-0.1325,-0.1736,-0.3945,0.0453,-0.0139,-0.117,-0.0938,-0.0509,-0.0226,-0.0316,-0.1459,-0.1153,-0.1211,0.2347,0.0877,0.196,0.0558,0.136,-0.0577,0.095,0.1439,0.282,-0.1069,-0.0406,-0.0046,0.1749,-0.183,-0.2342,-0.1786,-0.0912,-0.0848,-0.1548,-0.1093,-0.0861,-0.1097,-0.0247,0.0068,0.0157,-0.2811,0.0179,-0.0209,-0.1045,-0.119,-0.0963,-0.0054,-0.193,0.0823,0.0363,0.1945,-0.0371,-0.0572,-0.2652,-0.1195,-0.1467,-0.1174,-0.2506,-0.1801,0.0331,0.0669,0.053,-0.0368,-0.0798,0.0325,0.1738,0.2252,0.203,-0.2898,-0.3119,-0.0197,0.0818,-0.0035,-0.1072,0.0465,-0.1038,-0.002,-0.0422,-0.0896,-0.1477,-0.0319,-0.1171,-0.1023,0.0151,-0.1195,0.0191,-0.0187,0.0583,0.1329,0.115,-0.1039,-0.1758,-0.2265,-0.161,-0.1243,-0.2834,-0.1498,0.2713,-0.0714,-0.1275,0.0488,0.0294,-0.0911,0.0453,-0.0266,0.0005,0.1814,-0.0275,0.083,0.0327,-0.077,-0.0126,-0.0079,0.1187,0.2267,-0.2483,0.0111,0.0476,0.298,-0.0508,-0.0313,0.0453,-0.0491,0.0344,0.0478,0.0658,-0.0359,-0.0238,-0.1868,-0.1613,-0.1898,-0.0066,-0.0825,0.111,0.1938,0.2417,-0.009,-0.0044,0.0999,0.2144,0.0824,0.0655,0.0378,0.039,0.0338,-0.3482,-0.1609,-0.1793,-0.1781,-0.1053,-0.1741,-0.1809,-0.1268,-0.0173,-0.0731,-0.2563,-0.1544,0.0388,-0.0985,-0.3251,0.0839,-0.0852,-0.0115,0.0562,-0.0985,0.0115,-0.1868,-0.1051,0.0029,-0.1115,-0.049,0.0593,-0.1512,0.0585,0.0947,0.1013,-0.0182,-0.147,0.0758,-0.0352,-0.1978,-0.0403,-0.112,-0.1086,0.1277,0.0297,-0.0007,-0.1939,-0.1169,-0.0365,0.0133,-0.0696,-0.1014,-0.1509,-0.0774,0.0047,-0.0816,0.0921,-0.1441,-0.0625,0.0742,0.065,0.0464,0.0541,0.0308,-0.2443,0.0152,-0.0853,-0.1625,0.2161,0.3285,0.2888,-0.0551,0.4357,0.2263,-0.1893,-0.1174,0.3987,0.1536,0.077,0.1117,0.113,0.0811,-0.1039,-0.0957,-0.0855,-0.0989,0.4979,0.3974,0.2936,0.0822,0.2216,0.2154,0.433,0.4166,0.3633,-0.012,-0.0157,-0.0503,-0.0248,-0.0512,-0.0015,-0.2058,-0.1024,0.0164,-0.0124,-0.0953,-0.0819,0.1237,-0.0243,0.0213,-0.1008,0.0679,0.2148,0.2987,-0.0431,-0.0436,-0.1235,-0.0061,0.0034,-0.0399,-0.0369,-0.102,-0.0353,-0.0379,-0.1738,-0.2777,-0.2547,0.0414,-0.0737,-0.0184,0.2078,0.0651,0.2323,0.0688,0.1359,0.3168,-0.0435,-0.2004,-0.2025,-0.0455,0.1094,-0.076,0.1904,0.0996,0.18,0.0631,-0.2103,-0.2078,-0.1475,-0.1298,0.0766,-0.3242,-0.2148,0.063,-0.0538,0.1837,-0.0306,-0.0053,0.1248,0.0245,-0.0349,0.0373,-0.0785,-0.1808,-0.2284,0.029,0.0128,-0.0835,0.0178,-0.0562,0.0733,0.3651,0.3155,0.1442,0.2598,-0.0945,0.0558,0.1155,0.1932,0.2475,0.3331,0.0672,0.0849,0.0074,0.1867,0.1792,-0.0094,-0.0155,-0.0493,-0.0436,-0.1,0.0062,-0.041,0.0035,0.018,0.0224,0.0677,0.0065,0.1394,-0.1111,0.0926,0.0819,-0.1326,-0.1979,-0.0954,-0.137,-0.1831,0.1155,-0.0571,-0.111,-0.058,0.2012,0.0145,-0.2489,-0.0577,-0.0298,-0.1512,0.0116,-0.0426,0.0433,0.1176,0.0965,0.3898,0.2541,0.2452,-0.0065,0.0547,0.1321,-0.1521,-0.17,-0.0295,0.0207,-0.0618,-0.0211,-0.0422,-0.1118,-0.1211,-0.1929,-0.2402,-0.1966,-0.098,-0.053,-0.1438,-0.0012,-0.0935,-0.0152,-0.0105,-0.0854,-0.1062,-0.0774,0.2466,0.0046,-0.0389,-0.1441,0.1072,-0.0202,-0.1268,0.109,-0.2119,-0.1109,0.2074,-0.1551,-0.1591,-0.0499,0.0248,-0.0023,0.0442,-0.0677,-0.0725,-0.0398,0.0176,0.0246,-0.2348,0.0601,-0.0072,0.1416,0.0227,-0.2485,-0.1018,0.0055,-0.0625,-0.0667,-0.0417,-0.1605,-0.0319,0.025,-0.0199,0.0724,-0.3761,-0.1549,-0.1701,-0.296,-0.2145,-0.1633,-0.1412,-0.1412,-0.0743,-0.0524,0.09,-0.2491,-0.0665,-0.1432,-0.1378,-0.0196,-0.0625,-0.3525,0.1734,-0.255,0.077,0.0269,0.2797,-0.0183,-0.0202,-0.1763,-0.0844,-0.0237,0.0236,-0.0456,0.2123,0.0217,0.0882,0.2507,0.2133,-0.0037,0.0432,0.0114,-0.0182,-0.0176,-0.1001,-0.115,-0.0787,-0.1209,-0.0272,-0.0027,0.0118,0.0673,-0.0318,-0.0431,0.0829,0.0923,-0.0752,0.1302,-0.0184,-0.0877,0.0094,-0.1438,0.0149,-0.039,0.1412,-0.0963,0.1342,0.1217,0.0005,0.1721,0.1681,-0.0431,0.1561,0.0265,0.3189,0.1259,-0.0113,0.1432,-0.1721,0.0642,0.1375,0.0838,-0.0336,-0.0462,0.0522,-0.027,0.0132,-0.1532,-0.1988,-0.1118,-0.1394,-0.0312,-0.0599,-0.1934,0.2899,-0.0002,0.0555,0.078,-0.0162,-0.0106,0.0336,-0.0615,-0.149,-0.0527,0.109,0.1592,-0.0002,0.0536,-0.1208,0.0247,0.125,0.0976,0.1794,0.0689,0.0232,-0.0902,0.0647,-0.1233,-0.0455,0.0198,-0.0157,-0.0415,-0.0951,-0.0899,-0.116,-0.0304,0.0613,-0.1212,0.082,-0.0247,0.0615,0.0685,0.1061,0.1279,0.0782,-0.0727,-0.0763,-0.0948,-0.0523,0.0555,0.0661,-0.0614,-0.0614,-0.0202,0.0815,-0.0987,-0.1591,-0.1235,-0.1844,-0.156,-0.0482,-0.0499,0.0189,-0.1228,-0.1339,-0.1486,-0.0502,-0.106,0.0136,0.0596,-0.1028,0.1675,-0.153,-0.1395,-0.0684,0.0721,-0.0908,-0.0637,0.1186,0.0612,-0.2265,0.0343,-0.0054,-0.0677,0.0518,0.0768,0.0136,0.0842,-0.086,-0.2048,-0.0838,-0.2104,-0.266,0.0193,-0.1328,0.0644,0.0747,0.1588,0.1608,0.1545,-0.1571,-0.1979,0.0582,0.2226,0.2956,0.0317,-0.0867,0.0007,0.0185,-0.0832,0.08,-0.0796,-0.1597,-0.0509,-0.0283,-0.1029,-0.1693,0.1705,0.0413,0.0362,0.1527,-0.0093,0.0453,-0.0703,-0.0641,-0.0661,0.0052,-0.1045,0.0112,0.1326,0.0789,-0.0167,-0.0826,-0.0571,-0.1347,-0.0319,-0.0261,-0.2596,-0.0633,-0.0419,-0.0155,-0.0346,0.0499,0.0283,0.0512,-0.0704,0.0989,-0.2275,-0.1462,-0.1711,-0.1812,0.0073,-0.1702,-0.1485,-0.32,-0.1432,-0.1007,0.2009,-0.1811,-0.0478,-0.0582,0.0591,0.1547,0.1305,-0.1132,-0.1763,-0.0755,-0.0537,0.027,0.1382,-0.0775,-0.0776,-0.0767,0.1085,0.079,0.094,0.1911,-0.0116,-0.0307,0.1078,-0.0272,0.0672,0.0563,-0.0013,-0.0987,-0.0186,0.0256,0.1238,0.0149,0.1262,0.1358,0.0053,0.0235,-0.0181,-0.198,-0.1286,-0.0388,0.1452,0.2819,0.0929,-0.0152,-0.006,0.0181,0.3405,0.2115,0.1714,0.2121,-0.229,-0.0202,-0.048,0.0524,-0.0847,0.1085,-0.0177,-0.015,0.0334,0.0417,0.0714,-0.0735,0.0731,0.0773,-0.1619,0.2392,0.1202,0.0303,0.0434,0.0459,0.0533,-0.0145,-0.0333,-0.0062,0.0196,0.1356,0.219,0.2443,-0.1271,0.0303,0.0027,-0.0809,-0.1754,-0.3846,-0.3595,0.0244,0.0774,0.1024,-0.0682,0.0531,0.0979,-0.0471,-0.0688,-0.1151,0.064,-0.0689,-0.0165,0.0053,0.0786,-0.0188,-0.1813,-0.0518,-0.1792,-0.1164,-0.0036,-0.1311,0.0196,-0.2067,-0.0967,-0.0448,-0.0515,0.0243,0.1483,0.0173,-0.0868,-0.1255,0.2644,-0.1143,0.1486,0.1822,0.1622,-0.0133,0.0382,-0.1574,0.2585,0.234,-0.2069,-0.1241,-0.0611,-0.0301,-0.1156,-0.1347,-0.2177,-0.2548,-0.1067,-0.0141,-0.0843,0.0609,-0.0279,-0.0458,-0.1327,-0.2145,0.0996,0.0642,-0.1595,-0.1039,0.0003,-0.1161,-0.2296,0.1068,0.1883,-0.1348,0.0604,0.1488,0.1148,-0.2147,-0.2288,-0.1695,-0.2525,-0.0975,-0.0926,0.0045,0.0972,0.0401,0.1383,0.0016,0.2322,0.3237,0.238,0.1417,0.2605,-0.3289,-0.2539,-0.1698,0.0628,-0.0065,-0.0323,-0.0885,0.0221,0.0972,-0.1871,-0.1928,-0.0528,0.1814,-0.1663,-0.078,-0.0832,-0.0181,0.0904,0.1228,-0.0298,-0.0522,-0.0093,-0.0721,0.0348,0.16,0.1475,0.0658,0.0098,0.1036,0.1506,0.114,0.1098,-0.005,-0.1231,0.0096,-0.0362,0.0141,-0.0216,0.0253,0.1747,0.0809,0.0437,0.0522,-0.0199,-0.0159,-0.2211,-0.1832,-0.133,-0.1513,0.4001,0.0027,0.2484,0.1802,0.1189,0.0015,0.001,0.1707,-0.0515,0.281,0.2039,0.0641,0.1481,0.0767,0.0236,-0.0927,-0.0767,-0.1536,0.0543,0.2266,0.138,-0.1298,-0.0378,-0.0035,-0.0209,0.014,-0.0474,-0.107,-0.1269,-0.0123,-0.2223,0.0058,-0.096,0.1094,0.0968,0.1157,0.088,-0.0427,-0.0307,-0.0528,-0.0675,0.0938,0.1877,-0.0601,0.029,-0.067,0.0556,-0.0411,-0.0862,-0.0055,0.144,0.1076,-0.0195,-0.1976,-0.1071,-0.1591,-0.1229,0.037,0.089,-0.0799,-0.0189,-0.1037,-0.1589,-0.2675,-0.1816,-0.1614,-0.1643,-0.1257,-0.0965,-0.0987,0.1321,-0.2369,-0.2371,-0.2002,-0.0631,-0.0526,-0.2092,-0.097,0.0301,0.1541,0.077,-0.1157,0.3597,0.3298,0.2091,0.0053,0.0463,-0.0211,-0.1739,0.04,-0.0464,0.0399,0.1786,0.2041,-0.0463,0.03,0.0902,0.1286,-0.2124,-0.1217,-0.0549,-0.063,-0.1674,-0.1266,-0.0901,-0.1357,0.0349,-0.1845,-0.1645,0.1908,-0.0405,-0.255,0.0094,0.1409,0.1294,-0.0962,-0.1157,-0.4216,-0.3214,-0.1415,-0.3177,0.1147,-0.1116,-0.0991,0.0683,-0.1119,-0.089,-0.1931,-0.083,0.1233,0.1214,0.2531,0.183,0.2283,-0.0502,-0.021,0.1958,0.0299,0.1361,0.0982,0.0577,0.2481,0.157,-0.173,-0.279,-0.1396,-0.0688,-0.1479,-0.0375,-0.0918,0.0521,0.0367,0.0273,0.148,0.1006,-0.2236,-0.0358,-0.1629,-0.0317,-0.1913,-0.2694,0.0004,-0.0617,-0.0097,-0.0951,-0.0192,-0.1598,-0.0973,-0.2344,-0.1046,-0.1782,-0.055,-0.0449,-0.0286,-0.0385,-0.0675,0.0649,0.1097,0.041,-0.0848,-0.0882,-0.1426,-0.0288,0.1145,0.1149,-0.0993,0.2763,-0.0092,-0.0489,0.0784,0.0587,-0.0577,-0.0104,0.0082,0.049,-0.0022,-0.0109,0.1746,0.2974,0.4183,-0.0799,-0.0411,-0.0001,0.049,-0.0329,0.2114,-0.0414,0.3298,-0.1571,0.0674,0.042,0.1237,0.0211,-0.0032,-0.0148,0.0257,-0.0186,-0.0144,0.0709,0.0258,-0.059,-0.1387,0.0973,0.1952,0.2197,-0.2241,-0.1865,-0.203,0.0068,-0.1992,-0.0513,-0.0215,0.0454,0.0157,-0.047,-0.1604,-0.1747,-0.0157,0.0042,-0.1181,0.0344,0.299,0.0344,-0.0714,0.1815,0.4298,0.171,0.1259,0.2059,-0.0947,0.0341,0.2563,0.2098,-0.1231,0.2877,0.1178,0.0833,0.0856,0.4158,0.1041,-0.1795,-0.1579,-0.0996,-0.1047,0.0601,-0.1149,0.0064,-0.1182,-0.1223,-0.0233,-0.17,-0.0877,0.1295,-0.086,-0.2314,-0.1071,-0.1591,-0.065,-0.0598,-0.1033,-0.1095,-0.1129,-0.0601,-0.0598,-0.2161,-0.1554,0.1697,0.2895,-0.0312,-0.0406,0.0784,0.0289,-0.057,-0.08,-0.1269,-0.1863,0.0609,0.0875,-0.1968,-0.2545,-0.1136,-0.0691,-0.1192,-0.1529,-0.0025,-0.1298,-0.047,-0.128,-0.1059,-0.071,-0.124,-0.0443,-0.04,-0.0647,0.1703,-0.1157,0.0439,0.198,0.0792,-0.1842,-0.0593,-0.1819,-0.1731,-0.1,-0.0872,-0.0947,0.0788,0.1121,0.1489,-0.0212,-0.0766,-0.0171,-0.0739,0.0053,0.138,-0.1793,-0.0967,-0.1685,0.0349,0.0478,0.1443,-0.0282,-0.2746,-0.2296,-0.0392,-0.0284,0.0099,0.1429,0.1137,0.0003,-0.1245,-0.1435,-0.0784,-0.1678,-0.3331,-0.1411,-0.0962,0.1117,-0.0078,0.2094,-0.0413,0.1372,0.014,0.0382,0.03,0.0989,0.1804,0.058,-0.0212,0.0114,-0.0837,0.0305,-0.0221,0.0075,-0.0518,-0.0307,-0.0227,0.0106,-0.1034,-0.0649,-0.0829,-0.0737,-0.1838,-0.0399,0.0136,0.1014,-0.0793,0.0707,0.0094,0.0682,-0.0443,-0.0263,0.0353,-0.0559,-0.2342,-0.0903,0.1917,0.1868,-0.0102,-0.0736,-0.0952,-0.1565,-0.0818,-0.0185,-0.0944,0.1341,0.0828,-0.2171,-0.1996,0.007,-0.1639,-0.0556,-0.0481,0.4059,0.2567,-0.266,0.0852,-0.0934,-0.0146,-0.1006,-0.203,-0.2251,-0.1956,0.0475,-0.0073,-0.1212,-0.0036,-0.1125,-0.0654,0.1707,0.0055,0.0689,0.0044,0.0026,0.0259,-0.173,-0.0503,0.0767,-0.1488,0.1048,-0.24,0.1448,-0.1987,0.3046,0.1429,0.146,-0.2807,-0.2452,0.1095,0.2617,0.053,0.2453,0.0439,0.081,0.1212,0.0553,0.1179,0.0603,0.0539,0.0709,0.1031,0.0781,0.1147,-0.0779,0.1465,0.3072,0.566,0.251,0.1952,0.3973,0.2104,0.2449,0.2999,0.2126,0.2541,0.1622,0.2709,0.2797,0.1744,0.2245,0.3082,0.3507,0.2946,0.3188,0.1753,0.2719,-0.2392,-0.0619,-0.223,-0.1944,-0.1145,-0.2772,-0.2481,-0.1147,-0.0143,-0.0881,-0.3133,-0.2683,-0.1968,-0.0512,-0.0002,-0.1892,0.1191,-0.0303,-0.0799,0.0377,-0.1182,-0.0947,-0.0542,-0.0835,-0.1696,0.0933,-0.2169,-0.2287,0.0731,-0.0191,-0.0689,0.0142,0.0207,-0.1852,0.2002,0.1654,-0.1687,0.2528,0.2983,0.0602,0.0941,0.1589,-0.1015,0.3825,0.3856,-0.0444,-0.0459,0.1306,-0.0494,0.0176,-0.149,-0.0517,0.1242,-0.0279,-0.0772,0.0512,0.0168,-0.033,-0.0361,monetary reward prediction error
trm_558c73f3c8c6f,0.0037,0.0187,0.0004,-0.0048,-0.009,-0.0004,0.0119,-0.0056,0.0074,-0.0075,-0.0307,-0.0223,0.0159,-0.0,0.001,0.0053,0.0316,0.0105,0.0345,-0.0108,-0.0044,-0.0027,0.0022,-0.0145,-0.001,-0.0067,-0.0029,0.018,0.0049,0.0127,-0.0079,0.0176,0.0183,0.0097,-0.0059,-0.0,0.0032,0.0073,0.0034,0.0113,0.0175,0.0031,0.0165,-0.004,0.004,0.0093,-0.0048,0.0039,0.0115,0.0128,-0.0075,-0.0096,-0.0049,0.0007,-0.0083,0.018,0.005,-0.0078,-0.0097,0.006,-0.0074,-0.0059,-0.0002,0.0206,-0.0067,-0.0157,0.0016,0.0179,0.0145,0.0076,-0.0163,-0.0008,-0.0176,-0.0111,-0.0012,-0.0145,0.0558,-0.0086,-0.0067,0.0341,-0.0156,-0.0058,0.0048,-0.0166,0.0207,0.0122,0.0067,0.0114,0.0131,0.0644,0.0332,0.0232,0.0487,-0.0191,-0.0234,-0.0106,-0.0118,-0.0096,-0.0064,0.0151,-0.0195,-0.0038,-0.0022,-0.0092,-0.019,0.0482,-0.0049,-0.0049,-0.0012,0.0059,-0.0128,-0.013,-0.0028,0.0002,-0.0092,-0.0201,-0.0053,0.0229,-0.0069,0.029,-0.0085,0.0079,0.0096,0.0214,0.0072,-0.0022,0.0032,0.0031,0.0207,-0.0122,0.0083,0.0153,0.016,0.0233,-0.0033,0.0158,0.0125,0.0083,0.0128,-0.0043,0.0203,0.024,-0.0161,0.0059,-0.0102,0.0099,0.0212,-0.023,-0.0005,-0.0106,-0.0149,-0.0021,-0.0006,0.0139,-0.0285,0.0106,-0.0103,-0.0153,0.0024,0.0173,-0.0059,0.0167,-0.0054,0.014,-0.0011,-0.0006,-0.0185,-0.013,-0.0144,-0.0106,0.0112,-0.0012,0.0003,-0.0123,-0.0066,-0.0075,-0.0145,-0.0142,-0.0032,0.0036,0.0066,0.0158,0.0169,0.0098,0.0288,0.0086,0.0425,0.0148,-0.0154,-0.0108,-0.0148,0.001,0.0055,0.0082,0.0061,0.0055,-0.0041,-0.0185,0.0161,0.023,0.016,-0.0175,-0.0017,0.0191,-0.005,0.0222,0.0088,0.026,-0.0055,-0.0058,-0.0124,-0.006,0.0501,-0.0181,-0.0287,-0.0048,-0.01,0.0316,0.027,-0.0165,-0.0193,-0.011,0.0266,0.012,-0.0004,-0.0056,-0.0179,0.0091,0.0057,-0.0369,0.0197,-0.018,-0.0311,0.0106,0.0121,0.0714,-0.0227,-0.0125,-0.007,0.0055,0.0009,-0.0026,0.0016,0.0099,-0.0144,0.0146,0.0081,-0.0105,0.0176,-0.0051,0.0035,-0.0148,-0.0045,-0.0081,0.0199,0.0063,0.0164,0.0312,-0.014,-0.0371,-0.0189,-0.0504,-0.0078,-0.0172,-0.0222,-0.0373,-0.0312,-0.0172,-0.0196,-0.0189,0.0238,0.0331,-0.0001,0.0287,0.0522,0.0141,0.0763,0.0845,0.1153,0.0509,0.0216,-0.0005,-0.0144,0.0,-0.0064,0.0043,-0.0098,-0.0256,-0.0103,-0.0137,-0.0057,-0.0222,0.0136,-0.0184,0.0005,-0.0277,-0.0189,-0.0052,-0.0006,-0.0101,-0.0047,-0.0087,-0.0189,0.0399,0.0178,0.0197,0.0124,0.0138,0.0323,-0.0127,0.0159,0.0036,-0.0101,-0.0244,0.0003,0.0044,-0.0117,0.0123,-0.0287,0.0105,-0.0166,0.0011,-0.0065,-0.0092,0.0278,0.0103,0.0103,0.0091,0.0064,0.0035,0.0124,-0.0084,-0.0153,-0.0169,-0.011,-0.0097,0.0195,-0.0269,-0.0001,-0.0066,-0.0001,-0.0027,0.0016,-0.0139,0.0077,-0.0097,0.0173,0.0145,0.0098,0.0035,-0.0053,-0.0147,0.0246,0.0371,0.0017,0.0121,-0.0169,0.0248,0.0247,0.0152,0.0045,-0.002,0.0326,0.0288,0.0276,0.0034,0.0192,-0.0356,0.0084,0.0212,-0.0217,-0.0327,-0.0152,-0.0105,-0.0024,0.0118,0.0075,-0.011,-0.0077,0.004,0.0042,0.0189,-0.0112,-0.0197,0.0022,0.0103,-0.0017,0.0139,-0.0078,-0.0042,0.0273,0.0033,0.0057,-0.0047,-0.0035,0.0137,0.0237,0.0124,0.0254,-0.0045,0.0129,0.0149,-0.0075,0.0004,0.0004,-0.027,-0.0127,-0.0095,0.0273,-0.0027,-0.0146,0.0108,-0.0071,-0.0288,0.0107,0.0064,-0.0166,-0.0173,-0.0148,0.0008,-0.0283,0.0251,0.0074,0.0027,0.0072,-0.0009,0.0021,-0.0175,0.0058,-0.0014,-0.0133,0.0058,-0.0014,0.0083,0.0182,-0.0234,0.0192,0.0138,0.0234,0.0018,-0.0274,-0.0049,-0.0179,0.0076,0.0014,0.0315,-0.0091,0.0145,-0.0181,-0.0247,-0.0253,0.0076,0.0043,0.0184,-0.0181,-0.0077,0.021,0.0006,-0.0279,-0.0081,-0.0192,0.0106,0.0032,-0.0176,0.0173,0.0003,-0.0146,-0.0421,0.0445,0.0287,0.0107,0.0057,0.0016,0.0064,0.0059,-0.0023,0.014,-0.0091,-0.0023,-0.0261,0.0024,0.0307,0.0452,0.0154,-0.0033,-0.0145,0.0133,0.015,0.0124,0.007,0.0133,0.0157,0.0229,0.0349,-0.012,0.0001,0.0078,0.0257,-0.0283,-0.008,-0.0067,-0.015,0.0238,0.0138,0.0197,0.0015,-0.0112,0.0056,0.0144,-0.0054,0.0167,0.02,0.0075,0.0035,-0.0065,-0.0199,-0.017,-0.0062,-0.0109,-0.0128,-0.0101,-0.0105,-0.0235,-0.0357,-0.0311,-0.0106,-0.0173,-0.0215,-0.0064,-0.0179,0.0193,0.003,0.0047,0.0154,-0.0202,-0.006,-0.0001,-0.0089,-0.018,0.0294,0.0026,-0.0042,-0.0,0.0326,0.0028,-0.0095,-0.0219,0.0158,-0.0048,-0.0131,-0.0024,-0.0016,-0.0078,0.0292,0.0071,0.0023,-0.016,-0.027,-0.0112,0.0337,-0.0251,0.0045,0.0261,-0.0158,0.0279,0.0159,-0.0132,0.0112,-0.0042,0.008,-0.021,-0.0108,0.0329,0.019,0.0233,0.0146,0.0096,-0.0079,0.0128,-0.0028,-0.0082,-0.0258,-0.0137,0.0186,0.0051,-0.0181,-0.0119,-0.0093,-0.0022,0.0133,0.0127,-0.0179,-0.0028,-0.019,0.0151,0.0012,0.0171,-0.0234,0.0096,0.025,0.0241,0.0016,-0.0302,-0.0167,-0.0056,0.0109,0.0069,0.0197,0.0212,-0.0205,0.0092,0.0196,-0.0181,0.0087,0.0027,-0.0096,-0.017,-0.011,-0.0039,0.0302,-0.005,0.0103,0.0268,0.0247,0.0138,0.0089,-0.0161,0.0077,0.0036,-0.0043,-0.0112,0.0001,0.0128,-0.0101,-0.0167,0.008,-0.0314,-0.0097,-0.0021,0.028,-0.0105,0.0095,-0.0056,0.0278,-0.0162,-0.0031,-0.0284,-0.0184,-0.0304,-0.0032,-0.0141,0.0104,-0.0285,-0.016,-0.0045,0.0094,-0.0022,-0.0057,-0.0006,0.0082,-0.0165,0.0407,-0.0315,0.0237,-0.026,0.0102,0.0343,0.0312,0.0384,0.028,0.009,0.0012,-0.0012,0.0491,0.0065,-0.006,0.0162,-0.009,0.0209,-0.0076,-0.0166,0.017,-0.014,-0.0122,-0.0108,0.0083,0.0297,-0.02,-0.0243,0.0037,-0.01,-0.0515,-0.0298,-0.0206,-0.0047,-0.0107,-0.0197,0.0111,0.0087,-0.009,-0.0203,-0.025,0.0111,0.0,0.0044,-0.0124,0.0176,0.0043,0.0096,0.0035,-0.0179,-0.0265,-0.0226,0.0179,-0.0351,-0.0154,-0.01,0.0152,0.0251,-0.0174,0.006,0.0074,0.008,0.0139,-0.0104,0.0265,-0.0116,-0.0066,-0.0139,0.0024,-0.0171,-0.0038,0.0031,-0.041,-0.0212,0.0213,-0.0031,-0.0126,-0.0045,-0.019,0.0005,0.0121,0.0204,0.0028,-0.0092,0.0029,-0.0086,0.0089,-0.0181,-0.0087,-0.0121,-0.0164,0.0082,0.0055,0.0069,0.0057,-0.0123,-0.0087,-0.0067,0.0229,0.017,0.0068,-0.0035,-0.0032,-0.0026,-0.0054,-0.003,-0.0078,0.0435,-0.0163,-0.0046,-0.0098,0.0321,-0.0059,-0.0154,0.0093,-0.002,-0.0015,-0.0128,0.0038,0.0282,0.0217,-0.0154,-0.0235,-0.0171,-0.0056,-0.0128,0.0135,-0.0157,-0.0286,0.004,0.0068,-0.0193,0.0037,0.0165,-0.0012,0.0182,0.0131,-0.0229,0.0176,0.012,-0.017,-0.022,-0.0098,-0.0053,0.0114,-0.0318,-0.0081,-0.0107,-0.0228,-0.0216,-0.013,-0.0101,-0.0153,-0.0164,0.0054,-0.006,-0.0078,0.0072,0.0178,0.0169,0.0256,-0.0114,0.0542,-0.0096,-0.011,0.0074,-0.0099,0.0116,-0.0087,0.0035,-0.0085,-0.0206,0.0088,0.0114,0.0048,-0.0064,0.0254,-0.0244,0.0071,-0.0016,-0.0255,0.0175,-0.0343,-0.0099,-0.0167,-0.0405,-0.035,0.0014,-0.0222,-0.0284,0.0098,0.0058,0.0042,-0.0018,-0.0248,-0.0163,0.0082,-0.0039,-0.0163,-0.018,-0.0017,0.0126,-0.0184,0.0137,-0.0001,0.0122,0.0028,-0.0173,-0.0074,-0.0031,0.005,-0.0035,-0.0084,-0.0199,-0.0403,-0.0189,-0.0426,-0.0197,-0.023,0.0121,-0.0285,0.005,0.011,0.0466,-0.0264,0.0015,-0.0058,-0.0028,0.0046,0.0106,0.0054,0.0074,0.0077,-0.0054,-0.0043,0.0004,0.0118,0.0106,0.0132,0.0161,0.0026,-0.006,-0.0047,-0.0021,-0.0312,0.0105,-0.0062,-0.0026,-0.0191,0.0002,0.0235,-0.0075,0.0197,0.0101,-0.0007,0.0252,0.025,-0.0182,-0.0161,0.0157,0.0172,0.0044,-0.0027,0.0266,0.0164,0.0201,0.0011,-0.0144,-0.0109,0.0188,-0.0152,0.0063,0.0036,0.022,-0.0229,0.0074,0.0073,0.0003,-0.0029,-0.0044,-0.0002,0.003,-0.0023,0.0287,-0.0102,0.0047,-0.0031,-0.0089,0.0072,-0.0046,0.0241,0.003,-0.0045,0.0233,-0.0166,-0.0191,0.0128,-0.0111,0.0056,-0.0054,-0.0047,-0.0266,-0.0257,-0.017,0.0428,-0.0027,0.0012,0.0095,-0.005,-0.0072,-0.0065,-0.0113,0.0057,0.0055,-0.0193,-0.0041,-0.0078,0.0015,-0.0331,0.0046,-0.0211,0.0019,0.0193,-0.0151,-0.0102,-0.006,-0.0087,-0.0221,0.0311,-0.0126,-0.0065,-0.019,-0.003,0.005,0.0168,-0.0041,-0.0147,0.0066,0.015,0.0012,0.029,0.0054,-0.0127,-0.0105,0.0259,0.0229,-0.0112,-0.0059,-0.0074,-0.0197,0.0081,-0.0182,-0.0001,-0.0107,-0.0367,-0.0042,-0.015,0.0215,0.0155,0.021,-0.0127,0.0047,0.0307,0.0247,-0.0348,0.0091,-0.0123,0.0181,0.0027,0.0226,0.0035,-0.003,0.0021,-0.0228,-0.0314,-0.012,-0.0242,-0.0139,-0.0126,-0.0053,-0.0143,0.0007,0.0009,0.0032,0.0145,-0.0103,-0.0144,0.0075,0.0102,0.0047,0.0071,0.0254,-0.0015,-0.0063,-0.0163,-0.004,-0.0098,-0.0078,-0.0125,0.0036,-0.0047,0.0156,-0.0062,0.0022,-0.012,0.0107,0.0197,0.0209,-0.003,-0.0076,-0.0156,-0.0119,-0.0026,0.0009,0.0139,0.0031,0.0055,0.0084,0.0138,0.0035,-0.0053,-0.0028,-0.0005,-0.0024,-0.0057,-0.0135,0.024,-0.006,0.0174,-0.0294,-0.0156,-0.0407,-0.0226,-0.0338,-0.0147,-0.0402,-0.0302,0.0158,-0.027,-0.0125,-0.0312,-0.017,-0.0238,0.0037,-0.0058,0.0123,0.0044,0.0041,-0.0148,-0.013,0.0239,0.0129,0.0124,0.0017,0.0043,0.0123,-0.0057,-0.0085,-0.0184,-0.0296,0.0024,0.0045,0.0124,-0.0081,0.0061,-0.0324,-0.0008,-0.0,-0.0162,-0.0142,-0.0113,-0.0143,0.031,0.0401,0.0027,0.0178,0.0015,0.0212,-0.017,0.0108,-0.0359,-0.0177,-0.0045,0.0094,0.0255,0.0146,-0.0003,0.0119,-0.0429,0.0028,-0.0033,-0.0357,-0.0149,0.0019,-0.0104,0.0279,0.0006,0.0057,0.0183,-0.0123,0.0248,0.0088,-0.0052,0.01,-0.0009,0.0089,0.0033,-0.0007,-0.0061,0.0131,0.0099,-0.0026,0.0156,-0.0014,0.0056,0.006,-0.0002,0.029,0.0239,0.0434,-0.0062,0.0321,0.0028,-0.0217,-0.026,-0.0127,-0.0295,0.0091,0.0031,-0.0311,-0.0186,-0.0024,-0.0245,-0.0034,-0.0324,-0.0335,-0.0162,-0.0036,-0.0335,-0.0112,-0.0041,0.0033,0.0159,0.0049,0.005,-0.0024,0.0097,-0.0118,0.0436,0.0056,0.0355,0.0214,0.0115,-0.0027,0.0117,0.0087,0.015,-0.0191,-0.0153,-0.0053,-0.0184,-0.0188,-0.02,-0.0118,-0.0173,-0.0195,-0.008,-0.0011,-0.0217,0.0244,0.021,-0.024,0.0085,-0.0028,-0.0096,0.0107,0.0051,0.0099,0.0092,-0.0083,0.0202,0.0148,-0.0002,0.0079,0.0323,0.0021,-0.0155,0.0033,0.0,0.0,0.0214,-0.0203,-0.0037,-0.0066,-0.0052,-0.0086,0.0341,-0.0114,0.0152,0.015,-0.0152,-0.0003,0.027,0.0325,0.0473,0.0229,0.0243,0.0027,-0.0187,0.0021,-0.0017,0.0343,0.0267,-0.0049,-0.0051,0.0105,0.0089,-0.0041,0.0365,0.0012,-0.005,-0.0186,-0.0175,-0.0099,0.0712,0.0142,-0.0122,0.008,-0.0008,0.0008,0.0148,-0.026,0.0125,0.0085,-0.0203,-0.0223,0.0253,0.0139,0.0263,0.0294,-0.0124,0.0178,0.035,0.0088,0.0076,-0.0303,0.0341,-0.0205,0.0307,0.0295,-0.0002,0.0277,-0.006,0.0008,-0.0154,-0.0327,0.0367,0.0385,0.0092,0.0045,0.0019,-0.0153,0.1036,0.0963,0.0103,0.0005,0.0191,0.0091,0.0339,0.0186,0.0035,-0.005,0.016,-0.0065,0.0029,0.0036,0.0353,-0.0098,0.0253,-0.0152,0.0094,0.0153,-0.0233,-0.0198,-0.0027,0.01,0.0102,0.018,-0.0018,-0.0021,-0.0068,-0.0186,0.0052,-0.0156,-0.007,-0.0081,-0.004,0.0192,0.0131,0.0064,0.0154,0.0284,-0.0097,-0.0055,-0.0159,0.0061,0.0157,0.0001,-0.0077,0.0048,0.0062,0.0033,-0.0052,-0.0024,-0.0026,-0.0043,-0.0112,-0.0226,0.0018,0.0146,-0.0119,-0.015,-0.0119,-0.0122,-0.0126,-0.0077,-0.0043,-0.0164,0.0097,-0.0239,0.0233,-0.0165,-0.0282,0.0026,0.0062,-0.0087,-0.0024,-0.0126,-0.0199,-0.018,-0.0029,0.0182,0.025,0.0143,-0.0146,-0.023,-0.0236,-0.0166,-0.0114,0.0085,-0.0035,-0.0071,-0.0121,0.0239,0.008,0.0152,0.0167,0.0275,0.0005,0.0314,-0.0001,-0.0059,-0.0056,-0.0223,-0.0142,-0.0222,0.018,-0.0049,0.0268,0.0056,0.0073,-0.019,0.009,0.0135,0.0304,0.0287,-0.0031,0.0195,-0.0024,0.0187,0.012,-0.003,0.0032,0.013,-0.0242,0.0011,-0.0038,-0.0055,-0.02,0.0007,-0.0005,-0.0108,-0.0184,-0.0257,0.0193,-0.0054,0.007,-0.0252,0.0042,0.0021,0.0244,0.0094,0.0253,-0.0042,-0.0263,-0.0052,-0.0031,0.0014,-0.0152,0.007,0.0245,0.0305,0.0095,0.0259,0.0198,-0.0248,-0.0144,-0.0126,-0.0276,0.0093,0.0103,0.0073,-0.0106,0.0256,0.0065,0.0295,-0.0122,-0.0062,-0.0037,0.0047,-0.0109,-0.0064,-0.0162,0.017,-0.0208,0.0153,-0.0398,0.0066,-0.0101,-0.0095,-0.0057,0.0036,-0.0078,0.0253,0.0036,0.0271,0.0171,-0.0089,0.0253,0.0044,-0.0021,-0.0118,-0.0494,-0.0452,0.0272,0.0081,-0.0094,0.0314,0.044,0.0065,0.0159,-0.0009,0.005,-0.0082,-0.0022,0.0098,-0.0083,-0.0178,-0.0053,0.0116,-0.0191,-0.018,-0.044,0.0207,0.017,-0.0397,-0.0159,0.0007,-0.0112,0.0175,0.0001,0.0049,-0.0163,-0.0007,-0.0008,-0.0145,-0.0231,-0.0306,-0.0179,-0.029,-0.0308,-0.027,0.006,-0.0139,-0.0078,-0.0263,-0.0019,0.0135,0.0198,0.0248,-0.0036,-0.005,-0.0026,-0.0119,0.0297,0.0124,-0.0056,0.0178,-0.0261,-0.0231,0.011,0.0039,0.0225,-0.0037,-0.0132,-0.013,-0.0146,-0.0218,-0.0244,-0.0042,-0.0314,-0.01,-0.0135,-0.0179,0.0211,0.0425,0.0435,0.018,-0.015,0.0032,-0.0036,0.0063,-0.0082,-0.0181,-0.0197,-0.0218,0.0202,0.0071,-0.0132,0.005,0.0133,-0.0024,0.0122,0.0076,-0.0102,0.0044,0.0172,0.0004,-0.0201,0.0164,0.0284,-0.0124,-0.0105,0.0102,0.0175,-0.0101,0.0017,-0.0046,0.0067,0.0194,-0.015,-0.0109,-0.0056,0.0171,-0.0282,-0.0096,0.0062,-0.0069,0.0127,0.0377,0.0148,0.0601,0.0068,0.0072,-0.0146,-0.0159,-0.0149,-0.0063,-0.0192,0.0023,-0.01,-0.0195,0.0235,0.0218,0.0436,0.0232,-0.0021,-0.0054,-0.0305,-0.0152,-0.0219,-0.0116,0.0087,0.0098,0.0053,0.0161,-0.0246,0.0079,0.0181,0.0085,0.0162,-0.0001,0.0338,0.004,0.0038,-0.0014,0.0152,0.0621,-0.0033,0.0122,-0.0169,0.0223,-0.0145,-0.0289,-0.0259,-0.0051,0.0206,0.0206,0.0045,0.0331,-0.0236,-0.0268,0.0054,0.0102,0.0263,-0.0105,-0.0206,-0.0066,-0.0243,0.0266,0.0145,0.0165,0.0207,-0.0021,-0.0007,0.0323,0.0388,-0.0116,-0.0134,-0.0074,0.0028,0.024,-0.0107,-0.0109,-0.006,-0.0293,-0.004,0.0545,0.0221,0.0166,0.0287,0.0255,-0.0102,0.0094,0.0005,-0.0156,0.0087,0.0109,0.0036,0.0049,0.0097,0.0063,-0.0072,0.0203,0.0096,0.0212,0.034,-0.0181,-0.0155,0.004,-0.0071,-0.0148,-0.0298,-0.0058,0.0046,-0.0085,-0.0069,-0.0111,0.0003,0.0148,-0.0154,-0.0112,-0.0052,0.0246,0.0676,-0.013,-0.0397,-0.0132,-0.0176,-0.028,-0.0268,-0.0144,-0.0174,-0.0271,-0.0194,-0.0067,-0.0115,-0.0191,-0.0231,-0.0108,-0.002,-0.0057,-0.0016,-0.0164,0.012,-0.0145,0.0164,0.0426,0.0296,0.0122,-0.0019,0.0176,-0.0214,-0.011,0.0159,0.0265,0.0061,-0.002,-0.0045,-0.0026,-0.0178,-0.0015,0.0206,0.0052,0.0201,-0.0058,-0.0107,0.0185,-0.0099,-0.0032,0.025,0.0093,-0.0064,-0.0024,0.0114,-0.0187,-0.0175,-0.0125,-0.0129,0.0121,0.0161,0.0354,0.0184,0.0345,0.0027,-0.01,-0.0218,-0.0033,0.0238,-0.0006,0.026,0.014,0.0106,-0.0117,-0.005,-0.0175,0.0364,-0.0303,-0.0075,-0.0038,-0.0156,0.0246,0.0001,-0.0109,0.0099,0.0022,0.0282,0.0263,-0.0189,-0.0248,-0.0129,0.0423,0.0438,0.0472,-0.0033,0.0138,0.0038,-0.0118,0.0516,-0.0055,-0.0052,0.0341,0.0086,0.0299,0.0048,-0.0464,-0.0262,0.0035,-0.0152,-0.0293,0.0145,-0.0097,0.004,-0.0221,-0.0128,-0.0067,0.0137,-0.0076,0.0013,0.0165,0.0298,0.0486,0.0464,0.0014,-0.0009,0.0535,0.0099,0.0149,0.0065,-0.0045,-0.0289,-0.0073,0.0018,0.0078,-0.0206,-0.0199,-0.0088,0.0245,0.0121,0.0061,-0.0225,0.0017,-0.0044,0.0094,0.0167,-0.0092,0.0133,0.0186,-0.0153,0.0379,0.0089,-0.0014,-0.0073,-0.0092,-0.0135,0.0272,0.0327,-0.0008,-0.0114,-0.0119,0.0285,-0.0092,0.0153,0.0105,-0.0106,-0.015,0.02,0.0061,0.0052,-0.0161,0.0029,-0.0082,0.0028,-0.0218,0.0013,-0.0116,-0.0093,-0.0091,0.0322,-0.0189,0.0121,-0.0151,0.0426,0.0305,0.0335,-0.007,0.0229,0.0179,0.017,-0.0129,-0.0036,0.0168,0.0219,0.0049,-0.0043,-0.0148,0.0143,-0.0151,-0.0141,-0.017,-0.0193,-0.034,-0.0127,0.0002,-0.0331,-0.0264,0.0232,-0.0055,-0.0345,-0.0195,-0.0074,-0.0141,0.0079,-0.0027,-0.0065,-0.0062,-0.0145,0.0261,-0.0369,-0.0208,-0.0275,-0.0162,-0.029,-0.0229,-0.0372,-0.0362,-0.0286,-0.0158,0.0072,0.0119,0.0044,0.0024,0.0091,-0.0189,0.0372,0.0015,-0.0146,0.0007,-0.0021,-0.0129,-0.0073,-0.0037,0.0416,-0.0203,-0.0111,-0.0214,0.0318,0.0069,0.0419,0.011,-0.0011,-0.0315,-0.0044,0.0248,-0.0092,0.0696,-0.013,-0.0095,-0.0096,0.0212,0.0419,-0.0002,-0.0365,-0.024,-0.0216,-0.0186,-0.0233,0.0055,0.0277,-0.0016,-0.0241,0.0713,-0.0239,0.0065,-0.0221,-0.0291,0.0087,0.1067,0.0119,0.0104,0.0034,-0.0017,0.0248,0.0256,0.021,0.0054,0.0042,-0.0249,0.0,0.0041,-0.0019,-0.0079,-0.0148,-0.0286,-0.0079,0.0128,0.0116,0.0066,0.0098,0.0282,-0.0172,0.0031,-0.0047,-0.042,-0.0509,-0.0178,-0.0351,-0.0265,-0.019,-0.0162,0.0043,-0.024,-0.0234,-0.0045,-0.0088,0.0118,-0.0105,0.0037,0.0414,0.0431,0.0157,0.0069,-0.009,0.0021,0.0098,-0.0129,-0.0299,0.0062,0.001,0.0079,0.0022,0.0263,-0.0235,-0.0302,-0.0212,-0.0001,0.0026,-0.0085,0.0236,-0.0024,0.0027,0.0187,-0.0068,-0.0155,0.0163,-0.0078,0.0553,0.0174,-0.0269,0.0002,0.0092,0.0029,-0.0118,0.0271,-0.0349,-0.0178,-0.0276,0.0122,-0.0006,0.0113,0.007,0.0008,-0.0126,-0.0001,-0.0171,0.0034,0.0163,0.0013,-0.0323,-0.0205,-0.0019,0.0076,-0.0011,-0.0204,0.005,-0.0256,-0.0034,-0.0,-0.0085,0.0066,0.0325,0.0258,0.0351,-0.0153,0.0062,0.006,0.0017,-0.0189,0.1179,-0.0204,0.0077,0.007,-0.0073,0.0608,0.0575,0.004,-0.0043,0.0086,0.0046,0.0061,0.0147,-0.0079,-0.0158,-0.016,0.0097,-0.0188,-0.0182,0.0157,0.0027,0.0019,-0.0088,-0.0104,0.0231,-0.0064,-0.0091,0.0124,0.0203,0.0301,0.0014,-0.0067,0.0055,0.0459,0.0023,-0.0097,-0.0201,-0.0071,-0.0049,-0.0049,0.0115,-0.0104,-0.004,0.0158,0.0104,0.0448,0.0419,-0.0094,-0.0019,0.0038,-0.027,0.0562,0.0131,-0.004,-0.0285,0.0159,0.0042,0.0282,0.015,0.0074,0.002,0.0015,-0.0299,0.0173,0.0206,0.001,-0.0116,-0.0077,-0.0021,0.0421,0.0486,-0.0095,-0.0168,-0.0164,-0.0132,0.0003,-0.0045,-0.028,-0.0194,0.0043,-0.0086,0.0058,-0.0209,-0.0049,0.0014,0.0036,-0.0241,-0.0473,-0.0021,-0.0395,-0.0104,-0.0067,-0.0116,-0.0249,0.0201,0.0267,0.0289,-0.0352,-0.01,0.01,-0.0092,0.0164,-0.0429,-0.0086,0.0009,0.027,0.0176,-0.0235,-0.0138,-0.0091,0.019,-0.0019,-0.027,0.0045,0.0143,0.0632,0.084,0.0539,0.028,0.0178,0.0131,0.0579,-0.0286,0.0081,-0.019,-0.0152,0.0214,-0.0042,-0.0007,-0.0015,-0.0016,-0.0336,0.0118,-0.0226,0.0004,-0.0082,0.0058,0.0184,-0.0237,-0.0114,-0.0155,0.0107,-0.0071,0.0381,0.0504,0.0087,0.0541,0.143,-0.0153,0.0048,-0.01,-0.0005,0.0015,0.0195,-0.001,-0.0022,-0.0082,0.0832,0.0066,-0.013,-0.0145,-0.0141,0.001,-0.0021,0.0207,0.0119,0.011,-0.0194,-0.021,0.0063,0.0068,0.0094,0.0663,-0.0131,0.0072,0.0085,-0.0035,-0.0012,0.0064,0.0116,-0.0017,0.0083,0.0117,-0.0089,0.0045,-0.0212,0.0131,0.0139,0.0235,-0.0207,-0.0027,0.0167,0.0415,0.0036,0.009,-0.0237,-0.0066,0.0001,0.0366,-0.0112,0.0062,0.0074,-0.0149,-0.0152,-0.0219,0.0058,0.0011,0.0035,-0.0146,0.0055,0.0012,0.0056,0.0122,-0.018,0.0017,-0.0339,-0.0243,-0.0344,0.0019,-0.0175,-0.0071,-0.0149,0.0114,-0.0188,0.0054,-0.0085,0.0029,-0.0106,-0.0244,-0.0069,0.0115,0.0071,-0.0197,0.0015,0.0069,-0.0331,-0.0176,-0.003,-0.0103,-0.0034,-0.0099,-0.018,0.0149,0.0013,-0.006,0.0291,0.0163,-0.0024,0.0039,-0.0161,0.0213,0.0005,0.0222,-0.0017,-0.0109,-0.0015,-0.0022,0.0216,0.0052,-0.0144,-0.0013,-0.005,-0.009,0.0216,-0.0242,0.01,0.0032,0.0103,0.0123,0.0152,-0.0181,-0.0143,0.0132,0.0053,0.0235,-0.0137,0.0177,-0.0224,0.0037,-0.0159,-0.029,-0.0202,-0.0131,0.0162,0.0015,-0.0049,-0.0082,-0.0023,0.01,0.0271,-0.0108,-0.0165,-0.0093,-0.0009,0.004,0.0099,0.0272,-0.0114,-0.0193,-0.0243,-0.028,-0.0202,0.0146,0.0233,0.0179,-0.0087,-0.0187,0.047,0.0128,-0.0054,0.0055,-0.0108,0.0171,0.03,0.0053,0.0075,-0.0126,0.0112,-0.0142,-0.0121,-0.0175,-0.0227,-0.0351,-0.019,-0.0187,-0.0021,-0.0135,-0.0099,-0.0185,0.0168,-0.0011,-0.0025,0.0064,0.001,0.0237,0.0077,0.0272,-0.0076,-0.024,0.0043,-0.0227,-0.0048,-0.01,0.0036,-0.0163,-0.0195,-0.0111,-0.0115,0.0008,-0.0289,-0.0094,-0.0237,-0.0186,-0.0027,-0.0014,-0.0146,0.0032,0.0086,0.0241,0.0185,0.0132,0.014,-0.0232,0.02,-0.008,-0.012,-0.011,-0.0186,-0.0151,-0.0211,0.0035,0.0471,-0.0221,-0.0271,0.0022,-0.0169,-0.0179,0.0012,-0.0115,0.0017,-0.0017,-0.01,-0.0047,-0.003,-0.0226,0.04,-0.0012,-0.0192,0.0137,0.0006,-0.012,-0.0297,0.0046,-0.0334,-0.0021,0.0107,-0.0185,-0.0176,0.052,-0.0405,-0.0339,0.0393,-0.0027,0.0048,-0.0221,-0.0082,-0.0029,0.0933,-0.0017,0.011,-0.0045,0.0137,-0.0016,-0.0049,-0.0051,0.0069,0.0071,-0.0242,-0.0249,0.0106,0.0181,-0.0012,0.0148,0.0043,-0.005,-0.0112,0.0315,-0.0188,-0.0217,0.0004,0.0215,0.028,0.0083,0.0132,0.0093,0.0221,0.0126,-0.0003,-0.0009,-0.0114,-0.0031,-0.0037,-0.0332,-0.0194,-0.0261,-0.0306,-0.0103,-0.0025,0.0156,0.0098,-0.0104,0.0059,0.0016,0.0137,-0.0116,0.0246,0.0059,0.019,-0.0069,0.021,0.054,0.0476,0.0326,-0.0286,-0.0106,0.0383,0.0067,0.0089,0.0148,-0.0198,-0.0003,-0.0006,-0.0035,-0.0082,0.0286,0.0004,0.0042,0.0042,0.0047,-0.0075,-0.0221,0.008,0.0122,0.0114,-0.0019,0.021,-0.0045,-0.0247,0.0042,0.0009,0.0193,0.0108,0.0235,-0.0079,0.0175,-0.0333,0.0133,-0.0188,-0.0138,0.0192,0.0073,-0.0023,-0.0002,0.037,-0.0503,-0.0205,0.0035,0.0087,-0.0202,0.0004,0.0071,0.0081,0.0413,0.0017,-0.0137,0.0043,0.0061,-0.0046,0.0236,-0.0062,-0.0137,-0.0168,0.0262,0.0184,0.0192,0.0507,0.0523,-0.0092,-0.0016,0.0212,0.0078,0.0002,0.0128,0.0054,0.0412,0.0006,-0.0128,0.0344,0.0223,0.0131,0.0134,-0.0041,-0.0081,-0.0157,0.0065,-0.0315,-0.0002,0.0277,0.0041,-0.0128,0.0079,0.0044,-0.0145,0.0291,-0.0048,0.019,-0.0093,-0.0006,-0.0194,0.0096,-0.0071,-0.0239,0.0098,-0.0135,0.0228,-0.0214,0.0678,0.0491,0.0627,-0.004,0.0609,0.0502,0.0234,0.0336,-0.0272,-0.0256,0.1055,-0.0346,-0.0543,-0.0189,0.0098,0.0079,-0.002,0.0422,0.0259,0.0539,0.0078,0.0018,-0.0128,-0.0017,-0.0025,-0.0109,0.0099,0.0473,-0.0241,-0.0003,-0.0215,0.104,0.0636,0.1564,0.0453,0.0004,0.0183,0.0074,-0.0267,0.0302,0.0151,0.0107,-0.0016,0.009,0.0153,-0.0052,0.0266,0.0054,0.0135,0.0163,-0.0164,0.0201,-0.0064,0.007,0.0773,0.0161,0.0387,0.0039,-0.0189,-0.033,-0.0285,-0.0116,-0.0128,-0.0045,-0.0126,-0.0045,-0.002,-0.02,-0.0089,-0.0094,0.0179,0.0027,-0.0077,-0.0007,-0.0056,-0.003,-0.0092,-0.0192,0.0325,0.0091,-0.008,-0.032,-0.0199,-0.0067,0.0419,0.0237,0.0002,0.02,0.0296,0.0081,-0.0004,0.0165,-0.013,0.0477,-0.001,0.0287,0.0025,0.014,0.0223,-0.0084,-0.0045,-0.0081,-0.0285,-0.0047,0.0056,-0.0332,-0.0098,-0.0103,-0.0174,-0.0011,0.0003,-0.0042,-0.0075,0.0355,0.0081,-0.013,-0.0213,-0.0067,-0.0249,0.0304,-0.0157,0.0179,-0.0182,-0.0001,-0.0005,0.0162,-0.0309,-0.0245,-0.0439,-0.01,0.0175,-0.0022,0.0289,-0.0275,-0.0235,0.0078,-0.0306,0.0582,0.0178,0.0256,0.0023,-0.0178,0.0083,0.0417,0.0222,0.0232,0.0114,-0.0081,-0.0113,0.0053,-0.0096,-0.0268,-0.027,-0.0108,0.019,0.005,0.0086,0.0056,0.0378,0.0149,0.0083,0.0268,-0.0187,-0.0115,0.0306,0.0363,0.0038,0.0246,-0.0014,0.0068,-0.0226,0.0023,0.0143,-0.0125,-0.0331,-0.0093,-0.0212,-0.0197,0.0003,-0.009,-0.0253,-0.0111,-0.0125,-0.0273,-0.0163,-0.0135,-0.0105,-0.0117,-0.0167,0.0131,0.0427,0.0372,0.034,0.002,0.0046,0.0234,0.0198,0.0488,0.0062,0.0003,-0.0009,-0.0048,-0.0268,0.0058,0.015,0.0575,0.0155,-0.0119,-0.0101,-0.0028,-0.0118,-0.0027,-0.0257,0.0118,-0.0022,-0.0123,-0.0159,0.0231,-0.0098,-0.015,0.0107,-0.0032,-0.0162,0.0004,0.0114,-0.0085,-0.0178,-0.0085,-0.0058,0.0386,0.0026,0.0271,-0.0125,0.0171,-0.0134,-0.0187,0.0042,-0.0138,-0.0062,-0.0068,-0.003,-0.0028,0.0456,-0.028,0.008,-0.0057,-0.0343,0.0068,0.0286,0.0037,-0.0032,0.003,0.0023,0.0544,0.047,-0.0347,0.0065,-0.0101,0.0102,0.0086,0.0116,-0.0218,-0.0038,0.0003,0.0322,0.0163,0.0084,-0.0029,0.003,-0.0044,0.0177,-0.0094,0.0021,0.011,0.0144,0.0084,-0.0175,-0.0179,-0.0088,0.0011,-0.003,0.0054,0.006,0.0264,-0.016,0.0306,-0.0329,-0.0214,-0.0398,-0.0069,-0.0085,-0.0042,-0.0224,0.0059,-0.005,-0.0296,-0.0057,0.0127,0.0032,0.0123,-0.01,-0.0141,-0.0071,0.0045,0.0284,-0.0131,-0.0104,0.0046,-0.0089,-0.013,-0.023,-0.0149,0.0064,0.0045,-0.028,0.0218,-0.006,-0.0137,-0.0056,0.0004,0.0041,0.0179,-0.0055,0.0084,-0.0127,-0.0127,-0.043,0.0109,0.0213,0.0246,0.035,-0.0085,-0.0024,0.0261,0.001,0.0034,0.0038,0.0279,-0.007,-0.0048,0.0088,0.0164,-0.0288,-0.0245,0.0061,-0.0304,0.0261,-0.0131,-0.0004,-0.0261,0.0238,0.0143,-0.0124,-0.0144,0.0026,-0.0204,0.0114,0.0368,-0.0122,-0.0108,-0.0149,0.0053,-0.0144,0.0124,0.0315,0.0023,-0.0134,-0.0008,-0.0262,0.0088,0.0252,-0.0032,-0.0227,-0.0128,-0.0284,-0.013,-0.0146,0.0151,0.0114,0.0458,0.0117,0.0182,-0.0104,-0.0034,-0.027,-0.0136,-0.0262,-0.0261,-0.0191,-0.0118,-0.0235,-0.0346,-0.0034,-0.0229,-0.0142,-0.0494,-0.0171,0.0069,-0.0271,-0.0166,-0.0301,-0.0278,-0.0276,-0.0225,0.0003,-0.0502,-0.0131,-0.0149,-0.007,-0.0308,-0.0034,0.0176,-0.0172,-0.0095,-0.0324,0.033,0.0023,-0.0192,0.1421,0.0401,0.03,0.0169,0.0179,0.0075,0.0206,0.045,0.0287,0.0432,0.0388,-0.0123,0.0026,-0.0149,0.0141,-0.0064,0.0039,0.0015,0.0019,-0.0006,-0.0136,0.0306,-0.0098,0.0242,0.0216,0.0103,0.005,0.0151,-0.0013,-0.0001,0.0359,-0.0136,-0.0024,-0.0049,0.0108,-0.02,0.0062,-0.0135,0.0243,-0.001,-0.0294,-0.0323,-0.0086,-0.0149,-0.0217,-0.0179,-0.0158,0.0203,-0.0009,-0.0085,-0.0168,-0.0129,-0.0117,0.011,-0.0036,-0.0105,visual pseudoword recognition
trm_557b4acdee820,-0.108,-0.1037,-0.0845,-0.1373,-0.0005,-0.0321,-0.0498,-0.0645,0.0005,-0.0726,-0.0027,-0.0022,-0.0732,-0.0147,-0.1178,-0.0809,-0.1055,-0.1238,-0.0522,-0.0649,-0.0888,-0.0054,-0.03,0.0513,-0.0414,-0.0081,-0.0077,-0.0806,-0.1198,-0.0632,-0.0942,-0.0715,-0.0744,-0.0962,-0.0712,-0.1017,-0.0234,-0.0139,-0.139,-0.0708,-0.0944,-0.0909,-0.0448,0.0499,-0.1019,-0.0768,0.1021,-0.1037,-0.0021,-0.0978,-0.0711,0.0005,0.032,-0.0458,-0.0625,-0.0432,-0.0947,0.0111,0.02,-0.0384,-0.0326,-0.0013,-0.1227,0.054,-0.0131,0.0255,-0.1873,-0.2143,-0.1435,0.0228,0.0523,0.0255,0.1171,-0.0368,-0.1308,0.0809,-0.0789,0.0053,0.0487,-0.0063,0.0746,0.0431,-0.0229,-0.095,0.0094,0.0259,-0.0121,0.0161,0.0332,-0.1264,-0.0423,-0.0347,0.0327,0.102,0.1289,0.1067,0.0855,0.0095,0.1247,0.0571,-0.0049,-0.0056,0.0549,0.0131,0.0264,-0.094,-0.1295,0.1816,-0.0518,-0.036,-0.0124,-0.1009,0.0746,0.1119,0.0253,0.0226,-0.0957,0.0342,-0.0273,-0.0545,-0.1135,-0.1234,-0.0877,0.0252,-0.0749,-0.0986,-0.1105,0.022,0.0749,0.0642,0.0353,-0.083,0.0168,-0.0871,-0.0356,-0.1694,-0.035,-0.0657,-0.0116,-0.017,-0.089,-0.1135,0.0985,-0.0485,-0.0903,0.0105,-0.0862,-0.0212,-0.0711,0.091,-0.049,-0.0805,-0.072,-0.1257,0.0635,-0.0245,0.0766,-0.0386,0.0386,-0.0168,-0.0923,-0.0998,-0.195,-0.1826,0.0157,0.051,0.0189,-0.1324,-0.1273,0.0131,-0.0081,-0.1154,0.0684,-0.0103,-0.0607,-0.0574,-0.0378,-0.0342,0.013,-0.0138,-0.0985,0.1121,-0.0623,-0.0015,-0.068,-0.0552,-0.038,0.0566,0.0759,-0.1196,-0.1072,-0.0851,-0.0412,-0.1602,-0.1412,-0.2126,-0.1939,-0.0444,-0.0109,-0.1082,-0.0508,0.1045,-0.0976,-0.1193,-0.0736,-0.0266,0.0217,-0.0867,-0.0864,-0.0287,-0.1001,-0.0163,0.0474,0.0381,0.0534,0.037,0.1142,-0.0842,-0.1006,-0.0023,0.0849,-0.0789,-0.0711,-0.0382,0.0284,0.0213,-0.1116,0.091,0.0128,0.051,-0.0079,-0.0317,0.1029,-0.1228,-0.1155,0.0389,0.0213,0.0333,-0.0072,-0.0224,-0.0624,-0.1252,-0.0737,0.0051,-0.0853,-0.0499,-0.0313,-0.1173,-0.0591,-0.0693,0.0368,0.0477,0.025,0.0693,-0.0256,-0.1234,0.0191,-0.0602,0.132,0.1415,-0.0005,0.0692,-0.1053,0.0028,0.0756,0.1499,0.0194,-0.0335,0.0499,-0.0083,-0.0706,-0.0695,-0.0509,0.0264,-0.0441,0.0991,-0.0443,-0.0651,-0.0852,-0.0121,0.0706,0.017,0.0239,-0.1299,-0.0993,-0.0694,0.0718,0.1251,-0.1076,-0.0698,-0.033,-0.0437,-0.0415,-0.0558,-0.0932,-0.0439,0.0136,0.0076,-0.0543,0.0466,0.0333,-0.1282,-0.0812,-0.0405,-0.0752,-0.0729,-0.1034,-0.0342,0.0245,0.0204,0.0069,-0.0026,-0.158,0.0317,0.0361,-0.0784,0.0619,0.0571,0.0477,-0.1304,0.0203,0.027,-0.0463,-0.088,-0.0363,-0.0922,-0.0053,-0.052,-0.0351,-0.0699,0.0214,-0.0614,-0.0219,0.0161,0.048,0.0179,0.1013,-0.0298,0.0489,-0.1221,-0.1148,-0.0015,0.0027,-0.0036,0.0398,0.0141,-0.1597,-0.0962,-0.1107,-0.0723,-0.0506,0.1147,-0.0511,0.0072,0.007,-0.0512,-0.0585,-0.0532,-0.127,-0.0818,-0.0034,-0.0321,-0.0455,-0.0327,-0.0268,0.0628,-0.1184,0.0179,0.0486,-0.1192,-0.041,0.0117,-0.0276,0.1161,-0.1017,-0.0437,-0.0922,0.096,0.2196,0.1423,0.2593,0.0064,-0.1442,-0.0629,0.0511,0.0645,-0.0354,0.0099,0.0109,-0.0439,-0.03,-0.067,-0.0849,-0.0637,0.0173,-0.0029,-0.0548,-0.0853,-0.0792,-0.0745,-0.0325,0.0209,-0.006,-0.0091,0.0104,0.0355,0.0659,-0.0485,-0.0775,-0.0296,-0.0836,-0.0908,-0.0699,0.1935,-0.0527,-0.0234,0.2092,-0.0406,-0.1204,-0.0569,-0.0073,-0.1539,-0.1135,-0.29,-0.2345,-0.1298,-0.1705,-0.0609,-0.1126,-0.1175,-0.0324,0.089,0.0205,0.0145,0.0195,0.0509,0.036,0.0234,-0.2229,-0.1193,0.0347,0.0691,-0.0704,0.0945,-0.0318,-0.0601,0.0571,0.086,-0.093,-0.1347,-0.0809,-0.0002,-0.106,-0.1128,-0.0098,-0.1222,0.0646,-0.1048,-0.0506,-0.0175,-0.0011,-0.0773,0.0017,0.0549,-0.0955,-0.1207,0.0089,0.2355,-0.0816,-0.0059,-0.0137,0.0449,-0.0153,0.0069,0.0491,-0.0671,0.0208,0.0248,0.0066,-0.0654,0.0508,-0.029,-0.0124,0.0563,0.0392,0.0968,-0.0014,-0.0418,-0.0637,-0.0355,0.1026,0.0938,-0.1177,-0.1197,0.0299,0.0292,-0.0603,-0.0565,0.0012,-0.1251,-0.1198,0.0146,-0.1049,-0.1217,-0.1018,-0.0312,0.0423,0.0512,-0.0434,0.0693,-0.1407,0.0153,-0.0141,-0.0156,0.0716,0.0258,-0.0942,-0.0615,0.0769,-0.0488,-0.0756,-0.0861,0.0583,-0.0395,0.1121,0.0366,0.0777,0.1338,0.0987,0.0486,-0.0465,-0.0102,-0.0229,-0.1651,0.0066,-0.0082,-0.136,-0.1172,-0.0408,-0.068,-0.0144,0.0352,0.0159,-0.0145,-0.0608,-0.01,-0.021,0.0369,0.0465,-0.0802,0.0831,-0.0311,-0.0274,-0.0017,-0.0161,-0.0923,0.1163,0.0441,0.0981,-0.084,-0.0514,0.0301,-0.0731,0.0003,-0.0433,0.0641,0.0637,0.0416,-0.0245,-0.0076,-0.0816,0.003,-0.1355,-0.032,0.0714,0.0771,0.082,0.012,0.0326,0.0366,0.0203,-0.1163,-0.0181,-0.0565,0.0212,-0.0231,-0.1014,0.0092,0.0304,-0.0342,-0.0611,-0.0586,0.0089,0.0155,-0.1056,-0.0546,-0.1812,0.0153,0.1059,-0.0335,0.0408,0.0608,0.047,0.0712,-0.0103,0.032,0.0023,-0.1213,-0.1192,-0.0238,-0.1145,-0.0487,0.0079,-0.0092,-0.1856,-0.0658,-0.0926,0.0069,-0.0199,-0.174,-0.0874,-0.1894,0.0879,0.0344,-0.0271,0.062,-0.0984,-0.0348,-0.1001,-0.0053,0.0425,0.0089,-0.0353,-0.0337,-0.1024,0.0148,0.0082,-0.0703,-0.0503,-0.0475,-0.0522,0.0454,0.0184,0.0489,-0.1185,-0.0496,-0.0959,-0.0798,0.0644,-0.1276,-0.0293,-0.0794,0.0135,-0.121,0.0032,-0.0795,0.061,-0.0675,-0.0016,-0.1287,-0.0903,0.0324,0.1236,0.0155,0.024,0.0147,-0.0772,-0.1197,-0.0363,-0.043,-0.0192,-0.0182,-0.0511,-0.0391,-0.0416,-0.0856,0.1539,-0.0845,0.0184,-0.0409,0.0131,0.0609,0.0049,-0.0264,0.0918,-0.1477,-0.0649,0.0067,-0.0192,-0.0145,-0.0083,0.0486,0.0429,0.0277,-0.0411,-0.0216,0.0419,-0.0267,-0.0569,-0.0473,-0.0044,-0.0129,-0.0448,-0.0193,-0.0533,-0.0174,-0.1285,-0.1203,-0.1087,0.0371,0.0635,0.0264,-0.0583,0.1105,0.0197,-0.0127,-0.0486,0.0572,-0.0881,0.0263,0.155,-0.0422,-0.2117,-0.2139,-0.1241,-0.0397,-0.0277,-0.0986,0.0006,-0.0503,0.1067,0.0347,-0.0664,-0.0063,0.0365,-0.0164,-0.1268,0.0847,0.0437,0.1219,-0.0876,0.0062,-0.087,0.0421,0.0156,-0.108,0.0521,0.0875,-0.0517,0.0265,0.014,0.0887,-0.0964,-0.1607,-0.1361,-0.0962,0.0159,0.1411,0.0056,-0.0892,0.0383,-0.0055,0.0261,0.047,0.0181,0.0069,-0.0436,-0.0733,-0.0423,0.0437,0.055,0.0853,-0.0307,-0.0406,0.0225,-0.0585,0.0225,-0.0481,-0.1257,-0.0388,-0.1052,-0.0915,-0.0441,0.0815,0.0867,0.0491,0.0222,-0.0132,-0.027,0.0674,-0.0225,-0.074,0.0904,-0.0104,0.0315,0.0063,0.0437,-0.047,0.0375,-0.1485,-0.1541,0.0166,0.1064,0.0887,-0.0216,0.0619,0.0399,-0.0247,-0.0205,0.1228,-0.02,0.0368,0.1252,0.172,0.0542,0.0058,0.1563,0.1581,-0.0648,0.0556,0.0667,-0.1693,-0.1213,-0.0346,-0.0602,0.1311,-0.2019,-0.0824,-0.1091,-0.0996,-0.1157,-0.0118,-0.0122,0.1312,-0.0751,-0.0499,-0.0682,0.0491,0.0163,0.0348,0.037,0.0306,0.0393,0.0134,-0.011,-0.0366,0.0129,0.0606,-0.0951,0.0829,0.0482,-0.034,-0.0222,-0.0688,-0.0583,0.0416,-0.112,-0.2008,-0.0989,-0.0103,0.0613,0.0598,0.0155,0.0022,0.0661,0.0722,-0.0969,-0.0907,-0.0038,-0.0658,-0.0007,-0.0796,0.0766,-0.086,0.0355,-0.0631,-0.0431,-0.0583,-0.1372,-0.1184,-0.075,0.1053,-0.0823,-0.077,-0.0826,0.0347,-0.0472,-0.1288,-0.0591,-0.1077,0.0231,-0.0314,0.1157,0.0829,-0.0163,0.054,-0.1339,-0.0474,-0.0165,0.0781,-0.0576,0.0051,0.087,0.0229,0.0409,0.2622,0.0835,-0.0224,-0.0442,-0.0478,-0.0952,0.0197,-0.0088,0.0963,0.1533,0.0381,0.0464,-0.0975,0.0555,0.1436,-0.012,-0.0189,-0.03,-0.0476,-0.0634,-0.0176,0.0073,0.0333,-0.0136,-0.0838,-0.0068,0.1413,0.0121,-0.0792,-0.0228,0.0645,-0.0432,-0.0322,-0.0418,-0.1058,-0.116,-0.0502,-0.0695,-0.0408,0.0565,0.0285,-0.0311,-0.069,0.0402,-0.0534,0.0519,-0.021,-0.0602,-0.0362,0.0113,0.0165,0.0408,-0.0054,0.0205,-0.0091,0.0454,0.0608,0.0858,0.1176,0.0837,-0.0284,-0.0487,-0.0508,-0.0043,0.0698,0.0393,0.044,-0.0188,0.1013,0.0232,0.1004,-0.0089,-0.0455,-0.0603,0.0044,-0.0404,-0.0004,-0.1294,-0.0848,-0.0924,-0.079,-0.0591,0.0865,0.0642,0.0302,0.0616,0.145,0.1147,-0.0851,-0.0124,-0.0164,-0.0382,0.0091,-0.0061,-0.0222,-0.0709,-0.0908,-0.0376,0.1116,0.092,-0.0902,-0.0748,-0.0657,-0.1102,-0.045,0.0806,0.0198,0.072,0.1068,0.0726,-0.0909,-0.0137,0.0293,-0.0428,-0.0123,-0.0009,0.0492,0.0023,0.0105,-0.0024,-0.0234,-0.1003,-0.0219,-0.0779,0.0203,-0.1044,-0.0132,0.0477,0.1169,-0.0616,0.0106,-0.0469,-0.0737,-0.0218,-0.0016,-0.0484,-0.0794,-0.0107,0.0146,0.0312,-0.0276,-0.0355,-0.0049,0.0039,0.0017,-0.0221,-0.0514,-0.0808,-0.0887,-0.0686,0.1578,0.0049,0.0839,-0.0855,0.1645,0.1205,-0.0237,0.0276,-0.034,0.08,-0.0093,0.061,-0.09,-0.0661,0.0397,-0.0571,-0.0865,-0.0292,-0.0135,0.0953,0.1351,-0.0227,-0.0055,-0.053,0.0777,0.0429,-0.0087,0.0443,0.0048,-0.0755,0.0114,-0.0323,0.0076,-0.0054,-0.0414,0.3402,0.2124,0.1158,0.0274,0.05,-0.0257,0.0888,0.1132,-0.1437,0.4266,0.3974,0.3115,0.2255,0.3623,0.1598,0.1369,0.1146,0.0292,0.0826,0.0122,0.0567,0.0046,-0.1001,0.0657,0.0588,0.0583,0.0663,-0.0349,-0.0367,0.1681,0.0692,-0.0557,-0.04,-0.0972,0.0866,0.0488,0.109,-0.0636,-0.1424,0.0211,0.0767,0.0971,0.093,0.1374,-0.031,-0.0632,-0.0735,-0.0469,-0.04,0.3989,-0.0992,0.0725,0.0538,-0.0181,0.0459,-0.0251,0.1107,0.1103,0.085,0.0741,0.1015,-0.0489,-0.0038,0.0381,-0.0655,-0.1358,-0.0194,-0.0418,0.087,0.0193,-0.0738,-0.0615,-0.076,-0.0071,-0.0017,-0.0161,-0.0968,0.0383,0.1918,-0.0077,-0.011,-0.0456,0.1521,0.0349,0.0152,-0.1593,-0.1569,-0.0162,-0.1119,-0.0462,-0.0793,-0.077,0.0069,-0.0081,-0.0258,0.0002,-0.0065,0.0651,-0.0352,-0.0215,-0.0728,0.0386,-0.0049,0.0114,-0.0588,-0.0141,0.104,-0.0482,-0.0756,0.0607,0.0474,-0.0461,-0.0637,-0.0202,-0.1331,-0.0686,-0.1904,-0.023,0.0703,-0.1138,-0.0395,0.0225,-0.0758,0.0187,-0.0619,-0.0263,-0.043,-0.0989,-0.0771,0.0552,-0.0167,0.4575,0.4049,0.2735,0.3968,-0.1255,-0.0194,-0.0731,-0.0653,-0.1252,-0.0394,-0.0747,0.135,-0.039,-0.0568,0.068,0.0354,-0.0411,0.1065,0.0091,0.0217,0.0128,0.088,-0.0704,-0.059,-0.0584,0.1186,-0.0308,-0.0043,-0.047,-0.047,-0.1344,-0.004,-0.0081,0.0108,-0.0487,0.0737,-0.0742,0.1813,-0.2274,-0.2089,0.0579,-0.0018,-0.1705,-0.1731,-0.1528,-0.0287,-0.0124,-0.0046,-0.0198,-0.0088,0.0299,0.033,0.1121,-0.0532,0.085,-0.0514,0.025,0.0816,-0.0267,-0.0466,-0.019,-0.0451,-0.0376,-0.0665,0.0137,0.0385,0.0537,0.0901,0.0346,0.1193,-0.0356,0.1001,0.0287,0.0154,-0.0208,-0.059,0.0072,-0.112,-0.1726,-0.0179,-0.0372,-0.1426,0.0043,-0.0158,-0.1287,-0.0088,-0.0473,0.0024,-0.1312,-0.0137,-0.0976,-0.1256,-0.0111,-0.0117,-0.0262,0.1445,0.065,0.0108,0.0212,0.0008,-0.0031,0.0105,-0.0721,-0.0687,-0.0025,-0.0874,-0.029,-0.0812,0.0224,0.0283,0.0098,-0.0232,-0.0719,-0.1025,-0.0233,0.072,-0.0302,-0.0113,0.0127,-0.0136,0.0067,-0.0871,-0.0478,-0.1058,-0.0795,0.0195,-0.1303,-0.1318,-0.0045,-0.0025,0.0129,-0.0558,-0.0247,-0.0921,-0.0945,0.0164,-0.0917,0.0213,0.0642,-0.0325,-0.0392,-0.1172,0.0416,0.126,0.0307,0.0143,0.0113,-0.0325,0.2382,0.0155,0.0379,0.0174,-0.137,0.1006,-0.0423,0.107,0.0336,0.1681,0.015,-0.0591,-0.0434,0.0766,-0.0634,-0.0172,-0.0353,-0.0009,-0.1118,-0.0646,0.0061,0.0008,-0.0274,-0.0819,-0.0799,0.0393,0.0287,-0.0309,0.0362,-0.0917,0.0054,-0.0261,-0.0768,0.053,-0.0288,-0.0695,-0.0575,-0.0878,-0.0809,-0.0649,-0.0265,-0.043,0.0205,0.0239,0.0839,-0.0113,-0.0499,-0.0736,-0.003,0.0018,-0.0561,-0.1476,0.0716,-0.0311,0.0792,0.0143,0.1068,0.0174,0.0198,0.0298,-0.0666,0.0211,-0.0248,-0.0213,-0.1324,-0.0017,-0.0652,0.0284,0.0236,-0.0306,-0.0378,-0.085,-0.0542,0.0683,0.0345,-0.0333,0.3468,-0.0125,0.0492,-0.0251,0.184,0.0107,-0.0306,0.1044,0.1538,-0.0782,-0.0166,-0.0774,-0.0925,-0.0851,-0.0503,0.0483,-0.048,-0.0472,0.0938,0.1395,-0.0828,-0.0534,-0.0434,0.0176,-0.0058,0.0567,-0.1593,-0.084,-0.018,-0.1605,-0.1058,0.107,0.0061,0.0387,0.0276,0.0969,0.0349,-0.1496,-0.0883,-0.0187,-0.036,-0.1385,-0.0601,-0.0149,-0.048,-0.0796,0.0991,0.0115,-0.0092,0.068,0.0172,0.0798,0.0609,-0.0297,0.0685,-0.0266,-0.028,-0.0841,0.0043,0.0402,0.004,0.0548,0.1318,0.0194,-0.0015,-0.0442,-0.0338,-0.056,0.1541,0.1452,-0.1511,-0.1485,0.0188,-0.0332,-0.0571,0.0133,-0.1207,0.0524,-0.0518,0.003,-0.0042,-0.0153,0.1117,-0.0534,-0.0,0.0711,-0.0204,0.0095,0.118,0.0223,-0.0586,0.1452,0.0339,0.0303,0.0851,0.0634,-0.0655,0.0801,0.0374,-0.0634,-0.0269,0.0718,0.0294,0.0964,0.0419,-0.0316,-0.0434,-0.0377,0.1128,-0.0843,0.0363,0.1217,-0.0116,-0.0245,-0.005,-0.0067,-0.089,-0.026,0.0726,-0.0529,0.0746,-0.0473,0.0645,0.1018,-0.0767,-0.0367,-0.0195,0.0564,-0.0049,0.1059,0.0754,0.1051,0.0434,0.1233,-0.0413,0.0096,0.3409,-0.0617,-0.1182,-0.0344,-0.0545,0.0512,0.0439,0.106,-0.0804,0.0286,0.0183,-0.0443,-0.0209,-0.0083,-0.0335,0.0062,-0.0121,0.0456,0.0937,0.1253,0.1805,0.1894,-0.0388,-0.0808,-0.0696,-0.0363,0.0848,0.0914,0.0033,0.0709,0.0654,-0.0111,0.1151,-0.036,-0.1567,-0.103,-0.0223,0.0388,-0.0239,0.0608,0.0037,0.1088,0.0888,0.0336,-0.03,-0.0561,0.0076,0.0031,0.057,-0.0788,-0.0782,-0.093,0.0819,-0.0511,-0.0272,0.051,-0.0762,-0.0317,0.0273,0.0143,-0.0051,0.0519,0.0427,-0.0072,0.0641,0.0169,0.0972,0.0364,0.0715,-0.0496,0.0349,0.0612,-0.0173,-0.0868,0.0418,-0.1282,-0.0816,-0.0632,-0.123,-0.0424,0.0849,-0.107,0.0768,-0.0448,-0.0124,-0.0107,0.0243,-0.0747,-0.0141,-0.016,0.0273,-0.0311,-0.0015,0.0721,-0.0217,0.0149,-0.1618,-0.1148,-0.1127,-0.0003,-0.0104,-0.0796,-0.0797,0.0229,-0.0727,-0.0545,0.1168,-0.0255,0.0594,0.0691,-0.007,0.0446,-0.0442,-0.0025,-0.0145,-0.0401,-0.1766,-0.0574,-0.0773,-0.0804,-0.0202,0.0347,0.0809,0.2737,0.1926,0.0376,0.0819,-0.0731,-0.2468,-0.1221,-0.184,-0.1204,-0.0248,0.0184,0.019,-0.079,-0.1235,-0.1074,-0.0439,0.0506,0.0475,-0.0304,-0.0748,0.0471,-0.0064,-0.1489,-0.1062,-0.055,0.0336,-0.0187,-0.0244,-0.1722,-0.1078,-0.0843,-0.0792,-0.1897,-0.0175,0.0016,-0.0081,-0.0862,-0.0601,-0.0561,-0.0405,-0.1132,-0.0331,-0.0566,-0.0162,0.0982,0.0034,0.0568,0.043,-0.0938,-0.0054,-0.0082,0.0347,-0.0429,-0.0078,-0.0948,0.052,-0.1159,-0.0912,-0.0648,-0.0856,-0.0517,-0.1068,-0.0817,-0.0897,-0.0047,-0.0578,0.0208,0.0142,-0.1587,0.0211,-0.0305,-0.0878,-0.0375,-0.0758,-0.0535,-0.1255,-0.0575,-0.0222,0.0714,-0.024,-0.0092,-0.1708,-0.093,-0.1202,-0.0466,-0.1214,-0.0917,0.0143,0.0682,0.0439,0.0101,-0.0449,-0.0237,0.0677,0.1528,0.0891,-0.207,-0.2197,-0.0724,0.0209,-0.0013,-0.0513,0.0272,-0.0646,0.026,-0.0588,-0.0598,-0.0315,-0.0237,-0.0573,-0.0806,0.0055,-0.0984,0.0162,-0.0931,-0.0289,0.0476,0.0478,-0.0617,-0.0729,-0.0633,-0.1267,-0.051,-0.1779,-0.0779,0.1904,-0.0491,-0.0678,0.0614,0.0439,0.0591,0.039,0.0098,0.0195,0.105,0.0311,0.0085,0.0378,-0.0081,0.0522,0.0256,0.0916,0.1076,-0.1011,-0.0125,0.0555,0.1246,-0.0096,-0.0224,0.0691,-0.0094,-0.0173,0.0103,0.0307,0.0259,0.0702,-0.0618,-0.0631,-0.068,0.0157,-0.0844,0.0719,0.1618,0.1883,0.022,0.0753,0.0815,-0.0037,0.0148,0.1008,0.0203,-0.0045,0.0254,-0.1647,-0.0731,-0.1228,-0.0482,0.0304,-0.0982,-0.0887,-0.0495,0.0481,-0.0728,-0.1072,-0.0652,-0.0715,-0.133,-0.2038,0.0145,-0.1563,-0.0433,0.0446,-0.1188,-0.0027,-0.128,-0.0455,-0.0055,-0.0545,-0.076,-0.0096,-0.0678,0.0369,0.0884,0.0554,-0.0084,-0.0655,0.0133,0.0242,0.0369,0.1098,0.0164,-0.0303,0.0564,-0.0228,-0.0281,-0.1169,-0.0897,-0.0229,-0.0293,0.0165,-0.0021,-0.0684,-0.0796,-0.0349,-0.0291,0.089,-0.1064,-0.0409,0.078,0.0354,0.0037,0.0289,0.0316,-0.1549,-0.0558,-0.1312,-0.0937,0.0294,0.0874,0.0918,-0.1058,0.3318,0.2307,-0.1576,-0.0843,0.3682,0.1395,0.0699,0.0895,0.1457,0.1184,-0.1271,-0.1249,-0.042,-0.0816,0.3505,0.3206,0.2412,0.0519,0.03,0.2357,0.3879,0.3989,0.3694,0.0376,-0.013,-0.0417,-0.0076,-0.0489,-0.0118,-0.0924,-0.0317,-0.0625,-0.0461,-0.0959,-0.0975,0.096,-0.0137,-0.0344,-0.059,0.0715,0.0422,0.0928,-0.0045,-0.0143,-0.0714,-0.0349,-0.0587,-0.0238,-0.0586,-0.0533,-0.0219,0.008,-0.1022,-0.142,-0.1251,-0.036,-0.0729,-0.0124,0.1148,0.0331,0.0346,0.0586,0.063,0.2652,-0.0466,-0.1244,-0.1716,0.0262,0.0584,-0.0157,0.0716,0.0179,0.0614,0.0355,-0.1081,-0.1116,-0.0762,-0.071,0.0831,-0.1656,-0.1135,-0.0169,0.0294,0.1074,-0.047,0.0155,0.059,-0.0095,-0.0453,0.0095,-0.0857,-0.1059,-0.1075,-0.0255,-0.0004,-0.0251,-0.0181,-0.069,0.0382,0.0356,0.0491,0.0065,0.0622,-0.048,-0.063,0.0303,0.0263,0.101,0.0472,0.0033,-0.0047,-0.0545,-0.014,-0.0149,-0.0285,-0.0318,-0.0304,-0.0143,-0.0484,0.0363,-0.0065,-0.0069,-0.0108,0.0243,0.0352,0.04,0.1057,0.0622,0.165,0.0996,-0.1058,-0.1054,-0.0879,-0.104,-0.1583,0.074,-0.0144,0.005,-0.0249,0.127,0.0157,-0.1701,-0.0362,0.0474,-0.0083,0.029,0.052,0.0897,0.1077,0.2249,0.2912,0.1216,-0.0069,-0.065,-0.0472,0.044,-0.0726,-0.0852,-0.0881,0.0036,-0.0799,-0.0323,-0.0541,-0.0399,-0.0556,-0.1314,-0.1278,-0.1032,-0.0477,-0.0935,-0.1018,-0.0622,-0.1133,-0.0216,-0.008,-0.0357,-0.0567,-0.0649,0.143,0.0685,0.0749,-0.0635,0.1328,0.1254,-0.0707,0.0583,-0.1162,-0.0783,-0.0084,-0.04,-0.0482,0.0021,0.0334,0.0678,-0.0039,-0.0825,-0.0256,-0.0194,-0.0072,0.0313,-0.0386,0.0136,0.0006,0.0009,0.0638,-0.0957,-0.0922,-0.0533,-0.0773,-0.0456,-0.0296,-0.057,-0.0207,0.0826,-0.0123,-0.0306,-0.1819,-0.0906,-0.1089,-0.1396,-0.1257,-0.1012,-0.1023,-0.1023,-0.0249,-0.0491,0.0049,-0.1283,0.0259,-0.0457,-0.0433,-0.0391,0.0418,-0.2407,0.0777,-0.0934,-0.0147,0.0571,0.049,0.0785,0.0069,-0.0759,-0.1139,0.0732,0.0936,-0.0069,0.0159,0.0535,0.006,0.1167,0.067,0.0112,0.0442,-0.0001,-0.0087,0.0268,-0.2025,-0.1129,-0.0431,-0.0906,-0.0329,-0.0336,-0.0293,0.022,-0.0159,-0.0563,0.0044,0.0631,-0.0164,0.1103,0.035,-0.1631,-0.104,-0.1849,-0.0557,-0.076,-0.0035,-0.0322,0.0939,0.0846,-0.0008,0.0644,0.041,-0.0111,0.126,0.0224,0.2137,0.135,0.0179,0.0625,-0.0721,0.0395,0.0493,0.0632,-0.0415,-0.0105,0.038,0.001,-0.0289,0.0212,-0.0703,0.0449,-0.022,0.0698,-0.0382,-0.0239,0.147,-0.014,0.0965,0.1135,-0.0119,0.0151,0.0252,-0.0987,-0.0852,-0.0309,0.0762,0.0517,-0.0087,-0.024,-0.0626,-0.0037,0.0469,0.0851,0.0074,0.04,0.0312,-0.0468,0.0708,-0.0613,0.0172,0.0316,-0.0359,-0.0778,-0.0774,-0.0616,-0.0538,-0.035,0.0095,-0.073,0.0563,0.0351,0.1247,-0.0207,0.0113,0.0609,-0.0377,-0.0662,-0.0541,-0.138,-0.1048,-0.0163,0.0179,0.0227,0.0075,0.0203,0.1032,0.0361,-0.0858,-0.0601,-0.1227,-0.1038,0.0178,0.021,0.0679,-0.0993,-0.0735,-0.1086,-0.0376,-0.0687,-0.0177,0.0138,-0.0731,0.0318,-0.0486,-0.0414,-0.0128,0.0134,-0.1085,0.0309,-0.0082,0.0108,-0.1178,0.055,0.0102,-0.0856,0.0141,0.0752,-0.0135,0.0157,-0.0816,-0.0789,-0.0727,-0.1109,-0.1073,-0.0454,-0.082,-0.0478,-0.0253,0.0362,0.034,0.0618,-0.095,-0.0777,0.0636,0.1614,0.2601,0.0339,-0.0076,-0.015,-0.0623,-0.0679,-0.0179,-0.1136,-0.059,-0.0714,0.0115,-0.1004,-0.1375,0.2109,-0.009,0.0386,0.2275,0.0399,0.1054,-0.1051,-0.0044,-0.0353,-0.0552,-0.0089,0.014,-0.0004,0.0525,-0.0124,-0.0486,-0.0227,-0.0594,-0.0186,-0.0373,-0.1288,-0.0019,0.0026,-0.0049,0.0006,-0.0013,-0.0011,0.0056,-0.0482,0.0694,-0.1682,-0.0321,-0.1094,-0.1373,0.0039,-0.1209,-0.0872,-0.1646,-0.0927,-0.0354,0.0346,-0.1332,0.0015,-0.0856,0.0445,0.0314,-0.0007,-0.1239,-0.1414,-0.0766,-0.0271,0.0645,0.0556,-0.0357,0.0112,-0.0471,0.0586,0.032,0.0061,0.0253,0.0336,-0.0423,-0.0198,0.0236,-0.046,0.0276,-0.0304,-0.0204,0.0351,-0.0179,0.1159,-0.0486,0.166,0.1413,0.0267,0.0209,-0.0046,-0.1028,-0.0864,0.0256,0.1691,0.2022,0.1476,0.0531,0.0527,-0.016,0.095,0.095,0.0628,0.0209,-0.117,-0.0134,-0.0745,0.0388,-0.0178,-0.0393,-0.0063,-0.0177,0.0624,0.0532,0.0655,-0.042,0.0892,0.0203,-0.0891,0.0588,0.0428,0.0089,0.0046,0.1002,0.0984,0.0403,0.0388,0.0293,-0.0707,0.019,0.1221,0.1104,0.0605,0.0111,0.0866,-0.0072,-0.1365,-0.2952,-0.2867,0.0607,0.074,0.0053,0.0025,0.0049,-0.0303,-0.0793,-0.1019,-0.1265,0.0632,-0.0158,-0.004,-0.0525,-0.015,-0.0184,-0.1105,-0.0258,-0.1098,-0.1075,-0.0018,-0.024,-0.0049,-0.2204,-0.0802,0.0003,-0.0297,-0.0364,0.0363,-0.0456,-0.0631,-0.0774,0.1239,-0.1188,0.0336,0.0033,0.0174,0.0144,0.0315,-0.0006,0.0264,0.0265,-0.0055,-0.0378,-0.0344,0.0411,-0.0471,-0.086,-0.1143,-0.1773,-0.081,-0.0264,0.0025,0.0676,-0.042,-0.0599,-0.0918,-0.1264,0.0334,0.0609,-0.1311,-0.0414,-0.0307,-0.0822,-0.1544,0.2616,0.0668,-0.0462,-0.0097,0.0633,0.0874,-0.0443,-0.0558,-0.1477,-0.1831,-0.09,-0.0909,0.0582,0.0335,-0.0261,0.048,-0.08,0.0239,0.3343,0.0699,0.1003,0.2865,-0.1807,-0.1281,-0.0532,0.0697,0.0158,-0.0253,-0.0621,0.0134,0.0632,-0.1262,-0.0856,-0.0221,0.1824,-0.058,0.0357,0.0531,0.0296,0.074,0.138,-0.0078,-0.0666,-0.0716,-0.0412,0.0545,0.0447,0.0517,0.0609,0.0709,0.0039,0.0291,0.0367,0.0397,-0.0008,-0.0795,0.029,-0.0233,-0.0198,0.0053,0.0253,0.0423,-0.0064,-0.0324,0.0172,-0.0617,-0.0229,-0.1701,-0.0937,-0.0448,-0.0909,0.2531,0.0205,0.2178,0.0463,0.0228,0.0116,0.0186,0.0703,-0.0623,0.0535,0.1164,0.0749,0.056,0.0563,0.0168,-0.09,-0.0246,-0.0064,-0.015,0.0774,0.1072,-0.0634,0.067,0.0467,-0.0023,-0.0058,-0.0005,-0.0309,-0.0721,0.0047,-0.0492,0.1061,-0.0482,0.1274,0.0465,0.0888,0.0182,0.0022,0.0165,-0.0168,-0.0063,0.0436,0.1271,0.03,0.0357,-0.0504,0.0933,-0.0506,-0.0668,-0.032,0.057,0.0714,-0.0067,-0.0966,-0.0466,-0.0956,-0.084,0.0037,0.0846,-0.0093,-0.039,-0.1096,-0.1225,-0.0294,-0.0496,-0.0452,-0.0308,-0.0361,0.0285,-0.0895,0.0094,-0.0363,-0.0075,-0.0655,-0.0519,-0.0121,-0.0767,-0.0798,0.0565,0.002,-0.0012,-0.0645,0.0476,0.1201,-0.0107,-0.0731,0.0346,-0.01,-0.036,0.037,-0.0106,0.0537,0.1946,0.1815,-0.0146,0.0203,0.0572,0.0387,-0.0849,-0.0162,0.0041,-0.0102,-0.0584,-0.0524,-0.0123,-0.0946,0.0266,-0.131,-0.0548,0.0376,0.0441,-0.1687,-0.0181,0.0592,0.091,-0.0123,-0.0774,-0.2995,-0.2551,-0.1284,-0.1854,0.1678,-0.0455,-0.0368,-0.0028,-0.0181,0.0148,-0.0621,0.0053,0.2417,0.1113,0.198,0.0558,0.0636,-0.0503,-0.0139,0.0306,0.0289,0.0084,-0.0183,-0.0088,0.1534,0.0634,-0.0944,-0.169,-0.1012,-0.1046,-0.1166,-0.0082,-0.0092,0.0283,0.0338,0.0157,-0.0045,-0.0104,-0.118,-0.0275,-0.1376,0.0059,-0.1331,-0.1717,0.0183,0.0802,-0.0464,-0.0146,-0.0771,-0.1019,-0.0913,-0.1146,0.0132,-0.0763,-0.0788,0.0071,0.0406,-0.0581,-0.1107,0.0367,-0.0234,0.0063,-0.0802,-0.0675,-0.099,0.0173,0.087,0.0262,-0.0494,0.1151,-0.0499,-0.0444,0.033,0.0337,0.0536,0.0096,-0.0366,0.024,-0.0495,0.0171,0.0597,0.1523,0.1265,0.0492,0.0687,0.0361,0.0159,-0.086,0.1121,-0.0747,0.0868,-0.0009,0.0524,0.0634,0.07,0.0012,-0.0443,0.0011,0.0208,-0.0351,-0.0203,0.0838,0.0551,-0.0076,-0.0677,0.0268,0.0612,0.0013,-0.1692,-0.1024,-0.1547,-0.0097,-0.1188,-0.0786,-0.0068,0.034,0.0314,-0.0114,-0.0812,-0.1014,0.038,0.045,-0.123,0.0457,0.1122,0.0387,-0.0155,0.0462,0.1533,0.0821,0.035,0.0798,-0.0649,-0.0298,0.1504,0.046,-0.0548,0.137,0.0083,0.0066,0.06,0.1376,0.0288,-0.0911,-0.0613,-0.0471,0.0388,0.1609,-0.0443,0.0765,-0.0242,-0.0032,-0.0425,-0.0655,0.0186,0.1012,-0.086,-0.0591,0.0608,-0.0482,-0.0708,-0.0321,-0.0742,-0.1082,-0.0814,-0.0988,-0.0938,-0.1581,-0.1011,0.0804,0.17,-0.0134,-0.0634,-0.019,0.087,-0.0355,-0.0761,-0.1254,-0.1303,0.0445,0.042,-0.105,-0.0954,-0.0509,0.0326,-0.1223,-0.0919,-0.0383,-0.0462,-0.0707,-0.1423,-0.0472,0.0137,-0.0473,-0.0938,-0.0025,-0.0552,0.0501,-0.0752,-0.0092,0.1015,0.0358,-0.1127,0.0112,-0.0915,-0.1178,-0.0757,-0.078,-0.0673,0.0157,0.0687,0.1465,-0.0575,-0.1123,0.0629,-0.0537,-0.0274,0.0125,-0.1283,-0.08,-0.1289,0.0735,0.0383,0.0947,-0.0194,-0.1812,-0.1272,0.0096,0.0221,-0.028,0.024,0.0981,-0.063,-0.0661,-0.0771,-0.0647,-0.093,-0.1584,-0.0844,-0.0916,-0.0215,-0.0185,-0.0045,-0.0115,0.1596,0.0088,0.0308,-0.0195,0.0388,0.0829,0.0733,0.0174,0.0225,-0.1079,-0.0051,-0.0836,-0.0486,-0.0634,-0.0527,-0.0196,-0.0161,-0.0856,-0.0467,-0.0774,-0.0205,-0.0237,-0.0045,-0.0056,0.1803,-0.0099,0.1312,0.036,0.036,0.0215,0.075,0.001,-0.0595,-0.073,-0.0366,0.1109,0.0119,0.01,-0.048,-0.0247,-0.0917,-0.0748,0.0034,-0.0263,0.0495,0.1116,-0.1438,-0.132,-0.0076,-0.0804,-0.0328,-0.0507,0.2435,0.1723,-0.0625,0.0098,-0.011,-0.071,-0.048,-0.064,-0.1336,-0.1122,0.0738,0.0257,-0.0676,-0.0098,-0.0997,-0.0439,0.1452,-0.0031,0.0167,-0.0249,-0.0151,0.0634,-0.0986,-0.0093,0.1305,-0.1037,0.0414,-0.1144,0.1379,-0.1125,0.3418,-0.0274,-0.0173,-0.1048,-0.0913,0.0602,0.0476,-0.0362,0.0349,0.036,-0.0135,-0.052,0.0299,-0.0084,0.0297,0.0521,0.1164,0.1206,0.1749,0.2838,-0.0339,-0.0394,0.1935,0.3833,0.0925,0.172,0.2959,0.1514,0.1417,0.1827,0.1286,0.1671,0.1603,0.1262,0.226,0.0902,0.2172,0.2811,0.2422,0.2671,0.1225,0.0774,0.031,-0.1189,-0.1343,-0.1023,-0.0725,0.0082,-0.1774,-0.165,-0.0975,-0.0201,-0.023,-0.2005,-0.1685,-0.1163,-0.0172,-0.0076,-0.0866,0.098,-0.019,-0.0973,-0.0178,-0.074,-0.0461,-0.0761,-0.0259,-0.0996,0.1057,-0.1687,-0.195,0.0441,-0.0352,-0.045,0.0051,0.0036,-0.1062,-0.0135,0.0055,-0.0674,0.1849,0.2839,0.0282,0.1395,0.1591,-0.0878,0.0331,0.035,-0.0343,-0.0809,0.1448,-0.0374,0.0136,-0.0807,-0.0013,0.1768,-0.0828,-0.0859,-0.0273,-0.0015,-0.043,-0.0419,string maintenance
trm_4a3fd79d0a5ed,-0.0255,-0.0562,-0.014,-0.0756,-0.0131,-0.0243,-0.0422,0.0293,0.0213,-0.0313,-0.0177,0.0115,-0.0489,-0.0241,-0.0269,0.014,-0.0795,-0.1026,0.0098,-0.0742,-0.0579,0.0218,-0.029,-0.0469,-0.0054,0.0151,0.0155,-0.0598,-0.0788,-0.014,-0.0539,-0.1015,-0.0811,-0.0301,-0.0771,-0.067,0.0122,0.0029,-0.0893,-0.036,-0.0637,-0.0404,-0.0206,-0.0181,-0.0433,-0.0458,0.0322,0.0088,0.0427,-0.0597,-0.014,0.0657,0.0591,-0.0013,-0.0612,-0.0534,-0.028,-0.0147,-0.0187,-0.0196,-0.0081,0.0443,-0.075,0.0682,0.0158,0.1027,-0.0834,-0.132,-0.105,-0.0089,0.045,0.0526,0.0681,-0.0587,-0.0168,0.0085,-0.0295,0.0448,0.0114,0.0033,-0.0046,0.0068,-0.0171,-0.0652,-0.0003,-0.01,-0.0267,0.0195,-0.0142,-0.067,-0.0611,0.0421,-0.0488,0.1639,0.1385,0.1099,0.111,0.0414,0.1312,0.1259,0.0022,0.0053,0.0552,0.1123,0.0568,-0.1017,-0.0916,0.0961,-0.0074,-0.0788,-0.012,-0.0419,0.0435,0.1048,0.0115,-0.028,-0.0596,0.0566,0.0247,-0.0431,-0.0808,-0.0867,-0.0934,-0.019,-0.0357,-0.0951,-0.088,0.0355,0.0266,0.0406,-0.038,-0.0585,-0.0068,-0.0854,-0.0462,-0.1148,0.0043,-0.0695,-0.044,-0.0053,-0.0636,-0.0851,0.0005,-0.0367,-0.0548,-0.0003,-0.0069,0.0018,-0.0381,-0.0214,-0.0204,-0.0653,-0.0897,-0.1088,0.0607,0.066,0.0217,0.0257,-0.0147,-0.0552,-0.0656,-0.0627,-0.1256,-0.0944,-0.0374,0.0201,-0.0016,-0.1193,-0.1111,-0.0067,0.0044,-0.0743,0.0094,-0.1081,-0.0496,-0.0908,-0.0626,-0.0761,-0.0318,0.033,-0.0972,0.0118,-0.06,0.002,-0.005,-0.0109,-0.0157,-0.0602,-0.0275,-0.0789,-0.0604,-0.0198,-0.0295,-0.1103,-0.1037,-0.051,-0.0549,-0.0346,-0.0544,0.0367,0.0343,0.0948,-0.0769,-0.0799,-0.0234,-0.0335,-0.1246,-0.0164,-0.0026,-0.0006,-0.0966,-0.042,0.0108,0.0219,0.0179,0.0064,0.0389,-0.0024,0.0377,0.0155,0.0348,-0.0415,-0.0931,-0.0079,0.0402,0.0158,-0.0571,0.0816,-0.0233,0.0041,0.1306,-0.0219,0.0307,-0.0312,-0.0307,0.0717,0.002,-0.0031,-0.0309,-0.0289,0.0135,-0.0523,-0.0158,0.0326,-0.0394,-0.0264,-0.0848,-0.0677,-0.0353,-0.1246,0.0058,0.0435,-0.0238,0.0213,-0.0045,-0.1036,0.047,0.0211,0.0929,0.0477,0.0276,0.0754,-0.0515,0.0192,0.0562,0.0887,0.0012,-0.0181,0.036,-0.0123,-0.0412,0.0341,-0.0922,-0.0157,-0.0167,0.0043,-0.0277,-0.0841,-0.0621,-0.0246,0.0205,-0.0484,-0.0197,-0.1466,-0.1241,-0.0248,-0.0009,0.045,0.016,-0.0315,-0.092,0.0034,0.033,-0.0647,-0.0472,-0.0192,-0.0124,0.0249,-0.0255,0.0375,0.0583,-0.1221,-0.0055,-0.1125,0.0829,0.0877,-0.0462,-0.0256,0.0176,-0.0006,0.0071,0.0076,-0.067,0.0113,-0.0136,-0.0254,0.0402,0.0394,0.0106,-0.056,0.0076,0.0154,-0.0936,-0.0864,-0.038,-0.0353,-0.0359,-0.0732,0.0086,-0.0357,-0.0054,-0.021,-0.0035,-0.0048,-0.0277,0.0432,0.0381,-0.0586,-0.0005,-0.0865,-0.072,-0.0291,0.066,0.0687,-0.0121,0.0052,-0.0834,-0.0163,-0.0514,-0.0771,-0.006,0.0886,0.0079,0.0047,-0.0139,-0.0011,-0.0253,-0.0859,-0.0283,-0.0555,0.0399,-0.0037,0.0328,0.034,0.0265,0.0343,-0.0543,0.0395,0.0008,-0.0691,-0.0412,0.039,-0.0041,0.0815,-0.0756,0.0387,-0.0751,0.056,0.0329,0.0249,0.0547,0.1118,-0.0314,0.015,-0.0008,0.0109,-0.0523,-0.0366,0.0048,0.0129,0.0551,-0.0375,0.0782,-0.0489,0.1448,0.1685,0.0774,-0.0169,-0.0286,-0.0734,-0.0226,0.0113,0.0105,-0.02,-0.0107,0.0226,0.0153,-0.0196,-0.0744,0.0213,0.0153,-0.1177,-0.0476,0.0586,-0.0669,-0.0699,0.0738,-0.0506,-0.0855,-0.0204,0.037,-0.0067,-0.0408,-0.1202,-0.1095,-0.0467,-0.0887,0.0114,-0.0412,0.0226,-0.0147,0.019,0.0079,0.0387,-0.0591,-0.002,0.0621,-0.0065,-0.0993,-0.0328,0.0066,0.0592,0.0437,0.0285,0.0121,-0.0433,-0.0062,0.0204,-0.0682,-0.0463,0.0058,0.0223,-0.0578,-0.0636,0.0335,-0.1166,-0.0412,-0.0273,-0.0351,0.0277,0.0508,-0.0138,-0.0059,-0.0306,-0.0932,-0.0905,-0.0073,0.1096,-0.0624,-0.0068,0.0182,0.0549,0.0662,-0.0405,-0.0464,-0.0319,0.0465,0.041,-0.0039,0.0234,0.0764,0.0422,0.0334,0.061,0.0883,0.0318,-0.0342,0.0581,-0.0779,-0.0067,0.033,0.098,-0.113,-0.1374,0.008,-0.0237,-0.0773,0.0164,0.0007,-0.0645,-0.0726,-0.0331,-0.0781,-0.0521,-0.0435,-0.0104,-0.0221,-0.0326,-0.0267,0.0454,-0.081,0.0234,-0.0133,-0.0147,0.0223,0.0416,-0.0313,0.008,0.073,0.0217,-0.0372,-0.0209,0.0123,0.0688,0.0913,-0.0073,0.0592,0.0811,0.0447,0.0519,-0.0225,0.0013,-0.0084,-0.1448,-0.0199,-0.0046,-0.1041,-0.0566,-0.0284,-0.1029,-0.0658,0.0001,0.0678,-0.0328,-0.037,0.0104,-0.0279,0.0076,0.0091,-0.0577,0.0365,-0.0386,0.0078,0.0427,0.0319,-0.0952,0.0761,0.0494,-0.0167,-0.0284,-0.0668,-0.046,-0.0673,0.0542,-0.0247,0.007,0.014,-0.0902,-0.0211,-0.0087,-0.0401,-0.0475,-0.0677,-0.0098,0.1144,0.2111,0.0339,-0.0023,0.0245,0.0234,0.0252,-0.024,-0.0002,-0.0354,0.0592,0.0081,0.0694,-0.0159,0.0439,-0.0584,-0.0528,0.0257,0.0222,0.0383,-0.0016,0.0681,-0.1101,-0.0312,0.0839,-0.056,-0.0492,0.0272,0.0449,0.0171,0.0371,0.1512,-0.0524,-0.0668,-0.0691,0.0106,-0.0408,0.0051,0.0063,-0.0586,-0.0909,-0.0102,-0.0435,-0.057,-0.0521,-0.1021,-0.0283,-0.0975,0.0369,-0.0278,-0.0324,0.0575,0.001,-0.0602,0.0349,0.0109,0.0653,0.0853,-0.0673,0.0238,0.0049,0.0685,0.0269,0.0041,-0.0504,0.0093,0.016,0.0301,0.0743,0.1133,-0.0571,-0.0192,-0.0835,-0.0546,0.0614,-0.1359,0.0071,-0.0836,0.0536,-0.0965,0.0136,0.0083,0.1835,0.0021,0.0085,-0.0432,-0.1285,0.1025,0.1137,0.0696,0.0721,-0.0101,0.0599,-0.0942,0.0528,0.0257,0.0252,-0.0595,0.0205,-0.0744,-0.0303,-0.0496,0.1224,-0.0598,-0.0015,-0.0451,-0.0092,-0.0026,-0.0215,-0.0047,0.0681,-0.0824,-0.0459,-0.0676,0.0066,0.0781,0.0872,0.055,0.0853,-0.0035,-0.0211,-0.0987,-0.0086,-0.0417,-0.0148,0.0255,0.0439,0.0232,-0.0531,-0.0622,-0.0478,0.0046,-0.0635,-0.0959,-0.0529,0.0405,0.0179,-0.0058,-0.0382,0.0137,-0.0181,-0.0494,0.011,-0.0014,-0.0936,0.0331,0.0479,-0.0093,-0.183,-0.1815,-0.1237,-0.0409,-0.0069,-0.052,-0.0195,0.0658,0.005,0.018,0.0209,0.0377,0.0401,-0.0014,-0.0015,0.0252,0.0468,0.1195,-0.1176,-0.0303,-0.0195,0.0308,-0.0102,-0.0803,0.0464,0.0058,-0.0532,0.0078,0.0024,0.0615,-0.0965,-0.1524,-0.1147,-0.0807,0.0176,0.0072,-0.0224,0.0065,-0.0024,0.07,0.0581,0.0103,0.0338,0.0285,-0.0511,-0.0212,0.0151,0.0431,0.0077,0.0408,-0.0158,0.0076,0.0627,-0.0169,0.0248,-0.0814,-0.0772,-0.0732,-0.0902,-0.0893,-0.0416,0.041,0.0123,0.0187,0.0024,-0.0145,0.0189,0.0216,-0.0141,-0.0635,0.0675,-0.0139,0.0252,0.0167,0.0406,-0.078,0.0501,-0.1176,-0.1109,-0.0125,-0.0182,0.0095,-0.0411,-0.0054,0.0166,0.0017,-0.0048,0.126,0.0266,0.1006,0.0784,0.0745,-0.0023,-0.012,0.0663,0.0687,-0.0486,0.0248,0.0045,-0.1081,-0.0832,-0.0455,0.0037,-0.0166,-0.157,-0.0495,-0.0798,-0.0968,-0.0799,-0.0464,-0.0332,0.0148,-0.0459,-0.0083,-0.0167,0.057,0.0551,-0.0164,-0.008,-0.0311,0.0161,-0.0276,0.0547,-0.0383,0.071,0.0721,-0.0704,0.0593,0.0528,0.0086,-0.0613,-0.0278,-0.0307,0.0319,0.0098,-0.1772,-0.0491,0.0142,0.0566,0.0123,-0.0026,0.013,0.0593,0.1036,-0.0413,-0.0572,0.0945,0.004,-0.0362,-0.0069,0.1568,-0.027,0.0898,0.0428,-0.0394,0.0433,-0.068,-0.0697,-0.0534,0.0646,-0.0621,-0.0513,-0.0313,0.0142,-0.0219,-0.0764,-0.0381,-0.0845,0.0136,-0.0107,-0.0228,0.0434,-0.0265,0.018,-0.0979,-0.0589,-0.0439,0.0306,-0.0505,0.018,0.0085,0.038,0.0264,0.0871,0.0458,-0.0263,-0.0144,-0.0437,-0.0616,-0.0693,-0.0598,0.0175,0.0654,0.0508,0.0131,-0.0545,0.0251,0.0506,0.0397,0.0044,0.0045,-0.0193,0.094,-0.0159,0.002,0.0389,-0.0037,-0.0462,0.006,0.0778,0.0076,-0.0298,0.0043,0.0432,-0.0546,-0.0664,0.0422,-0.0174,-0.0183,-0.1169,-0.0703,-0.1054,-0.0198,0.0085,-0.0633,-0.057,-0.026,-0.0604,-0.0573,-0.1185,-0.019,-0.0206,0.0178,-0.0064,0.0387,0.0011,-0.0151,0.0333,-0.004,0.0695,-0.0167,0.0302,-0.006,-0.0663,-0.0298,0.0022,0.0391,0.0161,0.0066,0.0517,0.0275,0.018,-0.0142,0.0325,-0.0272,-0.0311,-0.0008,-0.0125,-0.032,-0.0169,-0.0825,-0.0888,-0.0068,-0.1288,-0.1084,0.0872,0.0797,0.0249,-0.0131,0.044,0.0467,0.0276,0.0021,-0.0229,0.0365,0.0483,-0.0291,-0.019,-0.0039,-0.0772,-0.0425,-0.0137,-0.0205,-0.0804,-0.0374,-0.0192,-0.1046,-0.0677,0.0553,0.0111,0.0898,0.0325,0.002,-0.0496,-0.0549,0.0059,-0.047,-0.0058,-0.0,-0.0071,-0.0121,0.0507,-0.0101,0.0141,-0.0502,-0.013,-0.0296,0.0081,-0.0629,0.0627,0.1309,0.2169,0.0188,0.0321,-0.0053,0.0263,-0.0207,-0.0382,-0.0529,-0.0538,-0.0047,0.0156,0.08,0.017,0.0397,0.0282,0.0149,-0.0449,0.0469,-0.0777,-0.0254,-0.0878,-0.0501,0.0795,-0.0035,0.0407,-0.0475,0.0772,0.0389,0.0144,-0.0261,-0.0263,0.0057,-0.0084,0.0186,-0.0628,-0.0656,-0.004,-0.0005,-0.0554,-0.0714,-0.0588,-0.0238,-0.0505,0.0251,-0.057,-0.0185,0.013,0.2181,0.0044,0.0369,0.0159,-0.058,0.0492,-0.0522,-0.0074,0.0077,-0.0678,0.1258,0.114,0.1441,0.1203,0.1083,0.0201,0.1372,0.0775,-0.109,0.0514,0.0548,0.0212,0.0158,0.0114,-0.0496,-0.0364,-0.0491,-0.0152,-0.0432,-0.0107,0.0257,0.002,-0.0752,0.0694,0.0765,-0.0147,0.0263,-0.0458,-0.0425,0.0115,-0.0419,-0.0799,-0.0644,-0.0433,0.0342,0.0285,0.0769,-0.0291,-0.1009,-0.0527,-0.0523,-0.0182,-0.0085,0.037,0.0671,0.0058,-0.0898,-0.0935,-0.052,0.059,-0.0218,0.1104,0.0749,-0.0339,0.0282,0.0293,0.1281,0.1234,0.1052,0.0242,0.0616,0.0037,0.0321,0.0275,-0.0188,-0.0666,0.0442,-0.0642,0.0673,-0.0337,-0.0454,0.0155,-0.084,0.0025,0.0019,-0.0134,0.2808,0.1122,0.0287,-0.013,-0.0192,-0.0104,0.0514,0.0299,0.0203,-0.1123,-0.109,-0.0691,-0.0495,0.036,-0.0481,-0.0546,0.0232,-0.0175,0.0775,0.051,0.0737,0.1293,0.03,-0.018,-0.022,0.0143,0.0947,0.0713,-0.0268,0.0353,0.0858,-0.0016,-0.0452,0.0579,0.02,-0.0187,-0.056,-0.0082,-0.0541,-0.0449,-0.1398,-0.0336,0.108,-0.0643,-0.0679,0.0361,-0.0262,0.0399,-0.0031,-0.0322,-0.0485,-0.052,0.082,0.0859,-0.0003,0.0885,0.0613,0.0823,0.0733,-0.0778,0.0036,-0.0164,-0.0729,-0.0538,-0.0464,0.0859,0.0661,-0.0641,-0.0787,0.0142,0.0049,-0.0465,0.0463,-0.0281,0.0651,0.0177,0.1003,-0.0766,-0.0674,-0.0054,0.0377,0.0458,-0.0246,0.0118,0.0118,-0.1233,-0.0112,0.0124,0.0042,0.0029,0.0324,-0.0827,0.115,-0.114,-0.1189,-0.0036,-0.0012,-0.0779,-0.0882,-0.0857,0.0341,0.0634,-0.0195,0.0018,0.0006,0.0952,0.0148,-0.018,-0.0233,-0.0009,-0.003,0.0494,0.0418,-0.0,-0.0603,-0.0131,-0.0508,-0.0836,-0.0674,-0.0049,0.0183,-0.0251,0.1391,0.1153,0.1246,-0.019,0.0621,-0.067,-0.0512,-0.0175,-0.0876,-0.0031,-0.0991,-0.032,-0.0097,-0.0535,-0.0992,0.0161,0.0147,-0.0831,0.0205,0.0652,0.0251,-0.0359,-0.0317,-0.0319,0.011,-0.0601,0.0244,-0.0063,0.0392,0.0455,0.0682,0.0737,0.0434,0.0403,0.0276,-0.0844,-0.0882,-0.0093,-0.0563,-0.0564,-0.078,0.0227,0.0176,0.0052,-0.0339,-0.0975,-0.0818,-0.0231,0.0342,-0.0267,0.0615,-0.0828,-0.0081,-0.0105,-0.0931,-0.0966,-0.1308,-0.061,0.0175,-0.1038,-0.1112,-0.0061,-0.0029,0.0056,0.0252,0.0033,-0.042,-0.05,0.0331,-0.069,0.0281,0.0033,0.0488,0.0394,-0.1439,-0.0384,0.0834,-0.0585,0.0301,0.0088,-0.0501,0.0188,0.0529,0.059,0.0751,-0.0799,0.0443,0.0394,0.0216,0.1645,0.0329,-0.0034,0.1057,0.0718,0.1,-0.0073,-0.0216,-0.0464,-0.03,-0.0865,-0.0999,-0.0629,0.0244,-0.0386,-0.035,-0.0728,0.0157,-0.0153,-0.0226,-0.0501,-0.0125,-0.0135,-0.0005,0.0257,0.038,-0.0554,-0.0045,-0.0553,-0.0574,-0.0397,-0.032,-0.0458,-0.0221,0.0439,-0.0099,0.0459,-0.0017,-0.0276,-0.0158,0.036,0.0136,-0.0949,-0.1702,0.0366,0.0521,0.0804,0.014,0.0048,-0.0124,0.002,0.0203,-0.0071,-0.0172,-0.0364,0.0139,-0.1036,0.0022,-0.0077,0.0216,-0.0037,-0.0058,0.0022,-0.0398,-0.0645,0.0659,0.034,0.0101,0.0411,0.0461,0.0089,0.0418,0.0242,-0.0045,-0.0544,-0.0153,0.0925,-0.0117,0.0096,-0.0081,-0.0208,-0.0461,-0.0313,-0.0119,0.0339,0.0862,0.1006,0.0831,0.0042,-0.0324,-0.0406,0.0748,0.026,0.0019,-0.0108,0.0131,0.031,0.0241,0.0159,-0.0003,0.049,0.0396,0.0107,0.032,0.0463,-0.0896,-0.0501,-0.0373,0.0053,-0.0335,-0.0883,-0.0379,-0.0914,-0.0595,0.0271,0.003,-0.0393,-0.0531,0.0,0.0405,0.0755,-0.0662,-0.0137,-0.0061,-0.0178,-0.0104,-0.0554,0.0079,0.033,-0.0282,0.0755,0.0797,0.0482,-0.0336,0.0458,-0.0306,0.1082,0.1024,-0.1268,-0.1034,0.0423,-0.0388,-0.0715,-0.0325,-0.0606,0.0496,-0.0142,-0.0347,0.0239,-0.0024,0.1588,-0.0439,0.0487,0.0116,0.021,0.0729,0.0731,0.1045,-0.0388,0.0609,-0.0062,0.0063,0.002,-0.0042,-0.0644,-0.0324,-0.0363,0.0833,0.1034,-0.0051,0.0044,-0.0065,-0.0032,-0.0749,-0.0545,-0.0619,0.0635,-0.0404,0.0388,0.0065,-0.0792,-0.0662,0.0117,0.0139,-0.0499,-0.052,0.0143,-0.0422,0.0354,-0.0391,0.0025,0.0364,-0.0655,-0.0521,-0.0153,-0.025,-0.0815,0.0295,0.0799,0.0107,-0.0635,0.0477,0.0161,-0.0005,0.1227,-0.0583,-0.1267,0.0061,-0.0911,0.0068,0.0486,0.0951,-0.0174,0.0412,0.0417,-0.0241,-0.0158,0.0513,-0.0245,0.0407,-0.0137,-0.0139,0.0058,0.0865,0.0581,0.0549,-0.0193,-0.0419,-0.0453,-0.0439,0.0316,0.0133,-0.0421,0.0069,-0.0071,0.0313,0.1206,0.2172,-0.1381,-0.0353,-0.0212,-0.0226,-0.0145,0.0075,0.0219,0.0231,0.0207,0.0285,-0.0361,-0.0276,-0.015,-0.0207,0.0292,-0.0408,-0.0715,-0.0689,0.0117,-0.043,-0.0121,0.0935,-0.065,-0.0431,-0.054,0.1293,0.0437,0.1355,-0.042,-0.028,-0.0401,0.0334,0.0822,0.0331,0.0267,-0.0175,-0.0054,-0.0004,0.045,-0.0419,0.0833,-0.0937,-0.0331,-0.0448,-0.0741,-0.0167,0.0162,0.071,0.1284,-0.0633,0.0639,0.0686,0.0107,-0.0652,-0.0264,-0.0063,0.0767,0.0222,0.0234,0.0646,0.0652,0.0617,-0.1031,-0.0725,-0.0907,0.0382,-0.0276,-0.0443,-0.0603,-0.0675,-0.0635,-0.0833,0.0318,-0.0424,0.0395,-0.0141,-0.0197,0.0333,-0.0115,-0.0029,-0.0031,0.0098,-0.0958,0.0174,-0.0911,-0.05,-0.0681,0.0485,0.0718,0.056,-0.0014,-0.0192,0.0023,-0.0363,-0.1394,-0.1155,-0.0622,-0.0774,-0.0216,-0.0045,0.0809,-0.1009,-0.0784,-0.0495,-0.0352,-0.0099,-0.0306,-0.0134,-0.0456,-0.0297,0.0108,-0.09,-0.0864,-0.0248,0.0245,-0.0307,-0.0199,-0.1216,0.0134,-0.0586,-0.0791,-0.1528,0.0384,-0.0649,0.0155,-0.0913,-0.0062,-0.0075,-0.0345,-0.0694,-0.1069,-0.123,-0.044,0.0107,0.0279,-0.048,0.0479,-0.1221,-0.0142,0.0457,0.0642,0.0124,0.0086,-0.0375,0.0998,-0.0958,-0.1071,-0.0887,0.0006,-0.0372,-0.0828,-0.0851,-0.0129,-0.0614,-0.0324,-0.0248,-0.0264,-0.1576,-0.0171,-0.0185,-0.052,-0.0062,-0.0121,-0.0692,-0.0225,-0.0226,-0.0136,0.0105,0.0026,-0.0914,-0.125,-0.0551,-0.1175,0.0045,-0.1391,-0.1135,0.0157,0.0788,0.0448,-0.0007,-0.0183,-0.035,0.0642,0.0722,0.0724,-0.1659,-0.1771,-0.0325,0.0314,-0.0233,0.0222,0.024,0.0086,-0.0533,-0.0101,-0.0367,-0.0407,-0.0109,-0.02,-0.0419,-0.0049,-0.0473,0.0516,-0.0105,0.0348,0.0907,0.0593,0.0012,-0.0734,-0.079,-0.041,-0.0589,-0.1402,-0.1009,0.0991,-0.0132,-0.0749,0.2173,0.1533,0.1702,0.2154,0.1376,0.1303,0.1546,0.0628,0.064,0.0826,0.2181,0.062,0.1886,0.2152,0.1273,-0.0872,0.1037,0.0488,0.0877,-0.0366,-0.0533,0.0376,-0.0361,-0.0088,0.0809,0.021,-0.0518,-0.0195,0.1367,0.0252,-0.0167,0.0652,-0.028,-0.0095,0.0895,0.0683,-0.0419,-0.0043,-0.0013,0.0169,0.0138,0.0152,-0.0248,0.0188,0.0097,-0.1561,-0.0598,-0.0942,-0.0823,-0.04,-0.0931,-0.0821,-0.0435,-0.0194,-0.0619,0.0336,0.0534,0.0069,-0.0679,-0.1733,0.0508,-0.057,0.0191,0.0466,-0.0607,0.0276,-0.0807,-0.0391,-0.0112,-0.0423,-0.0777,-0.0399,0.0114,0.0372,0.0839,0.0554,0.0024,-0.0521,-0.0243,-0.0864,-0.0834,-0.0447,-0.0083,-0.0581,0.0056,-0.0292,-0.012,0.0852,-0.0281,-0.045,0.0083,-0.0109,-0.0389,-0.0648,-0.0743,0.0177,-0.0136,-0.0237,-0.0767,-0.0072,0.0451,-0.0214,0.0079,-0.012,0.0071,0.033,0.04,-0.0118,-0.0629,0.024,0.0719,0.0457,-0.0353,0.1111,0.0294,-0.0267,-0.0628,0.1029,0.1678,0.0227,0.0369,0.0096,0.0633,-0.0756,-0.0715,-0.0375,-0.0475,0.0784,0.1088,0.0437,-0.0314,0.0094,0.0713,0.1253,0.1212,0.1361,-0.0275,0.0148,-0.0164,-0.0182,0.0168,0.0046,-0.0712,-0.0416,-0.0428,-0.101,-0.0514,-0.0397,0.0208,0.0135,0.012,-0.0605,0.0219,0.0322,0.0669,0.0992,0.0906,0.0907,-0.0113,-0.0399,-0.0449,-0.0198,-0.0465,-0.0304,0.0112,-0.0579,-0.1131,-0.1033,0.0404,0.0522,0.0215,0.0277,0.0106,0.0679,-0.0022,0.0217,0.1138,-0.0325,-0.0711,-0.0867,0.1034,0.0045,-0.0661,0.031,0.0648,0.066,0.087,-0.0556,-0.0516,-0.0794,-0.065,0.1124,0.0156,0.0323,0.0027,-0.0633,0.0113,0.0118,-0.0307,-0.0015,-0.0193,-0.0557,-0.0012,-0.0916,-0.0708,-0.0672,0.0066,-0.0106,-0.019,0.0433,0.0234,0.0144,0.0828,0.0847,0.0436,0.0841,-0.0811,0.0093,-0.0101,0.083,0.0875,0.0521,-0.0385,0.0171,-0.0349,0.0233,-0.0314,0.0043,-0.0021,0.0687,0.0906,-0.0359,0.0215,-0.0119,0.0621,0.0525,-0.0189,0.0186,-0.005,0.0906,0.0832,0.0429,0.0053,-0.1043,-0.0476,-0.0236,-0.0448,-0.1011,0.0252,0.0081,-0.0168,-0.0419,0.1228,0.0511,-0.154,-0.0538,0.0257,-0.0681,0.0358,0.0282,0.0028,0.0413,0.088,0.1206,0.1545,0.0527,-0.013,0.0421,0.0782,-0.0336,-0.0059,0.0156,0.0003,-0.027,0.0476,-0.0176,-0.0082,-0.0675,-0.106,-0.0988,-0.0889,-0.0379,-0.0077,-0.0435,-0.0273,-0.0486,0.0379,0.0532,-0.0267,0.0013,-0.0065,0.1104,-0.0195,0.0179,0.0055,-0.011,-0.0365,-0.0421,0.0317,-0.0614,-0.0341,0.1363,-0.028,-0.0282,0.0338,-0.012,0.0142,0.0236,-0.0403,-0.0141,-0.0265,0.0007,0.0199,-0.035,-0.0044,-0.0242,0.0316,0.0117,-0.0986,-0.0701,-0.0306,-0.0538,-0.0477,-0.0134,-0.0646,-0.0517,0.073,-0.0391,0.0177,-0.15,-0.0606,-0.0626,-0.1403,-0.108,-0.0581,-0.0129,-0.0129,-0.0436,0.0023,0.0417,-0.0814,0.0179,-0.0679,-0.1056,-0.1035,-0.0449,-0.2244,0.0353,-0.0322,-0.0113,-0.0067,0.0673,-0.0156,-0.0623,-0.0862,-0.0457,-0.0055,-0.0004,-0.0664,0.0557,0.0712,0.1273,0.2102,0.1473,-0.0255,0.0253,0.0981,0.0873,0.015,-0.1629,-0.1282,-0.0352,-0.0775,-0.0114,0.028,0.0283,0.0408,0.003,-0.035,0.0436,0.022,-0.0448,0.0496,-0.0203,-0.0765,-0.057,-0.1029,-0.0094,0.0057,0.0586,-0.0288,0.1982,0.186,0.0748,0.1636,0.0235,-0.0011,0.0276,0.0173,0.046,0.0214,0.0458,0.0347,0.0057,0.0233,0.0054,0.0329,0.0314,-0.0384,0.0302,-0.0535,-0.0013,0.1078,-0.087,0.1603,0.0432,0.1782,0.061,0.0593,0.1006,0.0454,-0.0261,0.01,-0.0174,0.0167,-0.029,-0.0593,-0.0742,0.0143,0.0363,0.0163,-0.0373,-0.0244,-0.0451,0.0108,0.0174,0.0081,-0.0049,0.0188,0.0644,-0.0523,0.0551,0.0218,-0.0305,0.0434,0.0093,-0.0592,-0.0291,-0.0325,-0.0017,-0.0035,-0.0039,-0.0497,0.1062,0.0503,-0.009,0.0006,-0.0148,0.0554,-0.0029,-0.0667,-0.0194,-0.0333,-0.0496,0.023,0.0305,0.0075,-0.0076,-0.0303,0.0515,-0.0207,-0.1104,-0.0786,-0.0563,-0.0963,-0.0,-0.0131,0.0277,-0.0911,-0.0715,-0.107,0.0109,-0.0206,0.0055,0.0234,0.0663,0.0225,-0.0571,-0.03,-0.0335,-0.0039,-0.041,-0.0396,0.0458,0.0599,-0.0249,-0.0184,0.0054,-0.0517,0.0404,0.0106,0.064,-0.0085,-0.019,-0.0688,0.0239,-0.0451,-0.0511,0.0446,-0.048,0.0415,0.0282,0.0527,0.0426,0.0797,-0.0045,-0.0501,-0.0267,0.0596,0.0831,-0.0056,0.0578,-0.0634,-0.0095,-0.0092,-0.0331,-0.0798,-0.0734,-0.0892,0.0473,-0.054,-0.0956,-0.0331,-0.0769,-0.0198,0.0098,-0.0042,0.0119,-0.1392,-0.0112,0.027,0.0199,0.009,0.0138,0.0415,0.0929,0.0167,0.007,-0.0212,-0.0442,-0.0115,-0.0839,-0.1319,-0.041,-0.022,-0.0271,-0.0165,0.0029,0.0589,-0.0122,-0.0651,0.0252,-0.0901,-0.0219,-0.0555,-0.1048,0.0329,-0.0217,-0.0446,-0.1096,-0.0342,0.0995,0.1307,-0.1114,-0.0174,-0.0121,0.0572,0.021,-0.054,-0.0642,-0.1043,-0.0894,-0.0254,-0.0089,0.0274,0.0046,-0.0407,-0.0064,0.0713,0.0303,0.0131,0.0083,0.015,-0.0276,0.006,0.0445,-0.0513,0.0043,-0.0673,-0.0434,0.0827,-0.0381,0.0897,0.0042,0.0782,0.0458,0.115,-0.0351,-0.0402,-0.0945,-0.0219,-0.0486,0.0986,0.0913,0.0753,-0.0146,-0.02,0.0182,0.0717,0.0616,0.0355,0.0355,-0.1349,-0.025,-0.0159,0.0605,-0.0392,0.0155,0.0693,0.0388,0.0017,0.0413,0.0341,-0.036,0.062,0.039,0.0065,0.1254,0.0252,-0.0066,-0.0437,0.049,0.0496,0.0169,0.0476,0.014,0.0435,0.1215,0.0535,0.0506,0.0179,0.0605,-0.0149,-0.0278,-0.0491,-0.1882,-0.1869,0.0657,0.0842,0.1055,0.018,0.0073,-0.101,-0.113,-0.0901,-0.0971,0.032,-0.034,-0.0156,-0.0329,-0.0026,-0.0498,-0.0792,-0.0042,-0.0576,-0.0765,0.1377,-0.1063,0.0042,-0.1285,-0.0604,-0.0253,-0.0045,-0.0288,0.0091,-0.0223,0.0733,-0.0692,0.0912,-0.086,0.0767,0.0203,0.0284,0.0247,0.003,0.0918,0.1051,0.0717,-0.0964,-0.0581,-0.0425,-0.0294,-0.0924,-0.0567,-0.0593,-0.129,-0.0553,-0.0392,-0.0881,0.0189,-0.064,-0.0127,-0.0017,-0.0466,0.0023,-0.0024,-0.1279,-0.0984,0.0485,-0.0353,-0.0991,0.0254,0.0294,-0.0431,0.0067,0.0173,0.05,0.0945,0.0816,-0.0824,-0.0809,-0.0614,-0.054,0.0202,0.0613,-0.0198,0.0101,-0.0251,0.0694,0.0602,0.0332,0.0287,0.0704,-0.1411,-0.1311,-0.043,-0.0298,-0.0166,-0.0602,-0.0715,-0.0555,0.0324,0.0057,0.0343,-0.0319,0.008,-0.0815,0.157,0.1364,0.0962,0.0439,0.0068,0.0812,-0.0656,-0.0382,-0.0412,0.1092,0.0654,0.056,0.0122,0.0096,0.0938,0.0758,0.0936,0.1124,-0.0471,-0.0611,0.0121,0.0445,0.01,0.0809,0.0115,0.0294,-0.0716,0.0571,0.0248,-0.0277,-0.0123,-0.1006,-0.0595,-0.055,-0.0427,0.0531,-0.0519,0.0266,0.0819,0.0675,0.0285,0.016,0.0373,-0.0248,0.0485,0.093,0.0208,0.054,0.0653,-0.0095,0.0017,-0.0215,0.112,0.064,0.0527,0.0458,0.0288,0.0776,0.0248,0.0255,0.0092,-0.0173,-0.0416,-0.0669,0.029,0.1259,0.0175,-0.0655,0.0234,-0.0207,0.0726,0.0337,-0.0553,0.015,-0.0037,0.0035,0.0551,0.0618,0.0812,0.0518,-0.0324,0.0677,-0.0394,-0.0601,0.0591,0.0221,0.0796,0.049,0.0121,0.0234,-0.0553,-0.0481,0.0365,0.2678,-0.0144,-0.0379,-0.0643,-0.0928,-0.1251,-0.0853,-0.0826,-0.0557,-0.0593,-0.0351,-0.0622,-0.0101,0.0607,0.0643,0.0175,-0.0801,-0.0096,-0.0685,-0.0538,-0.0188,-0.059,-0.0136,-0.0124,0.0372,0.0701,0.047,-0.019,-0.0426,-0.0199,-0.0518,0.0028,0.001,0.0131,0.1239,0.0291,-0.0319,-0.0019,-0.0007,0.0598,-0.0785,-0.0419,-0.011,-0.0038,-0.0497,-0.0403,-0.0353,-0.0811,0.0673,-0.0519,0.0776,0.1215,-0.0022,-0.1385,-0.0505,0.0159,0.04,-0.0302,0.0266,-0.203,-0.1469,-0.0808,-0.0905,0.0916,-0.0907,-0.0661,0.0055,-0.038,0.0846,0.0423,-0.0094,0.0411,0.0605,0.1248,0.0189,0.065,0.0055,0.0307,0.0571,-0.0501,-0.006,0.0279,-0.0178,0.0829,0.0515,-0.0441,-0.1094,-0.1052,-0.0274,-0.0587,-0.0581,0.0939,0.01,0.0064,0.0036,0.0301,-0.0021,-0.0842,-0.018,-0.059,-0.0254,-0.0853,-0.0633,-0.0028,-0.0249,0.0053,-0.0787,0.0031,0.0252,-0.0005,-0.0766,0.0614,-0.0578,0.0096,-0.0267,-0.0104,-0.0083,-0.032,-0.0057,0.0154,0.0539,-0.0724,-0.0441,-0.037,0.0518,0.0257,0.0174,-0.0155,0.0843,-0.038,-0.0735,0.0202,0.0244,0.0247,-0.0651,-0.0246,0.0074,0.012,-0.0496,0.0204,0.0572,0.0704,-0.0046,-0.0184,-0.0205,0.0315,0.0359,0.1109,-0.0017,0.1207,-0.0575,0.2585,0.2573,0.0122,0.0138,-0.0161,-0.0183,-0.0107,0.0174,0.0203,0.0874,-0.0284,-0.064,-0.0232,0.0372,0.0714,0.0386,-0.1194,-0.0711,-0.1245,0.016,-0.0989,-0.0432,-0.0568,-0.0266,0.0484,0.0107,-0.0627,-0.0884,0.0391,0.0099,-0.0436,0.1355,0.0814,0.0165,-0.0032,0.051,0.1331,0.1122,0.0722,0.0728,-0.0134,0.0058,0.0584,0.0529,-0.0458,0.0542,-0.005,0.0109,-0.0274,0.1712,0.0531,-0.055,-0.0411,-0.0239,-0.0877,-0.0075,-0.0602,-0.0467,-0.0097,-0.0784,-0.0133,-0.1032,-0.0868,-0.0105,-0.0953,-0.0926,-0.0623,-0.0282,-0.0641,-0.0406,-0.0725,-0.0854,-0.0756,-0.0146,-0.0681,-0.1166,-0.0937,0.0418,0.0671,0.0358,-0.0171,-0.0356,0.0049,-0.0193,-0.0603,-0.04,-0.0098,-0.0362,0.0188,-0.1235,-0.1356,-0.0412,0.0009,-0.0894,-0.1265,-0.0135,-0.0383,-0.0125,-0.1161,-0.0526,-0.0378,0.0244,-0.0287,0.0666,-0.0812,0.0744,-0.059,0.0366,0.0771,0.1318,-0.0717,0.0078,-0.1135,-0.0359,-0.0498,0.0129,-0.0224,0.0071,0.0365,0.0228,0.0071,-0.0132,0.0248,-0.0892,0.0023,0.0875,-0.0549,-0.0305,-0.0813,0.0424,0.0352,0.071,0.1117,-0.1289,-0.1024,0.0068,0.0139,-0.0132,0.0994,0.017,-0.0363,-0.0722,-0.0998,-0.0253,-0.0825,-0.0904,-0.0345,-0.0839,0.0722,0.0387,0.0684,0.0059,0.1155,-0.0334,0.0368,-0.005,0.0489,0.0713,-0.0072,-0.0536,-0.0313,-0.049,-0.0054,-0.051,-0.0457,-0.038,-0.0417,-0.046,-0.0206,-0.0353,0.0067,-0.0539,-0.0183,-0.0289,-0.0043,-0.0044,0.0111,0.0169,-0.0086,0.0022,0.0023,-0.0442,-0.0215,0.0118,-0.048,-0.0416,-0.0563,0.0788,0.0346,0.1341,-0.0134,0.0222,-0.0806,-0.0477,0.0108,-0.0718,0.0845,0.0541,-0.0873,-0.1043,0.07,-0.0655,0.008,-0.0345,0.083,0.1389,-0.0922,-0.0075,-0.0534,-0.0472,-0.0358,-0.1245,-0.0828,-0.0515,0.0067,0.0234,0.0267,-0.0048,-0.0868,-0.0316,0.0478,0.0068,0.0544,0.0087,0.0112,-0.0198,-0.0954,-0.0245,0.0167,-0.0584,0.0014,-0.1436,0.1735,-0.0971,0.0837,0.0071,0.0075,-0.1535,-0.1454,0.0721,0.0723,0.0159,0.133,0.0175,0.1318,0.0406,-0.0231,0.1241,0.033,0.0226,-0.0008,0.0153,-0.0006,0.038,-0.0112,-0.0049,0.0404,0.1566,0.035,0.0536,0.1086,0.0448,0.0362,0.079,0.121,0.1113,0.0664,0.0697,0.0402,0.0373,0.0957,0.0715,0.1462,0.0781,0.0763,0.1642,0.0198,-0.115,-0.0266,-0.1316,-0.0349,-0.0598,-0.0891,-0.0809,-0.0382,0.1733,0.0917,-0.1745,-0.1383,-0.0966,-0.0055,-0.0157,-0.0964,0.0504,-0.0056,-0.026,0.0151,-0.0077,0.006,-0.0287,-0.0121,-0.0789,0.0481,-0.1236,-0.1217,0.0274,-0.0208,-0.0225,-0.0015,0.0003,-0.0966,0.0144,-0.0097,-0.0218,0.0425,0.0567,-0.0591,0.0405,0.0159,-0.0708,0.0909,0.0949,-0.0874,-0.0862,0.0359,-0.0692,-0.0262,-0.0746,0.0082,0.0938,-0.0189,-0.0323,0.038,-0.0523,-0.0589,0.0303,inference
trm_557b49ad14adf,0.0534,-0.0594,0.0345,-0.0149,0.0087,-0.0432,0.0367,-0.0025,0.02,-0.005,0.01,0.0338,0.0111,-0.0014,-0.0013,-0.0334,0.0247,-0.0104,-0.0015,-0.0002,0.0091,-0.0115,0.0264,0.0485,0.022,0.0126,0.0175,0.0225,0.0064,0.0272,0.013,0.0017,0.0005,0.0055,0.0221,0.0242,0.0384,-0.0086,-0.0259,-0.0236,0.0104,0.025,0.0398,0.0107,-0.0482,-0.0224,0.0328,0.0216,0.0014,0.009,0.0154,0.039,0.0478,-0.0197,-0.01,-0.0052,0.0345,0.0032,0.0196,0.0205,0.0222,0.0318,0.001,-0.0314,-0.0794,0.0227,0.0187,0.0269,0.008,0.0156,-0.0495,0.015,-0.0168,0.0259,0.0009,0.0353,0.0323,0.0122,-0.0222,-0.0079,0.0707,0.0144,0.0054,0.034,-0.0195,-0.0456,-0.0507,-0.0256,0.0006,0.0274,-0.0143,0.0738,-0.0201,-0.0249,0.0255,-0.0247,0.033,-0.0071,-0.0287,-0.009,-0.0267,-0.0378,-0.0046,0.0115,-0.0042,0.0078,0.0077,0.0274,-0.0096,-0.03,0.0214,-0.0056,0.0038,-0.0119,0.0046,-0.0186,-0.0082,-0.0016,0.0233,0.0058,-0.0246,0.0092,-0.0031,-0.0009,0.0119,0.0116,-0.0208,0.0049,0.0035,0.0204,0.0679,-0.0126,0.038,0.0512,0.0164,0.0121,0.0246,0.0112,-0.0098,-0.0198,0.0179,-0.0084,-0.0206,0.0149,-0.0292,-0.0757,0.031,-0.044,0.0295,0.024,0.0052,-0.0164,0.0381,0.0278,-0.0344,0.0025,-0.0329,-0.0333,-0.0025,0.0269,0.0135,-0.0019,0.0087,0.0354,0.0021,-0.0349,0.0142,0.004,0.0036,0.0127,0.0489,-0.0002,-0.0041,0.0666,0.0418,0.0475,0.0578,0.0265,0.0522,-0.0137,0.0213,0.0121,0.034,0.0005,0.0558,-0.0284,0.0488,0.0737,0.0304,-0.0478,-0.0443,0.0763,0.0619,0.0716,0.0675,-0.0098,-0.0046,0.041,-0.0299,-0.0256,0.022,-0.0262,-0.0215,-0.0194,-0.0779,0.0498,0.0708,-0.0109,0.008,0.0128,0.0218,0.0482,0.0495,0.0018,0.0219,0.0289,-0.0137,0.0471,0.0066,0.0054,-0.0082,0.0304,0.0172,0.0189,-0.0341,0.0172,-0.038,0.0191,0.0206,-0.0631,0.0086,0.0392,-0.0278,-0.0176,-0.0261,0.0341,0.0251,-0.0217,0.0067,0.0157,-0.0208,0.0452,-0.0095,0.032,-0.0093,0.0128,0.0099,0.0209,-0.0331,-0.0002,0.0698,0.0079,0.0101,-0.0219,0.0392,0.0382,-0.0259,-0.0066,0.0022,-0.0356,-0.0655,-0.0803,-0.0041,-0.0748,-0.0556,-0.0801,-0.064,0.0071,0.0347,-0.0497,-0.0236,0.0416,-0.0248,0.0181,0.0171,0.0376,0.0269,0.0351,-0.0004,-0.0135,0.0286,-0.0007,0.026,-0.011,-0.0117,0.0189,-0.0121,0.0429,0.0155,0.0207,0.0059,0.0203,0.03,0.0037,0.0223,-0.0493,0.0325,-0.0176,-0.0456,-0.0487,0.0403,0.0248,0.0103,0.021,0.0041,-0.0022,0.0148,0.0047,0.0154,-0.0065,0.0031,0.0202,-0.0547,0.0062,0.0072,0.0282,-0.0379,0.0049,-0.0123,-0.0114,-0.0082,0.0101,-0.0904,-0.1041,-0.0019,0.0153,-0.0189,0.0,0.0416,0.0132,-0.0259,0.0149,0.028,0.0334,-0.011,-0.0197,0.0117,0.0013,0.0248,-0.0004,0.0015,0.0267,-0.011,0.0142,-0.0151,-0.0077,0.047,0.0435,0.0457,-0.0053,0.0485,0.0373,0.004,0.0166,0.0276,-0.0257,0.0187,0.0083,0.0298,-0.0251,0.0036,0.0169,0.0205,0.0064,0.028,-0.0385,0.0146,-0.1083,-0.0199,0.0545,-0.0385,-0.0126,-0.029,-0.0167,0.0365,0.0311,-0.0016,0.0045,0.0473,0.0049,0.0375,0.0211,-0.0107,-0.0383,-0.0359,-0.0285,-0.0233,0.0205,-0.0312,-0.0124,0.0222,-0.0257,-0.0271,-0.0341,0.0387,0.0273,0.0405,0.0413,0.0138,0.0007,-0.0096,-0.0068,0.0165,0.0141,-0.0052,-0.0344,0.0362,-0.014,0.0493,0.0404,0.0027,0.0296,0.0251,-0.013,0.0314,0.0023,0.0225,-0.0371,-0.0372,-0.0331,-0.0292,0.0498,0.0141,-0.0234,-0.0261,-0.0168,0.0,0.0243,-0.0045,-0.0114,-0.0303,0.0182,-0.0306,-0.0078,0.0529,-0.0194,0.0184,0.0035,0.0393,0.0256,-0.0137,0.0021,0.0095,-0.0128,0.0685,0.0173,-0.0338,-0.0272,-0.0333,-0.0866,-0.0708,0.0344,-0.0409,0.0023,-0.0235,-0.0131,-0.0303,-0.0129,-0.0773,-0.0199,-0.0106,0.0168,-0.0208,-0.0323,0.043,-0.0134,-0.0294,-0.0439,0.007,0.0401,0.0087,0.025,-0.0183,0.0025,0.0229,-0.0097,-0.0044,-0.0155,-0.0062,-0.0216,-0.0184,0.0109,0.0055,-0.0455,-0.0214,-0.0465,-0.0006,-0.0133,-0.0189,-0.0064,0.0334,-0.0157,-0.0725,-0.0446,-0.0219,0.0224,-0.0057,0.0196,-0.0458,-0.0041,-0.0107,-0.0238,-0.0242,0.0009,0.0306,0.0072,-0.0194,0.0407,-0.0167,-0.0009,0.0227,-0.0052,-0.0014,0.0022,0.0208,-0.0427,0.0382,0.0547,-0.0386,0.0277,0.0026,0.0344,0.0182,-0.0121,-0.0088,0.0143,-0.0035,0.0213,0.0127,-0.0567,0.0116,-0.0437,0.0116,-0.034,0.0398,0.0026,-0.0432,-0.0611,0.0032,0.0428,0.0058,0.0048,0.0335,-0.0211,-0.0196,0.0186,-0.0342,0.0013,0.0227,0.034,0.0411,0.0134,-0.0577,-0.004,0.0109,0.0427,0.0432,0.0108,0.048,0.0228,-0.027,-0.04,-0.0436,0.0045,0.0037,0.0219,0.0212,-0.0056,-0.0297,-0.0022,-0.0585,-0.0114,0.0184,0.0192,0.0167,0.0148,0.0279,-0.0577,0.0003,-0.0122,0.0226,0.0226,0.0045,-0.0034,-0.0908,-0.0464,-0.0537,-0.088,-0.0269,0.0039,0.0291,-0.0801,-0.0502,-0.0538,-0.0593,0.0184,0.0344,-0.0086,0.0187,0.0225,-0.0257,0.0165,0.018,-0.0116,-0.0265,0.022,-0.0125,0.0556,0.0545,-0.0662,0.043,-0.0108,-0.0017,-0.007,0.0392,0.0503,0.0091,-0.0595,-0.0144,0.0052,-0.0143,0.0003,-0.0181,-0.0077,-0.0039,0.019,0.0113,0.0525,0.0175,-0.0262,-0.0396,-0.0219,-0.0426,-0.0229,-0.0355,-0.0244,-0.0159,-0.0451,0.0091,-0.0541,0.0153,-0.031,-0.0378,0.0056,-0.0567,0.02,-0.0241,0.05,-0.061,0.0092,-0.0318,-0.0437,-0.0805,-0.1031,-0.0107,0.0141,-0.0178,0.014,0.0122,-0.003,0.0243,0.0087,0.0162,0.0273,-0.0016,-0.0483,0.0286,0.0349,-0.0334,-0.0054,-0.0054,0.0201,0.0166,-0.0698,-0.0285,0.0327,0.031,0.0172,0.0135,0.0325,-0.0292,-0.0217,-0.0694,0.0008,0.0093,0.0174,0.0486,0.0027,-0.0049,-0.008,0.0358,-0.0686,-0.0883,-0.0192,-0.0313,-0.0202,-0.0085,-0.0103,0.0335,-0.0175,-0.0447,-0.0447,0.043,0.026,0.0313,-0.0006,-0.0184,-0.0568,-0.0084,-0.0332,-0.0108,-0.003,-0.0141,0.0457,-0.0058,0.0067,-0.0037,0.0461,0.0156,-0.0023,-0.0107,0.0271,-0.0727,-0.073,-0.0175,-0.0003,-0.0044,-0.0079,0.001,0.0016,-0.0036,0.0101,0.0176,-0.0116,-0.0085,0.0147,0.0311,-0.0438,-0.0641,-0.055,0.0132,-0.018,-0.0164,0.0401,0.0222,0.0563,-0.0326,0.007,-0.0146,-0.0274,-0.0138,0.0045,0.0361,0.0427,0.0278,0.0225,0.0106,0.0029,-0.0167,0.0064,0.0068,0.0099,0.0002,0.03,0.004,-0.0013,0.0462,-0.0104,-0.0301,-0.039,-0.035,0.0075,0.001,-0.0001,-0.0111,0.0263,0.0335,-0.0094,0.0132,0.0046,0.0402,0.0169,0.0109,0.0098,-0.01,-0.0183,0.0042,0.0371,-0.0264,-0.0145,-0.0212,-0.0064,-0.0301,-0.0199,-0.0225,-0.0269,0.0028,-0.0339,-0.0593,0.0668,0.064,-0.0063,-0.0252,0.0189,-0.0006,-0.0112,-0.0199,0.0163,-0.063,0.0134,0.0371,-0.0361,0.0246,-0.0059,0.0342,-0.0109,0.0155,0.0214,-0.0052,0.0147,-0.0103,-0.0126,-0.0052,-0.0208,0.0059,0.0432,0.0141,-0.0074,0.0292,0.0071,0.0554,-0.0076,-0.0023,0.0487,-0.0197,0.0195,-0.0283,-0.0183,0.0119,-0.0458,-0.0428,-0.0394,0.0002,-0.0863,-0.0373,-0.0462,-0.0022,-0.0204,-0.0049,-0.0434,-0.019,0.0081,-0.0102,0.0054,0.023,-0.0239,-0.0429,-0.022,-0.0064,0.0327,-0.0107,-0.0651,-0.0713,-0.0263,0.0236,0.0133,-0.0038,0.0092,-0.0668,-0.0099,-0.0717,0.0142,-0.0152,0.0092,-0.0705,-0.0851,-0.0378,-0.0846,-0.0374,-0.0376,0.03,-0.0227,-0.0303,0.014,0.0166,-0.0343,0.0132,0.0213,0.0165,0.0414,-0.0058,0.0114,-0.0272,-0.0082,0.0222,0.005,-0.0038,-0.0016,0.0177,0.0359,0.0074,-0.0091,0.0302,-0.0057,-0.0416,0.0254,0.0128,0.0373,0.034,0.0132,-0.0038,0.0422,-0.0027,0.0223,0.0027,0.0097,0.072,0.0293,-0.0421,-0.0529,-0.0129,0.0273,-0.0683,-0.024,0.0333,0.0388,0.0267,0.0542,0.0178,0.047,0.0397,0.0476,0.012,-0.0314,0.011,-0.0231,0.0416,0.0004,0.0089,0.0536,0.0487,0.0508,-0.0109,0.0559,0.0255,0.0414,0.0096,0.0085,0.0383,0.0486,0.0579,0.0506,-0.0012,0.0145,-0.0009,0.0141,-0.0257,-0.0314,-0.0128,-0.0166,-0.0212,0.0363,-0.0237,0.0312,-0.0126,-0.0069,0.0152,-0.0309,-0.0205,-0.0312,-0.0024,-0.0004,0.0301,0.0246,0.0556,0.0197,-0.0066,0.0307,0.0326,-0.0329,-0.0461,-0.0514,0.0602,-0.004,-0.0313,-0.0247,-0.0241,0.0327,-0.0108,-0.0038,-0.0201,-0.0075,0.0155,-0.0176,-0.0124,0.036,0.0079,-0.0026,0.0009,0.0283,0.0568,-0.0434,-0.0116,0.023,0.0234,-0.0181,-0.0054,0.0292,0.0304,0.0073,-0.0474,-0.0027,-0.0255,0.0021,0.0119,-0.0387,-0.0548,-0.0339,-0.006,-0.0029,0.0073,0.0078,0.0156,0.0746,0.0112,-0.0985,-0.0314,0.0033,-0.0139,-0.0075,-0.0183,-0.0215,0.0188,-0.0499,-0.11,-0.0584,-0.0607,-0.059,-0.0016,-0.0041,0.009,0.0021,0.002,-0.0144,0.052,-0.0706,-0.0149,-0.0306,0.002,-0.0013,0.0315,0.0397,-0.0118,-0.0313,-0.0046,0.0038,-0.0279,-0.0285,0.015,-0.0043,0.035,0.0008,0.0284,-0.0244,0.0203,0.02,0.0296,0.0191,-0.0226,0.0173,0.0012,0.0232,0.0169,0.0322,0.0538,0.0726,0.0074,-0.0118,0.0195,0.027,0.0338,-0.0021,0.0311,-0.0451,-0.0461,-0.0837,0.0481,-0.0089,0.0154,0.0408,0.0562,0.0757,-0.0132,-0.0347,-0.045,0.0081,-0.0012,0.0466,0.0661,0.0763,0.0588,0.0375,0.0418,0.0829,0.0759,0.0413,0.0717,-0.0025,-0.022,-0.0123,-0.0004,-0.0515,0.0351,0.0244,0.0381,0.0318,0.0075,-0.0406,-0.0569,0.0109,-0.0101,-0.0176,-0.0276,0.0565,-0.0038,0.0491,-0.0376,-0.0149,-0.0418,0.0728,0.0822,0.0638,0.0029,0.0004,0.0275,-0.0086,-0.0119,0.042,-0.0037,0.0548,0.0657,0.0002,-0.0112,0.0247,0.0053,-0.0154,0.0099,-0.0041,0.0175,0.0107,0.0435,-0.0517,-0.0559,-0.06,0.0387,-0.0072,0.0177,0.0452,0.0094,-0.0229,-0.0247,0.0051,-0.003,-0.0165,0.0427,0.0504,0.0245,0.0245,0.0022,0.0471,-0.0067,-0.0303,-0.0366,0.0176,0.0155,0.0701,0.0696,0.0027,0.0171,0.034,0.0038,-0.0068,0.0046,0.0034,-0.0805,-0.0546,-0.0335,-0.0396,-0.0098,-0.0538,-0.009,-0.0124,-0.0126,-0.1427,0.0168,-0.0877,-0.101,-0.0322,0.0256,-0.1467,-0.1148,-0.0565,0.0025,0.0376,0.0278,-0.002,-0.0396,0.0102,-0.0489,-0.0542,-0.0561,0.0053,0.0147,0.0459,0.0236,0.0048,-0.012,-0.0283,-0.0264,-0.007,-0.0216,0.0714,0.0504,0.059,0.0695,-0.0055,0.0092,0.0049,-0.0059,-0.0508,0.0322,-0.003,0.0167,0.039,0.0291,-0.0293,0.0022,-0.0213,0.0183,0.0088,-0.0341,0.0244,-0.0166,0.0186,0.0223,0.0137,0.0064,-0.0405,-0.0108,0.0114,0.0114,0.0435,-0.0774,-0.0634,-0.0482,0.0091,0.0337,-0.0319,-0.0191,0.0769,0.0703,-0.0094,0.0199,0.052,0.055,0.0055,-0.0629,0.0299,-0.0154,0.006,0.0148,-0.0431,0.0443,0.0255,-0.0389,0.0017,0.0025,0.0038,0.0178,0.0108,-0.0491,-0.0205,0.0126,-0.0449,-0.0477,0.0389,0.0205,0.0038,0.0041,0.0223,0.0019,-0.0095,0.01,0.0599,0.0312,-0.0094,0.0077,0.0362,0.0106,0.0077,0.0044,0.0327,-0.008,-0.0129,0.0158,0.0284,0.0154,0.0048,0.0164,0.0458,0.0469,0.0188,0.017,-0.0061,-0.0371,0.0199,-0.0046,0.0405,0.0327,0.0061,0.0469,0.0189,0.0359,0.0335,0.0362,0.0249,0.0243,-0.0182,-0.0065,0.0333,-0.0096,-0.0302,-0.0006,0.0713,0.0112,-0.0283,-0.0247,0.0085,-0.0058,0.0545,-0.0192,0.0071,0.0011,0.0409,0.0478,0.0175,-0.0164,-0.0152,-0.0297,0.0159,0.0187,0.0412,0.0511,-0.0469,0.0235,-0.0106,-0.0022,0.0273,0.0043,-0.0255,-0.009,0.0052,-0.0623,-0.0142,-0.0165,0.0245,-0.0499,-0.0055,0.0015,0.0111,-0.0026,0.0143,0.0346,0.0132,0.0187,-0.0173,0.0553,-0.0081,0.0566,-0.0359,-0.0147,-0.0264,-0.0201,0.0406,0.0359,0.0184,0.0359,-0.0031,-0.006,0.0084,-0.0245,-0.0175,-0.0109,0.0123,0.0034,0.0277,-0.0338,0.0276,0.0284,-0.0004,-0.0048,0.0029,0.0234,0.0397,-0.0199,-0.0329,-0.0043,0.0085,0.0108,-0.0148,-0.0073,0.0297,0.0239,0.0127,-0.0017,0.0131,0.0053,-0.0086,0.0022,-0.0615,-0.0815,0.013,0.03,0.0125,0.0193,0.0018,-0.024,-0.0305,0.0076,-0.0003,0.0344,0.0097,0.0185,0.0279,0.0013,0.0373,0.038,0.0163,-0.0185,-0.0572,-0.0182,-0.0229,-0.0621,-0.0238,-0.0071,0.0274,-0.1446,0.0116,0.0139,0.0591,-0.0124,-0.0043,0.049,-0.0475,-0.0866,-0.0173,-0.0549,-0.0311,-0.0248,0.0659,-0.0197,-0.0022,0.0185,0.0577,0.0569,0.0202,0.0153,0.0063,-0.0562,-0.052,-0.0114,0.0268,0.0272,-0.0031,0.0296,0.007,0.0051,-0.0065,0.0216,-0.0459,0.0328,0.008,0.0491,-0.0115,-0.0264,-0.0184,0.0237,-0.079,-0.0557,-0.0872,-0.0548,-0.0227,0.029,0.0044,0.0026,-0.0662,-0.0031,-0.0306,0.0456,-0.0034,-0.0341,-0.0701,0.0124,-0.0079,-0.0017,-0.0076,0.0262,0.0349,-0.0061,0.0205,0.0412,0.0328,-0.1003,-0.0973,-0.1003,-0.0258,-0.0317,-0.0451,0.0103,0.0404,-0.0065,0.0404,0.016,0.0082,0.0274,-0.0217,-0.0227,-0.0246,-0.0264,-0.0159,-0.0075,-0.0266,-0.0872,-0.0632,0.0287,-0.0083,-0.0394,0.0173,0.0122,0.0432,-0.0124,0.0057,-0.051,-0.0479,0.0102,0.0001,-0.039,0.0077,-0.05,-0.0151,-0.0352,-0.0965,-0.0963,-0.0102,0.024,0.0201,-0.0408,0.0282,-0.0048,0.004,0.0201,0.0062,-0.0261,0.0146,0.0355,0.0274,-0.0057,0.044,0.0373,-0.0356,-0.0257,-0.0057,0.0458,0.0391,-0.0023,0.0195,0.0268,0.0205,-0.0153,-0.0437,-0.0233,0.0288,0.037,-0.0922,-0.0799,0.0437,0.0072,0.0211,-0.0102,0.0431,0.0174,0.0177,0.0189,0.0055,0.0495,0.0114,-0.0304,-0.0113,0.0059,0.0021,0.0103,-0.0304,-0.0027,0.0354,0.0273,0.0364,-0.0158,0.0498,0.0624,-0.0274,0.0436,0.0227,-0.0336,0.0346,0.0386,0.0416,0.0239,0.0778,-0.012,0.0235,0.0113,-0.025,0.0136,0.0109,-0.0075,-0.0207,-0.0012,0.0111,-0.0344,0.0054,0.0352,0.0488,0.0331,-0.021,-0.0205,-0.0268,-0.0779,0.0165,0.0369,0.0136,-0.0868,-0.072,-0.0051,0.0551,0.01,-0.0015,0.0394,0.0108,-0.0777,-0.0672,0.0394,-0.0029,-0.0094,-0.0041,0.0755,0.0181,0.0506,-0.0253,-0.0213,-0.0615,-0.0029,0.0026,-0.0097,0.0168,-0.0129,-0.0202,-0.0146,0.0012,0.0081,-0.0159,0.0013,0.0262,-0.0046,-0.0459,-0.0464,-0.074,-0.0729,0.0509,0.0352,0.0161,0.0221,-0.0707,-0.0179,0.0321,0.0587,0.0083,-0.0042,-0.0307,-0.0216,-0.0538,-0.0087,-0.0207,-0.0002,-0.0035,0.0187,-0.0159,0.0188,0.0115,0.0091,0.0585,0.0068,0.0066,0.0048,-0.01,0.0086,0.0052,-0.0229,-0.054,0.0227,0.0844,0.0416,0.0675,0.0502,-0.0041,-0.0043,0.0301,0.0066,0.031,0.0029,-0.0448,0.0078,-0.0231,-0.0135,0.0002,0.0249,0.0354,0.0416,-0.0151,0.014,-0.0303,0.0385,0.0091,-0.0336,-0.0624,0.019,0.0223,-0.0261,-0.0771,0.0189,0.055,-0.0083,-0.0266,-0.0381,0.0072,-0.0182,0.011,-0.0219,-0.0881,0.0264,-0.1252,-0.0056,0.0131,-0.0945,-0.0599,-0.0408,-0.1049,0.0067,0.0357,-0.0558,0.0221,-0.045,-0.0386,-0.0613,0.0072,0.0492,0.0291,0.0345,0.007,0.0374,-0.011,0.0063,-0.0226,0.0614,0.0486,-0.0287,0.0242,0.0026,0.034,0.0086,0.0109,-0.0792,0.0078,0.0137,0.0253,0.0374,-0.029,-0.0207,-0.0125,-0.0128,-0.064,-0.0916,-0.0113,0.0129,0.0006,-0.0338,0.0458,-0.0398,-0.0171,-0.0474,-0.0365,-0.0749,-0.0475,-0.0046,-0.0172,0.0157,-0.029,-0.0131,-0.0107,-0.0174,-0.0222,-0.0065,0.0314,-0.003,0.0163,0.0183,0.0053,0.0201,-0.0014,-0.0315,-0.0756,0.0223,0.0197,0.0402,0.0525,-0.0052,0.0311,0.051,0.0659,0.0224,0.0176,0.0181,0.0107,0.0134,0.0058,0.0313,-0.0041,0.0234,0.0223,-0.0066,0.0285,-0.0351,0.0127,0.0153,0.0204,0.0211,0.0185,0.0018,-0.0275,0.05,0.0332,0.0199,0.0194,0.0463,0.0172,-0.0035,0.0147,0.0214,0.0347,0.0253,0.0283,0.04,0.0346,0.0228,-0.0022,0.0324,0.0121,0.0634,0.0237,0.0187,0.0224,0.001,-0.065,0.0183,0.0229,-0.0845,0.0408,0.0047,0.0284,0.0353,-0.0324,0.0128,0.0076,0.0392,0.0067,-0.0022,0.0216,0.0211,0.037,-0.0104,-0.1274,-0.0671,-0.0097,-0.0581,-0.1101,-0.0671,0.0056,0.0403,0.0114,-0.0166,-0.0151,-0.0271,0.0365,-0.0139,-0.0334,0.0249,-0.0056,0.0408,0.0389,0.0341,0.0322,0.0092,-0.0211,0.0579,0.0546,0.0151,0.0212,-0.0204,0.0129,-0.0062,0.0095,-0.0076,-0.0464,-0.0674,0.0657,0.042,0.0371,-0.0283,0.0506,0.0215,-0.0145,-0.0157,-0.0212,0.0009,0.0066,0.0137,-0.0157,0.0126,-0.0061,0.0272,0.0226,0.0335,-0.0501,-0.0544,-0.063,0.0364,0.0003,0.0404,0.0086,-0.0345,0.0248,0.0262,0.0205,-0.0286,-0.0187,0.0202,-0.002,-0.0042,-0.0037,-0.0282,0.0338,0.0517,0.0271,-0.0283,-0.0012,0.0225,0.0146,0.0098,0.0597,-0.0017,-0.0022,0.0019,0.027,-0.0057,-0.0033,0.0437,0.0236,0.0376,-0.0494,-0.0179,-0.0315,0.0048,-0.0346,-0.0262,0.0299,-0.0201,-0.0278,-0.0673,0.0283,-0.0009,0.0085,-0.0189,-0.0276,-0.0547,0.0076,0.0545,0.006,0.0304,0.0361,0.0466,0.0417,-0.0658,0.0371,-0.0036,0.0312,-0.0426,-0.1145,-0.0275,0.0214,0.0378,0.0123,0.0166,0.007,0.0618,-0.0558,0.033,-0.0607,0.0237,-0.0214,0.0044,0.0507,0.0445,-0.0052,-0.0033,-0.0307,0.0283,0.018,0.0099,0.0175,0.0045,0.0114,0.005,-0.0501,-0.0673,0.0536,0.019,0.041,0.0546,0.0243,-0.0332,0.0253,0.0272,-0.0567,-0.0054,0.0134,-0.1783,-0.1568,-0.0537,-0.0655,-0.0773,-0.0899,-0.0436,-0.1173,-0.0547,-0.1339,0.0083,-0.0573,-0.0314,-0.0431,-0.0165,-0.0208,-0.0217,0.0217,-0.0009,0.0284,0.002,0.0066,-0.0282,0.0181,-0.0001,0.0175,-0.0158,-0.0022,0.0513,0.0182,0.0446,-0.0295,-0.0067,-0.0027,0.0012,0.0365,0.0433,0.0429,0.0384,-0.0014,0.0087,-0.0307,-0.0279,-0.0154,0.0422,-0.0028,0.0494,0.006,0.0126,-0.0047,0.0787,0.0331,-0.0519,-0.0852,-0.0425,-0.004,-0.0196,-0.0106,0.0388,-0.0012,0.0117,-0.0553,-0.0137,0.0046,0.0191,-0.0393,-0.0221,0.0284,0.0277,0.0049,-0.0283,0.0748,-0.052,0.0043,0.0178,0.0067,0.028,-0.0172,0.0387,0.0398,0.0084,0.0302,0.0421,0.0054,0.0028,-0.0012,0.0008,0.0255,-0.0015,-0.0835,0.0454,0.046,0.0473,-0.0253,0.0181,-0.0037,-0.0362,0.0133,0.0287,-0.0201,0.0451,0.0669,0.0266,-0.0224,-0.0755,0.0159,0.0362,0.0254,-0.0351,0.018,-0.019,-0.0071,0.031,0.0215,0.0205,-0.0555,0.0194,0.0488,0.002,-0.0016,0.0398,-0.0118,-0.0062,0.0501,0.0501,0.0155,0.0119,-0.0314,0.0203,-0.0146,0.0325,0.0316,-0.059,0.0373,-0.0511,-0.0216,0.0223,-0.0362,0.0202,-0.1197,0.0112,-0.0052,0.0353,-0.031,0.0358,-0.0116,-0.0156,-0.0796,0.0249,-0.0126,-0.0167,-0.0149,-0.0473,-0.0053,0.0159,0.0167,-0.0125,-0.226,-0.0898,0.024,0.0567,-0.0016,0.0299,0.0298,-0.0146,0.0256,0.0322,-0.0241,0.0278,0.0029,0.0197,0.0334,-0.092,-0.0434,-0.0958,-0.0188,-0.0715,-0.0942,0.0075,-0.0035,0.0063,-0.007,-0.034,-0.041,0.0473,0.0098,0.0304,-0.0142,0.0146,0.0105,-0.0256,0.0223,-0.0131,-0.0295,-0.0245,0.0303,-0.0429,-0.021,-0.0109,-0.0388,0.0525,0.0332,0.0352,0.0346,0.032,0.0301,-0.0001,0.0648,0.023,0.0032,0.0321,0.0113,0.0304,0.0146,0.0111,-0.0038,0.0116,0.0278,-0.0349,-0.0289,-0.0182,0.0481,0.002,-0.0122,0.0034,-0.0743,-0.0384,0.002,-0.0078,0.0349,-0.0055,0.0121,0.0271,0.0334,0.0286,-0.0146,0.0287,0.0469,-0.0167,0.0374,0.019,-0.0007,0.0269,0.0226,-0.0016,-0.0564,-0.0316,-0.0409,-0.0685,-0.0104,0.0094,-0.0089,-0.0117,-0.0164,0.0303,-0.0187,0.0253,0.0433,0.0277,-0.01,0.0065,-0.0101,-0.0129,0.0026,0.0054,-0.012,0.011,0.0233,0.0125,0.0013,-0.0081,0.0155,-0.0184,0.0253,-0.0745,0.0558,0.0535,0.037,-0.0542,-0.0607,-0.0241,-0.0046,-0.0303,0.024,-0.0195,-0.0137,-0.0185,0.018,0.0124,0.009,0.0206,0.0166,0.0505,0.0158,0.0396,0.0277,0.0542,0.0248,-0.0006,-0.0323,-0.0137,-0.0113,-0.0066,0.0107,0.0343,-0.0308,0.0159,0.0447,-0.0124,0.0291,-0.0227,-0.0767,-0.0184,-0.1022,-0.035,0.0259,0.007,-0.0053,-0.0282,0.0228,0.0075,-0.011,-0.0072,0.0321,0.0416,0.0047,-0.0449,0.0283,-0.0194,0.0382,0.0169,-0.0013,-0.0976,-0.0245,-0.0174,0.0276,-0.0083,0.0154,0.0519,0.0072,-0.0394,-0.008,-0.0045,-0.0112,0.0124,-0.0038,-0.002,0.0083,-0.0449,0.0116,0.0253,0.0472,0.0548,-0.0204,0.0298,0.0314,0.0308,0.0247,0.0059,0.003,0.0017,-0.0295,0.0333,-0.0397,0.03,-0.0426,-0.0808,-0.0273,0.0315,-0.0257,-0.005,-0.0095,-0.0536,-0.0152,-0.0044,0.0165,0.0224,-0.0307,-0.0292,-0.0111,0.0044,-0.03,-0.0069,-0.0027,-0.043,-0.025,-0.0209,0.0133,0.0249,0.011,0.0585,-0.0117,0.041,0.0286,0.0065,0.0219,0.0278,0.02,0.0394,-0.0139,-0.0178,0.0155,0.0321,-0.0265,-0.0145,-0.012,-0.0669,-0.0032,-0.0567,-0.0303,-0.0004,0.0189,-0.0118,0.0107,0.0815,-0.0307,-0.0162,-0.0301,0.0133,-0.0236,0.0092,0.0039,0.0204,-0.0815,0.0529,-0.0422,0.0,-0.0294,-0.0629,-0.0335,-0.0306,0.0075,0.0547,0.0222,-0.0525,-0.0359,-0.0299,-0.0264,0.0769,0.0057,0.0047,0.0097,-0.0064,-0.0313,-0.0342,0.0164,0.037,0.0345,0.0498,-0.0434,-0.074,-0.0276,-0.0635,-0.0319,0.0052,0.0302,0.0019,-0.0451,-0.0273,-0.0037,0.0239,0.0278,0.0375,-0.001,0.0323,0.0364,0.0282,-0.0012,-0.0065,-0.0098,0.0341,0.0072,0.0078,-0.0814,0.0039,0.0308,-0.0092,-0.0721,-0.0528,-0.0711,-0.0646,0.0138,0.0046,0.0008,-0.0546,-0.0359,0.0392,-0.0257,-0.0487,0.0158,0.0171,0.0218,0.0287,-0.0075,-0.0138,0.0222,0.0053,0.0217,-0.0152,-0.0116,0.0386,0.0379,0.0172,0.0182,-0.0072,-0.0046,0.0519,0.0146,0.0265,0.0376,-0.0368,0.0027,0.0269,0.0135,-0.0078,0.0065,0.0142,0.0174,-0.0096,0.0188,0.0271,0.0331,-0.0401,-0.0351,-0.0827,-0.0323,-0.0873,0.0281,-0.0157,-0.0331,0.0025,-0.0287,-0.0356,0.0407,0.0234,0.0039,-0.0004,-0.0121,0.0166,0.0233,-0.0041,0.0099,-0.0085,0.0482,0.0603,0.0325,0.0417,0.0181,-0.025,-0.0205,-0.0025,-0.0159,-0.0241,0.0015,0.0227,-0.0267,-0.0797,-0.0262,0.0338,-0.0106,-0.0347,-0.0103,0.011,-0.0092,0.044,0.012,0.0333,-0.0149,0.0609,-0.0124,-0.1036,-0.055,-0.0185,-0.0127,0.038,0.0217,0.0107,0.0415,0.0046,-0.0092,-0.0209,0.0256,-0.0392,-0.0303,-0.0498,0.0334,0.0277,-0.0529,-0.0002,-0.1242,-0.0678,0.0336,0.005,-0.012,-0.0355,-0.0162,0.0509,0.001,0.0416,0.0277,0.0446,0.022,0.0434,0.0021,-0.0136,0.0292,0.0307,0.0107,0.0041,0.0378,0.0299,0.0459,-0.0333,0.0492,-0.0303,-0.0203,0.0043,-0.0172,0.0153,0.0294,0.0073,0.0074,0.0492,0.0192,0.0175,0.0316,0.0233,-0.0574,-0.0529,0.0083,-0.007,-0.0431,0.0174,0.0182,0.0269,0.0354,-0.0213,-0.0165,0.0072,0.0237,0.0151,-0.0208,-0.0011,-0.002,-0.0091,-0.013,-0.0335,0.0214,0.0064,-0.0117,-0.0778,0.0239,0.0299,-0.0109,-0.0336,0.0092,0.0253,0.0024,0.0309,-0.0157,0.0227,0.0188,-0.0882,-0.0688,-0.0454,-0.0247,-0.0135,0.0446,0.0383,0.0344,0.0367,0.0505,-0.0031,-0.0356,0.017,-0.0254,0.0313,-0.0291,0.0051,0.0401,0.0292,0.0276,0.0445,0.0174,0.0233,0.0012,0.0405,-0.0162,0.0361,-0.0603,0.0519,-0.0023,-0.0192,-0.0354,-0.0144,0.0218,0.0023,-0.0282,-0.015,-0.0203,-0.0191,0.0284,0.0525,0.046,0.0001,0.0419,0.0229,0.0231,0.0168,0.0564,-0.0062,-0.0099,-0.0981,-0.0538,-0.0341,-0.0284,-0.007,-0.0062,-0.0395,-0.0583,-0.0384,-0.0161,-0.0096,-0.0007,0.0369,0.013,-0.0019,0.0189,-0.0403,0.0573,-0.0145,0.0361,-0.0212,-0.0249,-0.0069,0.0882,0.0238,0.0639,0.0812,0.0294,0.0507,-0.0048,0.0639,-0.0194,0.0173,-0.0164,0.0487,-0.0034,0.0356,0.0333,0.0225,-0.0285,0.0388,0.0306,-0.013,-0.0418,-0.035,-0.0641,-0.0247,0.0033,0.0376,-0.0129,0.0528,-0.005,-0.0235,-0.0092,-0.0321,-0.0202,0.0,0.0393,0.0016,0.0334,0.0108,-0.0331,-0.0425,-0.0403,0.0398,-0.014,-0.0494,-0.0566,0.0175,0.05,-0.0048,0.0056,-0.0336,-0.0363,-0.0064,-0.0726,0.047,-0.0178,-0.0088,-0.0141,-0.0439,0.0386,-0.004,0.0288,-0.0436,-0.0573,0.0145,-0.0154,-0.0148,0.002,-0.0301,-0.0435,-0.0487,0.0313,0.0038,-0.0084,-0.0213,0.0723,-0.0147,-0.0226,-0.0151,0.0219,0.0262,0.069,0.0575,-0.0056,0.0384,-0.0209,0.0081,-0.0655,-0.0034,0.0136,-0.086,-0.0937,0.007,0.0045,-0.0583,-0.0248,-0.0437,-0.0003,-0.0852,-0.0284,-0.0353,-0.0516,-0.0635,0.016,-0.075,0.0167,0.0617,0.022,0.0234,0.0659,0.042,-0.0128,0.0095,0.0404,0.0635,-0.0068,0.0561,0.0349,0.0389,-0.0025,0.0479,0.0401,0.046,-0.0238,-0.0618,-0.0848,-0.0512,-0.0557,-0.0104,-0.051,0.0655,0.0474,0.0171,0.0181,-0.0082,0.0355,0.0159,0.0027,0.0141,0.0512,0.0263,0.0225,0.0166,-0.0137,-0.0502,-0.0633,-0.003,0.0482,0.0437,-0.0218,0.0214,-0.0114,-0.0103,-0.1122,0.0364,0.0172,0.0637,0.0179,0.0317,-0.0748,-0.0349,0.0136,0.0099,-0.0005,0.0406,0.0253,0.0148,-0.0884,0.0598,0.0414,0.0173,0.0104,-0.0538,0.0304,0.0411,0.0241,0.0356,0.012,-0.0968,0.0231,0.0164,0.048,0.0506,0.0589,0.0217,0.0199,0.0037,0.0496,0.0223,0.0218,0.0016,-0.0001,0.024,0.0159,-0.0256,-0.0168,0.0444,0.0149,0.0083,0.0224,0.0472,0.0309,-0.0288,-0.0421,-0.004,-0.0782,0.0187,-0.0142,-0.0341,0.0255,0.0147,-0.0295,-0.0072,0.0058,-0.0195,0.0032,0.0051,-0.0572,-0.0363,-0.054,-0.002,-0.0492,-0.0079,0.0038,-0.0362,-0.0501,0.0039,0.0085,0.0502,-0.0066,-0.0035,0.0317,0.0406,0.0345,0.0144,0.0354,0.0279,0.0697,-0.0195,0.0105,0.0475,0.013,-0.0198,-0.0631,0.0243,-0.0179,0.0213,-0.0077,0.0195,-0.0096,0.0323,0.0056,-0.0114,-0.0274,0.0417,-0.0159,0.0388,0.0077,0.0181,0.0419,0.0357,0.0516,-0.0858,0.0403,-0.0137,-0.0023,0.0245,0.0437,0.0409,0.0541,0.0009,0.026,-0.006,0.0139,0.0295,-0.0137,0.0075,-0.0075,-0.0104,-0.0073,-0.0114,0.0352,0.0068,0.029,-0.0186,0.0045,-0.0191,0.0239,0.022,0.042,-0.0494,-0.0619,0.0163,0.014,0.0335,-0.0187,-0.0038,-0.0068,0.0445,0.036,-0.0829,-0.0182,0.0406,-0.0038,-0.0019,0.0333,0.0098,0.0568,0.0672,-0.0138,-0.0922,-0.0262,0.036,-0.0506,0.0192,0.073,0.0578,0.024,0.0177,0.0308,0.0186,0.0543,-0.0459,0.0224,-0.0205,0.0227,0.0217,-0.0197,0.0327,-0.055,-0.0417,-0.0717,0.0353,-0.0001,0.0064,0.0501,0.0373,0.0713,0.0572,0.0265,-0.0574,0.0088,0.0579,0.0588,0.0106,0.0109,-0.0159,0.034,0.0273,-0.0249,-0.0204,-0.0758,0.0233,0.0461,0.0282,0.0331,0.0713,-0.0452,0.0832,0.0826,0.0071,-0.0149,-0.0073,0.011,0.0117,0.0092,-0.0692,-0.101,0.0154,0.0163,0.0304,-0.0065,0.0521,0.0385,-0.0147,-0.122,-0.121,-0.023,-0.0223,0.0386,0.0063,-0.0137,-0.0081,0.0104,0.0231,0.0061,0.0066,-0.0032,-0.0507,-0.0463,0.0296,response conflict
trm_557b4af7cc1cb,-0.0294,-0.1181,-0.0385,-0.1028,0.023,-0.0068,-0.0198,-0.0285,-0.0094,-0.0647,-0.0057,0.0376,-0.0831,-0.0604,-0.0813,-0.0696,-0.0716,-0.0456,-0.0427,0.0065,-0.0153,0.0469,-0.0394,0.0368,-0.0159,0.0157,0.0169,-0.0933,-0.1309,-0.056,-0.0325,-0.0373,-0.0971,-0.088,-0.0862,-0.0899,-0.0089,-0.0581,-0.1086,-0.0156,-0.0843,-0.1001,-0.0294,0.0833,-0.0736,-0.0794,0.195,-0.0208,0.0314,-0.1069,-0.0587,0.0287,0.036,-0.0023,-0.0368,-0.0615,-0.0571,0.0232,0.0322,0.0093,0.0689,0.0659,-0.1505,0.0619,-0.0432,0.0468,-0.1184,-0.1152,-0.0577,0.0126,0.0176,0.0484,0.0769,-0.034,-0.1308,0.0313,-0.142,0.0832,0.0555,-0.0696,0.0462,0.0924,-0.0571,-0.052,0.024,0.0143,-0.0759,-0.012,0.0384,-0.2277,-0.07,-0.0118,-0.0106,0.0642,0.1022,0.0449,0.1135,-0.0218,0.1446,-0.0018,0.0355,0.0339,0.0379,0.0363,0.0712,-0.0679,-0.1424,0.1484,-0.0352,-0.0911,0.0373,-0.0413,0.0648,0.1271,0.0169,-0.0491,-0.0509,0.0617,0.0507,-0.0008,-0.0558,-0.1288,-0.0612,-0.0078,-0.0724,-0.0908,-0.0427,0.063,0.0849,0.0356,-0.0206,-0.0394,0.0309,-0.1684,-0.0127,-0.1101,0.007,-0.0819,-0.0302,-0.0086,-0.0727,-0.0892,0.0078,-0.0157,-0.0006,0.0029,-0.0386,0.0527,-0.0577,0.0002,-0.0319,-0.0327,-0.0951,-0.064,0.1109,0.0067,0.0788,0.031,0.05,-0.0157,-0.0759,-0.0079,-0.1087,-0.1412,-0.0129,-0.0174,0.0406,-0.112,-0.1057,-0.0034,0.0333,-0.0533,0.0254,-0.0846,-0.0767,-0.0994,-0.0701,-0.0467,-0.0139,-0.0398,-0.1248,0.1067,-0.0262,-0.0008,-0.0341,-0.0217,-0.0465,-0.0238,0.008,-0.149,-0.1457,0.0318,0.0123,-0.0489,-0.0372,-0.2117,-0.1712,0.0685,-0.0187,-0.1525,-0.0288,0.1487,-0.1187,-0.1661,-0.0144,-0.0938,-0.0798,-0.0182,-0.0005,0.0369,-0.0546,0.0202,-0.0101,0.0429,0.0798,0.0655,0.1529,-0.1123,-0.1553,0.0508,0.1146,-0.0708,-0.0992,-0.0135,0.0278,0.0509,-0.0768,0.1144,-0.0043,0.1116,-0.0418,-0.1012,0.1524,-0.0988,-0.1008,0.0172,-0.0076,0.0273,-0.0009,-0.0874,0.0353,-0.1456,-0.068,0.0055,-0.0294,-0.0558,-0.0347,-0.1127,-0.0933,-0.0325,0.0502,0.0577,-0.0243,0.0399,-0.0143,-0.092,-0.046,-0.0916,0.1222,0.2363,0.0488,0.1863,-0.069,0.0475,0.1446,0.2419,0.0687,0.0153,0.052,-0.0615,-0.0976,-0.01,-0.1558,0.0019,-0.1138,0.0049,-0.1864,-0.1852,-0.1823,-0.0675,0.0019,-0.0534,-0.0172,-0.1598,-0.1312,-0.0492,0.0116,0.0507,-0.1098,-0.1037,-0.0292,-0.0333,-0.0229,-0.039,-0.0701,-0.011,0.0983,0.0391,-0.0346,0.0492,0.0702,-0.053,-0.1148,-0.05,-0.0472,-0.0456,-0.1099,-0.0868,-0.0516,-0.0184,-0.0012,0.0244,-0.137,0.0882,0.0512,-0.0351,0.1024,0.0433,0.0739,-0.1377,-0.0202,0.0603,-0.1945,-0.2316,-0.0521,-0.0437,0.002,-0.0341,-0.0094,-0.0708,-0.025,-0.0721,0.0826,0.0628,0.0777,0.0802,0.0141,0.0193,0.0082,-0.0625,-0.0502,0.0896,-0.0009,-0.0319,0.1038,0.0443,-0.1415,-0.0996,-0.086,-0.0855,-0.0861,0.0794,-0.0449,-0.0356,-0.0295,-0.0458,-0.0308,-0.1017,-0.0699,-0.078,0.0169,-0.0237,-0.0735,0.0057,-0.018,0.0607,-0.1223,0.1162,-0.0009,-0.0558,-0.0182,0.0387,-0.0122,0.1004,-0.0669,-0.0516,-0.0965,0.111,0.1918,0.1155,0.1995,0.0169,-0.022,0.0541,0.0012,0.0419,-0.1109,-0.0067,0.0326,-0.0153,-0.0294,-0.0301,-0.0486,-0.0287,0.072,0.0107,-0.0538,-0.0845,-0.0921,-0.0513,-0.0184,0.0352,0.0166,0.0105,0.0337,0.0784,0.0398,0.0314,-0.0566,-0.0013,-0.0166,-0.1171,-0.0219,0.1697,-0.0395,-0.0016,0.1958,-0.0042,-0.0644,-0.0302,0.0407,-0.1733,-0.1011,-0.3142,-0.2838,-0.1185,-0.1723,-0.0708,-0.0927,-0.1424,-0.01,0.0049,-0.0626,-0.0529,0.0994,0.0741,-0.0187,-0.0385,-0.1425,-0.0992,-0.0057,0.0571,-0.0097,0.0269,0.0467,-0.0201,-0.037,0.0735,-0.1325,-0.1192,-0.0279,0.0872,-0.1195,-0.0812,-0.0406,-0.096,-0.0243,-0.0887,-0.1047,-0.0249,0.0404,-0.0955,-0.0691,-0.0246,-0.0458,-0.1099,0.007,0.2959,-0.0924,-0.0488,0.0124,0.0529,0.0062,-0.0381,-0.1108,-0.0495,-0.0089,-0.0345,-0.0281,-0.0054,0.0288,0.0017,-0.0422,0.0408,0.0887,0.0843,-0.0438,0.0266,-0.0285,-0.0073,0.0932,0.046,-0.1874,-0.212,0.0474,0.0702,-0.1753,-0.0114,0.0009,-0.0469,-0.0468,0.0244,-0.027,-0.0856,-0.0587,-0.1126,-0.026,-0.0103,-0.0483,0.1055,-0.1194,-0.0184,-0.0512,0.0317,0.1364,0.0104,-0.0264,-0.0282,0.0236,-0.0435,-0.0791,-0.0639,0.1149,0.0661,0.1171,0.1016,0.0916,0.0825,0.0291,0.0258,-0.0981,-0.0334,-0.0821,-0.2394,-0.0189,-0.0167,-0.1202,-0.167,-0.0336,-0.1013,-0.0204,0.0497,-0.0466,-0.0379,-0.0528,-0.0532,-0.0048,0.0608,0.0379,0.0157,0.0797,-0.0151,-0.1109,-0.0577,-0.0359,-0.0812,0.1244,0.0226,0.088,-0.0567,-0.0135,0.0273,-0.0522,0.0274,-0.0527,0.0247,0.1103,-0.0393,-0.0354,-0.0441,-0.0958,0.0117,-0.1222,0.0108,0.0048,-0.0109,0.0329,-0.0303,0.0446,0.0502,-0.0174,-0.0483,-0.0047,-0.0054,0.0577,0.0073,-0.0084,0.0008,0.0247,-0.0073,-0.0526,-0.0434,0.0525,0.0496,-0.1054,-0.0182,-0.1287,-0.0477,0.1114,-0.0462,0.0052,0.0855,0.1098,0.0206,0.0681,-0.0011,-0.0416,-0.0589,-0.0558,0.0261,-0.108,-0.0451,0.0753,-0.028,-0.1498,0.0222,-0.0225,-0.0192,0.0248,-0.1665,-0.0719,-0.1617,0.0422,0.0366,-0.0294,0.0163,-0.0973,-0.0676,-0.0874,-0.001,0.0589,0.0087,-0.0731,-0.0036,-0.0318,0.0047,0.041,-0.0711,-0.008,-0.1011,-0.0545,0.062,0.0062,-0.0411,-0.1208,-0.0244,-0.2059,-0.057,0.0675,-0.196,0.0297,-0.1633,0.1078,-0.1353,-0.0176,-0.0987,-0.0111,-0.0514,-0.0106,-0.0899,-0.1059,0.0019,0.1382,-0.0268,-0.0065,0.0126,-0.0938,-0.0249,-0.0927,-0.0153,-0.0444,-0.0347,-0.0413,-0.1186,-0.085,-0.0381,0.1558,-0.0259,0.0358,-0.0115,0.001,0.0583,0.0559,0.0193,0.1169,-0.1444,-0.0232,0.0204,0.0133,0.0208,0.0487,0.1258,0.0733,0.0694,0.1083,-0.01,0.0317,-0.0358,-0.0589,-0.0118,-0.0065,-0.0225,0.0258,-0.077,-0.037,-0.0384,-0.1175,-0.1443,-0.1018,0.0292,0.1176,0.0473,0.0011,0.0243,0.0575,-0.0056,-0.0011,0.0408,-0.0507,0.0156,0.0706,-0.0459,-0.318,-0.3229,-0.1891,-0.0205,-0.0475,-0.066,0.013,-0.0765,0.0714,-0.0222,-0.0227,0.0888,0.0764,-0.0064,-0.12,0.0796,0.061,0.1247,-0.0651,-0.0324,-0.0888,0.0102,0.0684,-0.0394,0.0656,0.0191,-0.0235,0.0083,-0.0207,0.0719,-0.071,-0.1232,-0.1004,-0.0544,0.0435,0.2371,0.0335,-0.0968,-0.0318,0.0201,0.061,0.111,0.0175,0.0333,-0.0074,-0.0525,-0.014,0.0808,0.0521,0.1138,-0.0435,0.0075,0.021,-0.0484,0.0974,-0.0733,-0.0715,-0.0318,-0.0659,-0.0608,-0.0261,0.0624,0.0682,-0.0051,-0.0115,-0.0077,0.0038,0.1116,-0.0524,-0.1143,0.0995,-0.0479,-0.0165,0.0005,0.0803,-0.1011,0.0381,-0.0637,-0.0671,0.1131,0.1135,0.1869,0.0143,0.0323,0.0157,-0.0037,-0.0494,0.2163,0.0379,0.0263,0.1117,0.1844,0.0623,-0.0172,0.1663,0.174,-0.0989,0.0042,0.0353,-0.1284,-0.1269,-0.0458,-0.0705,0.0504,-0.1281,-0.0368,-0.0692,-0.0508,-0.0934,0.071,0.0413,0.0833,-0.0724,-0.0468,-0.0118,-0.0069,0.0543,0.0282,0.0184,0.1312,0.029,-0.0332,0.0245,-0.0062,0.1068,0.1325,-0.1023,0.0844,0.0366,-0.0011,-0.0328,-0.0527,-0.0432,0.114,-0.0297,-0.2894,-0.1413,-0.027,0.0513,0.0833,-0.0459,0.0138,0.0097,-0.0262,-0.0066,-0.0304,0.0199,-0.0634,0.0014,-0.1486,0.0118,-0.0208,0.0744,0.0217,-0.0106,0.0281,-0.1981,-0.1765,-0.0074,0.2097,-0.0579,-0.0303,-0.0841,0.0345,0.0406,-0.0738,-0.0095,-0.069,-0.0218,-0.0464,0.0126,0.0581,-0.0017,0.0893,-0.1524,-0.0805,-0.0219,0.0283,-0.0708,0.0206,0.1988,0.1008,0.0955,0.3282,0.1343,0.0195,-0.0213,-0.0492,-0.041,-0.014,0.0039,0.0153,0.0996,0.0981,0.0643,-0.0483,0.095,0.1382,0.0246,-0.048,-0.0476,-0.0278,-0.1292,-0.0335,-0.0431,0.0361,0.0455,-0.0325,-0.0301,0.1119,0.0085,-0.1434,0.009,0.0413,-0.0031,-0.0026,-0.0238,-0.0574,-0.0576,-0.1725,-0.1276,-0.1487,0.0621,0.0117,-0.0606,-0.1327,-0.0401,-0.1144,-0.0342,-0.1484,-0.1014,-0.1434,0.0353,0.0626,0.0808,-0.0303,0.0382,-0.0145,0.0327,0.1164,0.1781,0.2243,0.0969,-0.0484,-0.035,0.0252,-0.0301,0.0451,0.0647,0.0758,-0.0392,0.0096,0.0644,0.1405,-0.0417,0.0038,-0.0267,0.1187,-0.0635,0.101,-0.0951,-0.0122,0.0147,-0.04,-0.0048,0.0585,0.0219,0.0134,0.0665,0.1682,0.1524,0.0042,0.0227,0.0279,-0.0622,0.0465,0.0065,0.0069,-0.0419,-0.1425,-0.0585,0.0218,0.0011,-0.0926,-0.0797,-0.0199,-0.1559,-0.0999,0.0903,0.0571,0.0717,0.0883,0.1178,-0.0753,-0.0579,0.0107,0.0,-0.0203,-0.0166,0.0188,-0.0527,-0.0578,0.0062,0.0403,-0.0762,0.0125,-0.0569,0.0322,-0.1038,0.0143,0.0826,0.0951,0.0022,0.0378,0.0185,-0.0375,0.0183,-0.0172,-0.0231,-0.0368,-0.0171,0.0138,0.0676,-0.0697,-0.025,0.0061,0.0394,-0.0286,-0.0215,-0.0866,-0.1148,-0.1185,-0.0692,0.1139,-0.0097,0.0339,-0.0974,0.1864,0.0712,-0.0021,-0.0241,0.0627,0.0378,-0.0221,0.1064,-0.0669,-0.0885,-0.0128,-0.0258,-0.0664,-0.025,-0.042,0.0512,0.0376,-0.0616,-0.0731,-0.0874,0.0177,-0.008,-0.0166,0.0157,-0.0245,-0.1202,-0.0263,0.0011,0.0649,-0.04,-0.0308,0.3777,0.3199,0.2476,0.1361,0.1359,0.0627,0.2484,0.1618,-0.0418,0.2742,0.2534,0.1613,0.1627,0.2393,0.0233,0.0508,0.021,-0.0057,0.0331,0.0014,0.0223,-0.0241,-0.0762,0.0164,0.0404,0.0303,0.0569,-0.0411,-0.125,0.0908,0.0464,-0.0395,-0.0292,-0.0141,0.053,0.0414,0.1339,0.0034,-0.13,-0.0284,0.0513,0.0711,0.1439,0.0824,-0.0579,-0.0822,-0.1943,-0.0786,-0.0466,0.2448,-0.0482,0.2263,0.1635,-0.0606,0.0398,-0.0617,0.0333,0.066,0.0199,0.1788,0.103,-0.0043,-0.0071,0.0203,-0.0233,-0.1166,0.0211,-0.0244,0.0043,-0.0361,-0.0898,-0.021,-0.1087,-0.0442,0.0534,0.0507,-0.1141,-0.0096,0.0939,0.0357,-0.0149,-0.0574,0.0472,0.0503,0.0248,-0.0357,-0.0478,-0.0874,-0.0642,-0.0475,-0.0998,0.0099,-0.0144,-0.0173,0.0351,0.028,0.0353,0.1605,-0.041,-0.0916,-0.0232,0.1064,-0.0197,0.0947,-0.0928,0.0968,0.1691,0.0532,-0.1143,0.1309,0.114,-0.0486,-0.1315,0.0218,-0.0864,-0.0396,-0.2357,-0.0171,0.0636,-0.0992,-0.1685,0.0076,-0.0911,-0.0054,-0.0525,-0.118,-0.0893,-0.0621,-0.0544,0.0723,-0.03,0.3734,0.2344,0.2814,0.309,-0.0678,0.0054,-0.0405,-0.0348,-0.0796,0.005,-0.0486,0.1786,-0.077,0.0019,0.0297,0.0348,0.04,0.0773,0.0186,-0.0269,0.0088,0.0488,-0.0228,-0.0006,-0.0576,0.0287,-0.0028,0.0075,-0.0165,-0.0165,-0.1044,0.0155,-0.0494,0.0002,-0.0186,0.1366,-0.0711,0.1474,-0.1596,-0.1417,0.0421,-0.0352,-0.0985,-0.1009,-0.1397,-0.0875,-0.015,0.0027,0.0377,-0.0195,0.0818,0.0072,0.0231,-0.1002,0.0716,-0.0049,-0.0188,-0.0142,-0.0482,-0.0476,-0.028,-0.1085,-0.0583,-0.0523,-0.1039,0.0192,0.007,0.0377,-0.0027,0.0856,0.0182,0.0853,-0.0038,0.0444,0.0227,-0.0839,0.0437,-0.1151,-0.1766,0.0202,-0.0152,-0.1378,-0.0259,-0.0511,-0.1289,0.02,-0.0673,0.0674,-0.1881,-0.0964,-0.0512,-0.1707,-0.0164,0.0001,-0.0051,0.2577,0.0618,0.0399,0.0627,-0.0034,0.0345,-0.0304,-0.1877,-0.1874,0.0578,-0.0608,-0.0547,-0.0185,-0.0041,0.0208,0.0299,-0.0097,-0.0114,-0.0622,-0.0634,-0.0516,-0.0495,-0.0153,0.0014,0.0881,0.0012,-0.1253,0.0534,-0.0184,-0.0243,-0.0235,-0.0841,-0.1048,0.0272,0.0356,0.0082,0.1083,-0.0422,-0.0649,-0.0648,-0.0071,-0.0876,0.0296,-0.0142,-0.0339,-0.1188,-0.2179,-0.0128,0.0932,0.0466,-0.0407,0.044,0.006,0.179,-0.0247,-0.0361,-0.0473,-0.1201,0.064,-0.0009,0.1105,0.0775,0.2095,-0.007,-0.0853,-0.0304,0.1115,-0.027,0.0543,-0.0424,-0.0185,-0.0881,-0.0557,-0.0324,0.0853,-0.0671,0.0114,-0.0812,-0.0041,0.0373,-0.0356,-0.0077,-0.0991,0.0119,-0.002,-0.0372,0.0734,-0.013,-0.0304,-0.0542,-0.0273,-0.0111,-0.0217,-0.052,-0.0506,0.0252,-0.0263,0.0539,-0.032,-0.0198,0.0192,0.0301,-0.0309,-0.1066,-0.2501,0.0589,-0.0695,0.0055,0.0374,0.0589,0.0683,0.0608,0.0393,-0.0711,-0.0726,-0.0116,-0.0344,-0.1273,0.0054,-0.114,0.0202,0.0049,-0.0546,-0.081,-0.1023,-0.1015,0.0029,-0.0331,-0.0472,0.2325,-0.0648,0.0577,0.0587,0.145,0.0036,-0.0769,0.1039,0.1542,-0.0502,0.0201,-0.0547,-0.0845,-0.0678,-0.0365,0.0298,0.0067,-0.0441,0.0326,0.0858,-0.0185,-0.0497,-0.0389,-0.0036,0.0483,0.0378,-0.1966,-0.1054,-0.0779,-0.1534,-0.1337,0.0558,0.0888,0.0297,-0.0106,-0.0489,0.0234,-0.124,-0.0074,-0.0747,-0.0797,-0.1795,-0.1213,-0.0453,-0.1817,-0.154,0.1097,-0.0269,-0.0536,-0.0569,0.0073,0.104,0.156,0.0142,0.0696,-0.0315,-0.0544,-0.0619,-0.0774,0.005,0.0326,-0.006,0.1058,0.1042,0.0618,-0.0176,-0.0369,-0.0717,0.2689,0.2713,-0.1672,-0.1616,0.0502,-0.0421,-0.0462,-0.034,-0.1298,0.0487,-0.038,-0.0225,-0.0555,-0.0415,0.1031,-0.0753,0.071,0.0386,-0.0537,-0.0266,0.251,-0.0409,-0.0424,0.2293,-0.0134,0.0381,0.0267,0.0242,-0.0309,0.1082,0.0519,-0.0323,-0.0284,-0.0498,-0.0174,0.0391,0.0385,-0.1008,-0.1585,-0.1076,0.0785,-0.0649,0.0418,0.1324,-0.0603,-0.0804,0.037,0.0108,-0.1106,-0.0075,0.0498,-0.0407,-0.054,-0.1444,-0.0057,0.035,-0.0679,-0.0437,0.0121,0.0783,0.0185,0.1835,0.0889,0.1321,0.0928,0.1295,-0.0031,0.0403,0.3969,-0.0347,-0.1759,0.006,-0.1238,0.0044,0.0385,0.0351,-0.0212,0.0337,0.023,-0.0163,0.0293,0.106,0.0439,-0.0162,-0.014,0.0342,0.0793,0.0983,0.1906,0.1804,-0.0399,-0.074,-0.0622,-0.021,-0.0127,0.0028,0.0026,0.0352,0.0841,-0.0151,0.0499,-0.0563,-0.1552,-0.061,0.0128,0.0471,0.0268,0.0739,0.0662,0.2853,0.1774,-0.0843,-0.0038,-0.0461,0.0094,0.0395,0.0748,-0.182,-0.1775,-0.2311,0.0419,-0.0046,0.0335,0.1214,-0.002,0.0759,0.0812,0.0411,-0.0097,0.0897,0.0533,0.0041,-0.0318,0.0359,0.0737,0.1443,0.2271,0.0047,0.0862,0.1048,0.0294,-0.0022,0.0357,-0.1265,-0.0316,-0.0409,-0.0928,0.0267,0.0168,-0.0378,-0.03,-0.0161,0.0253,0.0263,-0.0011,-0.0654,-0.0532,-0.0298,-0.0108,-0.0663,0.011,0.1354,0.0551,0.1082,-0.0554,-0.0645,-0.0621,0.0101,0.0285,-0.0524,-0.0582,-0.0516,-0.1259,-0.0441,0.0758,0.0206,0.0906,0.0628,0.0257,0.022,-0.0249,0.0356,0.0131,-0.0259,-0.1733,-0.0161,-0.049,-0.0313,-0.0361,0.0672,0.0608,0.2682,0.1981,0.0942,0.0901,-0.1219,-0.1485,-0.099,-0.1025,-0.0588,0.0547,-0.0575,0.0562,-0.0585,-0.0763,-0.1113,-0.0818,-0.043,-0.0129,-0.0409,-0.0121,0.0347,0.0147,-0.0822,-0.1219,-0.0116,0.0876,0.0176,0.0276,-0.184,-0.066,-0.0992,-0.0567,-0.3224,-0.0147,0.0896,-0.0278,-0.0796,-0.035,-0.0758,-0.0066,-0.0851,-0.0743,-0.0683,0.1061,0.1471,0.0448,0.0762,0.1222,-0.1459,0.0111,0.0456,0.1134,-0.0309,-0.0126,-0.1081,0.1376,-0.2033,-0.2557,-0.2099,-0.0504,-0.0083,-0.069,-0.0272,-0.0375,-0.0436,-0.0577,0.0012,-0.0106,-0.107,0.0368,-0.0467,-0.0315,-0.0966,-0.0048,-0.1114,-0.1213,-0.0461,-0.0175,0.2248,-0.0638,-0.1373,-0.2565,-0.0981,-0.0964,-0.082,-0.2779,-0.2295,-0.0269,0.0507,0.0344,-0.0338,-0.0126,-0.0001,0.1188,0.1463,0.0382,-0.3199,-0.3107,-0.0329,0.0503,0.0138,-0.0896,0.0314,-0.0556,-0.0179,-0.0244,-0.088,-0.0248,-0.0169,-0.0372,-0.0246,0.0451,-0.032,-0.0563,-0.0266,-0.0596,0.1076,0.1138,-0.0647,-0.0498,-0.2263,-0.0883,-0.0405,-0.1006,-0.0662,0.2291,-0.0172,-0.0534,0.0065,0.0053,-0.0437,0.0115,-0.0376,-0.0014,0.0614,-0.0055,0.0131,0.0184,-0.0721,0.0019,-0.0118,0.0848,0.1782,-0.1956,0.0369,0.0542,0.2657,-0.1002,0.0983,0.0228,-0.0619,0.02,0.01,0.0468,-0.0161,0.0407,-0.1006,-0.1459,-0.1749,-0.0615,-0.0289,0.059,0.1425,0.1165,0.0387,0.0067,0.0691,0.2284,0.0951,0.0466,-0.0156,0.0607,0.0735,-0.1651,-0.0927,-0.1137,-0.0889,-0.0447,-0.0799,-0.0448,-0.0451,0.0631,-0.0229,-0.1342,-0.11,-0.1699,-0.1756,-0.2923,0.0067,-0.2085,-0.0897,0.0595,-0.0552,-0.0168,-0.1194,-0.0797,-0.0148,-0.0444,-0.009,0.0065,-0.072,0.0436,0.1208,0.1268,-0.0024,-0.0806,0.0626,-0.0286,-0.039,0.0885,-0.0307,-0.0179,0.071,0.018,0.0355,-0.1321,-0.1306,-0.0387,-0.0025,-0.0243,-0.0545,-0.0848,-0.069,0.0018,-0.0408,0.0687,-0.149,-0.0145,0.0057,-0.0451,-0.0326,0.0469,0.0367,-0.1726,-0.005,-0.0226,-0.0512,0.1143,0.1994,0.1747,0.0023,0.3796,0.2263,-0.1302,-0.0616,0.3995,0.0969,0.0144,0.0899,0.085,0.0485,-0.0554,-0.0517,-0.0707,-0.0923,0.4859,0.4049,0.2732,0.0983,0.2077,0.2411,0.3939,0.3747,0.3106,0.0472,0.0044,-0.0237,-0.0058,-0.0478,-0.0215,-0.0722,-0.0505,0.0493,-0.0216,-0.0569,-0.0426,0.1291,-0.02,-0.0051,-0.0538,0.0822,0.0771,0.115,-0.0701,-0.0548,-0.0981,0.0158,0.0022,-0.0099,-0.0401,-0.0486,-0.0386,0.0036,-0.0507,-0.0968,-0.0801,-0.016,-0.1066,-0.0232,0.2432,0.0606,0.0955,0.0807,0.0984,0.1964,0.0175,-0.135,-0.1351,-0.0394,0.0207,-0.0425,0.1009,0.0559,0.0853,-0.0224,-0.0837,-0.0862,-0.088,-0.0741,0.0188,-0.2003,-0.1443,0.0396,-0.0315,0.0843,-0.0165,-0.0047,0.0584,-0.0538,0.1657,0.1569,0.0709,-0.068,-0.1382,0.0005,0.0903,-0.0368,0.0047,-0.0224,0.0599,0.1156,0.1087,0.018,0.1488,-0.1753,-0.0297,0.0513,0.0436,0.1161,0.1267,0.093,0.0562,-0.0389,0.0765,0.1133,-0.0051,-0.0088,-0.0849,-0.0548,-0.0429,0.0038,-0.0303,-0.0192,0.0323,-0.0003,0.0546,0.0152,0.0991,-0.0898,0.1068,0.0912,-0.0816,-0.1131,-0.0706,-0.0929,-0.0888,0.1068,0.023,-0.0149,-0.0382,0.1393,-0.0416,-0.2612,-0.038,0.0055,-0.1252,0.0464,-0.0182,0.0284,0.0908,0.129,0.3638,0.111,0.0651,-0.0442,-0.027,0.0437,-0.0646,-0.0774,-0.0131,0.0286,-0.0637,0.0411,-0.1077,-0.0463,-0.1295,-0.1592,-0.1414,-0.0925,-0.0852,-0.0646,-0.0603,-0.0453,-0.0349,-0.0182,0.0319,-0.0623,-0.0708,-0.1031,0.0573,0.0633,-0.0305,-0.0185,0.1216,0.0636,-0.1456,0.167,-0.087,-0.0845,0.1123,-0.1493,-0.1563,0.0111,0.0274,0.0592,0.0137,-0.0862,-0.0187,0.024,-0.0099,0.0639,-0.0552,0.0502,0.0115,0.0617,0.0563,-0.1429,-0.0241,-0.0011,-0.0189,-0.0246,-0.01,-0.0295,-0.0042,0.0149,-0.0846,0.0559,-0.197,-0.0975,-0.1027,-0.1524,-0.0993,-0.0825,-0.0502,-0.0502,-0.0107,-0.0362,0.0272,-0.1414,-0.0208,-0.0674,-0.0639,-0.166,-0.0116,-0.3449,0.0429,-0.127,0.0191,-0.0784,0.1262,-0.1344,-0.1045,-0.0793,-0.0974,0.0677,0.0386,-0.1066,0.1052,0.0516,0.0162,0.1034,0.0873,-0.0243,0.0196,-0.0225,-0.0242,-0.0094,-0.2298,-0.1758,-0.0288,-0.0406,-0.014,0.0121,0.0361,-0.0005,0.0273,-0.003,0.0121,0.1156,-0.0387,0.1224,0.0103,-0.1428,-0.0768,-0.1778,0.013,-0.0783,0.0102,-0.0473,0.048,0.0431,-0.0497,0.1029,0.0687,-0.0215,0.1149,0.0566,0.2173,0.0798,-0.023,0.0938,-0.1015,0.0354,0.0171,0.0634,0.0036,-0.0326,0.0443,-0.0391,0.0208,-0.0784,-0.1767,-0.0551,-0.0798,0.0003,-0.0624,-0.115,0.3094,0.0023,0.088,0.1016,-0.0334,-0.0051,0.0238,-0.0253,-0.0803,-0.0498,0.1172,0.0926,-0.0468,0.0058,-0.0322,0.0378,0.0361,0.0948,-0.0035,0.0149,0.015,-0.0504,0.0521,-0.089,-0.0432,-0.0479,-0.022,-0.0485,-0.0279,-0.0375,-0.0119,0.0028,0.018,-0.0647,0.0658,-0.0064,0.0429,0.0302,0.03,0.0625,-0.0039,-0.0685,-0.0313,-0.0702,-0.0638,0.0153,0.071,-0.0317,-0.0489,0.0015,0.0201,-0.1624,-0.0543,-0.0457,-0.1341,-0.1343,0.0326,-0.0144,0.0215,-0.1259,-0.086,-0.0659,-0.0715,-0.0563,-0.008,0.0369,-0.052,0.1308,-0.0584,-0.0522,-0.0231,-0.0339,-0.0915,-0.0545,0.0712,0.0162,-0.1337,0.0368,0.0178,-0.0693,0.0886,0.0638,-0.0071,0.0856,-0.0115,-0.1136,-0.054,-0.1111,-0.12,-0.0054,-0.0384,0.0655,0.0138,0.1118,0.1183,0.1278,-0.1017,-0.0652,-0.0431,0.0912,0.1599,0.0257,-0.0297,0.0153,-0.0029,-0.1139,-0.0313,-0.0965,-0.0739,-0.0194,-0.0131,-0.0467,-0.0756,0.13,0.0225,0.0138,0.137,-0.0143,0.0022,-0.1054,0.0013,-0.046,0.0103,-0.072,-0.0198,-0.0241,0.0207,-0.0812,-0.0318,-0.0188,-0.0393,0.061,-0.0614,-0.2503,-0.035,-0.0667,-0.0045,0.0173,0.0072,-0.0159,0.0172,-0.0783,0.0371,-0.0847,-0.0344,-0.0585,-0.0988,-0.0239,-0.0997,-0.0656,-0.1862,-0.0962,-0.0717,0.0689,-0.1061,0.0399,-0.1028,0.0942,0.0793,0.049,-0.0636,-0.1278,-0.0788,-0.0188,0.024,0.0865,-0.0741,-0.0303,-0.0803,0.0725,0.0495,0.0093,0.0533,-0.0131,-0.0502,0.0292,-0.0038,0.0081,0.062,0.0344,-0.0821,-0.0309,0.0351,0.194,-0.014,0.1244,0.0939,-0.0162,-0.0006,-0.0096,-0.1289,-0.0487,-0.0039,0.1007,0.1606,0.0848,-0.0091,0.0151,-0.0586,0.1507,0.1552,0.0603,0.1115,-0.1642,-0.0064,-0.0491,0.1241,0.0108,0.0204,0.0263,-0.0209,0.0033,0.0509,0.0699,-0.0235,0.104,0.0142,-0.086,0.1245,0.0698,-0.0034,0.0343,-0.0127,0.0373,0.0102,0.004,0.0564,-0.0328,0.0636,0.1204,0.1615,0.0026,0.03,0.0481,-0.0291,-0.1284,-0.3114,-0.2987,0.0329,0.082,0.0413,0.0085,0.0395,-0.0299,-0.0842,0.0013,-0.0461,0.0654,-0.0508,-0.0443,-0.0273,0.039,-0.0698,-0.0539,0.0351,-0.0594,-0.0501,0.0123,-0.048,0.0592,-0.1308,-0.0493,-0.0204,-0.0253,0.0256,0.0712,-0.0534,-0.0742,-0.0702,0.2048,-0.1175,0.0555,0.0641,0.0379,0.0152,0.0731,-0.1037,0.1476,0.1472,-0.0697,-0.058,-0.0991,0.0105,-0.0172,-0.0877,-0.1953,-0.1762,-0.0828,0.0482,0.0182,0.0555,-0.0345,-0.0455,-0.0979,-0.1324,0.2399,0.2156,-0.1475,-0.0883,-0.0012,-0.0423,-0.1179,0.1338,0.1331,-0.0626,0.0466,0.111,0.0266,-0.1379,-0.1608,-0.1444,-0.2028,-0.0367,-0.0656,0.0714,0.0143,0.0053,0.0398,-0.0454,0.0877,0.3362,0.1954,0.0607,0.2499,-0.2599,-0.2448,-0.0559,-0.0419,-0.0605,-0.0443,-0.0907,-0.0316,-0.0145,-0.1131,-0.1086,-0.0721,0.1806,-0.0653,-0.0525,-0.0208,-0.0163,0.0896,0.1125,-0.0776,-0.1662,-0.1069,-0.1656,0.033,0.1061,0.0891,0.0478,0.0264,0.0085,0.0617,0.0518,0.0596,-0.0397,-0.0324,0.0393,-0.026,-0.0312,0.0443,0.048,0.0415,0.0222,0.0475,0.0434,-0.0207,0.0205,-0.1321,-0.1067,-0.0607,-0.0887,0.3599,0.0224,0.1645,0.0997,0.0363,-0.0164,0.0056,0.0899,-0.0725,0.1476,0.135,0.0081,0.0512,0.0416,0.0001,-0.0798,-0.0449,-0.0852,0.0238,0.1837,0.0779,-0.089,-0.0112,0.0182,-0.0527,0.0386,0.0173,-0.1131,-0.0942,0.005,-0.142,-0.018,-0.0376,0.0619,0.0449,0.0564,0.0411,-0.0087,-0.0209,-0.0562,-0.0375,0.0764,0.1244,0.0062,0.0396,-0.0594,0.0435,-0.0912,-0.1364,-0.0161,0.1321,0.0466,-0.0438,-0.1162,-0.0418,-0.0497,-0.0871,0.037,0.011,-0.0356,0.0304,-0.0681,-0.0872,-0.2068,-0.1754,-0.1696,-0.1675,-0.1051,-0.0499,-0.0694,0.0244,-0.1382,-0.1325,-0.1448,-0.0739,-0.1133,-0.2075,-0.1006,0.0483,0.1747,0.0474,-0.1512,0.2543,0.2398,0.1565,-0.039,0.0188,0.0133,-0.163,-0.0365,-0.0531,0.0541,0.1307,0.1542,0.0338,0.0122,0.0481,0.0499,-0.1846,-0.0482,-0.0387,-0.0154,-0.1915,-0.1488,-0.0983,-0.1781,0.0628,-0.1174,-0.0773,0.1026,-0.0752,-0.1824,0.0019,0.1245,0.0801,-0.0795,-0.0852,-0.355,-0.2449,-0.1586,-0.2786,0.1128,-0.0348,-0.0291,0.0858,-0.1419,-0.0479,-0.0825,-0.013,0.176,0.0749,0.2,0.1024,0.1145,-0.0853,-0.0611,0.0999,-0.0253,0.0512,0.0289,-0.0416,0.1986,0.0822,-0.1306,-0.128,-0.0555,-0.0237,-0.0571,-0.0785,-0.0531,0.021,0.0761,-0.0188,0.0765,0.0442,-0.0674,0.0256,-0.0346,0.0134,-0.1277,-0.1316,0.0048,-0.0981,0.0014,-0.0653,-0.0674,-0.0875,-0.0668,-0.0994,-0.0536,-0.076,-0.0679,-0.0068,0.0441,-0.0074,-0.0762,0.035,0.0066,-0.0086,-0.0343,0.0148,-0.1113,-0.0241,0.0881,0.0158,-0.0767,0.129,-0.0363,-0.0535,0.1012,0.0285,0.0394,0.0356,-0.0037,-0.0186,-0.0545,-0.0101,0.1202,0.1073,0.2463,-0.1486,-0.0708,-0.006,-0.0831,-0.0197,0.1224,-0.1532,0.1752,-0.1968,0.0023,-0.009,0.0611,-0.0599,-0.0486,0.0081,0.0157,-0.1632,-0.153,0.1216,0.0089,-0.0349,-0.0503,0.0876,0.0909,0.0955,-0.1201,-0.1117,-0.0978,-0.0162,-0.0686,-0.1637,0.0176,-0.0269,0.0027,-0.0031,-0.0748,-0.0678,0.0073,0.0122,-0.0998,-0.0172,0.1952,0.0072,-0.0381,0.1259,0.1949,0.0697,0.0319,0.086,-0.0894,-0.0142,0.1813,0.0806,-0.1118,0.1525,0.0539,0.0443,0.062,0.1648,0.076,-0.0262,-0.0806,-0.0682,-0.1097,0.0358,-0.1052,0.0035,-0.129,-0.1772,-0.1237,-0.0263,-0.0165,0.1427,-0.0952,-0.1181,-0.1599,-0.1563,-0.1337,-0.1606,-0.2047,-0.1998,-0.1822,-0.0332,-0.054,-0.0707,-0.0488,0.1406,0.2244,-0.0482,-0.0115,0.0714,0.0352,-0.0741,-0.0533,-0.0923,-0.1129,0.0479,0.0619,-0.2197,-0.2838,-0.0245,0.0011,-0.0248,-0.1692,-0.0279,-0.0786,-0.0572,-0.1926,-0.0204,-0.0378,-0.0172,-0.0152,-0.0169,-0.134,0.0838,-0.1051,0.0278,0.1614,0.0236,-0.0852,-0.0235,-0.2258,-0.0623,-0.0303,-0.0787,-0.1013,0.053,0.0555,0.0933,-0.0184,-0.0421,0.002,-0.1502,-0.011,0.1054,-0.0778,-0.0152,-0.0562,0.0592,0.03,0.0895,-0.0224,-0.1704,-0.1165,-0.0152,-0.0064,0.0573,0.0733,0.1462,0.0028,-0.0406,-0.0421,-0.0135,-0.0746,-0.1521,-0.0428,-0.1153,0.0536,0.0093,0.0857,-0.0176,0.0702,-0.0269,0.0243,0.0418,0.0713,0.099,0.0407,-0.0422,0.0141,-0.0888,0.0073,-0.0174,-0.0357,0.0066,0.0124,-0.0083,0.0028,-0.0605,-0.0507,-0.0687,-0.0378,-0.1245,0.0015,-0.0508,0.0782,-0.0008,0.051,0.0446,0.0274,-0.0233,0.0566,-0.0212,-0.0006,-0.096,-0.0767,0.1447,0.0683,0.0116,-0.0425,-0.069,-0.1036,-0.0205,-0.0038,-0.0478,0.0273,0.0486,-0.1665,-0.0611,-0.0129,-0.0722,-0.0183,-0.0164,0.3832,0.2365,-0.1223,0.0279,-0.0143,0.0104,-0.0641,-0.0678,-0.0958,-0.1495,0.0492,-0.002,-0.0743,0.0298,-0.0723,0.0027,0.0887,-0.0185,0.0343,0.0139,-0.0077,0.0075,-0.0794,0.0182,0.1289,-0.103,0.0566,-0.1662,0.061,-0.0861,0.3531,0.0496,0.0496,-0.1397,-0.1312,-0.0156,0.0871,-0.0186,0.0679,-0.0757,0.0335,0.0294,0.0685,0.0379,0.0347,0.0359,0.0467,0.0778,0.1394,0.1967,-0.1129,0.1461,0.2624,0.4948,0.176,0.1166,0.4077,0.2446,0.2085,0.2832,0.1666,0.2116,0.1533,0.1935,0.2668,0.1033,0.2663,0.1944,0.2335,0.1881,0.209,0.129,0.1912,-0.1007,-0.0844,-0.1206,-0.1664,-0.1295,-0.1076,-0.1072,-0.0348,-0.0699,-0.0438,-0.1279,-0.099,-0.0889,-0.025,-0.0044,-0.0726,0.0844,-0.0272,-0.0985,-0.0492,-0.1169,-0.0334,-0.0352,0.0131,-0.053,0.076,-0.0741,-0.092,0.0941,-0.0309,-0.052,0.0267,0.0286,-0.0589,0.0982,0.0397,-0.0697,0.0857,0.1964,-0.0064,0.0361,0.0408,-0.1004,0.1501,0.1504,-0.0409,-0.0684,0.0595,0.0311,0.0508,-0.0412,-0.0215,0.1051,0.0215,-0.023,0.0235,0.0189,-0.0212,-0.0505,visual body recognition
trm_557b471bc6cd8,-0.1083,-0.1207,-0.1348,-0.1521,-0.0023,-0.0553,-0.1139,-0.0651,-0.0562,-0.1156,-0.0195,-0.0121,-0.1337,-0.0966,-0.1441,-0.0655,-0.0829,-0.1442,-0.08,-0.0574,-0.0864,0.0344,-0.0608,0.0301,-0.0143,0.0266,0.0222,-0.1429,-0.1828,-0.0843,-0.13,-0.141,-0.1619,-0.0909,-0.1876,-0.1295,-0.0696,-0.0858,-0.1661,-0.03,-0.133,-0.1356,-0.066,0.0876,-0.1042,-0.0993,0.1969,-0.069,0.0596,-0.1079,-0.0482,0.1035,0.0848,0.0556,-0.0387,-0.0836,-0.1187,-0.054,0.0016,-0.0473,0.0124,0.0526,-0.1863,0.1209,0.0326,0.1102,-0.2428,-0.293,-0.1576,-0.0099,0.0691,0.0309,0.1936,-0.1201,-0.1667,0.0809,-0.1528,0.0546,0.0506,-0.0373,-0.0083,0.0919,-0.0715,-0.1806,0.0763,0.0762,0.0015,0.0133,0.0018,-0.1764,-0.0942,-0.0137,-0.0156,0.2286,0.2178,0.1975,0.1816,0.0352,0.2994,0.1427,0.0916,0.0438,0.1318,0.1114,0.1394,-0.1756,-0.2084,0.1733,-0.0206,-0.0656,0.0075,-0.1476,0.1246,0.2185,0.0543,0.016,-0.125,0.0892,-0.0445,-0.0885,-0.1257,-0.2083,-0.1705,-0.0192,-0.1079,-0.1774,-0.0874,0.0723,0.1022,0.0491,-0.1343,-0.1024,-0.0308,-0.326,0.0014,-0.2293,0.0083,-0.178,-0.0392,-0.0471,-0.122,-0.1417,0.0307,-0.0146,-0.0233,0.0998,-0.0753,0.0349,-0.1113,0.0819,-0.107,-0.1088,-0.1925,-0.1912,0.1892,0.017,0.0757,0.0446,0.022,-0.0643,-0.0796,-0.1014,-0.2669,-0.2615,-0.0375,0.0007,-0.033,-0.2255,-0.213,0.0022,-0.0443,-0.1421,0.0812,-0.2971,-0.1927,-0.2435,-0.1797,-0.176,-0.1095,-0.0362,-0.1929,0.0831,-0.0612,0.0199,-0.064,-0.0729,-0.0893,-0.127,-0.1097,-0.0564,-0.0461,-0.0643,-0.0239,-0.2252,-0.209,-0.2863,-0.2612,-0.0349,-0.02,-0.1337,-0.0372,0.2843,-0.1958,-0.1752,0.0593,-0.0932,-0.1843,-0.0309,-0.0846,-0.0001,-0.2407,-0.1107,0.0122,0.0158,0.0681,0.0271,0.1077,-0.1718,-0.1265,0.0502,0.1174,-0.1418,-0.186,-0.0713,0.0977,0.0163,-0.0594,0.1647,-0.0398,0.2363,-0.0414,-0.2024,0.2055,-0.1516,-0.1408,0.1307,-0.0677,0.0667,0.0474,-0.0941,0.0234,-0.2345,-0.0776,0.0178,-0.0973,-0.1124,-0.1064,-0.148,-0.0665,-0.1214,0.0473,0.0271,-0.0022,0.0578,0.0413,-0.2233,0.0173,-0.0819,0.1498,0.2944,0.0875,0.3345,-0.1369,0.1383,0.2432,0.3856,0.1518,-0.0338,0.0111,-0.0435,-0.0655,-0.0043,-0.1779,-0.0116,-0.047,0.0604,-0.0617,-0.1506,-0.0969,0.0459,0.0869,-0.1028,-0.0781,-0.2594,-0.2005,-0.0894,0.0531,0.0649,-0.1436,-0.1444,-0.1288,-0.1469,-0.0292,-0.0916,-0.1143,0.0232,-0.0144,0.1434,-0.0456,0.189,0.1398,-0.2145,-0.1361,-0.113,-0.0224,-0.0014,-0.1515,-0.024,-0.0209,-0.019,0.0081,-0.0197,-0.1509,0.0778,0.0749,-0.0602,0.1795,0.0268,0.0722,-0.1649,-0.032,0.032,-0.166,-0.1926,-0.123,-0.061,0.0002,-0.0624,-0.0959,-0.121,0.056,-0.1069,-0.0178,0.0121,0.0346,0.175,0.0969,0.0095,-0.0394,-0.1814,-0.1558,0.0371,0.0522,-0.0077,0.1038,0.0554,-0.2987,-0.2185,-0.1915,-0.1385,-0.1252,0.0625,-0.0761,-0.0274,-0.0795,-0.0728,-0.0594,-0.1563,-0.141,-0.1371,-0.0079,-0.034,0.0389,0.0065,0.0127,0.0899,-0.1414,0.2863,0.0383,-0.1859,0.0145,0.102,-0.0003,0.1429,-0.1799,-0.0286,-0.1079,0.1245,0.1572,0.173,0.2176,0.0748,-0.088,0.0635,0.0227,0.0767,-0.1261,-0.0494,0.0478,-0.0448,-0.0438,-0.0097,-0.0245,-0.0478,0.1661,0.0956,-0.0592,-0.2082,-0.0977,-0.0746,-0.0819,0.0388,0.0202,-0.0412,0.0816,0.0862,0.0805,0.002,-0.1432,-0.0391,-0.0037,-0.2198,-0.0441,0.2638,-0.1544,-0.0404,0.2882,-0.019,-0.1333,-0.0513,0.0248,-0.268,-0.1629,-0.4102,-0.3741,-0.1424,-0.1986,-0.0892,-0.1882,-0.1179,-0.0391,0.0821,-0.0306,-0.0203,-0.0176,0.0829,0.025,0.0304,-0.3086,-0.1833,0.0395,0.0582,0.0197,0.0595,-0.0342,-0.1068,0.0401,0.1488,-0.156,-0.0272,0.0476,0.1081,-0.1394,-0.061,0.0349,-0.1805,0.0335,-0.064,-0.0281,0.0268,0.0767,-0.0693,-0.082,0.0537,-0.151,-0.1174,0.0503,0.434,-0.1339,-0.0449,0.0342,0.0443,0.1244,-0.0516,-0.1301,-0.0576,0.0551,0.0688,-0.0395,-0.0444,0.1195,0.0557,0.0213,0.0756,0.1431,0.1646,-0.0124,0.0155,-0.1058,-0.0288,0.0925,0.167,-0.1184,-0.1739,0.1427,0.0471,-0.1033,-0.0269,0.0586,-0.1269,-0.1105,0.0288,-0.0463,-0.1325,-0.1207,-0.1545,0.0385,0.0065,-0.0502,0.1528,-0.1934,0.0481,-0.0295,0.0112,0.1228,0.0991,-0.1497,-0.1294,0.1604,-0.1198,-0.1087,-0.0593,0.1031,0.131,0.203,0.0355,0.2077,0.1543,0.0724,0.0763,-0.1008,-0.0357,-0.1017,-0.2896,-0.1316,0.012,-0.1796,-0.1131,-0.0432,-0.1572,-0.0632,0.0242,0.0257,-0.0335,-0.1198,-0.0419,0.0156,0.0314,0.0155,-0.0297,0.1035,-0.0282,-0.0347,0.0095,-0.0217,-0.1771,0.1333,0.0443,0.0814,-0.0409,-0.0706,0.0232,-0.1031,0.0558,-0.0945,0.0725,0.1168,-0.0633,-0.0025,-0.0753,-0.0987,-0.0202,-0.1145,0.0208,0.0356,0.0079,0.0661,0.0486,0.1208,0.1165,0.0206,-0.1191,-0.0181,-0.0538,0.1645,0.0527,0.0729,0.0528,0.1004,-0.0607,-0.1236,0.0313,0.1391,0.1272,-0.0263,-0.0104,-0.2626,-0.0943,0.2004,-0.0506,0.0319,0.0872,0.0653,0.0564,0.099,0.0743,-0.0411,-0.1912,-0.1859,0.0925,-0.1982,-0.0476,0.0659,-0.0951,-0.3198,-0.0683,-0.0893,0.027,0.0315,-0.2614,-0.0825,-0.246,0.0714,0.0206,-0.0432,0.0532,-0.135,-0.1928,-0.1026,0.0495,0.1081,0.0924,-0.1081,-0.0273,0.0386,0.0678,0.0784,-0.0418,-0.0831,-0.05,-0.119,0.1008,0.0035,-0.0363,-0.1127,-0.0386,-0.3105,-0.2268,0.1498,-0.2375,0.0268,-0.1926,0.2282,-0.1256,-0.0614,-0.0586,0.0741,-0.088,-0.0673,-0.1005,-0.2306,0.0771,0.2096,-0.015,0.067,0.1471,-0.1041,-0.1388,-0.014,0.0075,-0.0692,-0.1124,-0.082,-0.0411,-0.0546,-0.1132,0.2525,-0.1157,0.0322,-0.051,0.0538,0.0705,0.0978,0.0555,0.2008,-0.1926,-0.1132,0.0321,0.0267,0.0235,0.1146,0.2055,0.1967,0.122,0.1887,-0.0653,0.0467,-0.0826,-0.11,-0.0301,0.0492,0.0241,-0.0208,-0.1465,-0.1058,-0.0826,-0.1472,-0.1201,-0.0985,0.0598,0.1274,0.0228,-0.0641,0.093,0.0029,-0.0172,-0.0188,0.0446,-0.136,0.0413,0.1322,-0.0944,-0.3383,-0.3324,-0.2447,-0.0159,-0.0381,-0.143,0.0074,-0.0557,0.0327,-0.039,-0.0547,0.1365,0.1319,0.0065,-0.1562,0.1348,0.1446,0.3108,-0.2029,-0.0514,-0.1042,-0.0254,0.0211,-0.147,0.1327,0.0634,-0.0515,0.0161,-0.0265,0.0638,-0.2363,-0.33,-0.2781,-0.2033,0.0756,0.228,0.0184,-0.1267,-0.0327,0.0639,0.0953,0.1023,0.0749,0.0343,-0.1099,-0.1249,-0.0368,0.1339,0.1141,0.1849,-0.0473,-0.0286,0.0329,-0.1015,0.0858,-0.1041,-0.1589,-0.0118,-0.2021,-0.1979,-0.1131,0.0704,0.1006,0.0291,-0.0338,-0.0426,0.0212,0.1662,-0.0104,-0.153,0.0644,0.0026,0.0339,0.0216,0.1405,-0.0912,0.1741,-0.2274,-0.2357,0.1276,0.1295,0.1962,-0.0306,-0.0479,0.0704,0.0137,0.0244,0.2617,0.0361,0.1068,0.1081,0.1751,0.0603,0.0075,0.2172,0.2058,-0.1266,0.0191,0.0771,-0.2381,-0.1861,-0.0275,-0.1478,-0.0529,-0.3197,-0.1131,-0.2039,-0.1364,-0.2742,0.0266,-0.0204,0.051,-0.0838,-0.0295,0.0164,0.0811,0.1577,0.0526,0.1048,0.1648,0.0365,0.0687,0.0507,0.0002,0.1557,0.1686,-0.1325,0.1825,0.0759,-0.0276,-0.0759,-0.1328,-0.0696,0.1197,0.0341,-0.3435,-0.2069,-0.0622,0.0967,0.2087,0.0627,0.0353,0.0525,0.0462,-0.0498,-0.1149,0.1484,-0.0957,0.0504,-0.2369,0.14,-0.0923,0.1729,0.1276,0.0198,0.1295,-0.2757,-0.2551,-0.1069,0.267,-0.0928,-0.1214,-0.1252,0.0994,0.0149,-0.202,-0.0669,-0.1843,0.0974,-0.0768,0.0089,0.0952,-0.0057,0.133,-0.2248,-0.1379,-0.07,0.1013,-0.1636,0.0417,0.1241,0.084,0.1417,0.3641,0.1493,-0.1306,-0.097,-0.1366,-0.0851,-0.1188,-0.0597,0.0341,0.1694,0.0892,0.0138,-0.1346,0.1336,0.2497,0.1122,0.0084,-0.0379,-0.0531,-0.1583,-0.0717,-0.07,0.0179,0.0629,-0.1501,-0.049,0.125,0.0165,-0.1111,-0.0341,0.1001,-0.0627,-0.0442,-0.0791,-0.17,-0.1675,-0.3423,-0.2091,-0.3562,-0.0357,-0.0565,-0.1221,-0.1842,-0.1678,-0.2258,-0.1647,-0.2917,-0.1581,-0.1567,0.0214,0.0682,0.1306,-0.0309,0.043,0.0176,0.0576,0.1267,0.1322,0.1804,0.116,-0.0542,-0.002,0.034,-0.0069,0.1372,0.1118,0.1479,-0.0133,0.1361,-0.0509,0.1098,-0.0583,-0.0562,-0.0253,0.1159,-0.031,0.103,-0.2047,-0.0881,-0.0612,-0.0873,-0.0546,0.0332,0.123,0.0735,0.113,0.1533,0.1183,0.0301,0.0265,-0.0061,-0.0206,0.0611,0.009,-0.0231,-0.0807,-0.1175,-0.0851,0.1067,0.0847,-0.1433,-0.1158,-0.1083,-0.2653,-0.1543,0.2137,0.1187,0.1687,0.0962,0.0594,-0.1073,-0.0335,0.0634,-0.0014,-0.0436,-0.0233,0.0226,-0.076,-0.0518,0.01,0.0826,-0.1297,-0.0223,-0.1164,0.0555,-0.1746,0.06,0.1458,0.2576,0.1281,0.0986,0.0387,0.0394,-0.0209,-0.051,-0.0688,-0.1094,0.0122,0.0091,0.1124,-0.012,-0.0478,0.026,-0.013,-0.078,-0.014,-0.1593,-0.2141,-0.2014,-0.1473,0.2274,0.0258,0.1013,-0.1821,0.2485,0.1348,-0.0202,-0.0379,0.011,0.0496,-0.0313,0.1225,-0.1363,-0.1398,-0.0371,-0.0385,-0.1636,-0.0498,-0.1092,-0.0334,-0.0874,-0.0692,-0.0854,-0.0724,0.0063,-0.017,0.0182,0.0302,0.0588,-0.1138,0.0219,-0.1317,0.0658,-0.0485,-0.085,0.421,0.3248,0.3831,0.2632,0.2864,0.094,0.3562,0.2042,-0.2115,0.1936,0.2073,0.1181,0.1023,0.1093,-0.1003,-0.0084,-0.0888,-0.0207,0.0356,0.0092,0.0577,0.0379,-0.1553,0.0605,0.0701,0.0213,0.1019,-0.0375,-0.1166,0.1061,0.0588,-0.1035,-0.0097,-0.0928,0.0811,0.0401,0.2007,-0.0242,-0.1967,-0.1991,-0.1207,-0.0475,0.129,0.1301,-0.0469,-0.108,-0.2732,-0.211,-0.1165,0.2121,-0.0891,0.2914,0.2795,-0.0895,0.0201,-0.0086,0.1159,0.166,0.1082,0.2353,0.1116,0.0306,0.1001,0.0745,-0.1072,-0.1927,0.1026,-0.1042,0.0962,-0.0081,-0.0997,-0.0166,-0.163,-0.0754,-0.0128,-0.095,-0.1626,0.0167,0.1945,-0.0534,0.0054,-0.0299,0.1632,0.0632,0.0448,-0.2184,-0.2234,-0.0737,-0.082,-0.0536,-0.1366,-0.06,-0.0517,-0.0377,0.2096,0.0777,0.1006,0.3102,0.0126,0.0274,-0.0546,0.1466,0.015,0.2494,-0.1039,0.2324,0.3641,0.0577,-0.1357,0.2985,0.2631,-0.06,-0.1995,0.0363,-0.22,-0.0905,-0.3017,-0.0595,0.1298,-0.0609,-0.0878,0.0641,-0.0654,0.001,-0.1042,-0.0653,-0.0502,-0.0947,0.0063,0.1113,-0.0339,0.3423,0.193,0.2787,0.3,-0.1547,-0.037,-0.1143,-0.1458,-0.1136,-0.048,-0.0034,0.1796,-0.189,-0.1189,0.1246,0.0577,-0.0222,0.1079,0.0931,0.0149,-0.0053,0.1794,-0.0856,-0.1172,-0.0044,0.136,0.0416,-0.0064,-0.0261,-0.0261,-0.2179,0.0878,0.0253,0.0589,-0.0308,0.0805,-0.0399,0.2848,-0.3328,-0.3046,0.1044,-0.0655,-0.258,-0.2589,-0.2103,-0.0337,-0.0686,-0.0785,-0.0186,-0.019,0.2013,0.0169,0.1116,-0.0847,0.1191,0.0078,0.0711,0.0638,-0.0628,-0.096,-0.0154,-0.0805,-0.0448,-0.0523,-0.0199,0.0902,-0.0013,0.1389,0.0631,0.174,0.0414,0.1766,-0.1948,-0.1214,0.0263,-0.1932,0.0031,-0.2187,-0.3194,-0.015,-0.1185,-0.2543,0.0231,-0.0771,-0.2238,-0.0194,-0.0694,0.0279,-0.2025,-0.0488,-0.1203,-0.193,-0.0772,0.0862,-0.0932,0.2654,0.1683,0.1538,0.1852,-0.0225,0.0865,-0.0782,-0.1629,-0.1608,0.0132,-0.1125,-0.0187,-0.1116,-0.0287,0.0631,0.0624,-0.0025,-0.1733,-0.1305,-0.0205,0.0216,0.0013,-0.0312,-0.0496,0.0871,-0.0792,-0.1363,-0.098,-0.2072,-0.1515,-0.0545,-0.1771,-0.1917,0.0258,0.0283,-0.0147,0.0365,0.0197,-0.1647,-0.1341,0.0632,-0.2117,0.036,0.0163,-0.0089,-0.1225,-0.1739,0.0049,0.1741,-0.021,0.0158,0.0251,-0.0604,0.1854,0.0806,0.0323,0.0066,-0.245,0.0884,0.002,0.0914,0.1871,0.0764,0.0168,-0.0834,0.0114,0.2003,-0.1015,0.0316,-0.1522,-0.0386,-0.1422,-0.121,-0.0177,0.1405,-0.0292,-0.0899,-0.1742,-0.0106,-0.0297,0.0068,-0.0622,-0.182,-0.0072,0.0061,-0.0862,0.0801,-0.0737,-0.0566,-0.0538,-0.108,-0.1045,-0.0901,-0.0838,-0.0451,0.0178,-0.0293,0.1217,-0.0644,-0.0293,-0.0254,0.0563,0.0112,-0.0469,-0.2009,0.0634,-0.0929,0.0267,-0.0018,0.0506,0.0712,0.0618,0.0714,-0.0945,-0.0657,-0.1251,-0.0612,-0.2854,0.0111,-0.1905,-0.0188,-0.0692,-0.0779,-0.0612,-0.1362,-0.1352,0.2098,0.1161,0.0077,0.2845,0.1279,0.0853,0.0858,0.1951,-0.016,-0.0694,0.0222,0.2837,0.0007,0.0389,-0.05,-0.1135,-0.0778,-0.0947,0.0381,0.0243,-0.0227,0.1003,0.1365,-0.0667,-0.0814,-0.0481,0.0853,0.1474,0.0869,-0.2984,-0.1326,-0.0429,-0.2347,-0.1828,0.0464,0.154,0.048,0.0326,0.0469,0.0108,-0.2187,-0.0612,-0.0403,-0.1101,-0.2483,-0.1028,-0.0433,-0.1524,-0.0824,0.1409,-0.0479,-0.0748,-0.0502,0.0077,0.1351,0.2629,-0.0645,0.0782,0.0202,-0.0396,-0.1265,-0.0878,0.0596,0.0126,-0.0106,0.2016,0.1328,0.0803,-0.074,-0.1242,0.0417,0.497,0.4931,-0.191,-0.1536,0.0773,-0.0859,-0.0726,-0.0539,-0.2189,0.0751,-0.0417,-0.1,0.0044,0.0323,0.2812,-0.0687,0.2208,0.0484,0.007,0.1148,0.4357,-0.0511,-0.0798,0.3105,0.0474,0.0943,0.0793,0.0651,-0.0761,0.1725,0.1137,-0.0166,-0.0519,-0.0022,0.0151,0.1139,0.1059,-0.05,-0.0507,-0.0705,0.1439,-0.1612,0.0385,0.1694,-0.0911,-0.0262,0.0136,0.0296,-0.1578,-0.0307,0.0526,-0.0754,0.0776,-0.1128,0.0958,0.1611,-0.0415,-0.0434,0.0405,0.0151,0.0166,0.1504,0.1343,0.1464,0.0169,0.1747,0.0737,0.0605,0.4214,-0.1938,-0.1621,0.0818,-0.1675,0.082,0.111,0.1511,-0.0847,0.01,0.0142,-0.0231,0.0543,0.0623,-0.0361,0.007,0.0401,0.0764,0.0591,0.135,0.3287,0.3068,-0.089,-0.1673,-0.1274,-0.024,0.1253,0.0605,-0.0434,0.0421,0.0605,0.0162,0.1089,-0.0461,-0.3322,-0.1274,-0.0214,0.1345,0.0017,0.0631,0.0263,0.2921,0.2225,0.0432,-0.0352,-0.1242,0.0126,0.0511,0.1359,-0.1176,-0.1659,-0.1933,0.0352,-0.0107,0.0202,0.2952,-0.0897,-0.0707,0.0514,0.2157,0.1043,0.2343,-0.0526,0.0037,0.0032,0.0365,0.1604,0.2398,0.248,-0.0322,0.0501,0.0595,0.0846,-0.125,0.1211,-0.277,-0.0995,-0.0536,-0.1265,-0.0093,0.0818,-0.0457,-0.0252,-0.0758,0.0126,0.0135,0.0091,-0.0856,-0.0639,-0.0174,-0.0276,-0.066,0.1016,0.2423,0.1735,0.2618,-0.2668,-0.1629,-0.2204,-0.0547,0.0692,-0.0983,-0.1617,-0.111,-0.1741,-0.0646,0.1507,0.038,0.2203,0.1124,0.0281,0.0614,-0.0049,0.0283,0.0283,0.0123,-0.2189,0.0092,-0.1571,-0.0502,-0.1185,-0.0088,0.1077,0.3092,0.186,0.1175,0.0932,-0.1148,-0.3582,-0.1996,-0.2648,-0.1922,0.0207,-0.051,0.0516,-0.1418,-0.2265,-0.1831,-0.0985,0.0275,0.0217,-0.0445,-0.0777,-0.021,-0.0532,-0.2382,-0.139,-0.1166,0.1017,0.0304,-0.0338,-0.3433,-0.0859,-0.1655,-0.1977,-0.4485,0.0577,-0.0319,-0.0747,-0.0815,-0.0564,-0.0363,-0.0382,-0.1705,-0.091,-0.1616,0.1804,0.0731,0.1784,0.0296,0.1195,-0.1081,0.0627,0.1179,0.2882,-0.1145,-0.0555,-0.0233,0.1946,-0.2143,-0.2658,-0.2048,-0.0861,-0.099,-0.176,-0.1345,-0.1022,-0.0972,-0.0226,-0.0039,0.0108,-0.312,0.0064,-0.0401,-0.1197,-0.0991,-0.1007,-0.0181,-0.1823,0.0658,0.019,0.2031,-0.0252,-0.0807,-0.2678,-0.1273,-0.1635,-0.1054,-0.2921,-0.2082,0.0498,0.1016,0.067,-0.029,-0.0958,0.0227,0.2092,0.2429,0.2326,-0.3162,-0.3373,-0.003,0.1006,0.0121,-0.0968,0.0454,-0.1022,-0.0013,-0.0396,-0.1004,-0.1418,-0.0107,-0.1088,-0.12,-0.001,-0.1228,0.0346,-0.0125,0.0503,0.165,0.1221,-0.0991,-0.2141,-0.2558,-0.1716,-0.1299,-0.3095,-0.1681,0.2999,-0.0905,-0.1432,0.1259,0.0701,-0.0213,0.1101,0.0127,0.0393,0.1882,0.0071,0.0963,0.0449,-0.0183,0.0345,0.0658,0.1928,0.257,-0.3002,0.0235,0.0507,0.3194,-0.0592,-0.0548,0.0569,-0.0412,0.0305,0.0552,0.131,-0.0289,-0.0161,-0.1366,-0.1271,-0.1564,0.0274,-0.093,0.0901,0.2154,0.2526,0.01,0.0041,0.0996,0.2234,0.0985,0.0548,0.0243,0.0259,0.0399,-0.403,-0.1807,-0.2032,-0.1991,-0.1296,-0.1993,-0.2158,-0.1453,-0.0385,-0.0841,-0.2199,-0.1077,0.0524,-0.0968,-0.3565,0.0957,-0.089,-0.0041,0.0523,-0.1056,0.0379,-0.1932,-0.1246,-0.0221,-0.1132,-0.0812,0.0555,-0.1429,0.0682,0.1015,0.1371,0.0124,-0.162,0.0456,-0.0492,-0.2183,-0.0527,-0.131,-0.1211,0.1204,0.0309,-0.0294,-0.1576,-0.1273,-0.0308,0.0104,-0.0346,-0.0829,-0.1546,-0.1018,-0.0027,-0.0809,0.0999,-0.151,-0.0713,0.0754,0.0641,0.0351,0.0512,0.0364,-0.2242,0.0161,-0.0935,-0.1781,0.2052,0.3197,0.2812,-0.0597,0.4666,0.2404,-0.2001,-0.1294,0.4212,0.2029,0.0688,0.1295,0.1167,0.1093,-0.1337,-0.1256,-0.1047,-0.0993,0.5118,0.4124,0.2979,0.0821,0.2213,0.2195,0.4471,0.4326,0.3809,-0.0218,-0.0063,-0.057,-0.0039,-0.0439,0.0341,-0.2464,-0.1018,0.0097,-0.0291,-0.1102,-0.0988,0.1238,-0.0291,0.0303,-0.0689,0.0843,0.2079,0.297,0.009,-0.0335,-0.078,-0.0041,0.0056,-0.0327,-0.0478,-0.1058,-0.0588,-0.0073,-0.2045,-0.3297,-0.3022,0.0609,-0.0389,-0.01,0.2216,0.06,0.2435,0.0786,0.1292,0.327,-0.0376,-0.2258,-0.2461,0.0058,0.1135,-0.0642,0.192,0.102,0.2007,0.1109,-0.1952,-0.1904,-0.1433,-0.1265,0.1281,-0.2817,-0.1757,0.0649,-0.0617,0.174,-0.0261,-0.0007,0.1319,0.0235,-0.0474,0.0324,-0.091,-0.1836,-0.226,0.0423,0.0087,-0.0782,0.014,-0.0541,0.0755,0.3765,0.3149,0.1397,0.2689,-0.1182,0.0758,0.1095,0.2097,0.2673,0.3296,0.0761,0.0771,0.0091,0.2207,0.1993,0.0045,-0.0044,-0.0364,-0.0335,-0.1096,0.0186,-0.0413,0.0045,0.0091,0.0441,0.0679,0.0104,0.174,-0.0636,0.0995,0.1001,-0.1725,-0.2046,-0.1195,-0.1532,-0.2197,0.1505,-0.0498,-0.1153,-0.0722,0.2165,0.0377,-0.27,-0.0446,0.0059,-0.1802,0.0117,-0.0138,0.068,0.143,0.1497,0.4234,0.2664,0.2311,-0.0144,0.0504,0.1537,-0.1571,-0.1669,-0.0197,0.026,-0.0478,0.0171,-0.0301,-0.1148,-0.1553,-0.2309,-0.2912,-0.2371,-0.1161,-0.0774,-0.1536,-0.0615,-0.0967,0.0144,0.0042,-0.0671,-0.0667,-0.0632,0.2593,-0.0053,-0.0078,-0.1429,0.0918,-0.0456,-0.0697,0.1143,-0.2296,-0.1218,0.2336,-0.0925,-0.0982,-0.0263,0.0228,0.0101,0.0487,-0.0754,-0.0683,-0.0382,0.0133,0.0207,-0.2321,0.0744,-0.0161,0.1473,0.0273,-0.2739,-0.1287,-0.0058,-0.0848,-0.0879,-0.0625,-0.1618,-0.0317,0.0559,-0.0161,0.1036,-0.4169,-0.1737,-0.165,-0.3302,-0.245,-0.1778,-0.1608,-0.1608,-0.071,-0.052,0.1044,-0.2582,-0.0512,-0.1069,-0.1119,-0.0089,-0.0541,-0.3893,0.184,-0.2011,0.0676,0.0188,0.3005,0.01,-0.0216,-0.1957,-0.086,-0.0105,0.0399,-0.044,0.2323,0.0601,0.1127,0.2675,0.2197,-0.0103,0.0389,0.055,0.0084,-0.0136,-0.1081,-0.1344,-0.0809,-0.129,-0.0331,-0.024,-0.0077,0.0756,-0.0424,-0.0358,0.097,0.0977,-0.0949,0.1436,-0.0174,-0.1776,-0.0188,-0.2283,-0.0201,-0.0615,0.1109,-0.1132,0.2114,0.1986,0.0457,0.2185,0.1938,-0.0269,0.1548,0.015,0.322,0.1346,0.0041,0.1642,-0.1637,0.073,0.1182,0.0922,-0.0067,-0.0701,0.0386,-0.0327,0.016,-0.068,-0.1442,-0.043,-0.078,0.0146,-0.0249,-0.1267,0.2947,0.0157,0.0622,0.062,-0.002,-0.0115,0.0229,-0.0705,-0.168,-0.0711,0.126,0.1495,-0.0145,0.0211,-0.1184,0.0302,0.1024,0.0954,0.1479,0.0518,0.0244,-0.0712,0.106,-0.1022,-0.0165,0.0748,-0.0264,-0.0412,-0.1036,-0.1062,-0.099,-0.0099,0.0659,-0.131,0.1051,0.0148,0.096,0.0531,0.0891,0.1449,0.0752,-0.0822,-0.0699,-0.0961,-0.0539,0.0548,0.0654,-0.0589,-0.0686,-0.02,0.1189,-0.085,-0.1965,-0.1527,-0.2037,-0.1715,-0.0136,-0.0448,0.0112,-0.1529,-0.1472,-0.1645,-0.043,-0.1252,0.0288,0.0641,-0.0653,0.1651,-0.1588,-0.1421,-0.0578,0.0458,-0.1011,-0.0859,0.13,0.0839,-0.2151,0.0353,0.0016,-0.0601,0.0716,0.077,0.0291,0.0876,-0.0829,-0.2182,-0.0742,-0.2211,-0.2726,0.0257,-0.1483,0.074,0.0978,0.165,0.1594,0.1673,-0.1686,-0.2182,0.0354,0.2054,0.2978,0.0408,-0.0654,-0.0083,0.0037,-0.1274,0.0314,-0.1047,-0.1748,-0.0624,-0.0387,-0.1123,-0.1926,0.1415,0.0004,0.0251,0.1428,-0.0101,0.0367,-0.1126,-0.0338,-0.0502,0.0246,-0.091,0.0131,0.1251,0.098,-0.0241,-0.0763,-0.0746,-0.1408,-0.0443,-0.0287,-0.3013,-0.058,-0.0404,-0.0085,-0.0537,0.0523,0.019,0.0476,-0.0859,0.1019,-0.2375,-0.1448,-0.1858,-0.1912,0.0153,-0.2099,-0.1731,-0.3556,-0.1666,-0.0608,0.2122,-0.1913,-0.0667,-0.0562,0.0617,0.1252,0.0978,-0.1328,-0.2048,-0.0909,-0.0588,0.0231,0.1315,-0.0688,-0.066,-0.0802,0.1178,0.0839,0.0895,0.1956,-0.0266,-0.0353,0.1099,-0.0318,0.048,0.0257,-0.028,-0.0983,0.0116,0.0261,0.1468,0.0116,0.1614,0.1689,0.0285,0.0197,-0.0264,-0.227,-0.1128,-0.0437,0.1935,0.3072,0.1004,-0.0101,-0.004,0.0258,0.3386,0.2097,0.173,0.203,-0.2676,-0.0264,-0.0565,0.0671,-0.0977,0.1031,0.0165,0.0033,0.0387,0.0565,0.0848,-0.077,0.084,0.0645,-0.1681,0.2432,0.1249,0.0343,0.0124,0.0557,0.0571,-0.0202,-0.0179,0.0047,0.0023,0.1463,0.2168,0.2342,-0.1136,0.0466,0.0087,-0.073,-0.1749,-0.4101,-0.3907,0.0515,0.0952,0.1177,-0.0513,0.0467,0.0501,-0.0766,-0.0784,-0.1296,0.0709,-0.0631,-0.0003,-0.0263,0.0849,-0.0113,-0.2128,-0.0527,-0.1865,-0.1462,0.0265,-0.1372,0.0192,-0.2568,-0.1233,-0.0467,-0.0331,0.009,0.1391,0.0086,-0.0863,-0.1506,0.2794,-0.1281,0.1518,0.167,0.1456,-0.0068,0.0413,-0.0974,0.2792,0.2635,-0.2143,-0.134,-0.0692,-0.0425,-0.1445,-0.1455,-0.1738,-0.2777,-0.1217,-0.0089,-0.0998,0.0781,-0.0368,-0.0352,-0.1276,-0.2189,0.1087,0.0657,-0.1993,-0.1032,-0.004,-0.1247,-0.259,0.1089,0.2009,-0.1271,0.0597,0.143,0.1197,-0.1474,-0.1591,-0.1926,-0.2621,-0.11,-0.1046,0.0259,0.1039,0.0556,0.1163,-0.0117,0.227,0.3425,0.2589,0.1397,0.2802,-0.3598,-0.2952,-0.1908,0.0269,-0.0223,-0.0399,-0.1159,0.0059,0.0848,-0.1551,-0.16,-0.0452,0.1983,-0.1675,-0.0034,-0.024,0.0585,0.1156,0.139,0.0037,-0.0845,-0.0274,-0.0857,0.0354,0.1786,0.1736,0.0687,0.0196,0.1338,0.1713,0.1542,0.1253,0.0046,-0.156,0.011,-0.0161,0.0203,-0.0054,0.0324,0.1751,0.0709,0.0441,0.0474,-0.0376,-0.0217,-0.2336,-0.1876,-0.1458,-0.1547,0.4127,0.0105,0.2485,0.1856,0.1315,-0.0062,-0.0069,0.1901,-0.0105,0.2816,0.2285,0.0797,0.1598,0.0893,0.0398,-0.0987,-0.0691,-0.0877,0.0619,0.2363,0.147,-0.1017,-0.0201,0.0144,-0.026,-0.001,-0.0214,-0.1007,-0.1212,0.0014,-0.1524,0.0439,-0.111,0.1234,0.0941,0.1499,0.0879,-0.0391,-0.0192,-0.0157,-0.0591,0.1155,0.227,-0.019,0.0549,-0.0367,0.0961,-0.0542,-0.1247,0.0019,0.1377,0.1323,0.014,-0.1833,-0.1165,-0.1531,-0.1195,0.0363,0.1456,-0.0771,-0.0255,-0.112,-0.1705,-0.3208,-0.2046,-0.1957,-0.1837,-0.1478,-0.1136,-0.0961,0.1058,-0.1489,-0.1667,-0.1331,-0.0832,0.0084,-0.1492,-0.0897,0.0554,0.1701,0.0889,-0.0598,0.3876,0.3588,0.2255,-0.0063,0.0875,-0.0215,-0.1508,0.0527,-0.021,0.0299,0.2017,0.2095,-0.0448,0.0191,0.1004,0.143,-0.1742,-0.1386,-0.0668,-0.0797,-0.1188,-0.0921,-0.0273,-0.1126,0.0572,-0.1737,-0.1413,0.2183,-0.0125,-0.2693,0.0074,0.1401,0.1606,-0.0955,-0.1225,-0.4503,-0.3531,-0.1555,-0.3287,0.1324,-0.1217,-0.1098,0.0735,-0.0687,-0.0351,-0.1229,-0.0495,0.161,0.1416,0.3039,0.188,0.2291,-0.0574,-0.0269,0.1876,0.0257,0.1073,0.0668,0.03,0.2894,0.1863,-0.1701,-0.2894,-0.1553,-0.0756,-0.1692,-0.0556,-0.0551,0.0505,0.0444,0.0231,0.1272,0.0738,-0.2391,-0.0412,-0.1876,-0.0358,-0.192,-0.2567,0.0085,-0.0382,-0.0154,-0.0995,-0.0172,-0.127,-0.0983,-0.2535,-0.0723,-0.1946,-0.0573,-0.0518,-0.05,-0.0481,-0.0777,0.048,0.0934,0.0595,-0.1073,-0.0986,-0.1508,-0.0074,0.1112,0.1321,-0.1055,0.2814,-0.0545,-0.0837,0.0795,0.0844,-0.0534,-0.0068,-0.0016,0.0452,-0.0061,-0.0317,0.1841,0.3417,0.4283,-0.0634,-0.0211,-0.0044,0.1038,-0.0425,0.2318,-0.0113,0.3743,-0.114,0.1301,0.1058,0.1182,0.0129,0.0054,0.0063,0.0488,0.0267,0.0308,0.0965,0.0404,-0.0493,-0.151,0.1061,0.1953,0.2141,-0.2436,-0.1961,-0.2329,0.0064,-0.1922,-0.0712,-0.0252,0.0451,0.0224,-0.0484,-0.1625,-0.1772,0.0546,-0.0088,-0.1544,0.0921,0.3301,0.0616,-0.0783,0.1974,0.4212,0.1814,0.1147,0.2139,-0.1032,0.0333,0.2629,0.2076,-0.1301,0.2879,0.1117,0.0721,0.0846,0.425,0.111,-0.184,-0.1472,-0.096,-0.0985,0.0708,-0.121,0.0293,-0.0909,-0.1101,-0.0257,-0.1858,-0.0855,0.1285,-0.1124,-0.2545,-0.0862,-0.0982,-0.0676,-0.0618,-0.1118,-0.127,-0.1318,-0.0789,-0.0885,-0.2513,-0.185,0.1616,0.2814,-0.031,-0.0354,0.0507,0.021,-0.0519,-0.1044,-0.1146,-0.167,0.0396,0.0655,-0.237,-0.2939,-0.1135,-0.0675,-0.131,-0.1959,0.0094,-0.1442,-0.0753,-0.1577,-0.1209,-0.09,-0.1163,-0.0237,-0.0133,-0.0458,0.1815,-0.1057,0.0471,0.2052,0.1065,-0.1845,-0.0187,-0.2113,-0.1921,-0.1021,-0.0519,-0.0507,0.0567,0.1345,0.1668,-0.0209,-0.0925,0.0487,-0.099,-0.0046,0.1661,-0.1954,-0.1062,-0.1874,0.0482,0.0399,0.1599,0.0138,-0.316,-0.2781,-0.0157,0.0051,0.0053,0.1652,0.1132,-0.0047,-0.1472,-0.1598,-0.083,-0.1824,-0.3629,-0.1521,-0.1108,0.1252,-0.0029,0.1975,-0.0247,0.1614,0.0042,0.0271,0.03,0.1099,0.1739,0.0426,-0.0228,0.0038,-0.0951,0.0256,-0.0545,-0.0054,-0.0646,-0.0361,-0.0305,-0.0076,-0.105,-0.0581,-0.0928,-0.0803,-0.196,-0.0457,0.0216,0.1039,-0.0496,0.098,0.0178,0.0599,-0.0408,-0.0231,0.0184,-0.084,-0.2273,-0.1003,0.2149,0.1774,0.0217,-0.0719,-0.0753,-0.145,-0.0994,-0.0206,-0.0767,0.1334,0.112,-0.2286,-0.2017,0.0174,-0.1856,-0.0598,-0.0507,0.4079,0.2817,-0.2928,0.0728,-0.1088,-0.0229,-0.0821,-0.2354,-0.2494,-0.1894,0.0673,-0.011,-0.117,-0.0173,-0.1385,-0.0429,0.1786,-0.0003,0.0726,0.0142,-0.0042,0.0303,-0.1931,-0.0478,0.0728,-0.1613,0.0866,-0.2514,0.2101,-0.2304,0.3068,0.1112,0.113,-0.3189,-0.2789,0.0989,0.2397,0.0511,0.2276,0.0532,0.0967,0.1016,0.0336,0.1229,0.0848,0.0722,0.0867,0.0979,0.0619,0.1161,-0.0989,0.1482,0.3286,0.601,0.2723,0.2344,0.4086,0.2166,0.2526,0.308,0.2294,0.2808,0.1804,0.2742,0.2904,0.1909,0.2427,0.3141,0.3948,0.3034,0.3394,0.2165,0.2787,-0.247,-0.0868,-0.2524,-0.1402,-0.0901,-0.2925,-0.2662,-0.12,0.0398,-0.0462,-0.3379,-0.2939,-0.1921,-0.0294,0.0033,-0.2173,0.1411,-0.0396,-0.1025,0.0335,-0.1238,-0.0916,-0.0657,-0.0949,-0.1751,0.1033,-0.2562,-0.2702,0.0942,-0.0152,-0.0758,0.0187,0.026,-0.1808,0.1904,0.1741,-0.1866,0.2358,0.301,0.0364,0.0987,0.1548,-0.1032,0.3604,0.3643,-0.0619,-0.0818,0.1342,-0.0616,0.0183,-0.154,-0.0596,0.1457,-0.0503,-0.0974,0.0491,0.0135,-0.0417,-0.0329,animacy decision
trm_557b477b4a15f,-0.0294,-0.1181,-0.0385,-0.1028,0.023,-0.0068,-0.0198,-0.0285,-0.0094,-0.0647,-0.0057,0.0376,-0.0831,-0.0604,-0.0813,-0.0696,-0.0716,-0.0456,-0.0427,0.0065,-0.0153,0.0469,-0.0394,0.0368,-0.0159,0.0157,0.0169,-0.0933,-0.1309,-0.056,-0.0325,-0.0373,-0.0971,-0.088,-0.0862,-0.0899,-0.0089,-0.0581,-0.1086,-0.0156,-0.0843,-0.1001,-0.0294,0.0833,-0.0736,-0.0794,0.195,-0.0208,0.0314,-0.1069,-0.0587,0.0287,0.036,-0.0023,-0.0368,-0.0615,-0.0571,0.0232,0.0322,0.0093,0.0689,0.0659,-0.1505,0.0619,-0.0432,0.0468,-0.1184,-0.1152,-0.0577,0.0126,0.0176,0.0484,0.0769,-0.034,-0.1308,0.0313,-0.142,0.0832,0.0555,-0.0696,0.0462,0.0924,-0.0571,-0.052,0.024,0.0143,-0.0759,-0.012,0.0384,-0.2277,-0.07,-0.0118,-0.0106,0.0642,0.1022,0.0449,0.1135,-0.0218,0.1446,-0.0018,0.0355,0.0339,0.0379,0.0363,0.0712,-0.0679,-0.1424,0.1484,-0.0352,-0.0911,0.0373,-0.0413,0.0648,0.1271,0.0169,-0.0491,-0.0509,0.0617,0.0507,-0.0008,-0.0558,-0.1288,-0.0612,-0.0078,-0.0724,-0.0908,-0.0427,0.063,0.0849,0.0356,-0.0206,-0.0394,0.0309,-0.1684,-0.0127,-0.1101,0.007,-0.0819,-0.0302,-0.0086,-0.0727,-0.0892,0.0078,-0.0157,-0.0006,0.0029,-0.0386,0.0527,-0.0577,0.0002,-0.0319,-0.0327,-0.0951,-0.064,0.1109,0.0067,0.0788,0.031,0.05,-0.0157,-0.0759,-0.0079,-0.1087,-0.1412,-0.0129,-0.0174,0.0406,-0.112,-0.1057,-0.0034,0.0333,-0.0533,0.0254,-0.0846,-0.0767,-0.0994,-0.0701,-0.0467,-0.0139,-0.0398,-0.1248,0.1067,-0.0262,-0.0008,-0.0341,-0.0217,-0.0465,-0.0238,0.008,-0.149,-0.1457,0.0318,0.0123,-0.0489,-0.0372,-0.2117,-0.1712,0.0685,-0.0187,-0.1525,-0.0288,0.1487,-0.1187,-0.1661,-0.0144,-0.0938,-0.0798,-0.0182,-0.0005,0.0369,-0.0546,0.0202,-0.0101,0.0429,0.0798,0.0655,0.1529,-0.1123,-0.1553,0.0508,0.1146,-0.0708,-0.0992,-0.0135,0.0278,0.0509,-0.0768,0.1144,-0.0043,0.1116,-0.0418,-0.1012,0.1524,-0.0988,-0.1008,0.0172,-0.0076,0.0273,-0.0009,-0.0874,0.0353,-0.1456,-0.068,0.0055,-0.0294,-0.0558,-0.0347,-0.1127,-0.0933,-0.0325,0.0502,0.0577,-0.0243,0.0399,-0.0143,-0.092,-0.046,-0.0916,0.1222,0.2363,0.0488,0.1863,-0.069,0.0475,0.1446,0.2419,0.0687,0.0153,0.052,-0.0615,-0.0976,-0.01,-0.1558,0.0019,-0.1138,0.0049,-0.1864,-0.1852,-0.1823,-0.0675,0.0019,-0.0534,-0.0172,-0.1598,-0.1312,-0.0492,0.0116,0.0507,-0.1098,-0.1037,-0.0292,-0.0333,-0.0229,-0.039,-0.0701,-0.011,0.0983,0.0391,-0.0346,0.0492,0.0702,-0.053,-0.1148,-0.05,-0.0472,-0.0456,-0.1099,-0.0868,-0.0516,-0.0184,-0.0012,0.0244,-0.137,0.0882,0.0512,-0.0351,0.1024,0.0433,0.0739,-0.1377,-0.0202,0.0603,-0.1945,-0.2316,-0.0521,-0.0437,0.002,-0.0341,-0.0094,-0.0708,-0.025,-0.0721,0.0826,0.0628,0.0777,0.0802,0.0141,0.0193,0.0082,-0.0625,-0.0502,0.0896,-0.0009,-0.0319,0.1038,0.0443,-0.1415,-0.0996,-0.086,-0.0855,-0.0861,0.0794,-0.0449,-0.0356,-0.0295,-0.0458,-0.0308,-0.1017,-0.0699,-0.078,0.0169,-0.0237,-0.0735,0.0057,-0.018,0.0607,-0.1223,0.1162,-0.0009,-0.0558,-0.0182,0.0387,-0.0122,0.1004,-0.0669,-0.0516,-0.0965,0.111,0.1918,0.1155,0.1995,0.0169,-0.022,0.0541,0.0012,0.0419,-0.1109,-0.0067,0.0326,-0.0153,-0.0294,-0.0301,-0.0486,-0.0287,0.072,0.0106,-0.0538,-0.0845,-0.0921,-0.0513,-0.0184,0.0352,0.0166,0.0105,0.0337,0.0784,0.0398,0.0314,-0.0566,-0.0013,-0.0166,-0.1171,-0.0219,0.1697,-0.0395,-0.0016,0.1958,-0.0042,-0.0644,-0.0302,0.0407,-0.1733,-0.1011,-0.3142,-0.2838,-0.1185,-0.1723,-0.0708,-0.0927,-0.1424,-0.01,0.0049,-0.0626,-0.0529,0.0994,0.0741,-0.0187,-0.0385,-0.1425,-0.0992,-0.0057,0.0571,-0.0097,0.0269,0.0467,-0.0201,-0.037,0.0735,-0.1325,-0.1192,-0.0279,0.0872,-0.1195,-0.0812,-0.0406,-0.096,-0.0243,-0.0887,-0.1047,-0.0249,0.0404,-0.0955,-0.0691,-0.0246,-0.0458,-0.1099,0.007,0.2959,-0.0924,-0.0488,0.0124,0.0529,0.0062,-0.0381,-0.1108,-0.0495,-0.0089,-0.0345,-0.0281,-0.0054,0.0288,0.0017,-0.0422,0.0408,0.0887,0.0843,-0.0438,0.0266,-0.0285,-0.0073,0.0932,0.046,-0.1874,-0.212,0.0474,0.0702,-0.1753,-0.0114,0.0009,-0.0469,-0.0468,0.0244,-0.027,-0.0856,-0.0587,-0.1126,-0.026,-0.0103,-0.0483,0.1055,-0.1194,-0.0184,-0.0512,0.0317,0.1364,0.0104,-0.0264,-0.0282,0.0236,-0.0435,-0.0791,-0.0639,0.1149,0.0661,0.1171,0.1016,0.0916,0.0825,0.0291,0.0258,-0.0981,-0.0334,-0.0821,-0.2394,-0.0189,-0.0167,-0.1202,-0.167,-0.0336,-0.1013,-0.0204,0.0497,-0.0466,-0.0379,-0.0528,-0.0532,-0.0048,0.0608,0.0379,0.0157,0.0797,-0.0151,-0.1109,-0.0577,-0.0359,-0.0812,0.1244,0.0226,0.088,-0.0567,-0.0135,0.0273,-0.0522,0.0274,-0.0527,0.0247,0.1103,-0.0393,-0.0354,-0.0441,-0.0958,0.0117,-0.1222,0.0108,0.0048,-0.0109,0.0329,-0.0303,0.0446,0.0502,-0.0174,-0.0483,-0.0047,-0.0054,0.0577,0.0073,-0.0084,0.0008,0.0247,-0.0073,-0.0526,-0.0434,0.0525,0.0496,-0.1054,-0.0182,-0.1287,-0.0477,0.1114,-0.0462,0.0052,0.0855,0.1098,0.0206,0.0681,-0.0011,-0.0416,-0.0589,-0.0558,0.0261,-0.108,-0.0451,0.0753,-0.028,-0.1498,0.0222,-0.0225,-0.0192,0.0248,-0.1665,-0.0719,-0.1617,0.0422,0.0366,-0.0294,0.0163,-0.0973,-0.0676,-0.0873,-0.001,0.0589,0.0087,-0.0731,-0.0036,-0.0318,0.0047,0.041,-0.0711,-0.008,-0.1011,-0.0545,0.062,0.0062,-0.0411,-0.1208,-0.0244,-0.2059,-0.057,0.0675,-0.196,0.0297,-0.1633,0.1078,-0.1353,-0.0176,-0.0987,-0.0111,-0.0514,-0.0106,-0.0899,-0.1059,0.0019,0.1382,-0.0268,-0.0065,0.0126,-0.0938,-0.0249,-0.0927,-0.0153,-0.0444,-0.0347,-0.0413,-0.1186,-0.085,-0.0381,0.1558,-0.0259,0.0358,-0.0115,0.001,0.0583,0.0559,0.0193,0.1169,-0.1444,-0.0232,0.0204,0.0133,0.0208,0.0487,0.1258,0.0733,0.0694,0.1083,-0.01,0.0317,-0.0358,-0.0589,-0.0118,-0.0065,-0.0225,0.0258,-0.077,-0.037,-0.0383,-0.1175,-0.1443,-0.1018,0.0292,0.1176,0.0473,0.0011,0.0243,0.0575,-0.0056,-0.0011,0.0408,-0.0507,0.0156,0.0706,-0.0459,-0.318,-0.3229,-0.1891,-0.0205,-0.0475,-0.066,0.013,-0.0765,0.0714,-0.0222,-0.0227,0.0888,0.0764,-0.0064,-0.12,0.0796,0.061,0.1247,-0.0651,-0.0324,-0.0888,0.0102,0.0684,-0.0394,0.0656,0.0191,-0.0235,0.0083,-0.0207,0.0718,-0.071,-0.1232,-0.1004,-0.0544,0.0435,0.2371,0.0335,-0.0968,-0.0318,0.0201,0.061,0.111,0.0175,0.0333,-0.0074,-0.0525,-0.014,0.0808,0.0521,0.1138,-0.0435,0.0075,0.021,-0.0484,0.0974,-0.0733,-0.0715,-0.0317,-0.0659,-0.0608,-0.0261,0.0624,0.0682,-0.0051,-0.0115,-0.0077,0.0038,0.1116,-0.0524,-0.1143,0.0995,-0.0479,-0.0165,0.0005,0.0803,-0.1011,0.0381,-0.0637,-0.0671,0.1131,0.1135,0.1869,0.0143,0.0323,0.0157,-0.0037,-0.0494,0.2163,0.0379,0.0263,0.1117,0.1844,0.0623,-0.0172,0.1663,0.174,-0.0989,0.0042,0.0353,-0.1284,-0.1269,-0.0458,-0.0705,0.0504,-0.1281,-0.0368,-0.0692,-0.0508,-0.0934,0.071,0.0413,0.0833,-0.0724,-0.0468,-0.0118,-0.0069,0.0543,0.0282,0.0184,0.1312,0.029,-0.0332,0.0245,-0.0062,0.1068,0.1325,-0.1023,0.0844,0.0366,-0.0011,-0.0328,-0.0527,-0.0432,0.114,-0.0297,-0.2894,-0.1413,-0.027,0.0513,0.0833,-0.0459,0.0138,0.0097,-0.0262,-0.0066,-0.0304,0.0199,-0.0634,0.0014,-0.1486,0.0118,-0.0208,0.0744,0.0217,-0.0106,0.0281,-0.1981,-0.1765,-0.0074,0.2097,-0.0579,-0.0303,-0.0841,0.0345,0.0406,-0.0738,-0.0095,-0.069,-0.0218,-0.0464,0.0126,0.0581,-0.0017,0.0893,-0.1524,-0.0805,-0.0219,0.0283,-0.0708,0.0206,0.1988,0.1008,0.0955,0.3282,0.1343,0.0195,-0.0213,-0.0492,-0.041,-0.014,0.0039,0.0153,0.0996,0.0981,0.0643,-0.0483,0.095,0.1382,0.0246,-0.048,-0.0476,-0.0278,-0.1292,-0.0335,-0.0431,0.0361,0.0455,-0.0325,-0.0301,0.1119,0.0085,-0.1434,0.009,0.0413,-0.0031,-0.0026,-0.0238,-0.0574,-0.0576,-0.1725,-0.1276,-0.1487,0.0621,0.0117,-0.0606,-0.1327,-0.0401,-0.1144,-0.0342,-0.1484,-0.1014,-0.1434,0.0353,0.0626,0.0808,-0.0303,0.0382,-0.0145,0.0327,0.1164,0.1781,0.2243,0.0969,-0.0484,-0.035,0.0252,-0.0301,0.0451,0.0647,0.0758,-0.0392,0.0096,0.0644,0.1405,-0.0417,0.0038,-0.0267,0.1187,-0.0635,0.101,-0.0951,-0.0122,0.0147,-0.04,-0.0048,0.0585,0.0219,0.0134,0.0665,0.1682,0.1524,0.0042,0.0227,0.0279,-0.0622,0.0465,0.0065,0.0069,-0.0419,-0.1425,-0.0585,0.0218,0.0011,-0.0926,-0.0797,-0.0199,-0.1559,-0.0999,0.0903,0.0571,0.0717,0.0883,0.1178,-0.0753,-0.0579,0.0107,0.0,-0.0203,-0.0166,0.0188,-0.0527,-0.0578,0.0062,0.0403,-0.0762,0.0125,-0.0569,0.0322,-0.1038,0.0143,0.0826,0.0951,0.0022,0.0378,0.0185,-0.0375,0.0183,-0.0172,-0.0231,-0.0368,-0.0171,0.0138,0.0676,-0.0697,-0.025,0.0061,0.0394,-0.0286,-0.0215,-0.0866,-0.1148,-0.1185,-0.0692,0.1139,-0.0097,0.0339,-0.0974,0.1864,0.0712,-0.0021,-0.0241,0.0627,0.0378,-0.0221,0.1064,-0.0669,-0.0885,-0.0128,-0.0258,-0.0664,-0.025,-0.042,0.0512,0.0376,-0.0616,-0.0731,-0.0874,0.0177,-0.008,-0.0166,0.0157,-0.0245,-0.1202,-0.0263,0.0011,0.0649,-0.04,-0.0308,0.3777,0.3199,0.2476,0.1361,0.1359,0.0627,0.2484,0.1618,-0.0418,0.2742,0.2534,0.1613,0.1627,0.2393,0.0233,0.0508,0.021,-0.0057,0.0331,0.0014,0.0223,-0.0241,-0.0762,0.0164,0.0404,0.0303,0.0569,-0.0411,-0.125,0.0908,0.0464,-0.0395,-0.0292,-0.0141,0.053,0.0414,0.1339,0.0034,-0.13,-0.0284,0.0513,0.0711,0.1439,0.0824,-0.0579,-0.0822,-0.1943,-0.0786,-0.0466,0.2448,-0.0482,0.2263,0.1635,-0.0606,0.0398,-0.0617,0.0333,0.066,0.0199,0.1788,0.103,-0.0043,-0.0071,0.0203,-0.0233,-0.1166,0.0211,-0.0244,0.0043,-0.0361,-0.0898,-0.021,-0.1087,-0.0442,0.0534,0.0507,-0.1141,-0.0096,0.0939,0.0358,-0.0149,-0.0574,0.0472,0.0503,0.0248,-0.0357,-0.0478,-0.0874,-0.0642,-0.0475,-0.0998,0.0099,-0.0144,-0.0173,0.0351,0.028,0.0353,0.1605,-0.041,-0.0916,-0.0232,0.1064,-0.0197,0.0947,-0.0928,0.0968,0.1691,0.0532,-0.1143,0.1309,0.114,-0.0486,-0.1315,0.0218,-0.0864,-0.0396,-0.2357,-0.0171,0.0636,-0.0992,-0.1685,0.0076,-0.0911,-0.0054,-0.0525,-0.118,-0.0893,-0.0621,-0.0544,0.0723,-0.03,0.3734,0.2344,0.2814,0.309,-0.0678,0.0054,-0.0405,-0.0348,-0.0796,0.005,-0.0486,0.1786,-0.077,0.0019,0.0297,0.0348,0.04,0.0773,0.0186,-0.0269,0.0088,0.0488,-0.0228,-0.0006,-0.0576,0.0287,-0.0028,0.0075,-0.0165,-0.0165,-0.1044,0.0155,-0.0494,0.0002,-0.0186,0.1366,-0.0711,0.1474,-0.1596,-0.1417,0.0421,-0.0352,-0.0985,-0.1009,-0.1397,-0.0875,-0.015,0.0027,0.0377,-0.0195,0.0818,0.0072,0.0231,-0.1002,0.0716,-0.0049,-0.0188,-0.0142,-0.0482,-0.0476,-0.028,-0.1085,-0.0583,-0.0523,-0.1039,0.0192,0.007,0.0377,-0.0027,0.0855,0.0182,0.0853,-0.0038,0.0444,0.0227,-0.0838,0.0437,-0.1151,-0.1766,0.0202,-0.0152,-0.1378,-0.0259,-0.0511,-0.1289,0.02,-0.0673,0.0674,-0.1881,-0.0964,-0.0512,-0.1707,-0.0164,0.0001,-0.0051,0.2577,0.0618,0.0399,0.0627,-0.0034,0.0345,-0.0304,-0.1877,-0.1874,0.0578,-0.0608,-0.0547,-0.0185,-0.0041,0.0208,0.0299,-0.0097,-0.0114,-0.0622,-0.0634,-0.0516,-0.0495,-0.0153,0.0014,0.0881,0.0012,-0.1253,0.0534,-0.0184,-0.0243,-0.0235,-0.0841,-0.1048,0.0272,0.0356,0.0082,0.1083,-0.0422,-0.0649,-0.0648,-0.0071,-0.0876,0.0296,-0.0142,-0.0339,-0.1188,-0.2179,-0.0128,0.0932,0.0466,-0.0407,0.044,0.006,0.179,-0.0247,-0.0361,-0.0473,-0.1201,0.064,-0.0009,0.1105,0.0775,0.2095,-0.007,-0.0853,-0.0304,0.1115,-0.027,0.0543,-0.0424,-0.0185,-0.0881,-0.0557,-0.0324,0.0853,-0.0671,0.0114,-0.0812,-0.0041,0.0373,-0.0356,-0.0077,-0.0991,0.0119,-0.002,-0.0372,0.0734,-0.013,-0.0304,-0.0542,-0.0273,-0.0111,-0.0217,-0.052,-0.0506,0.0252,-0.0263,0.0539,-0.032,-0.0198,0.0192,0.0301,-0.0309,-0.1066,-0.2501,0.0589,-0.0695,0.0055,0.0374,0.0589,0.0683,0.0608,0.0393,-0.0711,-0.0726,-0.0116,-0.0344,-0.1273,0.0054,-0.114,0.0202,0.0049,-0.0546,-0.081,-0.1023,-0.1015,0.0029,-0.0331,-0.0472,0.2325,-0.0648,0.0577,0.0587,0.145,0.0036,-0.0769,0.1039,0.1542,-0.0502,0.0201,-0.0547,-0.0845,-0.0678,-0.0365,0.0298,0.0067,-0.0441,0.0326,0.0858,-0.0185,-0.0497,-0.0389,-0.0036,0.0483,0.0378,-0.1966,-0.1054,-0.0779,-0.1534,-0.1337,0.0558,0.0888,0.0297,-0.0106,-0.0489,0.0234,-0.124,-0.0074,-0.0747,-0.0797,-0.1795,-0.1213,-0.0453,-0.1817,-0.154,0.1097,-0.0269,-0.0536,-0.0569,0.0073,0.104,0.156,0.0142,0.0696,-0.0315,-0.0544,-0.0619,-0.0774,0.005,0.0326,-0.006,0.1058,0.1042,0.0618,-0.0176,-0.0369,-0.0717,0.2689,0.2713,-0.1672,-0.1616,0.0502,-0.0421,-0.0462,-0.034,-0.1298,0.0487,-0.038,-0.0225,-0.0555,-0.0415,0.1031,-0.0753,0.071,0.0386,-0.0537,-0.0266,0.251,-0.0409,-0.0424,0.2293,-0.0134,0.0381,0.0267,0.0242,-0.0309,0.1082,0.0519,-0.0323,-0.0284,-0.0498,-0.0174,0.0391,0.0385,-0.1008,-0.1585,-0.1076,0.0785,-0.0649,0.0418,0.1324,-0.0603,-0.0804,0.037,0.0108,-0.1106,-0.0075,0.0498,-0.0407,-0.054,-0.1444,-0.0057,0.035,-0.0679,-0.0437,0.0121,0.0783,0.0185,0.1835,0.0889,0.1321,0.0928,0.1295,-0.0031,0.0403,0.3969,-0.0347,-0.1759,0.006,-0.1238,0.0044,0.0385,0.0351,-0.0212,0.0337,0.023,-0.0163,0.0293,0.106,0.0439,-0.0162,-0.014,0.0342,0.0793,0.0983,0.1906,0.1804,-0.0399,-0.074,-0.0622,-0.021,-0.0127,0.0028,0.0026,0.0352,0.0841,-0.0151,0.0499,-0.0563,-0.1552,-0.061,0.0128,0.0471,0.0268,0.0739,0.0662,0.2853,0.1774,-0.0843,-0.0038,-0.0461,0.0094,0.0395,0.0748,-0.182,-0.1775,-0.2311,0.0419,-0.0046,0.0335,0.1214,-0.002,0.0759,0.0812,0.0411,-0.0097,0.0897,0.0533,0.0041,-0.0318,0.0359,0.0737,0.1443,0.2271,0.0047,0.0862,0.1048,0.0294,-0.0022,0.0357,-0.1265,-0.0316,-0.0409,-0.0928,0.0267,0.0168,-0.0378,-0.03,-0.0161,0.0253,0.0263,-0.0011,-0.0654,-0.0532,-0.0298,-0.0108,-0.0663,0.011,0.1354,0.0551,0.1082,-0.0554,-0.0645,-0.0621,0.0101,0.0285,-0.0524,-0.0582,-0.0516,-0.1259,-0.0441,0.0758,0.0206,0.0906,0.0628,0.0257,0.022,-0.0249,0.0356,0.0131,-0.0259,-0.1733,-0.0161,-0.049,-0.0313,-0.0361,0.0672,0.0608,0.2682,0.1981,0.0942,0.0901,-0.1219,-0.1485,-0.099,-0.1025,-0.0588,0.0547,-0.0575,0.0562,-0.0585,-0.0763,-0.1113,-0.0818,-0.043,-0.0129,-0.0409,-0.0121,0.0347,0.0147,-0.0822,-0.1219,-0.0116,0.0876,0.0176,0.0276,-0.184,-0.066,-0.0992,-0.0567,-0.3224,-0.0147,0.0896,-0.0278,-0.0796,-0.035,-0.0758,-0.0066,-0.0851,-0.0743,-0.0683,0.1061,0.1471,0.0448,0.0762,0.1222,-0.1459,0.0111,0.0456,0.1134,-0.0309,-0.0126,-0.1081,0.1376,-0.2033,-0.2557,-0.2099,-0.0504,-0.0083,-0.069,-0.0272,-0.0375,-0.0436,-0.0577,0.0012,-0.0106,-0.107,0.0368,-0.0467,-0.0315,-0.0966,-0.0048,-0.1114,-0.1213,-0.0461,-0.0175,0.2248,-0.0638,-0.1373,-0.2565,-0.0981,-0.0964,-0.082,-0.2779,-0.2295,-0.0269,0.0507,0.0344,-0.0338,-0.0126,-0.0001,0.1188,0.1462,0.0382,-0.3199,-0.3107,-0.0329,0.0503,0.0138,-0.0896,0.0314,-0.0556,-0.0179,-0.0244,-0.088,-0.0248,-0.0169,-0.0372,-0.0246,0.0451,-0.032,-0.0563,-0.0266,-0.0596,0.1076,0.1138,-0.0647,-0.0498,-0.2263,-0.0883,-0.0405,-0.1006,-0.0662,0.2291,-0.0172,-0.0533,0.0065,0.0053,-0.0437,0.0115,-0.0376,-0.0014,0.0614,-0.0055,0.0131,0.0184,-0.0721,0.0019,-0.0118,0.0848,0.1782,-0.1956,0.0369,0.0542,0.2657,-0.1002,0.0983,0.0228,-0.0619,0.02,0.01,0.0468,-0.0161,0.0407,-0.1006,-0.1459,-0.1749,-0.0616,-0.0289,0.059,0.1425,0.1165,0.0387,0.0067,0.0691,0.2284,0.0951,0.0466,-0.0156,0.0607,0.0735,-0.1651,-0.0927,-0.1137,-0.0889,-0.0447,-0.0799,-0.0448,-0.0451,0.0631,-0.0229,-0.1342,-0.11,-0.1699,-0.1756,-0.2923,0.0067,-0.2085,-0.0897,0.0595,-0.0552,-0.0168,-0.1194,-0.0797,-0.0148,-0.0444,-0.009,0.0065,-0.072,0.0436,0.1208,0.1268,-0.0024,-0.0806,0.0626,-0.0286,-0.039,0.0885,-0.0307,-0.0179,0.071,0.018,0.0355,-0.1321,-0.1306,-0.0387,-0.0025,-0.0243,-0.0545,-0.0848,-0.069,0.0018,-0.0408,0.0687,-0.149,-0.0145,0.0057,-0.0451,-0.0326,0.0469,0.0367,-0.1726,-0.005,-0.0226,-0.0512,0.1143,0.1994,0.1747,0.0023,0.3796,0.2263,-0.1302,-0.0616,0.3995,0.0969,0.0144,0.0899,0.085,0.0485,-0.0554,-0.0517,-0.0707,-0.0923,0.4859,0.4049,0.2732,0.0983,0.2077,0.2411,0.3939,0.3747,0.3106,0.0472,0.0044,-0.0237,-0.0058,-0.0478,-0.0215,-0.0722,-0.0505,0.0493,-0.0216,-0.0569,-0.0426,0.1291,-0.02,-0.0051,-0.0538,0.0822,0.0771,0.115,-0.0701,-0.0548,-0.0981,0.0158,0.0022,-0.0099,-0.0401,-0.0486,-0.0386,0.0036,-0.0507,-0.0968,-0.0801,-0.016,-0.1066,-0.0232,0.2432,0.0606,0.0955,0.0807,0.0984,0.1964,0.0175,-0.135,-0.1351,-0.0394,0.0207,-0.0425,0.1009,0.0559,0.0853,-0.0224,-0.0837,-0.0862,-0.088,-0.0741,0.0188,-0.2003,-0.1443,0.0396,-0.0315,0.0843,-0.0165,-0.0047,0.0584,-0.0538,0.1657,0.1569,0.0709,-0.068,-0.1382,0.0005,0.0903,-0.0368,0.0047,-0.0224,0.0599,0.1156,0.1087,0.018,0.1488,-0.1753,-0.0297,0.0513,0.0436,0.1161,0.1267,0.093,0.0562,-0.0389,0.0765,0.1133,-0.0051,-0.0088,-0.0849,-0.0548,-0.0429,0.0038,-0.0303,-0.0192,0.0323,-0.0003,0.0546,0.0152,0.0991,-0.0898,0.1068,0.0912,-0.0816,-0.1131,-0.0706,-0.0929,-0.0888,0.1068,0.023,-0.0149,-0.0382,0.1393,-0.0416,-0.2612,-0.038,0.0055,-0.1252,0.0464,-0.0182,0.0284,0.0908,0.129,0.3638,0.111,0.0651,-0.0442,-0.027,0.0437,-0.0646,-0.0774,-0.0131,0.0286,-0.0637,0.0411,-0.1077,-0.0463,-0.1295,-0.1592,-0.1414,-0.0925,-0.0852,-0.0646,-0.0602,-0.0453,-0.0349,-0.0182,0.0319,-0.0623,-0.0708,-0.1031,0.0573,0.0633,-0.0305,-0.0185,0.1216,0.0636,-0.1456,0.167,-0.087,-0.0845,0.1123,-0.1493,-0.1563,0.0111,0.0274,0.0592,0.0137,-0.0862,-0.0187,0.024,-0.0099,0.0639,-0.0552,0.0502,0.0115,0.0617,0.0563,-0.1429,-0.0241,-0.0011,-0.0189,-0.0246,-0.01,-0.0295,-0.0042,0.0149,-0.0846,0.0559,-0.197,-0.0975,-0.1027,-0.1524,-0.0993,-0.0825,-0.0502,-0.0502,-0.0107,-0.0362,0.0272,-0.1414,-0.0208,-0.0674,-0.0639,-0.166,-0.0116,-0.3449,0.0429,-0.127,0.0191,-0.0784,0.1262,-0.1344,-0.1045,-0.0793,-0.0974,0.0677,0.0386,-0.1066,0.1052,0.0516,0.0162,0.1034,0.0873,-0.0243,0.0196,-0.0225,-0.0242,-0.0094,-0.2298,-0.1758,-0.0288,-0.0406,-0.014,0.0121,0.0361,-0.0005,0.0273,-0.003,0.0121,0.1156,-0.0387,0.1224,0.0103,-0.1428,-0.0768,-0.1778,0.013,-0.0783,0.0102,-0.0473,0.048,0.0431,-0.0497,0.1029,0.0687,-0.0215,0.1149,0.0566,0.2173,0.0798,-0.023,0.0938,-0.1015,0.0354,0.0171,0.0634,0.0036,-0.0326,0.0443,-0.0391,0.0208,-0.0784,-0.1767,-0.0551,-0.0798,0.0003,-0.0624,-0.115,0.3094,0.0023,0.088,0.1016,-0.0334,-0.0051,0.0238,-0.0253,-0.0803,-0.0498,0.1172,0.0926,-0.0468,0.0058,-0.0322,0.0378,0.0361,0.0947,-0.0035,0.0149,0.015,-0.0504,0.0521,-0.089,-0.0432,-0.0479,-0.022,-0.0485,-0.0279,-0.0375,-0.0119,0.0028,0.018,-0.0647,0.0658,-0.0064,0.0429,0.0302,0.03,0.0625,-0.0039,-0.0685,-0.0313,-0.0702,-0.0638,0.0153,0.071,-0.0317,-0.0489,0.0015,0.0201,-0.1624,-0.0543,-0.0457,-0.1341,-0.1343,0.0326,-0.0144,0.0215,-0.1259,-0.086,-0.0659,-0.0715,-0.0563,-0.008,0.0369,-0.052,0.1308,-0.0584,-0.0522,-0.0231,-0.0339,-0.0915,-0.0545,0.0712,0.0162,-0.1337,0.0368,0.0178,-0.0693,0.0886,0.0638,-0.0071,0.0856,-0.0115,-0.1136,-0.054,-0.1111,-0.12,-0.0054,-0.0384,0.0655,0.0138,0.1118,0.1183,0.1278,-0.1017,-0.0652,-0.0431,0.0912,0.1599,0.0257,-0.0297,0.0153,-0.0029,-0.1139,-0.0313,-0.0965,-0.0739,-0.0194,-0.0131,-0.0467,-0.0756,0.13,0.0225,0.0138,0.137,-0.0143,0.0022,-0.1054,0.0013,-0.046,0.0103,-0.072,-0.0198,-0.0241,0.0207,-0.0812,-0.0318,-0.0188,-0.0393,0.061,-0.0614,-0.2503,-0.035,-0.0667,-0.0045,0.0173,0.0072,-0.0159,0.0172,-0.0783,0.0371,-0.0847,-0.0344,-0.0585,-0.0988,-0.0239,-0.0997,-0.0656,-0.1862,-0.0962,-0.0717,0.0689,-0.1061,0.0399,-0.1028,0.0942,0.0793,0.049,-0.0636,-0.1278,-0.0788,-0.0188,0.024,0.0865,-0.0741,-0.0303,-0.0803,0.0725,0.0495,0.0093,0.0533,-0.0131,-0.0502,0.0292,-0.0038,0.0081,0.062,0.0344,-0.0821,-0.0309,0.0351,0.194,-0.014,0.1244,0.0939,-0.0162,-0.0006,-0.0096,-0.1289,-0.0487,-0.0039,0.1007,0.1606,0.0848,-0.0091,0.0151,-0.0586,0.1507,0.1552,0.0603,0.1115,-0.1642,-0.0064,-0.0491,0.1241,0.0108,0.0204,0.0263,-0.0209,0.0033,0.0509,0.0699,-0.0235,0.104,0.0142,-0.086,0.1245,0.0698,-0.0034,0.0343,-0.0127,0.0373,0.0102,0.004,0.0564,-0.0328,0.0636,0.1204,0.1615,0.0026,0.03,0.0481,-0.0291,-0.1284,-0.3114,-0.2987,0.0329,0.082,0.0413,0.0085,0.0395,-0.0299,-0.0842,0.0013,-0.0461,0.0654,-0.0508,-0.0443,-0.0273,0.039,-0.0698,-0.0539,0.0351,-0.0594,-0.0501,0.0123,-0.0479,0.0592,-0.1308,-0.0493,-0.0204,-0.0253,0.0256,0.0712,-0.0534,-0.0742,-0.0702,0.2048,-0.1175,0.0555,0.0641,0.0379,0.0152,0.0731,-0.1037,0.1476,0.1472,-0.0697,-0.058,-0.0991,0.0105,-0.0172,-0.0877,-0.1953,-0.1762,-0.0828,0.0482,0.0182,0.0555,-0.0345,-0.0455,-0.0979,-0.1324,0.2399,0.2156,-0.1475,-0.0883,-0.0012,-0.0423,-0.1179,0.1338,0.1331,-0.0626,0.0466,0.111,0.0266,-0.1379,-0.1608,-0.1444,-0.2028,-0.0367,-0.0656,0.0714,0.0143,0.0053,0.0398,-0.0454,0.0877,0.3362,0.1954,0.0607,0.2499,-0.2599,-0.2448,-0.0559,-0.0419,-0.0605,-0.0443,-0.0907,-0.0316,-0.0145,-0.1131,-0.1086,-0.0721,0.1806,-0.0653,-0.0525,-0.0208,-0.0163,0.0896,0.1125,-0.0776,-0.1662,-0.1069,-0.1656,0.033,0.1061,0.0891,0.0478,0.0264,0.0085,0.0617,0.0518,0.0596,-0.0397,-0.0324,0.0393,-0.026,-0.0312,0.0443,0.048,0.0415,0.0222,0.0475,0.0434,-0.0207,0.0205,-0.1321,-0.1067,-0.0607,-0.0887,0.3599,0.0224,0.1645,0.0997,0.0363,-0.0164,0.0056,0.0899,-0.0725,0.1476,0.135,0.0081,0.0512,0.0416,0.0001,-0.0798,-0.0449,-0.0852,0.0238,0.1837,0.0779,-0.089,-0.0112,0.0182,-0.0527,0.0386,0.0173,-0.1131,-0.0942,0.005,-0.142,-0.018,-0.0376,0.0619,0.0449,0.0564,0.0411,-0.0087,-0.0209,-0.0562,-0.0375,0.0764,0.1244,0.0062,0.0396,-0.0594,0.0435,-0.0912,-0.1364,-0.0161,0.1321,0.0466,-0.0438,-0.1162,-0.0418,-0.0497,-0.0871,0.037,0.011,-0.0356,0.0304,-0.0681,-0.0872,-0.2068,-0.1754,-0.1696,-0.1675,-0.1051,-0.0499,-0.0694,0.0244,-0.1382,-0.1325,-0.1448,-0.0739,-0.1133,-0.2075,-0.1006,0.0483,0.1747,0.0474,-0.1512,0.2543,0.2398,0.1565,-0.039,0.0188,0.0133,-0.163,-0.0365,-0.0531,0.0541,0.1307,0.1542,0.0338,0.0122,0.0481,0.0499,-0.1846,-0.0482,-0.0387,-0.0154,-0.1915,-0.1488,-0.0983,-0.1781,0.0628,-0.1174,-0.0773,0.1026,-0.0752,-0.1824,0.0019,0.1245,0.0801,-0.0795,-0.0852,-0.355,-0.2449,-0.1586,-0.2786,0.1128,-0.0348,-0.0291,0.0858,-0.1419,-0.0479,-0.0825,-0.013,0.176,0.0749,0.2,0.1024,0.1145,-0.0853,-0.0611,0.0999,-0.0253,0.0512,0.0289,-0.0416,0.1986,0.0822,-0.1306,-0.128,-0.0555,-0.0237,-0.0571,-0.0785,-0.0531,0.021,0.0761,-0.0188,0.0765,0.0442,-0.0674,0.0256,-0.0346,0.0134,-0.1277,-0.1316,0.0048,-0.0981,0.0014,-0.0653,-0.0674,-0.0875,-0.0668,-0.0994,-0.0536,-0.076,-0.0679,-0.0068,0.0441,-0.0074,-0.0762,0.035,0.0066,-0.0086,-0.0343,0.0148,-0.1113,-0.0241,0.0881,0.0158,-0.0767,0.129,-0.0363,-0.0535,0.1012,0.0285,0.0394,0.0356,-0.0037,-0.0186,-0.0545,-0.0101,0.1202,0.1073,0.2463,-0.1486,-0.0708,-0.006,-0.0831,-0.0197,0.1224,-0.1532,0.1752,-0.1968,0.0023,-0.009,0.0611,-0.0599,-0.0486,0.0081,0.0157,-0.1632,-0.153,0.1216,0.0089,-0.0349,-0.0503,0.0876,0.0909,0.0955,-0.1201,-0.1117,-0.0978,-0.0162,-0.0686,-0.1637,0.0176,-0.0269,0.0027,-0.0031,-0.0748,-0.0678,0.0073,0.0122,-0.0998,-0.0172,0.1952,0.0072,-0.0381,0.1259,0.1949,0.0697,0.0319,0.086,-0.0894,-0.0142,0.1813,0.0806,-0.1118,0.1525,0.0539,0.0443,0.062,0.1648,0.076,-0.0262,-0.0806,-0.0682,-0.1097,0.0358,-0.1052,0.0035,-0.129,-0.1772,-0.1237,-0.0263,-0.0165,0.1427,-0.0952,-0.1181,-0.16,-0.1563,-0.1337,-0.1606,-0.2047,-0.1998,-0.1822,-0.0332,-0.054,-0.0707,-0.0488,0.1406,0.2244,-0.0482,-0.0115,0.0714,0.0352,-0.0741,-0.0533,-0.0923,-0.1129,0.0479,0.0619,-0.2197,-0.2838,-0.0245,0.0011,-0.0248,-0.1692,-0.0279,-0.0786,-0.0572,-0.1926,-0.0204,-0.0378,-0.0172,-0.0152,-0.0169,-0.134,0.0838,-0.1051,0.0278,0.1614,0.0236,-0.0852,-0.0235,-0.2258,-0.0623,-0.0303,-0.0787,-0.1013,0.053,0.0555,0.0933,-0.0184,-0.0421,0.002,-0.1502,-0.011,0.1054,-0.0778,-0.0152,-0.0562,0.0592,0.03,0.0895,-0.0224,-0.1704,-0.1165,-0.0152,-0.0064,0.0573,0.0733,0.1462,0.0028,-0.0406,-0.0421,-0.0135,-0.0746,-0.1521,-0.0428,-0.1153,0.0536,0.0093,0.0857,-0.0176,0.0702,-0.0269,0.0243,0.0418,0.0713,0.099,0.0407,-0.0422,0.0141,-0.0888,0.0073,-0.0174,-0.0357,0.0066,0.0124,-0.0083,0.0028,-0.0605,-0.0507,-0.0687,-0.0378,-0.1245,0.0015,-0.0508,0.0782,-0.0008,0.051,0.0446,0.0274,-0.0233,0.0566,-0.0212,-0.0006,-0.096,-0.0767,0.1447,0.0683,0.0116,-0.0425,-0.069,-0.1036,-0.0205,-0.0038,-0.0478,0.0273,0.0486,-0.1665,-0.0611,-0.0129,-0.0722,-0.0183,-0.0164,0.3832,0.2365,-0.1223,0.0279,-0.0143,0.0104,-0.0641,-0.0678,-0.0958,-0.1495,0.0492,-0.002,-0.0743,0.0298,-0.0723,0.0027,0.0887,-0.0185,0.0343,0.0139,-0.0077,0.0075,-0.0794,0.0182,0.1289,-0.103,0.0566,-0.1662,0.061,-0.0861,0.3531,0.0496,0.0496,-0.1397,-0.1312,-0.0156,0.0871,-0.0186,0.0679,-0.0757,0.0335,0.0294,0.0685,0.0379,0.0347,0.0359,0.0467,0.0778,0.1394,0.1967,-0.1129,0.1461,0.2624,0.4948,0.176,0.1166,0.4077,0.2446,0.2085,0.2832,0.1666,0.2116,0.1533,0.1935,0.2668,0.1033,0.2663,0.1944,0.2335,0.1881,0.209,0.129,0.1912,-0.1007,-0.0844,-0.1206,-0.1664,-0.1295,-0.1076,-0.1072,-0.0348,-0.0699,-0.0438,-0.1279,-0.099,-0.0889,-0.025,-0.0044,-0.0726,0.0844,-0.0272,-0.0985,-0.0492,-0.1169,-0.0334,-0.0352,0.0131,-0.053,0.076,-0.0741,-0.092,0.0941,-0.0309,-0.052,0.0267,0.0286,-0.0589,0.0982,0.0397,-0.0697,0.0857,0.1964,-0.0064,0.0361,0.0408,-0.1004,0.1501,0.1504,-0.0409,-0.0684,0.0595,0.0311,0.0508,-0.0412,-0.0215,0.1051,0.0215,-0.023,0.0235,0.0189,-0.0212,-0.0505,body maintenance
trm_4a3fd79d0af71,0.1614,0.1267,0.1546,0.1737,0.0122,0.0103,0.1116,0.0833,0.0668,0.128,0.0556,0.0187,0.1373,0.0841,0.1548,0.0745,0.1069,0.1748,0.0951,0.0878,0.1134,0.0037,0.0324,0.0035,0.0182,0.0008,0.0018,0.1428,0.1644,0.094,0.116,0.1333,0.1299,0.1105,0.1157,0.0945,0.0466,0.0677,0.1563,0.0459,0.1269,0.1255,0.0667,-0.0801,0.1138,0.0848,-0.1565,0.1131,-0.0157,0.1118,0.048,-0.0319,-0.0631,0.0492,0.0304,0.079,0.0768,0.0375,-0.0017,0.0568,0.0067,-0.0383,0.1584,-0.0613,0.005,-0.0926,0.2514,0.3024,0.1876,-0.0078,-0.0544,-0.0453,-0.1232,0.081,0.1496,-0.0749,0.1107,-0.0333,-0.0156,-0.0329,-0.0386,-0.0648,0.0502,0.1534,-0.017,-0.094,0.0131,-0.0351,0.0245,-0.0083,0.0549,-0.0068,-0.017,-0.1316,-0.1455,-0.1466,-0.1458,-0.0133,-0.231,-0.1255,-0.0793,-0.0052,-0.0828,-0.0782,-0.0905,0.1377,0.2076,-0.1617,0.0115,0.0277,0.0269,0.1469,-0.0931,-0.1715,-0.0374,-0.0092,0.1556,-0.0895,0.075,0.0832,0.1401,0.1927,0.1588,0.0119,0.1276,0.1653,0.1314,-0.0555,-0.0784,-0.1407,0.0417,0.0981,-0.0021,0.1594,0.0079,0.2517,0.0556,0.1269,0.0162,0.0335,0.1501,0.1606,-0.0546,0.0206,0.0935,-0.0898,0.1234,-0.0015,0.1064,-0.0657,0.1104,0.1004,0.1518,0.1903,-0.1327,-0.0075,-0.0532,-0.0135,-0.0474,0.034,0.1037,0.0713,0.2788,0.2251,0.0075,-0.0345,0.0071,0.2157,0.2138,-0.0022,-0.0317,0.1638,-0.1078,0.1442,0.1098,0.1277,0.0853,0.128,0.0539,0.0549,0.1173,-0.1299,0.0222,0.0069,0.0795,0.0533,0.0368,0.0181,0.0307,0.1447,0.1371,0.0822,0.0418,0.2779,0.2568,0.2313,0.2316,0.032,0.0447,0.0567,0.0023,-0.2022,0.1631,0.1394,0.0449,-0.0256,0.051,0.0458,0.0932,0.0159,0.1634,0.07,-0.0274,-0.0445,-0.0608,-0.0362,-0.1639,0.1344,0.0817,-0.0156,-0.1027,0.1128,0.0933,0.041,-0.0531,-0.0263,0.0996,-0.1615,-0.0319,-0.0676,0.0105,0.0807,-0.1956,0.1229,0.1078,-0.117,0.0283,0.0156,-0.0502,0.0371,0.0063,0.2027,0.0743,0.0001,0.1318,0.1076,0.0539,0.1565,0.0318,0.1177,-0.0213,-0.0339,-0.0156,-0.0511,-0.0294,0.2144,-0.0146,0.1074,-0.125,-0.2683,-0.0776,-0.2209,0.1679,-0.0713,-0.1827,-0.2618,-0.07,0.0446,-0.0518,0.0378,0.0763,0.0214,0.1272,-0.0083,-0.0555,-0.2263,-0.1432,-0.1019,-0.0439,-0.1524,-0.1875,0.0322,0.0255,0.2064,0.167,0.0725,-0.072,-0.0955,0.1141,0.1088,0.1069,0.0803,-0.021,0.0593,0.1043,-0.0029,-0.0022,-0.0657,0.0463,-0.0823,-0.0753,0.2069,0.0892,0.0476,0.0492,0.0405,0.1344,0.0198,-0.0782,0.0347,-0.0035,0.0054,0.1773,-0.0117,-0.0293,0.0877,-0.0713,-0.0336,-0.0668,0.1843,0.0297,-0.0141,0.0976,0.1243,0.0667,0.1039,-0.0101,0.0287,0.0845,0.078,-0.0488,0.1015,0.0331,-0.0244,-0.017,-0.1094,-0.092,0.0224,-0.0135,0.1841,0.1656,-0.0416,-0.0435,0.0082,-0.0686,-0.0333,0.215,0.1701,0.1406,0.0735,0.0723,-0.0684,0.0011,-0.0117,0.0068,0.0169,0.0501,0.153,0.1204,0.0994,0.0404,0.0577,0.0076,0.0058,0.0022,-0.1056,0.1253,-0.0869,-0.0847,0.2174,0.0118,-0.0329,0.0044,-0.1429,0.1808,0.0515,0.0992,-0.0809,-0.2091,-0.2038,-0.2753,-0.0155,0.1669,0.0267,-0.0048,-0.0476,0.0843,0.018,-0.0182,0.0434,0.004,0.0318,0.0117,0.0387,0.0071,0.0274,0.0786,0.1578,0.085,0.0492,0.0673,-0.0371,-0.0135,0.018,-0.0804,-0.0758,-0.055,0.0163,0.1254,0.0287,0.0172,0.1835,0.0717,-0.1977,0.105,0.039,-0.2159,0.0685,0.1546,0.0881,-0.0099,0.2349,0.1325,0.3723,0.322,0.1531,0.1847,0.1007,0.1634,0.1409,0.0333,-0.0775,-0.0024,0.03,-0.0248,-0.0555,-0.0588,-0.0816,0.2828,0.1791,-0.0681,-0.059,0.0003,-0.0655,0.0092,0.0962,-0.0768,-0.1332,0.1795,0.1827,0.0958,-0.0418,0.1243,0.1171,0.0548,0.193,-0.0865,0.1504,0.0686,0.0302,-0.0005,0.11,0.0294,-0.087,0.1406,0.0955,-0.0179,-0.3063,0.0833,-0.0364,-0.0477,-0.0952,-0.0324,0.0097,0.0045,0.0771,-0.039,-0.0406,-0.0023,0.079,-0.1143,-0.0091,-0.0052,-0.0242,-0.0995,-0.1428,0.014,0.0027,0.0927,0.0404,-0.1594,-0.1635,0.0748,0.101,-0.1386,-0.0581,0.0095,0.0181,-0.0539,0.1635,0.1479,-0.0001,0.0416,0.1521,0.1574,0.1192,-0.022,-0.0078,0.0409,-0.1183,0.1999,-0.0676,0.0523,-0.0277,-0.1106,-0.0354,0.1422,0.118,-0.1962,0.0639,0.1102,0.0613,-0.0831,-0.0096,-0.1321,-0.027,-0.1749,-0.1822,-0.131,-0.0712,0.0598,0.0189,0.0615,0.2567,0.0747,-0.0363,0.1658,0.1019,0.0505,0.1287,0.0294,-0.0124,-0.012,-0.0144,0.1116,0.0162,0.0511,-0.0429,-0.0608,0.0275,-0.0966,0.0623,0.0554,-0.008,0.0087,0.1398,-0.1065,-0.031,-0.1077,0.0583,0.0972,-0.0218,0.1052,-0.0548,0.0687,-0.1348,-0.1267,-0.0262,0.0028,0.0222,0.0863,0.0008,0.0876,-0.0156,-0.0968,-0.0679,-0.0978,-0.0499,-0.0759,-0.0321,-0.0218,0.144,0.0306,0.073,-0.0734,-0.0095,0.0817,-0.0227,-0.0787,0.067,0.078,0.0554,-0.0522,-0.0423,0.0372,0.0663,0.2739,0.0573,-0.1373,-0.0007,-0.0722,-0.0745,-0.0346,-0.121,-0.0422,-0.046,-0.0195,0.2163,0.2174,0.0135,0.1909,0.0609,0.0009,0.0684,0.2849,0.1004,0.1111,-0.0349,-0.0539,0.2346,0.1006,0.2348,-0.0906,0.0026,-0.0252,-0.0727,0.1183,0.1257,0.1065,-0.0242,-0.073,-0.0136,0.1003,0.069,0.1102,-0.0258,-0.0183,0.0289,0.0668,0.0615,0.0578,-0.084,-0.0051,-0.0045,0.1183,0.0203,0.2213,0.1836,-0.073,0.2199,0.0676,0.159,-0.1237,0.1201,0.0459,0.0244,-0.0386,0.0574,0.0362,0.113,0.1709,-0.0835,-0.1707,0.0121,-0.0589,-0.0729,0.0749,0.1266,-0.0376,0.0982,0.0107,0.0777,0.0615,-0.0484,0.0703,0.1256,-0.2561,0.0967,-0.0538,0.0653,-0.0152,-0.079,-0.0587,-0.0352,-0.2333,0.2054,0.1031,-0.0332,0.0033,-0.031,0.0576,-0.107,-0.0929,-0.1168,-0.1365,0.0323,-0.0674,0.0477,0.1033,0.0761,-0.0075,0.0136,0.0809,0.1083,0.0816,0.0785,0.1431,0.0924,0.0505,-0.0307,-0.0916,0.0047,0.0934,-0.089,0.0427,0.0218,0.0622,-0.1327,0.0843,-0.0268,-0.1527,0.0814,0.293,0.2905,0.2006,0.039,0.0898,0.1646,0.0377,0.0613,-0.1286,0.0152,0.0382,-0.0368,-0.0821,-0.0326,0.1085,-0.0818,-0.0708,-0.1545,0.1731,0.0093,0.1387,-0.0106,0.0181,0.1668,-0.0907,-0.1118,0.0575,-0.0355,-0.0018,-0.0977,0.2071,0.282,0.2492,0.1746,-0.0772,-0.1983,-0.0074,0.0717,-0.0022,-0.0546,-0.0673,-0.1607,-0.0342,-0.0101,0.1236,0.1189,0.0151,-0.1135,-0.1532,-0.178,-0.0149,0.0384,-0.0163,0.0852,-0.0688,0.0708,0.1599,0.0458,0.1746,0.1735,0.0952,-0.038,-0.0751,-0.0449,-0.0086,0.054,0.0076,-0.102,0.0085,0.1326,-0.0896,-0.0105,-0.052,-0.0138,-0.0717,0.0778,-0.0785,0.2637,0.2685,-0.0318,-0.1227,-0.165,0.0373,-0.0352,-0.0741,-0.0187,0.0019,-0.2397,0.0012,-0.0774,-0.1225,-0.1751,-0.0667,-0.017,-0.2351,-0.2174,0.0326,-0.0211,-0.0872,0.2628,0.2012,0.0403,0.0838,-0.062,0.3161,0.1432,0.1714,0.1216,0.203,-0.065,-0.0004,-0.0976,0.0961,0.0845,0.0596,-0.0774,-0.0859,-0.025,-0.068,-0.0936,-0.0442,-0.0166,-0.0122,0.0225,-0.0674,-0.116,0.0991,-0.135,-0.0227,-0.0285,0.0529,0.1109,0.0645,-0.0225,0.1174,0.3052,0.171,0.0303,-0.091,-0.1535,-0.0533,0.0146,-0.0727,-0.0838,0.104,0.1292,-0.0565,0.0945,-0.0297,0.1814,-0.1135,0.0941,-0.0977,0.0818,0.0515,0.0677,0.2124,0.1875,0.1356,-0.1932,0.1384,0.1627,0.1206,-0.0861,-0.0064,0.2067,0.0672,0.1961,-0.0483,0.0508,-0.1016,-0.057,-0.0285,-0.1631,0.2307,0.1016,0.0417,-0.0924,0.153,-0.023,-0.1624,-0.0165,-0.0892,-0.3857,-0.1224,0.1189,0.1195,0.0764,0.1482,0.0107,0.07,-0.0382,-0.1263,-0.0752,-0.03,0.0804,-0.076,-0.1824,-0.0609,-0.0254,0.0229,0.0751,0.0817,0.0055,0.0044,-0.0347,-0.0167,0.1061,-0.0158,-0.1719,-0.0094,0.0989,0.0278,-0.1013,0.0139,0.0601,0.0797,0.1734,0.1707,0.1756,0.1484,0.1791,-0.007,0.0082,0.0476,0.1068,0.0533,0.1366,0.0372,0.1163,0.0943,0.066,-0.0521,-0.0514,-0.0782,-0.006,-0.0292,-0.0457,-0.097,-0.0993,-0.1041,-0.1252,-0.1009,0.0358,-0.0062,0.0061,0.0227,-0.124,-0.0559,-0.1043,0.0259,-0.1226,-0.0317,-0.1239,0.0015,0.0587,0.0342,-0.1129,-0.0349,-0.096,0.1807,0.1215,0.1044,0.1276,0.0932,-0.0682,-0.1027,-0.037,-0.0827,-0.1934,-0.1453,0.0394,0.0182,0.0206,0.0379,-0.01,0.0137,0.0186,0.0855,0.096,0.0511,-0.0902,-0.0677,0.0954,0.0961,0.0805,0.1907,0.1338,-0.159,-0.1061,-0.0845,-0.1197,-0.0603,0.0936,0.0245,-0.0506,0.0464,0.0392,0.0114,-0.0058,0.0395,-0.0613,-0.016,0.0353,0.108,0.0164,0.0856,-0.0522,0.1502,-0.0042,-0.109,-0.1767,0.0565,-0.0006,0.0396,0.0596,0.0167,0.0701,0.0624,0.1143,0.002,0.0116,-0.1064,0.0144,0.0472,-0.0068,-0.0393,0.0207,0.0154,0.0586,0.1334,0.1547,0.1143,-0.1937,-0.0394,-0.1265,0.1203,-0.2286,-0.0999,0.0063,0.0247,0.0202,-0.0736,0.0281,-0.1278,0.1447,0.136,-0.0286,0.0315,0.1369,0.0393,0.03,-0.0455,-0.0448,0.0784,0.0193,0.0572,-0.0486,-0.0373,-0.049,-0.0571,-0.0324,0.0853,-0.0061,0.0495,-0.038,-0.0199,0.0475,-0.422,-0.3351,-0.2744,-0.1455,-0.1542,-0.0749,-0.2537,-0.1736,0.2556,-0.2862,-0.2567,-0.1829,-0.1557,-0.2092,-0.0355,-0.09,-0.0182,0.0091,-0.0697,-0.012,-0.0827,0.0018,0.1259,-0.1141,-0.1087,-0.0481,-0.0843,0.0563,0.0862,-0.0821,-0.0309,0.1021,0.0421,0.1408,-0.0856,-0.0597,-0.1844,0.0482,0.1827,0.0732,0.0221,-0.0166,-0.1554,-0.1862,0.0021,0.0585,0.1412,0.1255,0.0856,-0.2517,0.1713,-0.1946,-0.2024,0.0704,-0.0605,-0.0077,-0.1104,-0.1163,-0.0798,-0.1853,-0.1648,0.0786,-0.0178,-0.0419,0.0759,0.1683,-0.0146,0.0947,-0.0771,-0.0101,0.0446,0.0305,0.1459,0.0175,0.0333,0.0776,0.1232,-0.0144,-0.2001,0.067,0.0077,0.0681,-0.16,-0.0947,-0.0339,0.2703,0.2759,0.0156,0.1008,-0.0038,0.0583,0.0931,0.0533,0.0537,-0.0706,-0.0334,-0.077,-0.1791,0.0148,-0.0043,0.1162,-0.0759,-0.0327,-0.0868,0.0954,-0.0664,-0.2056,0.0089,0.0857,-0.1566,-0.1399,0.0785,0.1279,-0.0209,0.2309,0.0881,0.2892,0.0541,-0.1567,0.0623,0.0244,-0.0725,0.05,-0.049,0.0892,-0.0111,0.0153,0.0925,0.1131,-0.0849,-0.0019,-0.3788,-0.2391,-0.27,-0.352,0.1801,0.0141,0.1148,0.1278,0.1491,0.0262,0.0421,-0.2088,0.1222,0.1265,-0.1305,-0.1355,0.068,-0.0979,-0.0187,-0.0157,0.0028,-0.1307,0.1389,0.1323,0.0345,-0.1473,0.0143,0.0066,0.058,0.058,0.2285,-0.0279,0.0052,-0.0098,0.0466,-0.0432,0.0432,-0.2374,0.3193,0.3082,-0.0894,0.0063,0.2588,0.2607,0.1991,0.0605,0.024,0.0617,0.0212,0.0061,-0.122,-0.0726,-0.1712,0.0494,-0.1249,0.0507,-0.0716,-0.0455,0.0283,0.0604,0.0278,0.0519,0.0532,0.0866,-0.1477,-0.11,-0.0241,-0.1121,-0.0399,-0.1333,-0.0001,-0.1537,0.0851,0.056,0.0245,0.1699,-0.0443,0.1758,0.3068,-0.0168,0.1007,0.2455,-0.0177,0.065,0.1968,0.0148,0.062,0.0055,0.0646,-0.0615,0.0894,0.1274,0.0173,-0.0012,0.0599,-0.2841,-0.1287,-0.0735,-0.1002,-0.0838,-0.1205,0.0057,-0.0552,-0.0558,0.0427,0.1118,-0.0466,0.1273,-0.0281,-0.0841,0.011,0.0128,0.1648,0.1349,0.0289,-0.0416,-0.0383,0.0107,-0.0219,-0.0611,0.0264,0.1027,0.1082,0.1698,0.1511,-0.0068,0.1658,0.1845,-0.0115,-0.0182,-0.0776,0.0131,0.015,0.1618,0.1572,-0.0669,0.159,-0.0393,-0.0303,0.006,0.0386,0.0969,0.0109,-0.1719,-0.0334,-0.0392,-0.0437,0.0344,-0.2186,-0.0675,0.0094,0.0182,0.2154,-0.1073,0.0007,-0.077,-0.1041,-0.0472,-0.0128,0.1077,0.0524,-0.1419,0.0647,-0.0431,0.1113,0.0709,0.1951,0.1344,0.0452,-0.0578,0.0258,0.0693,0.1667,-0.0146,0.0171,-0.0097,-0.0361,0.1526,0.033,0.0058,0.0907,-0.0186,0.0424,0.0721,0.0354,0.1223,0.1141,0.0967,0.0766,0.0726,-0.0371,-0.0429,-0.1297,0.065,0.0422,0.0449,-0.0202,-0.0277,0.0256,0.1172,-0.093,0.0919,-0.0589,0.0154,-0.0897,-0.0305,-0.0376,-0.0613,0.0681,0.0127,0.0778,0.0204,0.2348,-0.0039,0.08,-0.0188,-0.0306,0.0237,0.0507,0.0749,0.0875,-0.1001,-0.1045,0.0315,-0.3291,0.0224,-0.0371,0.0004,-0.1526,-0.0011,0.0596,-0.07,-0.2732,0.062,-0.0082,0.0634,0.0856,0.0968,0.0545,-0.0264,0.0481,0.0702,-0.1678,-0.1823,0.0635,0.0962,0.0284,-0.0524,-0.0742,-0.0571,0.1464,0.0634,-0.011,0.1441,0.1028,-0.0624,-0.1521,-0.083,-0.0327,-0.1883,-0.0595,0.2591,0.1257,-0.0089,0.0759,0.1429,0.0854,0.0385,0.0841,0.0685,-0.1612,0.0169,0.0298,-0.05,-0.0494,-0.1349,-0.1192,0.0603,-0.0984,0.0453,0.0683,0.0753,0.0349,-0.0976,-0.0211,-0.0507,-0.1651,-0.0347,-0.0413,0.0778,0.0958,0.017,-0.3087,-0.3073,0.1195,0.1363,-0.0449,0.0737,0.0466,0.0496,0.1578,-0.088,0.0656,0.0262,0.0467,-0.0047,-0.1836,0.0837,-0.0998,-0.0868,0.0272,-0.0114,-0.2653,0.0007,0.0968,-0.2601,-0.0588,-0.0416,-0.0993,-0.059,0.0862,-0.1039,-0.0177,0.1009,-0.0303,-0.0003,-0.0266,-0.0823,-0.0734,0.0722,0.0313,0.0362,-0.1722,0.1411,-0.0559,-0.1281,0.0581,0.0331,0.0156,-0.0125,0.1196,0.0102,-0.0651,0.072,-0.1119,0.0124,-0.121,-0.146,0.0572,0.0166,-0.0382,-0.0472,0.0009,-0.1717,-0.1542,-0.1561,-0.016,-0.0888,0.0311,-0.034,-0.3899,0.1512,0.1701,0.0638,0.086,-0.0762,-0.1327,-0.162,0.0724,-0.0406,0.0065,0.0308,-0.0276,0.0189,0.0821,-0.0235,-0.0315,-0.0053,-0.0618,-0.1478,-0.235,-0.201,0.0273,0.0995,0.121,0.014,-0.1152,-0.0682,0.0016,-0.0509,-0.0803,0.0143,-0.0757,0.0482,0.2133,0.1289,0.0071,-0.0844,-0.0234,-0.1565,-0.0166,-0.2774,-0.2271,-0.101,0.0462,0.1504,-0.0071,-0.0256,-0.1094,-0.0589,0.0084,-0.0298,-0.0557,0.0478,0.0326,-0.1085,0.1244,0.0944,-0.0699,-0.0336,0.0083,-0.036,-0.026,-0.0427,-0.08,-0.0354,-0.1017,-0.1876,-0.1558,0.0473,-0.0042,-0.0261,-0.0264,0.1769,-0.0502,0.1993,0.1155,0.0458,0.1239,0.0075,-0.1613,0.0934,-0.0369,0.0683,-0.0288,-0.0345,-0.0233,0.0046,0.047,0.0413,0.0198,0.0587,-0.0179,-0.1845,-0.0476,-0.0922,0.2501,0.1732,0.1951,0.0185,-0.0009,0.1208,0.1188,0.0286,0.1338,0.0666,-0.1477,0.0005,-0.1155,-0.1234,-0.0181,-0.0748,-0.0041,-0.0182,0.0313,0.0346,0.1783,0.0426,0.1621,0.0913,0.0459,0.0044,-0.0838,-0.3188,-0.1833,-0.0687,-0.0551,0.0863,0.3905,0.2032,0.267,0.1738,-0.0056,0.0171,-0.0246,0.1589,0.1931,0.1979,0.0899,-0.0897,-0.0634,0.0197,0.0556,-0.0095,0.0045,0.2184,0.0754,0.1005,-0.0757,0.0312,0.0153,0.2875,0.1315,0.1463,0.1543,0.3307,-0.0543,0.0436,0.0048,0.0712,0.0942,0.0785,0.0243,0.1668,-0.0018,0.1404,0.0115,-0.0778,-0.0509,-0.0121,-0.0551,0.1551,0.0255,0.0046,-0.1124,0.0763,0.0575,0.091,-0.1068,0.1687,0.1466,0.1246,0.0967,0.0688,0.1748,0.1331,0.1107,0.0143,0.0514,0.0199,0.0147,0.2907,-0.0021,0.0568,0.147,0.0611,0.0956,0.009,0.1436,0.0227,0.0315,-0.1916,-0.0128,0.0091,0.2183,0.1266,0.1616,0.063,0.1911,0.1173,-0.0227,-0.0852,-0.0616,-0.028,0.1105,0.0138,-0.2424,-0.2734,-0.2433,0.2811,0.2986,0.0111,-0.0873,-0.0302,0.0802,-0.0452,0.0781,-0.0422,0.0464,0.0935,0.0819,-0.0419,0.0938,0.1178,0.0208,0.1064,-0.0483,0.0405,-0.0153,-0.1105,-0.0907,0.1167,0.1666,0.1733,0.181,0.1033,0.2907,0.1613,-0.2967,0.0985,0.1213,-0.092,-0.04,-0.0309,-0.0486,0.0027,0.0034,-0.0834,-0.0041,-0.0626,-0.034,0.0169,-0.0379,-0.0483,-0.1445,-0.2043,0.2159,0.0369,-0.0612,-0.2848,-0.0224,0.08,-0.0552,-0.035,0.0255,0.0273,-0.2055,-0.0179,-0.0373,0.1013,-0.0159,0.0152,-0.0677,0.1375,-0.0561,-0.1682,-0.2484,-0.0956,-0.121,-0.1103,-0.1354,-0.0919,-0.06,-0.0297,0.012,-0.0229,0.309,0.1172,0.199,0.1364,0.0568,0.1618,0.1777,0.1003,-0.0253,0.0734,0.1635,0.0439,-0.0045,0.1003,0.3144,-0.0616,0.1152,0.0078,-0.0432,0.1258,-0.0476,0.1748,0.0886,0.0465,0.1024,0.1065,-0.0071,0.1375,-0.0512,-0.0646,-0.0889,-0.0569,0.1397,0.0378,-0.0038,0.0594,-0.0227,0.05,0.0267,-0.0773,0.0043,0.0584,0.1197,0.1132,0.0159,-0.0121,-0.0944,0.0326,0.1264,0.137,0.0711,0.0777,-0.1183,0.1374,0.0732,-0.0533,-0.022,0.0067,-0.0611,-0.0803,0.1822,0.0729,0.1468,0.1506,-0.0675,-0.1512,-0.1412,0.0974,-0.4108,-0.2325,0.2054,0.1157,-0.3835,-0.1723,-0.0413,-0.0992,-0.1269,-0.1267,0.1671,0.1607,0.0809,0.0964,-0.4701,-0.4242,-0.3035,-0.1035,-0.1191,-0.2187,-0.4082,-0.4081,-0.3482,0.0072,-0.011,0.0427,-0.0383,0.0448,-0.1011,0.1963,0.0691,-0.0033,0.023,0.1609,0.1524,-0.115,-0.0038,-0.0335,0.0515,-0.1296,-0.0672,-0.1615,-0.0466,0.0262,0.0238,-0.0039,-0.0102,0.0336,0.0679,0.1226,0.0401,-0.0259,0.1693,0.2693,0.2428,-0.0526,0.0277,0.0045,-0.1809,0.0013,-0.1681,-0.1002,-0.0977,-0.2438,0.0229,0.1748,0.2539,-0.0263,-0.081,-0.0048,-0.1339,-0.047,-0.1354,-0.1024,0.1423,0.1398,0.0801,0.0742,-0.1124,0.184,0.1007,-0.0295,0.0152,-0.1329,0.058,-0.0437,-0.1197,-0.0398,0.0483,-0.0251,0.0957,0.1241,0.1418,-0.0153,-0.0099,0.0202,0.0527,0.086,-0.0972,-0.1584,-0.1311,-0.0228,-0.1504,0.0484,0.0118,-0.0527,-0.0656,-0.152,-0.1633,-0.0385,-0.0261,0.0285,-0.0997,-0.1065,0.0361,0.042,0.0276,0.0262,0.0722,-0.0544,0.0036,0.0012,0.035,-0.0902,-0.0368,-0.005,-0.1562,-0.0718,-0.1201,-0.1721,0.1758,0.1454,0.1618,0.1675,0.2181,-0.171,0.041,0.0738,0.0769,-0.1708,-0.0228,0.246,0.0586,-0.0953,0.1131,-0.0144,-0.0574,-0.1094,-0.1882,-0.3013,-0.4252,-0.1409,-0.0077,0.0662,0.0395,-0.0849,0.119,0.1177,0.0681,-0.0139,-0.0043,-0.0508,0.0219,0.0586,0.116,0.2262,0.2392,0.1808,0.0909,0.0838,0.1357,0.1258,0.1262,-0.0118,0.0041,0.0321,0.0154,-0.0099,-0.1896,-0.0227,-0.0484,0.0637,-0.1106,-0.0397,-0.0676,-0.0658,0.207,0.1372,-0.0986,-0.0822,-0.0734,0.0289,-0.0309,-0.0373,-0.0193,0.0663,0.0547,0.0308,0.0129,-0.0168,0.0852,-0.0629,0.0245,-0.071,-0.0408,0.1677,0.1541,0.0546,0.1008,0.0775,0.0728,0.125,0.0276,-0.1197,-0.007,-0.06,0.3018,0.1508,0.1458,0.235,0.237,0.1701,0.1655,0.1655,0.0734,0.0537,-0.0804,0.2199,-0.0126,0.0352,0.0436,0.0171,-0.0152,0.3636,-0.096,0.0587,-0.0242,-0.0303,-0.159,-0.1184,-0.0279,0.1319,0.1107,-0.0479,-0.1059,-0.019,-0.1228,-0.0622,-0.0188,-0.1181,-0.0982,0.0158,-0.0663,-0.0119,0.0302,0.0109,0.1608,0.1507,0.0492,0.1126,0.0328,0.0584,0.0371,-0.072,0.0743,0.0181,-0.0856,-0.1285,0.0556,-0.1183,-0.0356,0.2696,0.0822,0.3016,0.0823,0.1063,0.0235,0.1082,-0.1414,-0.139,0.0009,-0.1362,-0.1206,0.0025,-0.1795,-0.0081,-0.3349,-0.1428,-0.0142,-0.1501,0.1067,-0.101,-0.0628,-0.0552,-0.0033,0.0392,-0.0182,0.0137,0.0059,-0.052,-0.0654,-0.0122,-0.0103,-0.0418,-0.0329,0.0387,-0.3009,0.0087,-0.08,-0.0706,0.0087,-0.0112,0.0023,0.0563,0.1607,0.0612,-0.1112,-0.1005,0.0329,0.0263,0.0842,-0.0044,-0.0575,-0.1432,-0.0544,-0.0135,-0.0365,0.019,-0.139,0.0676,-0.0505,-0.0963,0.0604,0.0356,0.0979,0.1467,0.0835,0.0021,-0.0021,0.1003,-0.0852,-0.0235,-0.188,0.0134,-0.018,-0.1075,0.004,0.0827,0.0449,0.1021,0.0776,0.0031,-0.0276,0.0111,0.0352,-0.0238,-0.1194,-0.0163,0.1571,0.11,0.1872,0.1397,-0.0943,0.0204,0.0012,0.1292,0.1005,0.1459,0.0284,0.1,-0.0522,-0.0357,0.0718,-0.111,0.0919,0.1052,0.0384,0.0031,0.1104,0.0247,-0.0863,-0.0727,0.1599,-0.0762,-0.0115,0.0534,-0.0903,-0.1038,-0.0139,-0.0614,0.0851,0.1124,0.0521,0.161,0.1578,0.058,0.151,-0.0084,-0.037,-0.0866,-0.0785,-0.108,0.142,0.1453,-0.0532,-0.1529,-0.2781,-0.0574,-0.0064,-0.0098,0.023,0.1106,0.0258,0.1201,0.0812,0.0978,0.0125,0.1074,0.188,-0.147,0.0395,-0.0216,-0.1411,-0.029,-0.076,0.1564,-0.0384,-0.0096,-0.0314,0.0544,-0.0312,-0.0743,-0.0766,0.0404,0.0642,0.0756,0.1116,0.0537,0.0276,0.244,0.0029,0.0099,-0.0045,0.0155,-0.031,-0.0179,-0.0534,0.0434,-0.1343,0.2194,0.1084,0.1697,0.1824,-0.0079,0.2016,0.151,0.2785,0.1272,0.035,-0.0797,0.1883,0.0568,0.0814,-0.0785,-0.0417,-0.0177,0.1709,0.1835,0.1059,0.012,-0.0781,-0.0798,0.0696,0.0082,0.0719,-0.0818,-0.0782,-0.0589,-0.1417,0.007,0.0316,-0.0372,0.0176,0.0465,-0.005,0.0306,0.0455,-0.0057,0.0029,-0.1234,0.0446,-0.1791,-0.1384,-0.0108,-0.0024,0.0392,0.1953,0.0642,0.0233,-0.1867,-0.2402,-0.1099,-0.035,-0.021,-0.0218,-0.2111,-0.138,-0.1309,-0.0836,0.2207,0.0237,0.0839,-0.0736,0.0761,0.0009,-0.0387,0.0082,-0.0549,-0.084,-0.116,0.0859,-0.0829,-0.0145,0.129,-0.1375,-0.1153,-0.0441,0.0268,-0.0964,-0.1245,-0.0395,-0.0131,-0.0719,0.0418,-0.0622,-0.1743,-0.169,-0.0442,-0.039,-0.0794,0.0382,0.1555,0.3726,0.3598,-0.0548,-0.1129,-0.0595,-0.0093,-0.0,0.051,0.1055,0.0931,0.1387,-0.0647,0.012,-0.0177,0.044,-0.0535,0.0332,0.1824,0.0368,0.1489,0.1482,-0.0157,0.073,-0.0137,0.2868,0.119,0.0074,0.0164,0.0275,-0.0699,-0.0025,0.1059,0.1218,-0.1946,0.1409,-0.0646,-0.042,-0.0293,0.0076,-0.0775,0.0103,-0.1525,-0.1546,0.098,0.0571,0.0403,-0.0282,0.1486,0.1492,0.0657,0.2367,0.1004,-0.0094,0.0582,-0.0765,0.0575,0.037,0.1109,0.2019,-0.0973,-0.0797,0.1727,0.0331,0.0824,0.1204,0.2402,-0.1791,-0.1467,0.0955,-0.0096,-0.1375,-0.0978,0.0435,0.0563,0.2054,0.2388,0.1141,0.1101,-0.0617,-0.04,-0.0516,-0.0547,0.0612,-0.0936,-0.3623,-0.2073,-0.1254,-0.3171,0.2853,0.2381,0.139,-0.0366,-0.0057,0.0445,0.1258,-0.0474,-0.0412,0.1135,0.1079,0.0253,-0.2539,0.1001,-0.0342,-0.0389,-0.1663,-0.1294,-0.2096,-0.0113,0.0313,0.0188,-0.0165,-0.0461,-0.108,-0.1429,-0.0809,-0.0615,-0.0451,-0.0999,-0.0891,-0.0487,-0.0106,0.1689,-0.0325,-0.0105,-0.012,0.001,0.0042,-0.1064,-0.0359,-0.017,-0.0078,0.0288,0.0619,0.2413,0.1653,0.0955,0.1355,-0.3459,-0.055,-0.2294,-0.129,-0.1104,0.0379,0.0351,-0.1495,-0.0187,-0.186,-0.2122,-0.1094,-0.0961,-0.0779,-0.0949,0.107,0.0483,0.0086,-0.0338,-0.2349,-0.1512,0.035,-0.0463,-0.0283,-0.0012,-0.0129,-0.073,0.0433,0.088,0.0165,0.0538,-0.1423,0.058,-0.1277,-0.0833,-0.1478,-0.0244,-0.0046,-0.0098,-0.0502,-0.0072,-0.1187,-0.2158,-0.0547,-0.1207,0.0234,-0.1097,0.0413,0.1144,0.047,-0.0441,-0.119,-0.0211,0.1078,0.0597,0.1084,0.0824,-0.0095,-0.0818,0.0573,0.0267,0.1207,0.1591,0.1708,0.1256,0.1282,0.0802,0.0873,0.0241,0.0859,-0.028,0.022,0.0535,0.0118,0.0595,-0.1598,-0.0661,0.0687,-0.1377,-0.1169,-0.0614,-0.0269,-0.2319,-0.2521,-0.1426,0.0573,-0.1322,0.0049,-0.0383,-0.0957,-0.0578,-0.0281,-0.2321,-0.2028,0.027,-0.0118,-0.0829,-0.0862,-0.0098,0.0752,0.0349,0.0428,-0.0565,-0.0552,-0.0651,0.0105,-0.012,0.1405,0.1218,-0.093,-0.139,0.2034,-0.0309,-0.1002,-0.1629,0.042,0.1076,0.3787,0.3543,0.1511,0.2179,-0.1571,0.1003,0.0828,-0.0267,-0.1192,-0.0372,0.0095,-0.0208,-0.3263,-0.1905,-0.3776,-0.1689,-0.1314,0.04,0.016,-0.0413,-0.0342,-0.0386,0.0103,0.0058,-0.2976,-0.2063,0.1173,0.2459,0.1404,0.1293,0.1716,0.0503,0.0578,-0.0771,-0.0568,-0.0098,0.0021,0.0293,0.2381,0.0284,0.2096,0.0071,0.1472,0.1926,-0.018,-0.134,0.0469,0.0166,0.0365,0.0954,0.0843,0.2008,0.0094,0.1378,0.0679,0.0274,0.0518,0.0622,0.0922,-0.0612,0.0132,-0.0488,0.1316,0.0963,0.1275,0.0007,-0.1094,-0.0953,0.1008,-0.1532,0.0938,0.0997,-0.0713,-0.0972,-0.0213,-0.0058,0.0062,-0.0237,0.0377,0.0302,-0.1438,-0.3225,-0.2661,-0.0318,-0.1194,-0.0086,-0.171,0.1032,-0.1588,-0.0317,-0.2119,-0.1046,-0.0765,-0.0756,-0.0494,0.0107,0.0155,-0.0357,-0.0597,-0.025,-0.0353,-0.1134,-0.0681,-0.0005,0.1122,-0.0898,-0.099,-0.0553,0.2364,0.1823,0.2164,0.0119,0.1823,0.0484,-0.0047,-0.0654,-0.046,0.0528,0.1724,0.1786,-0.124,-0.0075,0.1475,-0.0529,-0.2752,-0.1145,0.0513,-0.1511,-0.2097,-0.0854,-0.0464,-0.1178,0.0929,0.0178,-0.2376,-0.078,0.1084,-0.2026,-0.0674,-0.0001,-0.078,-0.2262,-0.0599,0.1441,0.0919,0.0866,-0.075,-0.1476,0.0658,-0.1337,-0.0001,-0.0539,0.021,0.1242,-0.0418,-0.1157,0.1125,0.1298,-0.1014,-0.0734,0.0594,-0.0201,0.033,0.0997,0.0911,0.1249,0.1027,0.2746,0.1947,-0.0789,-0.214,0.0151,0.0544,0.0558,-0.0198,0.0327,0.1208,0.086,0.126,-0.0361,-0.0453,0.1579,0.1757,0.0723,0.0202,0.1436,0.1743,0.0089,0.0992,0.1073,0.1495,0.0668,0.0227,0.0955,0.0178,-0.0295,-0.0321,-0.0961,0.0766,-0.0303,-0.1358,-0.1001,0.1625,-0.0519,0.1193,0.1865,0.1124,-0.0396,-0.0804,-0.0181,-0.1343,-0.1662,0.0565,0.1692,-0.1456,0.0604,0.0126,-0.1183,0.2284,0.0969,0.1994,-0.0795,-0.0322,-0.0937,0.0226,0.2723,0.2253,0.0052,-0.0212,0.0253,-0.1336,-0.1541,0.0277,0.1346,0.1431,0.0976,0.1619,0.2916,0.12,0.1027,-0.0848,-0.0042,-0.0794,-0.0025,-0.1522,-0.0196,-0.0192,-0.0147,-0.1023,-0.1588,-0.0392,-0.0031,-0.0217,0.1366,-0.0032,0.0704,0.0663,0.0767,0.0429,0.0498,0.0154,0.0641,0.0515,0.0959,0.0402,0.1163,-0.0077,-0.0357,-0.1083,0.0078,-0.1806,-0.0366,-0.0676,0.0043,-0.0122,-0.0045,0.0921,0.1119,0.0373,-0.2092,-0.0487,-0.0105,0.0661,0.0579,0.0655,0.1013,0.0275,0.0373,-0.0451,-0.1528,0.195,0.1761,-0.0086,0.153,0.068,0.0511,-0.4311,-0.2762,0.1689,-0.0735,0.0677,0.04,0.0475,0.1707,0.2217,0.1245,-0.0987,-0.0135,0.0828,0.0387,0.1455,-0.0023,-0.2062,0.0031,-0.0076,-0.0127,0.039,-0.0908,0.1929,0.0437,-0.0759,0.1296,-0.0319,0.1694,-0.1646,0.1907,-0.3303,-0.0269,-0.0461,0.2187,0.1998,-0.0582,-0.0825,0.0317,-0.0444,-0.0212,0.0181,0.0022,-0.0322,0.0399,-0.1006,-0.0979,-0.1338,-0.124,-0.1375,-0.1936,0.0643,-0.0753,-0.3562,-0.575,-0.2225,-0.3017,-0.445,-0.2409,-0.2859,-0.3192,-0.1904,-0.2571,-0.2134,-0.1714,-0.2969,-0.219,-0.2691,-0.266,-0.3395,-0.287,-0.2346,-0.1465,-0.1643,0.1878,0.1226,0.1907,0.007,-0.0616,0.2939,0.2563,0.1632,-0.0283,0.0209,0.3246,0.2799,0.1487,0.0275,-0.0236,0.1536,-0.1312,0.0204,0.1089,-0.0008,0.0789,0.0871,0.1011,0.0692,0.1828,-0.1112,0.2812,0.3124,-0.0869,0.0311,0.0735,-0.0099,-0.0139,0.1128,-0.0061,-0.0563,0.1568,-0.1935,-0.2671,-0.041,-0.1113,-0.1472,0.0676,-0.1048,-0.1065,0.0083,0.1143,-0.1454,0.0307,-0.0547,0.1315,0.0639,-0.1801,0.1255,0.1459,0.0267,-0.0128,0.0462,0.0644,response selection
trm_4a3fd79d09902,-0.0923,-0.0784,-0.1014,-0.0936,0.0168,-0.0234,-0.1029,-0.0787,-0.1063,-0.1075,-0.0079,0.0038,-0.102,-0.0733,-0.0868,-0.0465,-0.0135,-0.0547,-0.0773,-0.0248,-0.029,0.081,-0.048,0.0074,0.0302,0.0602,0.0528,-0.0938,-0.1493,-0.0753,-0.0888,-0.0834,-0.1298,-0.0302,-0.154,-0.0462,-0.054,-0.0663,-0.1268,0.0165,-0.089,-0.1068,-0.0628,0.0716,-0.0583,-0.0582,0.168,-0.083,0.0433,-0.0583,-0.0329,0.0511,0.0399,0.0189,-0.0185,-0.0491,-0.0984,-0.0352,-0.0195,-0.0201,0.0422,0.0745,-0.0932,0.0974,0.0421,0.0413,-0.1309,-0.1676,-0.1278,-0.0029,0.0189,0.0609,0.1512,-0.0778,-0.1408,0.0471,-0.1368,0.0874,0.0298,-0.0316,-0.0114,0.0506,-0.0485,-0.1428,0.0568,0.061,0.0032,0.0087,0.021,-0.1575,-0.0395,-0.0443,0.0052,0.1208,0.1286,0.1226,0.1023,-0.015,0.1745,0.1036,0.078,0.0678,0.089,0.0571,0.0731,-0.1211,-0.1113,0.0739,-0.0124,-0.0754,0.0212,-0.0992,0.0761,0.1346,0.0475,0.009,-0.0704,0.0506,-0.053,-0.0808,-0.0246,-0.1316,-0.0709,-0.0295,-0.065,-0.0964,-0.0299,0.0553,0.06,0.0143,-0.1287,-0.0722,-0.0512,-0.2704,0.0376,-0.1124,0.0013,-0.1247,-0.0002,-0.0662,-0.0849,-0.0974,0.0244,0.0284,0.0368,0.0818,-0.0692,0.0415,-0.0775,0.078,-0.0863,-0.0129,-0.1241,-0.116,0.135,0.049,0.0457,0.0378,0.0531,-0.0144,-0.0502,-0.0359,-0.1452,-0.1651,-0.0356,-0.0105,-0.0001,-0.1342,-0.1247,-0.0327,0.0096,-0.0287,0.0959,-0.252,-0.171,-0.1862,-0.1492,-0.1287,-0.094,-0.0253,-0.1354,0.0605,0.0098,-0.0021,-0.0448,-0.0188,-0.0705,-0.0939,-0.1258,0.0289,0.032,-0.0117,-0.0016,-0.1672,-0.1646,-0.2206,-0.1905,0.0225,-0.0172,-0.1705,-0.0747,0.1911,-0.0812,-0.0917,0.0762,-0.0838,-0.1571,0.0088,-0.0651,0.0103,-0.1885,-0.1026,-0.0294,0.0234,0.0419,0.0198,0.092,-0.1391,-0.1028,0.0805,0.0705,-0.083,-0.1026,-0.0256,0.0736,-0.0023,-0.0102,0.1122,-0.0241,0.1645,-0.0302,-0.1558,0.1329,-0.0792,-0.0731,0.043,-0.0531,0.0376,0.0316,-0.0719,0.0325,-0.165,-0.057,0.0185,-0.0627,-0.0827,-0.0782,-0.0779,-0.0609,-0.0554,0.029,-0.0148,0.0224,0.0189,0.0339,-0.1632,-0.0025,-0.0639,0.0538,0.2253,0.0708,0.2614,-0.0828,0.1207,0.1771,0.2647,0.0988,-0.0287,0.0207,-0.0209,-0.0577,-0.0047,-0.1496,-0.0097,-0.0599,0.0284,-0.0693,-0.1241,-0.1,0.0395,0.0566,-0.0706,-0.0438,-0.1162,-0.0812,-0.056,0.0272,0.0102,-0.1185,-0.1093,-0.1018,-0.143,-0.0137,-0.044,-0.0774,0.0483,0.0084,0.0801,-0.0141,0.1166,0.0895,-0.1187,-0.0914,-0.0489,-0.0647,-0.0443,-0.1124,0.004,-0.0598,-0.0319,-0.0071,-0.0448,-0.0933,0.0281,0.0692,-0.0801,0.1163,-0.0053,0.0457,-0.1022,-0.0479,0.0093,-0.1105,-0.1099,-0.1065,-0.0116,0.0063,-0.0485,-0.0749,-0.0476,0.0655,-0.0574,0.0106,0.0196,0.0467,0.1207,0.0479,0.0292,-0.0378,-0.1312,-0.1143,0.0752,0.0286,-0.03,0.0647,0.0273,-0.2364,-0.1639,-0.1462,-0.1168,-0.1044,-0.0305,-0.0551,-0.0562,-0.0736,-0.0222,-0.0313,-0.1032,-0.1171,-0.1071,-0.0137,-0.0278,-0.0102,-0.0102,-0.0163,0.0666,-0.0794,0.1962,0.0556,-0.1537,0.0522,0.0723,0.0429,0.066,-0.1082,-0.0222,-0.0714,0.0912,0.0895,0.1258,0.1525,0.0557,-0.0551,0.0616,-0.0177,-0.0085,-0.0742,-0.0565,0.0209,-0.0262,-0.0771,0.0199,0.0352,0.003,0.1463,0.0661,-0.0674,-0.1459,-0.0759,-0.0203,-0.0568,0.0213,0.0071,-0.0193,0.0874,0.0616,0.0213,-0.0054,-0.0914,-0.0297,0.0193,-0.1403,-0.0019,0.1391,-0.0743,-0.0053,0.1701,0.0022,-0.0987,-0.0374,0.0373,-0.1999,-0.1255,-0.2641,-0.245,-0.1192,-0.115,-0.0958,-0.1461,-0.0922,0.0105,0.0374,-0.0122,-0.0242,-0.0106,0.0557,-0.0258,0.0112,-0.1944,-0.1535,0.0352,0.0302,0.0756,0.0335,-0.0243,-0.0657,0.0137,0.0635,-0.0913,0.0137,0.0308,0.0644,-0.0881,-0.0439,0.0384,-0.1164,0.0269,-0.0343,-0.0204,0.0602,0.1067,-0.0352,-0.0467,0.1014,-0.1045,-0.0385,0.0529,0.3275,-0.1122,-0.0532,0.0138,0.0394,0.0846,-0.0274,-0.116,-0.0593,0.0256,0.07,-0.0282,-0.0323,0.0622,0.0351,0.0264,0.0259,0.1251,0.1266,-0.0078,0.0437,-0.0435,-0.0228,0.0614,0.1019,-0.0069,-0.039,0.1605,0.0315,-0.0639,0.0015,0.0743,-0.077,-0.0677,0.0305,0.0075,-0.0666,-0.1131,-0.1141,0.0208,-0.025,-0.0238,0.0999,-0.1151,0.0246,-0.01,0.0186,0.0927,0.0683,-0.1027,-0.0914,0.0951,-0.0929,-0.1098,-0.0189,0.0841,0.0884,0.1311,0.0219,0.1573,0.0558,0.0344,0.0424,-0.0583,-0.0318,-0.0724,-0.1574,-0.1082,-0.0058,-0.0779,-0.0379,0.0169,-0.0751,-0.0467,0.0487,0.011,-0.0451,-0.0727,-0.0372,0.0326,-0.0055,0.0141,0.0422,0.0682,-0.0069,-0.0128,-0.0386,-0.0201,-0.114,0.1041,-0.0063,0.0931,-0.0295,-0.0064,0.0612,-0.0236,0.0474,-0.0708,0.0517,0.1131,-0.0162,0.0086,-0.0542,-0.0513,0.0106,-0.0433,0.0423,-0.0152,-0.033,0.0356,0.0155,0.0777,0.0948,-0.0114,-0.0658,-0.0105,-0.0411,0.1448,0.0644,0.0131,0.0507,0.0548,-0.0321,-0.0458,0.0398,0.0866,0.0736,-0.006,0.0066,-0.1578,-0.0872,0.1295,-0.0025,-0.0046,0.061,0.032,0.0288,0.0707,0.0272,-0.0192,-0.1493,-0.1537,0.0834,-0.1239,-0.0316,0.0405,-0.0989,-0.2279,-0.0366,-0.0697,0.0408,0.0527,-0.1344,-0.058,-0.1311,0.0511,0.0227,0.0008,0.0385,-0.1117,-0.1735,-0.1052,0.0273,0.1009,0.0516,-0.0863,-0.0374,0.0192,0.0269,0.0754,-0.0296,-0.0388,-0.0993,-0.1132,0.0615,-0.0089,-0.0432,-0.0286,-0.0123,-0.1774,-0.1861,0.0921,-0.0812,0.0163,-0.0887,0.1721,-0.0039,-0.0661,-0.0065,0.0257,-0.0802,-0.0377,-0.0605,-0.1138,0.0326,0.1457,-0.0478,0.0001,0.121,-0.1369,-0.0442,-0.0342,0.0157,-0.0555,-0.0941,-0.048,-0.018,-0.0364,-0.0919,0.1435,-0.0457,0.0441,-0.0288,0.0439,0.0344,0.0841,0.0533,0.1422,-0.1204,-0.1002,-0.0009,-0.0052,-0.0054,0.1195,0.1506,0.1385,0.1099,0.2882,-0.0204,0.063,-0.0574,-0.1155,-0.0438,0.0552,0.0338,-0.0016,-0.0854,-0.0823,-0.0804,-0.0732,-0.0097,-0.0148,0.0423,0.0835,0.0386,-0.0078,0.07,0.0409,-0.0234,0.0031,0.0231,-0.0633,0.0554,0.0819,-0.0754,-0.1155,-0.1135,-0.097,0.0183,-0.0348,-0.0898,-0.0238,-0.0722,0.0266,-0.0335,-0.0339,0.1472,0.1209,0.0009,-0.137,0.1058,0.0999,0.1998,-0.1464,-0.0494,-0.0804,-0.0633,0.0284,-0.0733,0.099,0.0242,-0.0248,0.0124,-0.0248,0.0287,-0.1618,-0.2082,-0.1697,-0.1261,0.0621,0.1721,0.0627,-0.0893,-0.0051,0.0367,0.0671,0.1135,0.0587,0.0401,-0.075,-0.1043,-0.0106,0.0748,0.0779,0.1461,-0.021,-0.0469,0.0071,-0.0694,0.0982,-0.0663,-0.0829,0.0169,-0.1416,-0.1464,-0.0666,0.0118,0.0791,0.0082,-0.0346,-0.0319,-0.0132,0.1347,-0.0152,-0.1242,0.0597,0.0163,0.0229,0.0016,0.0831,-0.0592,0.1026,-0.1798,-0.1823,0.1083,0.0933,0.1722,-0.0174,-0.0441,0.0331,-0.0117,0.0313,0.2081,0.0422,0.0714,0.0587,0.1352,0.0245,0.0181,0.1256,0.1265,-0.1014,0.0021,0.0455,-0.144,-0.092,-0.0359,-0.0866,-0.0661,-0.2132,-0.0694,-0.1217,-0.0689,-0.1775,0.0164,0.0087,0.0081,-0.0299,0.0122,0.0229,0.0095,0.1219,0.0622,0.0857,0.1449,0.0215,0.0779,0.0439,-0.0293,0.1166,0.1177,-0.0918,0.1448,0.0594,-0.0276,-0.0511,-0.1038,-0.0464,0.0745,0.0133,-0.1462,-0.0956,-0.0806,0.0696,0.1821,0.0536,0.0129,-0.0129,-0.0033,-0.0289,-0.0785,0.1338,-0.0561,0.0763,-0.1516,0.0959,-0.0699,0.1394,0.081,0.0294,0.0784,-0.1633,-0.1479,-0.0704,0.2209,-0.047,-0.0916,-0.0819,0.0978,0.0177,-0.1603,-0.0195,-0.1339,0.0631,-0.0799,-0.0444,0.0191,-0.0118,0.1489,-0.1325,-0.1128,-0.0625,0.0391,-0.1267,0.0315,0.1453,0.0713,0.1132,0.3486,0.1077,-0.1161,-0.0549,-0.0966,-0.0502,-0.0632,-0.0584,-0.03,0.0788,0.0838,-0.0014,-0.1169,0.0938,0.1511,0.0684,-0.0107,-0.0312,0.0056,-0.1439,-0.0288,-0.0302,0.0111,0.087,-0.1067,-0.0534,0.0868,0.0148,-0.0746,-0.0044,0.0897,-0.0186,-0.0148,-0.0671,-0.113,-0.1101,-0.2591,-0.1484,-0.2815,-0.0379,-0.0511,-0.0897,-0.11,-0.1303,-0.1755,-0.1351,-0.2092,-0.1584,-0.1746,-0.0022,0.0312,0.0915,-0.0103,0.0276,0.0303,0.0987,0.0955,0.1432,0.1498,0.1252,-0.0274,-0.0256,0.016,-0.0017,0.1298,0.0633,0.1305,-0.0409,0.0797,-0.0543,0.0658,-0.0406,-0.0736,-0.0281,0.1248,-0.0135,0.1106,-0.1433,-0.0411,0.0228,0.0271,0.0416,-0.0317,0.0874,0.0415,0.076,0.1239,0.1,0.0227,0.0063,-0.0273,-0.0191,0.0391,0.0187,0.0002,-0.0266,-0.0776,-0.0429,0.0885,0.0804,-0.1057,-0.0748,-0.074,-0.1829,-0.0978,0.1512,0.0848,0.0865,0.0869,0.0401,-0.0309,-0.0114,0.0466,-0.0216,-0.0478,-0.0293,0.0222,-0.0885,-0.0747,0.0155,0.0869,-0.0598,-0.0161,-0.0694,0.0562,-0.1179,0.0528,0.097,0.1429,0.1198,0.0877,0.0468,0.0331,-0.0365,-0.0529,-0.0636,-0.0876,0.0155,0.002,0.105,-0.0109,-0.0228,-0.0021,-0.0163,-0.0629,-0.0004,-0.1237,-0.1761,-0.118,-0.1244,0.1474,0.0568,0.1225,-0.1013,0.1731,0.0934,-0.0091,-0.0094,0.0443,0.0399,-0.0167,0.0984,-0.0803,-0.0923,-0.0045,-0.041,-0.1047,-0.0036,-0.0925,-0.0508,-0.1217,-0.028,-0.0786,-0.0347,-0.0225,-0.0149,0.0239,-0.0063,0.0171,-0.0577,0.011,-0.0896,0.0668,-0.03,-0.0346,0.3138,0.2683,0.3038,0.2116,0.2273,0.1061,0.2834,0.191,-0.1661,0.0602,0.0939,0.025,0.0245,0.025,-0.1382,-0.056,-0.1161,-0.0082,0.0075,0.0134,-0.0183,0.0489,-0.1034,0.0041,0.0351,0.0061,0.0456,-0.0445,-0.0925,0.0297,0.0606,-0.0492,-0.0052,-0.0748,0.0262,0.0101,0.1249,0.0166,-0.0852,-0.1643,-0.1249,-0.0547,0.0799,0.0606,-0.0638,-0.0755,-0.2212,-0.1652,-0.1004,0.0923,-0.0779,0.2678,0.224,-0.051,-0.0089,-0.0071,0.0343,0.0743,0.0327,0.2081,0.0956,0.0366,0.0757,0.0351,-0.0497,-0.0584,0.0732,-0.065,0.0625,0.0108,-0.0598,-0.0111,-0.1221,-0.0617,-0.0296,-0.0823,-0.1434,-0.0313,0.1098,-0.0319,0.0023,0.0055,0.0686,0.036,0.018,-0.1428,-0.1681,-0.0412,-0.0249,-0.0077,-0.0647,0.0191,-0.0627,-0.022,0.1237,0.0145,0.0419,0.2339,-0.0002,-0.0275,-0.035,0.1042,-0.0307,0.197,-0.0927,0.1792,0.2563,0.0536,-0.1035,0.2393,0.219,-0.0388,-0.179,0.0393,-0.1424,-0.0399,-0.155,-0.0327,0.0603,0.005,-0.0215,0.0078,-0.0357,-0.019,-0.0863,-0.0188,-0.013,-0.0427,0.0195,0.1023,-0.0128,0.1963,0.0725,0.1935,0.1647,-0.0831,-0.0421,-0.0893,-0.0885,-0.0627,0.0095,-0.045,0.1381,-0.1216,-0.0762,0.0859,0.0758,-0.0137,0.0649,0.1179,0.0037,0.0042,0.1312,-0.0272,-0.0667,-0.0004,0.0465,-0.0084,0.0338,-0.026,-0.026,-0.1576,0.0875,0.0367,0.0555,-0.0063,0.0943,0.0096,0.1936,-0.2267,-0.2015,0.0428,-0.0508,-0.1993,-0.1903,-0.135,-0.0078,-0.0509,-0.0263,-0.0154,-0.0199,0.1347,0.0241,0.0622,-0.0824,0.066,0.0501,0.0045,-0.0148,-0.0799,-0.0644,-0.0191,-0.0559,-0.0089,0.0231,-0.0522,0.0723,-0.0072,0.0744,0.0251,0.0805,0.0552,0.0887,-0.1744,-0.0996,0.0272,-0.1485,0.0337,-0.1362,-0.2366,-0.0237,-0.1043,-0.1512,0.0054,-0.0612,-0.1508,-0.0429,-0.0753,0.0194,-0.1598,-0.0747,-0.0894,-0.2038,-0.0612,0.0694,-0.0506,0.204,0.0676,0.0978,0.11,0.0013,0.1163,-0.0654,-0.1286,-0.1246,0.0097,-0.0661,-0.0333,-0.0505,-0.0161,0.0623,0.0464,0.0156,-0.1033,-0.0767,-0.0269,-0.0039,-0.0404,-0.0382,-0.0212,0.0999,-0.0508,-0.0799,-0.0232,-0.0958,-0.1021,-0.0549,-0.0715,-0.0855,0.0611,0.065,-0.0224,0.024,0.0078,-0.1203,-0.0813,0.0175,-0.1575,0.0654,-0.0112,-0.0076,-0.1154,-0.0297,-0.0244,0.1093,-0.0159,0.0497,0.0315,-0.0499,0.0967,0.0166,0.0221,-0.0159,-0.1487,0.0343,-0.0009,0.091,0.1443,0.0343,-0.0096,-0.0756,0.0325,0.1441,-0.0464,0.0353,-0.1014,-0.0261,-0.0993,-0.0837,-0.0155,0.1214,-0.0401,-0.0339,-0.1346,-0.0205,-0.0006,0.0218,-0.0406,-0.1402,-0.0251,0.0132,-0.0665,0.0376,-0.0565,-0.0311,-0.0125,-0.0617,-0.0938,-0.0629,-0.0566,-0.0072,-0.0003,-0.0375,0.0466,-0.0486,-0.0276,0.0131,0.0841,0.0022,0.0352,-0.0376,0.024,-0.1006,-0.0107,-0.028,0.0283,0.0522,0.0104,0.0301,-0.0698,-0.0534,-0.0783,-0.0539,-0.1897,0.0195,-0.1507,-0.0026,-0.057,-0.064,-0.0265,-0.0757,-0.0788,0.0702,0.0178,-0.0311,0.1919,0.0349,0.068,0.0522,0.1116,-0.025,-0.0543,0.0127,0.2182,-0.0005,0.0053,-0.0645,-0.1227,-0.0703,-0.0724,0.0118,0.0296,-0.0579,0.0234,0.0485,-0.0152,-0.0092,-0.0237,0.0634,0.145,0.0834,-0.2917,-0.1624,-0.0843,-0.2239,-0.1943,0.0136,0.1483,0.038,0.0251,0.0125,-0.0047,-0.1522,-0.0251,-0.0283,-0.1097,-0.2103,-0.0257,-0.0065,-0.1052,-0.0401,0.1079,-0.0339,-0.0787,-0.0573,0.0114,0.0668,0.1446,-0.0402,0.0708,0.0254,-0.0159,-0.0848,-0.0764,0.0249,0.0244,-0.0071,0.1098,0.1163,0.0654,-0.0584,-0.0788,0.0446,0.3488,0.3503,-0.0713,-0.0627,0.043,-0.0812,-0.0346,-0.0233,-0.1643,0.0646,-0.0024,-0.0912,-0.0045,0.014,0.1676,-0.0407,0.1776,-0.0157,0.0241,0.0394,0.3016,-0.0861,-0.0555,0.2138,0.0257,0.0585,0.0366,0.0536,-0.0347,0.1627,0.1135,-0.0052,-0.0352,-0.0279,0.0286,0.1044,0.0911,0.0037,-0.0155,-0.0257,0.1065,-0.1028,0.0627,0.1389,-0.0596,0.0074,0.03,0.0176,-0.0977,0.0067,-0.0037,-0.0801,0.0069,-0.0842,0.0665,0.0715,0.0041,0.0054,0.0476,0.0122,0.02,0.1515,0.0791,0.122,0.0267,0.1016,0.0521,0.0483,0.274,-0.1501,-0.0484,0.0569,-0.1091,0.0368,0.071,0.062,-0.0558,-0.0003,-0.0123,0.0034,0.0609,0.0416,-0.0241,-0.0219,0.026,0.0282,0.0338,0.0685,0.2271,0.1746,-0.0668,-0.1374,-0.1189,-0.0038,0.0495,0.0006,0.0281,0.03,0.0332,-0.0115,0.0582,-0.0412,-0.2442,-0.0528,-0.0398,0.0863,0.0554,0.0721,0.0139,0.3452,0.2762,-0.0027,-0.0213,-0.0969,-0.0087,0.0459,0.1221,-0.0849,-0.1459,-0.174,0.0325,0.0432,0.0568,0.2073,-0.0315,-0.0129,0.0653,0.1445,0.0394,0.1967,-0.0079,-0.0013,-0.0512,0.0282,0.1052,0.2281,0.2191,-0.016,0.0378,0.0523,0.0487,-0.102,0.0898,-0.1978,-0.067,0.0234,-0.0309,0.0182,0.0846,-0.0068,-0.0457,-0.0537,-0.016,-0.0165,-0.0222,-0.0287,-0.0841,-0.0282,-0.0498,-0.0746,0.0842,0.1913,0.1876,0.1912,-0.1693,-0.0994,-0.1351,-0.048,0.0765,-0.0156,-0.141,-0.0952,-0.1236,-0.0154,0.0624,0.018,0.1341,0.0816,0.0256,0.0279,0.0133,0.065,0.0471,-0.0025,-0.1535,0.0143,-0.094,-0.0105,-0.0963,0.0068,0.0965,0.2092,0.1158,0.1003,0.0747,-0.1397,-0.2566,-0.146,-0.1869,-0.1194,0.0434,-0.0578,0.0585,-0.0955,-0.1411,-0.1321,-0.0811,0.001,0.0145,-0.0345,-0.0586,0.006,-0.0096,-0.1855,-0.0888,-0.0793,0.0479,0.0152,-0.0358,-0.1641,-0.054,-0.1096,-0.1364,-0.2619,0.0669,0.0241,-0.0589,-0.0592,-0.0374,-0.0228,-0.0526,-0.093,-0.0385,-0.0467,0.197,0.0694,0.1294,0.0367,0.1046,-0.0377,0.074,0.0885,0.1998,-0.0764,-0.0234,0.0577,0.1606,-0.1164,-0.1408,-0.1163,-0.0559,-0.0878,-0.1054,-0.0528,-0.0273,-0.0431,-0.0337,0.0062,0.0201,-0.2017,-0.0106,-0.0386,-0.0934,-0.122,-0.0908,-0.0165,-0.1271,0.0397,-0.0268,0.1995,-0.0451,-0.0525,-0.1166,-0.0713,-0.0948,-0.0828,-0.1719,-0.1066,0.0554,0.0391,0.0157,0.0033,-0.071,0.0125,0.1537,0.1914,0.1473,-0.1091,-0.1198,-0.0022,0.0469,0.0324,-0.08,0.0252,-0.0922,-0.0136,-0.0498,-0.0684,-0.1181,-0.0234,-0.1048,-0.0794,-0.0015,-0.0527,0.0055,0.0171,0.0395,0.0944,0.0438,-0.0968,-0.1506,-0.161,-0.1218,-0.0908,-0.2152,-0.1245,0.2152,-0.0762,-0.1165,0.0438,0.0064,-0.0585,0.0379,-0.0189,0.0125,0.0831,-0.0432,0.0678,0.002,-0.0688,-0.024,0.0182,0.0991,0.1792,-0.1675,0.0312,0.0271,0.2546,-0.0622,0.0027,0.0272,-0.0067,0.0337,-0.0189,0.0711,0.0083,-0.0251,-0.1535,-0.117,-0.1295,-0.0138,-0.0694,0.1101,0.1208,0.1351,0.0148,0.026,0.1162,0.2833,0.0985,0.0365,0.0317,0.0301,0.0114,-0.273,-0.1355,-0.1262,-0.1559,-0.1301,-0.1293,-0.1285,-0.0869,-0.0257,-0.0279,-0.1911,-0.0885,0.0806,0.0119,-0.1598,0.0459,0.0012,-0.0056,0.0252,-0.0539,-0.0197,-0.1462,-0.0869,-0.0008,-0.0965,-0.0349,0.0565,-0.1055,0.0178,0.0621,0.0728,0.0232,-0.1087,0.0353,-0.0196,-0.1984,-0.0569,-0.1111,-0.1015,0.1051,0.0671,-0.0013,-0.1668,-0.0458,-0.004,0.0083,-0.0181,-0.0812,-0.1471,-0.0672,0.0231,-0.0565,0.0799,-0.0956,-0.0265,0.0244,0.0431,0.0291,0.0468,0.0266,-0.2194,0.0295,-0.0654,-0.142,0.1396,0.2143,0.1753,-0.0458,0.3249,0.173,-0.1645,-0.0653,0.2651,0.0985,0.0377,0.0816,0.0611,0.0304,-0.0869,-0.08,-0.0793,-0.0417,0.4141,0.3197,0.244,0.1175,0.2438,0.1422,0.2859,0.2648,0.2109,-0.0379,-0.0081,-0.0389,-0.018,-0.0617,0.0431,-0.1929,-0.0877,0.0643,0.0665,-0.0432,-0.0347,0.0809,-0.0118,0.0582,-0.0358,0.1274,0.1494,0.2208,-0.0296,-0.0971,-0.1197,0.0285,0.0593,-0.009,-0.0471,-0.0738,0.0079,-0.0394,-0.1451,-0.256,-0.2402,0.0263,-0.0431,-0.0041,0.1945,0.0532,0.2065,0.0626,0.1195,0.1672,0.0299,-0.1649,-0.1398,-0.0417,0.1006,-0.0386,0.1488,0.0655,0.1508,0.0386,-0.1458,-0.1455,-0.1216,-0.1042,0.0467,-0.2765,-0.1964,0.0607,-0.0399,0.103,-0.026,0.0314,0.1036,0.0114,0.0481,0.0683,0.0097,-0.1088,-0.1623,0.0699,0.0282,-0.0373,-0.0155,-0.0523,0.0463,0.2727,0.2163,0.1178,0.193,-0.0658,0.0664,0.0847,0.1287,0.1702,0.2652,0.1132,0.08,0.0127,0.222,0.229,0.01,0.0015,-0.0955,-0.0971,-0.0578,0.0024,0.0102,0.0094,-0.0224,0.0192,0.0295,0.0045,0.1244,-0.0846,0.035,0.0575,-0.0655,-0.1293,-0.0595,-0.1276,-0.1433,0.0991,-0.0505,-0.1,-0.0881,0.127,0.0347,-0.0838,-0.038,0.012,-0.1336,-0.0193,-0.0474,0.0454,0.0753,0.0272,0.2831,0.1892,0.1852,-0.0139,0.0762,0.0973,-0.1095,-0.1484,-0.0153,0.0577,0.0033,0.0447,-0.0451,-0.0945,-0.0727,-0.1264,-0.1933,-0.135,-0.087,0.0068,-0.0957,-0.0427,-0.0761,-0.0186,0.01,-0.0633,-0.0735,-0.0686,0.1214,0.0205,-0.047,-0.1197,0.0423,-0.0673,-0.0834,0.1056,-0.1947,-0.1056,0.1883,-0.1074,-0.1099,-0.0212,0.0436,-0.0222,0.0452,-0.0863,-0.0589,-0.0586,0.0034,-0.003,-0.1981,0.0579,-0.0062,0.1436,0.0325,-0.1949,-0.0729,0.0084,-0.0341,-0.0519,-0.04,-0.1004,0.0122,0.0054,-0.0308,0.0868,-0.2675,-0.1274,-0.0966,-0.2122,-0.1745,-0.1264,-0.1071,-0.1071,-0.047,-0.0364,0.0469,-0.1856,-0.0526,-0.0887,-0.0799,0.0387,-0.0259,-0.1763,0.1025,-0.1917,0.0825,-0.0059,0.2266,-0.0605,-0.0504,-0.1161,-0.0445,-0.0167,0.0719,-0.0366,0.1726,0.0186,0.0399,0.1353,0.1231,-0.017,0.0261,-0.0111,-0.0321,-0.0105,0.0613,-0.0407,-0.045,-0.0786,0.0042,0.0016,-0.0002,0.0598,-0.0346,-0.0019,0.0671,0.0809,-0.0564,0.0641,-0.0317,-0.0972,0.031,-0.121,0.0191,-0.0581,0.0268,-0.0828,0.0913,0.0932,-0.0087,0.1286,0.1379,0.0046,0.0948,0.0106,0.2215,0.0913,0.0147,0.1179,-0.1783,0.0429,0.0826,0.0493,0.0089,-0.0466,0.0317,-0.0217,0.05,-0.0837,-0.1118,-0.0748,-0.1205,0.001,-0.0214,-0.138,0.2889,-0.0277,0.0349,0.0078,0.0273,-0.0346,0.0351,-0.0004,-0.144,-0.0611,0.1059,0.0957,-0.0214,0.0247,-0.0892,-0.0008,0.0725,0.0906,0.1173,0.0433,0.0042,-0.0654,0.0483,-0.0771,-0.0344,0.021,-0.038,-0.014,-0.0627,-0.0943,-0.1093,-0.0164,0.0431,-0.1055,0.0753,-0.0345,0.0525,0.0539,0.07,0.0909,0.0894,-0.0427,-0.0308,-0.0613,-0.0317,0.0542,0.0571,-0.0519,-0.0407,-0.0015,0.009,-0.1093,-0.1116,-0.1091,-0.1141,-0.1048,-0.0376,-0.0691,-0.0281,-0.0749,-0.1028,-0.0907,-0.0458,-0.0868,-0.0166,0.0909,-0.1008,0.1117,-0.1112,-0.111,-0.0565,0.0411,-0.0725,-0.0513,0.1122,0.051,-0.1731,-0.0003,0.0227,-0.0013,0.0289,0.0251,0.0236,0.0862,-0.0832,-0.1692,-0.0445,-0.1412,-0.2335,0.0779,-0.0972,0.1011,0.0979,0.1,0.1081,0.1096,-0.1127,-0.1462,0.0128,0.1045,0.1679,0.0568,-0.0478,0.0479,0.0468,-0.0813,0.0663,-0.037,-0.1395,-0.0353,-0.0477,-0.0686,-0.1345,0.0904,0.0176,0.0592,0.0706,-0.0164,0.0012,-0.0039,0.021,-0.0161,0.0369,-0.0715,-0.0082,0.0811,0.0648,-0.0174,-0.0623,-0.0624,-0.124,-0.0596,0.0564,-0.1643,-0.0471,-0.0085,0.0185,-0.0368,0.0619,0.0229,0.0536,-0.0403,0.0813,-0.1509,-0.1111,-0.1173,-0.0797,-0.0453,-0.1436,-0.1351,-0.2651,-0.1383,-0.0628,0.1197,-0.0852,-0.0527,-0.0142,0.0273,0.1087,0.1166,-0.0586,-0.1201,-0.0791,0.0087,0.0274,0.0984,-0.0594,-0.0772,-0.0814,0.0665,0.0728,0.0774,0.1888,0.0072,0.0043,0.1192,-0.0482,0.0839,0.0639,0.046,-0.0603,-0.027,0.0287,0.0713,0.0322,0.0646,0.0869,-0.0007,0.0214,0.0188,-0.1467,-0.0735,-0.0309,0.0965,0.2065,0.0607,-0.0024,0.0145,0.0196,0.2801,0.1453,0.1232,0.2,-0.179,0.0025,-0.035,0.0821,-0.0704,0.0931,-0.0162,-0.0285,-0.0,0.0426,0.0616,-0.054,0.0526,0.0506,-0.1001,0.1595,0.1014,0.0392,0.0161,-0.004,0.0074,-0.0295,-0.0498,-0.0399,-0.0356,0.0773,0.14,0.1538,-0.132,0.0171,-0.0311,-0.0882,-0.0538,-0.1814,-0.1587,0.0408,0.0497,0.0808,-0.019,0.0475,0.0935,-0.0075,0.047,-0.0128,0.0452,-0.029,-0.0135,-0.0066,0.0764,0.0124,-0.1523,-0.0256,-0.133,-0.087,-0.0079,-0.0779,0.0193,-0.1217,-0.0808,-0.0063,-0.0222,0.0156,0.1086,0.0238,-0.0516,-0.0982,0.2056,-0.0287,0.0881,0.1475,0.122,-0.0061,0.0267,-0.1315,0.2435,0.2324,-0.1703,-0.0616,-0.0223,-0.038,-0.0645,-0.1068,-0.1726,-0.1581,-0.0654,-0.0033,-0.0373,0.027,-0.0064,-0.0166,-0.093,-0.1339,0.152,0.0859,-0.0943,-0.0582,-0.0627,-0.0892,-0.1787,0.0282,0.1445,-0.118,0.0457,0.1254,0.056,-0.1779,-0.1856,-0.1204,-0.1395,-0.0656,-0.0695,-0.0101,0.0674,0.0434,0.1252,0.0132,0.179,0.2202,0.1945,0.0701,0.1844,-0.2062,-0.1587,-0.1274,0.0179,-0.0068,-0.0219,-0.0573,0.0015,0.0389,-0.1431,-0.1552,-0.0282,0.1467,-0.1425,-0.0341,-0.0358,0.0224,0.091,0.0823,-0.007,-0.0694,-0.0197,-0.0858,-0.0241,0.1512,0.1519,0.0553,-0.0039,0.1017,0.1047,0.0718,0.0692,0.0051,-0.1149,0.0182,-0.0192,0.0199,-0.0096,0.042,0.1573,0.0353,0.0258,0.0375,0.0104,-0.0235,-0.134,-0.1235,-0.1195,-0.0953,0.3119,0.0439,0.1671,0.1394,0.0968,0.0135,0.0122,0.1336,-0.0355,0.2681,0.1456,0.0197,0.0689,0.0881,0.0297,-0.0407,-0.0357,-0.1088,0.0191,0.2471,0.0489,-0.0673,-0.0115,-0.0333,-0.0695,-0.005,-0.018,-0.0837,-0.0733,-0.0277,-0.1652,-0.0143,-0.0557,0.0586,0.079,0.0931,0.0362,-0.0037,-0.003,-0.0302,-0.0221,0.0461,0.1779,-0.0113,0.0605,-0.0747,0.0417,-0.016,-0.1037,-0.028,0.1223,0.0687,-0.0273,-0.1774,-0.0911,-0.0964,-0.0916,0.0037,0.0319,-0.0388,-0.0087,-0.0369,-0.091,-0.2249,-0.1405,-0.1355,-0.1373,-0.1009,-0.0948,-0.037,0.1045,-0.1619,-0.1818,-0.1477,-0.0514,-0.0123,-0.1256,-0.0189,0.0649,0.1806,0.0704,-0.0428,0.3513,0.267,0.2317,0.0164,0.1025,0.0062,-0.136,0.0036,-0.0417,0.0191,0.1011,0.1182,-0.0456,0.0161,0.0879,0.1189,-0.1189,-0.0863,-0.0274,-0.0452,-0.1324,-0.0916,-0.0618,-0.0818,0.0387,-0.0976,-0.1292,0.1617,-0.0443,-0.1394,0.0347,0.1251,0.1163,-0.062,-0.0836,-0.2179,-0.1643,-0.0402,-0.188,0.0143,-0.095,-0.0793,0.0615,-0.08,-0.0513,-0.1373,-0.0556,0.0473,0.0828,0.2026,0.116,0.1809,-0.0933,-0.08,0.1293,0.021,0.1147,0.0461,0.0483,0.2149,0.1381,-0.0952,-0.185,-0.0803,-0.0677,-0.1256,-0.0353,-0.0563,0.0149,0.032,-0.0,0.0813,0.0245,-0.172,-0.0076,-0.1324,-0.0382,-0.1265,-0.1862,0.0048,-0.0837,-0.0007,-0.0647,0.0025,-0.1373,-0.1014,-0.1927,-0.062,-0.1222,-0.0425,-0.0346,-0.0427,-0.0128,-0.0377,0.0543,0.0894,0.0541,-0.0728,-0.0683,-0.1199,-0.0371,0.0484,0.1245,-0.1096,0.1661,-0.0385,-0.0613,0.071,0.0217,-0.0927,0.038,0.0438,0.0411,0.0084,-0.0158,0.1248,0.2221,0.283,-0.0933,-0.0784,-0.0022,0.0645,-0.0157,0.1563,0.0182,0.2903,-0.119,0.0393,0.0146,0.0753,0.0027,0.0137,-0.0018,0.0241,-0.002,0.001,0.0727,0.0525,-0.0299,-0.0888,0.0851,0.1452,0.175,-0.1739,-0.1311,-0.1551,0.0188,-0.1577,-0.0887,0.0151,0.0005,0.0076,-0.0317,-0.1367,-0.1386,-0.0141,-0.0416,-0.0757,0.0264,0.2494,0.0505,-0.0336,0.1542,0.3023,0.1191,0.0505,0.1419,-0.0837,0.0369,0.1486,0.1644,-0.0728,0.1856,0.0992,0.0144,0.0498,0.2798,0.1087,-0.1551,-0.0705,-0.0774,-0.0887,0.0011,-0.0833,0.0163,-0.0877,-0.108,-0.039,-0.1194,-0.0433,0.0893,-0.0826,-0.1963,-0.1052,-0.1099,-0.0278,-0.0311,-0.0529,-0.0622,-0.0606,-0.0395,-0.0528,-0.1884,-0.1375,0.109,0.2001,-0.0123,-0.0095,0.0476,-0.0113,-0.0164,-0.0776,-0.0541,-0.1346,0.0394,0.0431,-0.1442,-0.1769,-0.0718,-0.0642,-0.035,-0.1099,0.0089,-0.0883,-0.017,-0.0407,-0.0847,-0.086,-0.1108,0.0053,-0.0198,-0.024,0.1294,-0.0563,0.0129,0.1163,0.0709,-0.1303,-0.0476,-0.109,-0.1232,-0.0779,-0.0467,-0.0347,0.0522,0.1019,0.1128,0.0092,-0.0294,0.0022,-0.0404,0.027,0.1343,-0.1702,-0.0967,-0.1482,0.029,0.0169,0.1053,-0.015,-0.1992,-0.1733,-0.0309,-0.0264,0.015,0.1398,0.0989,0.0201,-0.1007,-0.0908,-0.057,-0.1248,-0.2705,-0.1101,-0.0651,0.1093,0.0057,0.1473,-0.0365,0.0552,0.0378,-0.0115,0.0346,0.089,0.1264,-0.0021,-0.0476,0.0002,-0.0685,-0.0173,-0.0209,0.0004,-0.0404,-0.0034,-0.0066,-0.0229,-0.0766,-0.0429,-0.066,-0.053,-0.1325,-0.0113,0.021,0.0267,-0.0428,0.0422,0.0203,0.0649,-0.022,-0.024,-0.005,-0.0688,-0.2038,-0.0747,0.1533,0.1465,0.0127,-0.0569,-0.0982,-0.0644,-0.0412,-0.0257,-0.0231,0.0757,0.0563,-0.0969,-0.156,0.008,-0.1359,-0.0519,-0.0298,0.3917,0.1928,-0.2233,0.0764,-0.0548,0.0007,-0.045,-0.1613,-0.1438,-0.1388,0.0477,0.0163,-0.0757,-0.0429,-0.0941,-0.0143,0.1324,-0.0145,0.071,0.0284,-0.0214,0.0372,-0.1512,-0.0303,0.0355,-0.0833,0.052,-0.1238,0.0926,-0.164,0.2042,0.0655,0.0933,-0.187,-0.1538,0.06,0.1784,0.0311,0.1645,0.0079,0.1048,0.0797,0.0534,0.1205,0.0737,0.0497,0.0409,0.0745,0.01,0.0262,-0.0881,0.2003,0.2996,0.4564,0.2462,0.1627,0.3463,0.1717,0.2385,0.2541,0.1537,0.1946,0.1072,0.2318,0.2141,0.1899,0.177,0.1707,0.2746,0.2014,0.2538,0.1594,0.2257,-0.1896,-0.0621,-0.1192,-0.1612,-0.0894,-0.1958,-0.1917,-0.0648,0.0203,-0.0598,-0.227,-0.2037,-0.1403,-0.0269,-0.0093,-0.1382,0.0833,-0.0094,-0.0728,0.0364,-0.07,-0.087,-0.0574,-0.0591,-0.1433,0.0577,-0.1822,-0.1947,0.0965,-0.0149,-0.0962,0.0495,0.0577,-0.118,0.1255,0.1364,-0.1614,0.1279,0.1755,0.0532,0.0276,0.0771,-0.056,0.2501,0.253,0.0216,-0.0217,0.0511,-0.0143,0.0512,-0.0912,-0.0646,0.0817,0.028,-0.0461,0.0827,0.0522,0.0047,-0.0525,attention
trm_55ef3ba010121,0.0834,0.0929,0.1005,0.1183,0.0074,0.0381,0.0441,0.039,0.0055,0.0951,0.0182,0.023,0.0889,0.0585,0.108,0.0676,0.1056,0.1231,0.0793,0.0212,0.0884,0.0168,0.022,-0.0576,0.0404,0.0149,0.0173,0.0959,0.1455,0.076,0.0685,0.101,0.1144,0.1096,0.079,0.1187,0.0367,0.0493,0.1229,0.0345,0.1064,0.0799,0.0496,-0.0566,0.095,0.0929,-0.1282,0.0724,-0.0249,0.102,0.0664,-0.0047,-0.008,0.028,0.0525,0.0802,0.1062,0.0038,-0.0249,0.026,0.0197,-0.0198,0.1428,-0.0861,0.0289,-0.0776,0.1837,0.2151,0.1118,-0.005,-0.0423,-0.0073,-0.1229,0.0577,0.1309,-0.0588,0.1225,0.0061,-0.0506,0.0158,-0.0693,-0.0799,0.0253,0.0997,-0.015,-0.0473,0.0185,-0.0019,-0.0098,0.144,0.0857,0.0524,-0.0101,-0.1325,-0.1563,-0.1124,-0.1159,-0.0164,-0.1701,-0.0573,-0.027,-0.0209,-0.0752,-0.0437,-0.0741,0.1169,0.1388,-0.2092,0.0377,0.0501,-0.0091,0.1061,-0.081,-0.147,-0.0319,-0.0071,0.1046,-0.0467,-0.0067,0.0617,0.1067,0.1618,0.1122,-0.0001,0.0786,0.1084,0.1001,-0.0567,-0.0722,-0.0579,0.0001,0.0512,-0.0304,0.1576,0.0065,0.1905,0.0321,0.0736,0.0271,0.0056,0.0977,0.1065,-0.0919,0.0496,0.0847,-0.0206,0.0825,0.0104,0.0622,-0.093,0.0454,0.0807,0.1083,0.1355,-0.1221,0.0126,-0.0596,-0.0118,-0.0164,0.0396,0.068,0.094,0.1854,0.1857,0.0209,-0.0466,-0.0025,0.1378,0.1303,-0.0042,0.0273,0.1083,-0.0181,0.1062,0.0874,0.1133,0.08,0.1058,0.0608,0.0531,0.1169,-0.109,0.0693,-0.002,0.1018,0.055,0.0611,0.0217,-0.017,0.1215,0.1167,0.0522,0.0306,0.1454,0.123,0.1971,0.1952,0.0151,0.0088,0.0915,0.0316,-0.1801,0.1505,0.1469,0.0239,0.0234,0.0335,0.0808,0.0724,0.0047,0.1104,0.0221,-0.0172,-0.0254,-0.0861,-0.0245,-0.1307,0.1362,0.1419,0.0037,-0.1121,0.0979,0.0999,0.0503,-0.0386,-0.0314,0.0791,-0.1349,0.017,-0.137,0.0149,0.0649,-0.157,0.1444,0.1404,-0.0406,0.0017,-0.0363,-0.015,0.0555,0.0266,0.168,0.0586,-0.0012,0.0923,0.0711,0.0436,0.1212,0.0587,0.083,-0.031,-0.0792,0.0207,-0.0616,0.0323,0.1333,0.0133,0.0914,-0.1362,-0.2259,-0.0334,-0.1984,0.1183,-0.0871,-0.1403,-0.2595,-0.0896,0.0189,-0.0581,0.0163,0.0728,0.034,0.079,-0.0189,0.0493,-0.0914,0.065,0.098,0.1009,-0.0019,-0.0726,0.0191,0.0044,0.1776,0.1393,0.0773,-0.0794,-0.0875,0.092,0.1032,0.0603,0.0675,0.0322,0.0562,0.0838,0.0159,-0.0306,-0.0542,0.0407,-0.0887,-0.0348,0.1425,0.0845,0.0646,0.0781,0.0711,0.0998,0.0347,-0.0287,-0.0236,-0.0002,-0.0135,0.149,-0.0617,-0.0468,0.0679,-0.1105,-0.038,-0.0613,0.1698,0.0006,-0.0409,0.0793,0.1222,0.0659,0.0937,-0.0028,0.0272,0.0688,0.0927,-0.002,0.0912,0.0162,-0.0021,-0.0431,-0.064,-0.0722,0.0162,-0.0387,0.1031,0.0913,-0.043,-0.0082,0.0231,-0.0846,-0.0509,0.1847,0.1332,0.1312,0.0714,0.0819,-0.1122,0.0594,0.0023,0.0358,0.0706,0.0586,0.0954,0.114,0.0841,0.0065,0.0274,0.0525,0.0385,0.0422,-0.0649,0.1182,-0.138,-0.0432,0.1071,0.0276,-0.0433,0.0082,-0.1102,0.1335,0.0424,0.0711,-0.1012,-0.2347,-0.1759,-0.2462,0.024,0.1184,0.019,-0.0286,-0.0857,0.0896,-0.0061,-0.0046,0.0443,0.0241,0.047,0.068,0.0434,-0.0155,0.0166,0.0498,0.1343,0.083,0.0719,0.0614,-0.0327,0.0019,0.0211,-0.0217,-0.0549,-0.0773,-0.0081,0.1026,0.0319,0.0465,0.1164,0.062,-0.2316,0.0698,-0.0001,-0.247,0.0188,0.0879,0.0672,0.0037,0.1999,0.1301,0.3086,0.2666,0.1148,0.1729,0.084,0.1381,0.1295,0.0427,-0.0678,0.005,0.0228,-0.0261,-0.0643,-0.0283,-0.0099,0.2321,0.1209,-0.0432,-0.0705,0.0399,-0.0795,0.0351,0.0682,-0.0484,-0.1413,0.0952,0.111,0.042,-0.0352,0.0936,0.109,0.0328,0.1258,-0.0456,0.0793,0.0361,0.019,-0.0172,0.0906,0.0347,-0.0628,0.1208,0.1227,-0.0289,-0.3237,0.1036,0.0011,-0.0212,-0.0274,-0.0146,0.0385,0.0053,0.0504,-0.0038,-0.0394,-0.0109,0.0391,-0.0909,0.0027,0.0132,-0.0351,-0.0431,-0.1225,-0.003,0.0202,0.0693,0.0435,-0.1026,-0.064,0.131,0.169,-0.0588,-0.0445,0.0849,0.0632,-0.016,0.1085,0.1036,-0.0346,0.0901,0.1191,0.0938,0.0536,-0.0619,-0.0237,0.06,-0.1031,0.1762,-0.025,0.0289,-0.0026,-0.0813,-0.0441,0.1111,0.102,-0.0946,0.0748,0.0859,0.0615,-0.056,-0.0325,-0.1329,-0.0456,-0.1107,-0.1624,-0.0917,-0.0705,0.0822,0.011,0.0646,0.218,0.0436,-0.0082,0.1354,0.1204,0.0266,0.1237,0.0198,-0.0368,-0.012,0.0137,0.068,0.033,0.0126,-0.0695,-0.0214,0.0472,-0.1015,0.0295,0.0688,0.0138,0.0271,0.1099,-0.0946,-0.0454,-0.1003,0.0584,0.0495,0.0049,0.0893,-0.0376,0.0534,-0.0836,-0.0964,-0.0041,0.0263,0.0523,0.0889,0.019,0.1236,-0.0075,-0.0215,-0.0076,-0.0697,-0.0107,-0.0546,-0.0461,0.0,0.0917,0.0271,0.0677,-0.0329,-0.0028,0.0502,-0.0107,-0.0329,0.0442,0.0884,0.0225,-0.0531,-0.0571,0.0863,0.0663,0.1998,0.0424,-0.1345,0.03,-0.0385,-0.052,-0.0447,-0.0668,-0.0305,-0.0275,0.0033,0.1105,0.1071,0.0,0.1532,0.0452,-0.0658,0.018,0.2169,0.044,0.0767,-0.002,-0.0211,0.2147,0.1013,0.1916,-0.0987,-0.0051,0.0185,-0.0476,0.1014,0.0954,0.077,-0.0197,-0.0353,-0.0135,0.0379,-0.0058,0.087,-0.035,-0.0318,0.0598,0.0599,0.072,0.0601,-0.0698,-0.0021,0.0405,0.1267,0.0419,0.1696,0.0965,-0.0997,0.1787,0.0406,0.1341,-0.1427,0.0943,0.023,0.0869,-0.0156,0.0472,0.0345,0.1119,0.1349,-0.017,-0.1258,0.0114,-0.053,-0.0524,0.099,0.0921,0.0322,0.0743,0.0597,0.0556,0.0634,0.0477,0.0597,0.0721,-0.1833,0.0793,-0.0178,0.0405,-0.0257,-0.0611,-0.0609,-0.0178,-0.1259,0.1647,0.0712,-0.0389,-0.0346,0.0126,0.0103,-0.139,-0.0758,-0.0773,-0.051,0.037,-0.0572,0.0288,0.0605,0.0091,-0.0019,0.0185,0.0135,0.0823,0.0717,0.0665,0.1174,0.1236,0.1156,-0.0316,-0.1055,-0.0247,0.0497,-0.071,-0.0253,-0.0013,0.0626,-0.0549,0.1084,-0.0106,-0.1166,0.0496,0.2736,0.2735,0.1736,0.0386,0.048,0.1125,-0.0262,0.0563,-0.0932,0.0051,0.0671,-0.0118,-0.0433,-0.0216,0.1184,-0.0754,-0.081,-0.1602,0.0973,0.0189,0.0851,-0.0092,-0.0064,0.1104,-0.0573,-0.0741,0.0365,0.0022,-0.0089,-0.0628,0.1413,0.208,0.1718,0.1279,-0.065,-0.1718,-0.0137,0.0985,0.0092,-0.0067,-0.031,-0.0828,-0.0199,-0.0098,0.048,0.0703,0.0411,-0.0866,-0.1009,-0.1395,0.0423,0.0151,-0.0248,0.0535,-0.0528,0.0561,0.1022,0.0173,0.1078,0.0864,0.0401,-0.1158,-0.1202,-0.0643,-0.0074,0.0319,-0.0,-0.0907,0.0301,0.0926,-0.0746,-0.0059,-0.0186,-0.0362,-0.0786,0.0606,-0.085,0.1445,0.1499,-0.0914,-0.1406,-0.1279,0.0082,-0.0205,-0.0671,0.0297,0.0166,-0.1589,-0.0044,-0.0541,-0.1067,-0.1726,-0.0591,-0.0102,-0.1943,-0.1734,0.0634,-0.0429,-0.071,0.1915,0.1285,0.051,0.0735,-0.0868,0.2149,0.0946,0.1451,0.1115,0.1664,-0.0331,0.0078,-0.0863,0.0738,0.0715,0.0482,-0.0558,-0.0774,-0.028,-0.0832,-0.118,-0.0386,-0.02,-0.0108,-0.0091,-0.0809,-0.1099,0.0779,-0.0929,-0.0442,0.005,0.0444,0.0798,0.0653,-0.1027,0.0945,0.2653,0.1547,0.0283,-0.0888,-0.1061,-0.0238,-0.0132,-0.048,-0.019,0.0799,0.0845,-0.0285,0.0609,-0.0183,0.1397,-0.0415,0.0745,-0.0622,0.0367,0.0377,0.0294,0.1731,0.1526,0.069,-0.1966,0.0624,0.063,0.0968,-0.0505,0.0012,0.1368,0.0425,0.1092,-0.0434,0.0628,-0.0649,-0.0839,-0.0066,-0.0741,0.1756,0.0645,0.0218,-0.0914,0.0955,-0.0099,-0.0993,-0.0366,-0.0669,-0.2846,-0.074,0.027,0.0681,0.0543,0.0684,0.0387,-0.0035,-0.0559,-0.1316,-0.0379,-0.0488,0.1051,-0.1036,-0.1955,-0.0178,0.0106,0.0278,0.0604,0.1223,0.0541,0.0488,-0.0033,-0.0075,0.0909,0.008,-0.137,-0.0372,0.0851,0.0447,-0.0674,0.023,0.0375,0.0436,0.1354,0.1418,0.1478,0.1135,0.1453,-0.0165,-0.011,0.0612,0.1232,0.0408,0.1156,0.0208,0.1116,0.0682,0.0635,-0.0231,-0.086,-0.098,0.0133,-0.0403,-0.0084,-0.0487,-0.1063,-0.1024,-0.1439,-0.0914,0.0647,0.0347,-0.0129,0.0002,-0.0927,-0.087,-0.0785,-0.0012,-0.0881,-0.0316,-0.1339,-0.0066,0.0282,0.0238,-0.0824,0.0427,-0.048,0.1595,0.0715,0.0755,0.0964,0.0608,-0.0666,-0.0602,-0.0302,-0.0942,-0.1311,-0.116,0.0543,0.0065,-0.0156,0.0285,-0.0099,0.004,0.0417,0.1109,0.1461,0.0691,-0.1089,-0.0943,0.0965,0.1098,0.0799,0.1486,0.0897,-0.106,-0.0665,-0.0908,-0.0891,-0.0791,0.0887,0.0162,-0.0464,0.0289,0.0254,0.0181,-0.0208,0.0256,0.0309,0.0169,-0.0223,0.1112,0.005,0.105,-0.0398,0.1153,0.0105,-0.0697,-0.1227,0.0326,-0.0283,0.0212,0.0481,0.0041,0.0254,0.0152,0.0759,0.0063,-0.0235,-0.0112,0.0417,0.0392,-0.0311,-0.0111,0.0297,0.0301,0.057,0.111,0.1165,0.096,-0.1659,0.0199,-0.0628,0.1104,-0.1854,-0.1224,0.0083,-0.005,0.0066,-0.0364,0.0128,-0.0798,0.0964,0.0818,-0.0022,0.0489,0.1072,0.013,0.0299,-0.0694,-0.0608,0.0485,0.0242,0.0633,-0.0451,0.0151,-0.0057,-0.0471,-0.0433,0.0948,0.035,0.0468,-0.0243,0.0345,0.0758,-0.3647,-0.2459,-0.1954,-0.0813,-0.1147,-0.0108,-0.1741,-0.1527,0.1234,-0.3504,-0.3383,-0.2567,-0.1889,-0.282,-0.0768,-0.1158,-0.0482,-0.008,-0.0778,-0.0067,-0.1016,-0.0311,0.1234,-0.0567,-0.0432,-0.0343,-0.0711,0.0347,0.0732,-0.1849,-0.0678,0.1044,0.0131,0.0686,-0.0999,-0.0483,-0.1359,0.0606,0.1485,0.0518,-0.0251,-0.0558,-0.1183,-0.1393,0.0575,0.0767,0.1255,0.0679,0.0665,-0.3366,0.1032,-0.1448,-0.1288,0.0646,-0.0463,0.0476,-0.0552,-0.0883,-0.0334,-0.1462,-0.0706,0.0053,-0.0312,-0.0613,0.0844,0.1429,-0.0144,0.0497,-0.0915,0.0395,0.1066,0.0308,0.0981,0.0275,0.0054,0.0071,0.1086,0.0105,-0.2069,0.0034,0.0141,0.0357,-0.1398,-0.0386,-0.0351,0.1393,0.1415,0.0245,0.1021,0.0786,0.1068,0.057,0.0156,0.0473,-0.0449,-0.0369,-0.0529,-0.1285,0.0247,0.0034,0.0631,-0.0754,0.0065,-0.081,0.0729,-0.0808,-0.1953,0.0096,0.0844,-0.1561,-0.1206,0.0724,0.092,-0.0102,0.1613,0.0758,0.2283,0.0454,-0.0812,0.0999,0.0656,-0.0249,0.0784,0.0116,0.0865,0.0405,0.0558,0.0985,0.0833,-0.0797,0.0201,-0.4348,-0.3302,-0.2913,-0.3785,0.1179,0.0159,0.0838,0.075,0.1124,0.0357,0.073,-0.1851,0.0715,0.0676,-0.1043,-0.0513,0.0291,-0.1186,-0.0559,-0.0168,0.0122,-0.0783,0.0661,0.0708,0.0534,-0.1212,-0.0257,0.0105,0.0548,0.0548,0.1475,-0.0122,0.0375,-0.0035,0.0259,-0.0801,0.0572,-0.2228,0.2315,0.2164,-0.0559,0.0281,0.1782,0.1887,0.1855,0.0731,0.0441,0.035,-0.0017,0.0062,-0.0791,-0.0179,-0.1106,0.0462,-0.0996,0.0437,-0.0352,-0.0759,0.0329,0.0486,0.0128,0.0455,0.0316,0.0383,-0.0,-0.0561,-0.0423,-0.0662,-0.0066,-0.0992,0.0211,-0.1221,0.042,0.0266,-0.0099,0.1185,-0.0019,0.1592,0.2449,0.0209,0.0352,0.1772,0.0235,0.0475,0.1486,-0.0038,0.0718,-0.0116,0.15,0.0326,0.0915,0.1387,0.012,-0.0022,0.0334,-0.2214,-0.0919,-0.0406,-0.0375,0.0119,-0.0226,0.0202,0.1098,0.1058,0.0052,0.0716,0.0141,0.0847,0.0151,-0.0279,-0.0155,-0.0234,0.0908,0.0862,0.0288,-0.0291,0.0069,0.0353,0.0118,-0.0162,0.0146,0.0957,0.0489,0.1245,0.0937,-0.0034,0.1354,0.14,0.0074,0.0023,-0.0463,0.0188,0.0129,0.1019,0.109,-0.0449,0.1072,-0.0209,-0.0193,0.0383,0.0885,0.1674,-0.0661,-0.1127,-0.0301,-0.0075,-0.0004,0.0222,-0.2477,-0.0307,-0.008,0.0097,0.1497,-0.0804,0.0351,-0.0958,-0.078,-0.1758,-0.0238,0.0939,0.048,-0.1054,0.0665,-0.0074,0.0739,0.0175,0.1025,0.063,0.0137,-0.0563,0.0428,0.0674,0.1116,-0.0457,-0.0254,0.021,-0.0131,0.1112,-0.0293,-0.0027,0.0612,-0.051,0.0358,0.0634,0.04,0.0897,0.0829,0.0913,0.0406,0.0579,-0.0175,0.0125,-0.1127,0.0309,0.0306,0.052,0.0139,0.0072,0.0684,0.193,-0.0782,0.0716,-0.0193,-0.0247,-0.0745,-0.0439,-0.0182,-0.0322,0.0659,0.0066,0.0644,0.0361,0.1646,-0.0213,0.1076,0.0097,-0.0084,0.0359,0.0611,0.0884,0.086,-0.1189,-0.0634,0.0251,-0.3218,-0.041,-0.0644,-0.0483,-0.1821,0.0033,0.0374,-0.0655,-0.1775,0.0506,0.01,0.0518,0.0811,0.0503,0.0687,-0.0649,0.0545,0.0418,-0.0926,-0.1519,0.0628,0.068,0.0163,-0.0094,-0.0323,-0.0444,0.1782,0.097,0.0057,0.1725,0.1232,-0.1061,-0.0552,-0.0585,-0.0292,-0.0883,-0.0281,0.1592,0.0622,0.0043,0.0483,0.1798,0.0594,0.0334,0.0694,0.0897,-0.1347,0.0187,0.0141,-0.0267,-0.026,-0.1097,-0.1579,0.0662,-0.054,0.0405,0.0659,0.0873,0.0332,-0.0274,-0.0016,-0.0214,-0.1472,-0.0286,-0.0039,0.0543,0.0794,0.0218,-0.3205,-0.3089,0.1462,0.1553,-0.0526,0.0592,0.0596,0.0272,0.145,-0.0519,0.0251,0.0127,0.0311,0.0081,-0.1536,0.0865,-0.054,-0.0702,0.0292,-0.057,-0.2929,0.037,0.0556,-0.256,-0.0469,-0.0516,-0.0869,-0.053,0.067,-0.1104,-0.0497,0.0569,0.0158,-0.0436,-0.0166,-0.0934,-0.0467,0.0353,0.0258,0.0359,-0.1254,0.1079,-0.0108,-0.1452,0.0236,0.038,0.0153,-0.0237,0.1293,0.0415,-0.0739,0.0784,-0.0481,0.0833,-0.0564,-0.1152,0.0603,0.0347,-0.0043,-0.0422,-0.0197,-0.084,-0.0719,-0.1241,-0.0289,-0.1283,0.0358,-0.0261,-0.4009,0.0871,0.1432,0.0272,0.0949,-0.0297,-0.0312,-0.1122,0.0588,-0.0271,-0.0279,0.034,-0.008,-0.0104,0.0421,-0.0184,-0.0412,-0.0539,-0.1015,-0.1389,-0.2257,-0.2341,0.0631,0.0971,0.0738,0.0411,-0.0822,-0.0714,0.0027,-0.0378,-0.0708,-0.0217,-0.07,0.0494,0.1762,0.1196,0.0109,-0.0836,0.0274,-0.0742,-0.0269,-0.1776,-0.1303,-0.0251,0.0218,0.0792,-0.0075,-0.0327,-0.0667,0.0842,0.109,0.1388,-0.078,0.0531,0.032,-0.1106,0.0769,0.0361,-0.0522,-0.0876,-0.0446,-0.0867,-0.0146,-0.0128,-0.0479,-0.0078,-0.0863,-0.1153,-0.1431,0.0284,-0.0556,-0.0599,-0.0044,0.0963,-0.0134,0.1614,0.0782,0.0492,0.1051,0.016,-0.0833,0.0789,0.0256,0.0335,0.007,0.0006,0.0028,0.0828,0.0039,0.0328,-0.003,0.0281,-0.0107,-0.1002,-0.027,-0.0583,0.1919,0.119,0.1457,0.0048,-0.023,0.0827,0.0649,0.0209,0.1078,0.0343,-0.1298,-0.0238,-0.1128,-0.0761,-0.0067,-0.0642,0.0382,0.0023,0.0048,0.0194,0.1919,0.0386,0.1004,0.0716,0.0566,-0.0187,-0.0943,-0.2844,-0.2081,-0.0682,-0.08,0.0957,0.2481,0.1311,0.1864,0.122,0.0055,0.023,0.0115,0.0765,0.1604,0.1228,0.0528,-0.0468,-0.0475,0.0278,0.0364,-0.0007,0.0537,0.1679,0.1027,0.0742,-0.0798,0.0031,-0.0189,0.2259,0.0903,0.1026,0.093,0.2771,-0.0074,0.0182,0.031,0.0736,0.0397,0.0638,0.028,0.1362,0.0737,0.0885,-0.038,-0.0946,-0.0635,-0.0734,-0.0747,0.1085,-0.0163,-0.0365,-0.1012,0.0744,0.0276,0.0526,-0.1161,0.1521,0.1472,0.0947,0.0855,0.0541,0.1179,0.0775,0.0846,0.0461,0.0261,-0.0215,-0.0195,0.2062,-0.0314,0.0285,0.0664,0.0577,0.0692,0.0398,0.1081,0.0201,0.0104,-0.1437,0.0102,0.0475,0.2059,0.0982,0.1117,0.0569,0.1762,0.1209,0.0031,-0.0777,-0.0677,-0.0105,0.0775,-0.004,-0.1218,-0.1744,-0.1349,0.2638,0.2766,0.0511,-0.0633,-0.0061,0.0629,-0.0397,0.0552,-0.0334,0.0093,0.0648,0.0744,0.0373,0.0696,0.0937,-0.0149,0.1096,0.0146,0.0602,0.0213,-0.0466,-0.1057,0.0767,0.1059,0.1368,0.1143,0.0942,0.1829,0.094,-0.2281,0.0505,0.0674,-0.0259,-0.006,0.024,-0.0439,0.0223,0.0099,-0.1026,0.001,-0.0275,-0.0368,0.0474,-0.0005,0.0144,-0.0873,-0.16,0.1652,0.0274,-0.0472,-0.1795,0.0263,0.0278,-0.0464,0.006,0.0116,-0.0071,-0.1141,-0.0232,-0.0439,0.096,0.0961,0.1237,0.0085,0.0744,-0.0648,-0.156,-0.2014,-0.041,-0.035,-0.0769,-0.0868,-0.0681,-0.0779,-0.0132,-0.0181,-0.0506,0.2234,0.1006,0.1504,0.1045,0.0044,0.1249,0.1143,0.0648,-0.0097,0.0695,0.1527,0.0642,0.045,0.1396,0.2703,-0.0406,0.1466,0.0227,-0.0512,0.1068,-0.0176,0.1329,0.0629,0.0088,0.0637,0.0634,-0.0004,0.0968,-0.0728,-0.0824,-0.0705,0.0176,0.0944,-0.0302,-0.0025,0.0388,-0.0647,0.0221,0.0449,-0.0806,0.0121,0.0488,0.1289,0.0875,0.0448,0.0134,0.0255,0.0252,0.0913,0.0892,0.0552,0.0637,-0.1006,0.1285,0.0532,-0.0241,-0.0145,0.0139,-0.0526,-0.0427,0.1638,0.0631,0.1141,0.0984,-0.1073,-0.2276,-0.2143,0.0493,-0.3994,-0.2476,0.157,0.0868,-0.4062,-0.153,-0.0476,-0.1074,-0.1477,-0.1258,0.1138,0.1092,0.0645,0.1169,-0.4338,-0.3508,-0.2685,-0.068,-0.1076,-0.2392,-0.442,-0.4352,-0.3806,-0.0409,0.0158,0.0495,0.0179,0.0361,-0.0009,0.11,0.0372,0.0267,0.0179,0.1278,0.1211,-0.1013,0.025,0.0266,0.0646,-0.0714,-0.0862,-0.1418,0.0292,0.0377,0.0759,0.0119,0.0221,0.0065,0.0665,0.0628,0.0472,0.0133,0.1178,0.1625,0.1472,0.0038,0.076,-0.0107,-0.1537,-0.0414,-0.1234,-0.0879,-0.0629,-0.2988,0.0507,0.1487,0.1721,0.0271,-0.0639,0.0343,-0.1187,-0.0273,-0.1008,-0.0175,0.1311,0.1318,0.0744,0.0623,-0.0578,0.1881,0.1324,-0.0239,0.0073,-0.1472,0.0548,0.0007,-0.0883,0.0224,0.0234,-0.029,0.0633,0.1249,0.1359,0.0029,0.0097,0.0516,0.0091,0.0619,-0.0952,-0.1871,-0.1709,-0.039,-0.1649,0.0532,-0.0064,-0.0863,-0.1123,-0.1791,-0.1375,-0.0435,-0.0612,0.0347,-0.0795,-0.0944,0.0462,0.0449,0.0612,0.0377,0.0699,-0.0129,0.0182,-0.0035,0.008,-0.0445,-0.0405,-0.0195,-0.1019,-0.001,-0.15,-0.1416,0.133,0.1485,0.1035,0.1082,0.1597,-0.1024,-0.002,0.0285,0.0207,-0.1529,-0.0089,0.2148,0.06,-0.0213,0.0579,-0.0395,-0.0482,-0.0933,-0.1293,-0.1968,-0.3904,-0.1296,-0.0563,0.0593,0.0239,-0.0699,0.1121,0.0881,0.0824,0.0011,0.0788,-0.0087,0.0541,0.0434,0.0736,0.1633,0.168,0.1352,0.0908,0.0953,0.1192,0.071,0.074,-0.0065,0.0077,0.048,0.0576,0.0774,-0.1522,-0.0427,-0.0662,0.0726,-0.1225,-0.0998,0.0742,-0.0801,0.1145,0.0715,-0.0626,0.0555,0.064,0.0152,-0.0303,-0.0776,-0.0095,0.072,0.0366,0.0006,-0.0027,-0.0327,0.0929,-0.0216,-0.0253,-0.0304,-0.0368,0.1362,0.0989,0.0324,0.0881,0.0387,0.024,0.0552,0.0144,-0.0807,-0.0242,-0.0338,0.2503,0.1307,0.1336,0.1882,0.1519,0.1161,0.1289,0.1289,0.0421,0.0496,-0.0347,0.1584,-0.0071,0.0491,0.0508,0.0262,-0.0209,0.2898,-0.1113,0.1249,0.0073,-0.01,-0.1636,-0.0603,0.0018,0.1151,0.1032,-0.0394,-0.0615,0.012,-0.1451,-0.0394,-0.0133,-0.1081,-0.0829,-0.0228,-0.0351,0.007,0.0261,0.0108,0.1363,0.1036,0.0194,0.0773,0.044,0.0192,0.0267,-0.0273,0.0036,0.0426,-0.0526,-0.0706,0.0428,-0.1404,-0.0185,0.1779,0.0826,0.2126,0.0763,0.0742,-0.041,0.0522,-0.0864,-0.0732,0.0081,-0.1142,-0.1261,0.0416,-0.1459,-0.0329,-0.2887,-0.1153,0.0043,-0.0806,0.0969,-0.0572,-0.0602,-0.0492,0.0279,0.0312,-0.0341,0.0228,0.0172,0.0476,0.109,0.0415,0.0365,-0.0106,0.0226,0.0647,-0.1894,0.0024,-0.0752,-0.1104,-0.0046,-0.0117,-0.0202,0.0755,0.1397,0.0285,-0.1109,-0.079,0.0287,0.009,0.1007,-0.0224,-0.0719,-0.11,-0.0473,-0.0274,-0.0221,0.0414,-0.0827,0.1017,-0.0188,-0.0073,0.0303,0.0627,0.0651,0.0636,0.0601,0.0253,0.0038,0.0936,-0.0648,0.0204,-0.1238,-0.0191,-0.0499,-0.0637,0.0113,0.0685,0.0752,0.1074,0.08,-0.0138,-0.0363,-0.0121,0.019,-0.0144,-0.0982,0.006,0.1325,0.0977,0.1445,0.1194,-0.0114,0.027,-0.0129,0.1023,0.0654,0.1299,0.0385,0.0836,-0.0117,-0.0085,0.0912,-0.1175,0.0673,0.087,0.0529,-0.0306,0.0996,-0.015,-0.0259,-0.0088,0.1221,-0.081,0.0015,0.0821,-0.0939,-0.0801,-0.0267,-0.0498,0.0616,0.0986,0.0684,0.1592,0.1698,0.0669,0.0859,-0.0063,-0.0415,-0.092,-0.0834,-0.0978,0.1269,0.1111,-0.0637,-0.1937,-0.2801,-0.0506,0.0383,0.0322,0.0395,0.098,0.0203,0.1149,0.0875,0.0472,-0.0139,0.0614,0.1349,-0.1989,-0.0125,-0.0206,-0.1796,-0.0379,-0.071,0.1154,0.0021,0.0671,0.0365,0.0612,-0.0125,-0.0328,-0.034,0.0202,0.0561,0.0432,0.1071,0.0165,0.0474,0.1857,0.0161,0.035,0.0228,0.0168,0.0021,0.0103,0.01,0.0557,-0.066,0.1779,0.073,0.1165,0.1407,-0.0097,0.1533,0.1167,0.209,0.1171,0.0586,-0.0636,0.1414,0.0057,0.061,-0.0464,-0.0556,-0.049,0.1126,0.1545,0.0599,0.0286,-0.0655,-0.0752,0.0701,0.0178,0.066,-0.0738,-0.0411,-0.0316,-0.0889,0.0091,0.0561,-0.0137,-0.0047,0.0334,-0.0118,0.0281,0.0548,0.011,-0.023,-0.1393,0.0284,-0.1509,-0.15,0.0114,-0.0067,0.0302,0.1608,0.0812,0.0062,-0.1777,-0.2239,-0.1088,-0.0316,-0.0339,-0.0051,-0.15,-0.1498,-0.1146,-0.1023,0.1585,0.0441,0.0792,-0.0567,0.0407,-0.001,-0.0051,0.0087,-0.0662,-0.0217,-0.0596,0.0372,-0.104,-0.0037,0.1343,-0.1252,-0.0914,-0.0206,-0.0388,-0.0902,-0.0927,-0.0201,-0.0376,-0.0442,0.0195,-0.0556,-0.1712,-0.1787,-0.0196,-0.0164,-0.0988,0.0143,0.1585,0.3365,0.3221,-0.0439,-0.0685,-0.032,0.0317,-0.0122,0.0189,0.0867,0.093,0.1332,-0.0747,0.0385,0.0075,0.0275,-0.0431,0.0286,0.123,0.0202,0.1235,0.1044,0.0118,0.0719,-0.0238,0.2159,0.0581,0.0109,0.0593,0.0124,-0.0621,0.0542,0.0947,0.083,-0.1908,0.1154,-0.0751,-0.0319,-0.0441,-0.0224,-0.044,0.0529,-0.1046,-0.0942,0.0694,0.0464,0.0324,-0.0279,0.0684,0.1043,0.1379,0.2046,0.0891,0.0102,0.0152,-0.0713,0.0253,0.058,0.1143,0.1725,-0.0557,-0.081,0.1472,0.0498,0.0299,0.0843,0.1614,-0.217,-0.089,0.0659,-0.0341,-0.1003,-0.0475,0.0788,0.0836,0.1647,0.2013,0.0905,0.0907,-0.0675,-0.0161,-0.0258,-0.0525,0.0585,-0.0515,-0.3728,-0.1643,-0.1275,-0.3086,0.2538,0.1835,0.1163,-0.0275,0.0274,0.0191,0.1016,0.0112,-0.0426,0.1331,0.0955,0.0355,-0.1878,0.076,0.012,0.0192,-0.0408,-0.1011,-0.1503,0.03,0.0822,0.0584,0.0697,-0.0591,-0.095,-0.0997,-0.045,-0.0425,-0.0058,-0.0506,-0.0721,-0.0646,-0.0011,0.0823,-0.0357,0.024,0.0038,-0.001,-0.0123,-0.0829,-0.0564,-0.0128,-0.0066,0.0779,0.0084,0.1822,0.1359,0.0637,0.1102,-0.3146,0.0061,-0.2298,-0.0884,-0.0618,0.0281,0.014,-0.101,0.0582,-0.1307,-0.1627,-0.0803,-0.0969,-0.0265,-0.0208,0.0791,0.0667,0.0615,-0.0021,-0.1192,-0.155,0.0837,-0.0091,-0.0379,-0.0017,-0.0208,-0.0223,0.0595,0.0956,-0.0159,0.1073,-0.0441,0.0579,-0.1261,-0.0639,-0.0897,-0.0418,-0.007,0.0023,0.0176,0.0504,-0.098,-0.1557,-0.0002,-0.0294,0.0234,-0.0735,0.0412,0.0945,0.029,-0.0895,-0.0898,-0.0018,0.1132,0.0724,0.091,0.082,-0.033,-0.0432,0.0459,0.0422,0.0929,0.13,0.1122,0.093,0.0959,0.0834,0.0511,0.0028,0.0827,-0.0255,0.0825,0.0659,0.0881,0.0751,-0.0055,0.1014,0.0976,-0.0537,-0.0834,-0.0629,0.0905,-0.2086,-0.2426,-0.0796,0.0699,-0.0546,0.0287,0.0756,-0.0406,0.0376,-0.0431,-0.1709,-0.1986,0.0082,-0.0307,-0.0494,-0.059,0.132,0.0398,0.0438,0.0237,0.0949,0.0845,0.0401,0.1051,-0.0365,0.1565,0.0952,-0.1144,-0.0142,0.1876,0.0064,-0.0954,-0.1028,0.0572,0.1114,0.3461,0.2843,0.1711,0.2352,-0.1637,0.0595,0.0444,-0.0154,0.0378,0.0225,0.0754,0.0229,-0.252,-0.1509,-0.259,-0.1309,-0.1125,0.0445,0.0138,-0.074,-0.0308,-0.0346,0.01,0.0185,-0.2191,-0.1396,0.1139,0.2162,0.1254,0.113,0.1313,0.0279,0.0655,-0.0518,-0.0504,-0.0194,-0.0507,-0.0431,0.1403,0.0098,0.1372,0.0214,0.153,0.1836,-0.0031,-0.0471,0.0305,0.0382,0.0589,0.1283,0.0782,0.1495,0.0503,0.1148,0.0711,0.0135,-0.0175,0.0363,0.1057,-0.0394,-0.026,-0.0131,0.0843,0.0633,0.0908,-0.018,-0.0831,-0.0212,0.0651,-0.1819,0.0503,0.0519,-0.044,-0.039,-0.0448,-0.0122,0.0084,-0.0187,0.0133,0.0265,-0.1655,-0.2608,-0.2913,-0.0084,-0.0497,-0.0107,-0.0572,0.0552,-0.1571,0.0865,-0.205,0.0366,-0.0224,-0.0204,-0.0972,0.0188,0.0406,0.0135,-0.0311,0.0221,0.0119,-0.0898,-0.0583,0.028,0.0941,-0.0652,-0.1291,-0.0791,0.1761,0.1266,0.1544,-0.0148,0.1004,0.0831,0.0207,-0.0312,-0.0031,0.0274,0.1044,0.1103,-0.0739,-0.0173,0.1156,0.0047,-0.1893,-0.053,0.0733,-0.1084,-0.2128,-0.0878,-0.0537,-0.1025,0.0779,-0.005,-0.2175,-0.077,0.0962,-0.2181,-0.0234,-0.0453,-0.0805,-0.2157,-0.0644,0.1065,0.1195,0.0644,0.0069,-0.1395,0.0729,-0.0721,0.0712,0.0403,0.05,0.0983,0.0123,-0.1202,0.0622,0.1102,-0.0276,0.064,0.1043,0.0125,0.066,0.0734,0.069,0.0672,0.0562,0.1607,0.1016,-0.1165,-0.2034,0.0313,0.0419,-0.0334,-0.0607,0.0452,0.0784,0.1116,0.1469,-0.0444,-0.0346,0.1341,0.1567,0.0606,0.0134,0.0986,0.116,0.0278,0.0718,0.074,0.1528,0.0607,0.0214,0.0797,0.0605,0.0415,0.055,-0.0979,0.0991,-0.0032,-0.1508,-0.0126,0.1107,0.0023,0.1222,0.1477,0.0917,0.0688,0.0752,-0.0368,-0.0753,-0.1243,0.0496,0.126,-0.0842,0.054,0.0403,-0.0679,0.1395,0.0809,0.1117,-0.0745,-0.0471,-0.1077,0.0217,0.1971,0.1701,0.017,0.0061,-0.0088,-0.0608,-0.1233,0.0479,0.0895,0.0992,0.056,0.1138,0.2268,0.0958,0.0969,-0.0453,-0.0038,-0.079,-0.0041,-0.15,0.0177,-0.0447,-0.002,-0.0618,-0.1378,-0.0633,-0.0206,-0.0366,0.0968,-0.0239,0.0774,0.0215,0.0644,0.0591,0.04,0.0045,0.0697,0.0474,0.0607,0.0373,0.0845,-0.0035,-0.0027,-0.177,0.0195,-0.1354,-0.0343,-0.0563,-0.004,-0.0496,0.0055,0.0478,0.1215,0.0569,-0.1683,-0.0705,-0.0001,0.0475,0.0574,0.1093,0.077,0.0023,0.0544,-0.0681,-0.0888,0.1757,0.1239,0.0198,0.1071,0.0687,0.0612,-0.2948,-0.1915,0.1342,-0.0288,0.0673,0.0568,0.0822,0.0862,0.1625,0.1588,-0.0695,-0.0068,0.0785,-0.0119,0.116,0.0223,-0.1701,0.0082,-0.0304,-0.0017,-0.0087,-0.0406,0.1114,-0.0028,-0.1073,0.1237,-0.0416,0.1616,-0.1381,0.1419,-0.366,-0.0138,-0.0228,0.1738,0.1537,-0.0129,-0.0756,0.0257,-0.0528,-0.0132,0.0121,0.0107,-0.0553,0.0076,-0.0535,-0.0671,-0.1175,-0.1287,-0.1662,-0.2512,0.0381,-0.0558,-0.2367,-0.4952,-0.1893,-0.2026,-0.3513,-0.1941,-0.2022,-0.2631,-0.1818,-0.1887,-0.1585,-0.1908,-0.2543,-0.1333,-0.2519,-0.3337,-0.2778,-0.2544,-0.2084,-0.1143,-0.1486,0.1468,0.1262,0.1462,0.1083,0.0109,0.2019,0.1758,0.1046,0.0307,0.0577,0.2116,0.1738,0.1279,0.0217,-0.0118,0.1156,-0.1084,0.0399,0.0953,0.0074,0.0904,0.0515,0.0587,0.0279,0.111,-0.093,0.1586,0.1812,-0.0659,0.038,0.0421,0.0015,0.0011,0.113,-0.0494,-0.0546,0.0837,-0.1942,-0.3012,-0.0186,-0.1576,-0.1514,0.1014,-0.1222,-0.1253,0.0518,0.0562,-0.1589,-0.0031,-0.0596,0.1119,0.0208,-0.153,0.0865,0.0948,0.034,0.0003,0.0517,0.0538,vocal response execution
trm_567982752ff4a,-0.0328,0.0111,-0.0537,0.0305,-0.0241,0.0193,-0.0175,-0.0594,-0.0395,0.0082,-0.0104,-0.0232,0.0018,0.0232,0.0579,0.0432,0.0007,0.0679,0.0029,0.0563,0.0221,-0.009,0.0134,0.0262,-0.0309,-0.0307,-0.0269,0.0281,0.0397,-0.0429,0.0213,0.0601,0.0265,-0.0382,0.0634,0.0357,-0.0338,-0.0018,0.0503,0.0333,-0.0015,0.0437,0.0215,0.0143,0.0084,0.0387,-0.0438,0.005,-0.0079,0.0091,0.0128,-0.075,-0.0448,0.0045,0.0321,0.0121,0.0078,0.0298,0.0081,0.0041,-0.0404,-0.0667,0.0614,-0.0409,0.0157,-0.1044,0.0749,0.0825,0.0624,-0.0333,0.0219,-0.0516,-0.0391,0.0463,0.0593,0.0382,0.008,-0.0059,0.0269,-0.0087,-0.0125,-0.024,0.0732,0.0471,-0.0092,-0.0696,0.0055,-0.0655,0.0189,-0.0267,0.0006,-0.0934,0.0107,-0.1412,-0.1062,-0.1146,-0.0479,-0.0161,-0.1693,-0.1222,-0.0379,0.0408,-0.0715,-0.1138,-0.0226,0.0775,0.0651,0.0108,0.0092,0.0037,0.0227,0.049,-0.0104,-0.0484,-0.0013,0.0415,0.0299,-0.0681,0.0353,0.0177,0.0918,0.0775,0.1023,0.0305,0.0166,0.0624,0.0793,-0.0486,-0.0567,-0.0797,0.0535,0.0194,0.0174,0.0823,0.0236,0.0441,-0.0396,0.0585,0.0434,-0.0331,0.0251,0.0165,0.0605,0.0444,0.0006,-0.0006,-0.0433,0.0233,0.0481,0.0217,0.0006,0.0414,0.0172,0.081,-0.0122,-0.0456,-0.043,0.009,0.0097,0.0044,0.01,0.0382,0.0761,0.053,0.0108,0.0304,-0.0013,0.069,0.0672,0.0373,-0.0215,0.0468,-0.0799,0.0911,0.0347,0.0585,0.0392,0.06,0.0457,-0.0602,0.0356,-0.026,0.0518,-0.0037,-0.0635,-0.0216,-0.0053,0.0437,0.0644,0.0393,0.0369,0.0211,-0.013,0.0816,0.0785,0.0746,0.08,0.0364,0.0923,0.0049,-0.0356,-0.1454,0.0595,0.0264,0.0751,-0.0284,0.0918,0.0253,0.0141,0.0213,0.098,0.0613,-0.0245,-0.0446,0.049,-0.0031,-0.0094,0.0221,-0.0921,0.0265,-0.0311,0.0459,0.0541,-0.0096,-0.0498,-0.0123,0.0595,-0.0503,0.0401,0.0573,-0.1245,0.0247,-0.0348,0.0447,0.0363,-0.0719,0.0081,0.0454,-0.0132,0.0017,-0.0355,0.0307,0.0015,-0.0294,0.0128,0.0182,0.0775,0.051,-0.0012,0.0949,-0.029,0.0059,0.0172,0.0075,-0.0465,0.038,-0.02,0.0226,0.0192,-0.049,-0.0332,-0.0365,0.0489,-0.021,-0.0294,-0.0041,0.0465,0.0548,0.0175,0.0286,0.0348,-0.0503,0.0623,-0.0069,-0.0323,-0.0468,-0.0488,0.0168,-0.0323,-0.0223,-0.0453,0.0235,0.0079,0.0988,0.0943,0.0201,0.044,0.0074,-0.0336,-0.0083,0.036,0.0122,-0.0201,0.0498,-0.0105,-0.0122,0.0297,-0.0012,0.0245,-0.0267,-0.047,0.0984,0.0047,0.0339,-0.0791,-0.0904,-0.0063,-0.0415,-0.0532,0.0527,0.0114,-0.0127,0.0557,0.0399,0.0416,0.0253,0.0124,-0.0202,0.0123,0.0481,0.0021,-0.0164,0.0543,0.0935,0.0056,0.0285,0.0351,0.0597,-0.0207,-0.0027,-0.0193,-0.0002,0.0195,0.0163,0.0513,-0.0821,0.0112,0.0763,0.0185,0.0615,0.043,0.0163,-0.0904,-0.0732,0.0189,0.0055,0.0056,-0.004,-0.0131,0.0064,-0.0121,-0.0545,-0.0987,-0.0735,-0.0082,-0.0634,-0.0042,0.0355,0.0262,0.0241,-0.0394,0.0154,-0.0148,-0.084,-0.0807,-0.0882,-0.0085,0.0075,0.0228,0.0387,0.0402,-0.0453,0.0172,-0.0698,0.0632,-0.0051,0.0557,-0.0089,0.0435,-0.0097,0.0252,-0.1343,0.045,0.0246,-0.0065,0.0094,-0.0027,-0.0216,0.0272,-0.0175,-0.0391,0.028,-0.1092,0.0478,-0.2122,-0.2361,-0.1146,0.0041,-0.027,0.0318,0.0466,-0.02,-0.0375,-0.0282,-0.0336,0.0416,-0.0031,0.0599,0.0381,-0.0043,-0.0237,0.0416,0.0382,0.0242,0.0437,0.0467,0.0496,0.0791,0.0895,0.019,-0.0176,0.0159,0.0064,0.1015,0.1262,0.0221,0.0151,-0.0684,0.0332,-0.0207,-0.0197,-0.0327,-0.0103,-0.0378,0.0675,0.0235,-0.0234,0.0153,0.0349,0.0143,-0.013,-0.051,-0.031,0.0048,-0.0466,-0.0017,-0.0359,-0.0417,0.0884,0.0934,0.0758,-0.02,0.0334,0.0481,-0.0494,0.0968,-0.036,0.0211,0.0607,-0.0384,-0.0428,-0.0038,0.0383,0.0431,0.0344,0.0643,0.0377,0.0151,0.0172,-0.0215,-0.0342,-0.0516,-0.0758,0.0076,0.0281,0.0404,-0.0731,-0.0489,0.0056,-0.0087,-0.0901,-0.0677,-0.0729,-0.0812,0.0182,-0.007,0.011,-0.0083,0.0949,-0.0001,-0.0408,-0.0779,0.0796,0.0645,-0.0022,0.0257,0.0758,-0.0279,0.0212,0.0793,0.0775,0.0147,0.0145,-0.0096,0.0204,0.038,0.0514,0.0462,0.0423,-0.0605,0.0478,-0.0369,0.0276,0.0109,-0.0257,0.017,0.0204,-0.0045,-0.1069,-0.0106,-0.0042,-0.0311,-0.01,0.0059,-0.0217,0.0022,-0.0289,-0.056,-0.0339,0.0195,0.0168,-0.0254,-0.0423,0.0615,0.0174,0.004,0.056,0.0229,0.0136,0.0274,0.0579,0.0031,-0.0414,-0.0137,-0.0088,-0.0513,0.0403,-0.0035,0.004,-0.0059,-0.0707,0.075,0.019,-0.074,0.0144,0.0486,-0.0606,0.0034,0.0023,-0.0495,0.0525,0.0579,0.0682,-0.0448,0.0508,-0.0126,-0.0271,0.0904,-0.0034,0.0281,0.0367,0.0636,-0.0478,-0.0119,-0.2392,-0.2421,-0.0339,-0.0278,-0.0292,0.029,0.0003,0.0376,0.0359,-0.0174,-0.0438,-0.0059,-0.0235,0.0194,-0.0485,0.008,0.03,-0.0024,0.0248,0.0062,-0.0056,-0.076,0.0524,0.0094,-0.0902,0.0388,0.038,-0.0388,-0.0164,-0.006,-0.0291,-0.2229,0.0526,0.039,0.0387,0.0212,-0.0433,-0.0318,0.0017,0.0591,0.0341,0.0293,0.0232,0.0084,0.0479,0.0647,-0.0027,0.0199,-0.0328,0.0005,-0.0193,-0.0908,0.0505,0.0731,-0.0211,-0.0161,-0.0275,-0.1492,0.0585,0.0402,0.0443,-0.045,-0.0103,-0.0254,0.021,-0.0221,0.0006,-0.0458,-0.0522,-0.1737,0.0612,-0.0141,0.0969,0.0673,-0.0761,0.058,0.0446,0.0251,-0.0598,0.0589,0.0112,-0.0458,-0.1801,0.0016,-0.0143,0.033,0.0711,-0.1578,-0.1066,-0.1339,-0.0741,-0.0528,-0.0711,0.0564,-0.0876,-0.0715,-0.0157,0.0146,-0.0133,0.0055,-0.0149,0.0614,-0.1052,0.0291,0.0055,0.0038,0.0426,0.0049,0.027,-0.0213,-0.0602,0.0506,0.0291,0.0769,0.0427,-0.0484,-0.1054,0.0045,-0.0424,0.0241,-0.0497,0.0866,-0.0269,0.012,0.0138,0.0409,-0.0163,0.0364,0.0074,0.0489,0.0309,-0.0081,0.0375,0.0288,0.0091,0.0109,0.0262,0.078,0.0818,0.0146,0.1047,0.0559,-0.0554,0.0302,0.0548,-0.0449,-0.044,-0.0222,0.1107,0.1015,0.0755,0.0346,0.0199,0.0414,0.0171,-0.0335,0.0017,0.0043,-0.0309,-0.0497,-0.0307,0.0058,0.0045,-0.0303,0.0012,0.0091,0.0824,0.0038,-0.0091,0.0234,0.0608,0.0142,0.0244,-0.0263,0.0391,-0.0104,0.0333,-0.0306,0.083,0.1379,0.1153,0.0786,-0.0052,-0.0007,0.0037,-0.0271,0.013,-0.0869,-0.0143,-0.0139,-0.0307,-0.0463,0.0317,0.0145,-0.0451,0.0094,-0.0121,-0.0681,-0.0467,-0.0086,-0.0462,0.0297,-0.0249,0.0308,0.0514,0.0476,0.069,0.0714,0.0793,-0.0213,0.0468,0.0281,0.0147,-0.0236,0.0095,0.0218,-0.0413,0.0442,0.0264,0.0102,-0.0359,-0.0226,0.0139,0.0729,-0.0023,0.081,0.061,-0.0166,0.0501,-0.0458,0.0444,0.0223,0.002,-0.0033,0.0217,-0.1189,-0.0526,-0.0639,-0.0575,-0.0045,-0.0409,0.0259,-0.0403,-0.0489,0.0291,-0.0345,0.004,0.0528,0.063,-0.0075,0.0166,0.0367,0.1171,0.0323,0.0681,0.0474,0.0738,0.0299,0.0216,0.0092,-0.0054,-0.072,0.0643,-0.039,-0.0604,0.0403,0.0291,0.006,-0.03,-0.0007,-0.0516,0.0504,-0.0323,-0.0601,0.0317,-0.0803,-0.0453,-0.0124,0.0288,0.0046,0.0406,0.0103,0.0508,0.1087,0.0635,0.0352,-0.0364,0.0363,0.0833,0.0254,-0.0372,-0.1136,0.0377,0.029,-0.0761,0.0678,0.022,0.042,-0.2318,0.0462,-0.0713,0.0395,0.0685,0.0218,0.0848,0.0974,0.0499,-0.0497,0.0531,0.053,-0.0003,-0.0332,0.0134,0.0746,0.045,0.0392,-0.0267,0.0046,-0.0173,-0.0301,0.0381,-0.0583,0.0486,0.0561,0.0263,-0.0287,0.0246,-0.0411,-0.0147,-0.017,-0.0021,-0.0393,-0.018,0.0552,-0.0006,0.0623,0.0519,0.0352,0.0485,0.0237,-0.024,-0.0508,0.0084,0.0247,0.0126,-0.0319,-0.0624,-0.0188,0.0375,-0.0132,-0.087,-0.0318,-0.0444,-0.1025,0.0415,0.0515,-0.0386,-0.0675,-0.0129,0.0123,-0.009,0.0102,-0.006,0.0036,0.0028,0.0031,0.0057,0.1034,0.0926,0.1099,0.031,-0.0038,0.0401,0.0204,0.0458,0.0464,0.0894,0.0883,0.0305,0.0485,-0.0187,0.0212,0.0029,0.0607,-0.0019,0.0287,0.0051,-0.0256,0.0761,-0.0021,0.0087,0.0378,-0.013,-0.0264,-0.0256,0.0238,-0.0131,-0.0266,0.0058,0.0206,0.004,-0.0121,0.0022,0.0208,-0.0097,0.0441,0.0331,0.0081,0.0478,0.0785,0.0381,0.1176,0.1035,-0.0623,-0.0497,-0.089,-0.0201,0.0112,-0.0099,0.0113,0.011,0.0112,-0.044,-0.012,-0.0201,-0.0123,-0.04,0.0121,-0.0083,0.0095,0.0219,0.0108,-0.0176,0.0448,0.0577,0.0586,-0.0326,-0.0497,-0.0392,0.0046,0.0152,0.0611,0.0551,0.0118,0.046,-0.0135,0.0089,0.0155,-0.0078,-0.0945,-0.0296,0.044,0.0192,0.0055,0.0363,0.0148,-0.0153,-0.0688,-0.1819,-0.2114,0.0488,0.0237,0.0351,0.0427,0.0362,0.027,0.0816,0.0362,-0.0457,-0.0013,-0.0576,0.0159,-0.012,0.0143,0.0044,0.0426,-0.0788,0.0724,0.0446,0.08,0.0485,-0.0525,-0.0179,-0.0737,0.0583,-0.0726,-0.0223,-0.0145,0.016,0.0552,0.0424,0.0268,-0.0643,0.0308,0.0682,0.0415,0.0309,0.102,0.0808,0.0345,0.0007,0.0245,-0.0121,0.0549,-0.0291,-0.0189,-0.1569,-0.008,0.0021,-0.0098,-0.0045,-0.061,0.0234,0.0148,0.0002,0.0054,-0.0934,-0.1128,-0.1694,-0.1515,-0.1196,-0.1077,-0.1746,-0.06,0.0763,0.0688,0.0506,0.0565,0.0328,0.0765,0.0569,0.0245,0.0357,0.0767,0.055,0.0173,-0.0248,-0.0087,0.0348,-0.0697,-0.0773,0.0614,-0.0185,0.0431,0.0494,0.0371,0.0547,0.0775,0.0142,0.0317,-0.0291,-0.0385,-0.0693,0.062,0.066,0.0598,0.0572,0.0302,0.0701,0.0226,-0.1326,0.0308,0.0829,0.0746,0.0469,0.0523,-0.0158,-0.1881,-0.1169,0.0267,-0.0318,-0.0871,-0.2846,-0.2357,-0.2301,-0.0689,-0.0533,0.0227,-0.0324,0.0055,-0.0229,0.06,-0.0394,0.0076,-0.0886,-0.014,-0.004,-0.0239,0.0445,0.0278,-0.0065,0.0281,-0.0686,-0.2054,0.0472,0.0278,0.0191,0.0455,0.0285,-0.0781,-0.0491,0.0757,0.0809,0.0923,0.02,-0.0792,-0.0107,0.0424,-0.0005,0.0479,0.0073,0.0079,-0.0346,-0.1381,-0.0115,0.0346,0.0573,0.0243,-0.0339,0.0043,0.0544,-0.0043,-0.0673,0.0137,0.0646,0.0216,0.0189,0.0349,0.0373,-0.0451,0.0457,0.0154,0.0667,0.0209,-0.0928,0.038,-0.0028,-0.0605,0.0118,-0.0591,-0.0127,-0.0088,0.0168,0.0255,-0.0327,-0.0263,0.0238,0.0521,0.0403,-0.0153,0.0599,0.0645,0.0101,0.0628,0.0267,0.0683,0.0261,-0.0901,-0.0353,0.0727,0.088,0.0334,-0.0661,0.0561,-0.0036,-0.0111,-0.0389,-0.029,-0.1103,0.1096,0.0961,0.044,-0.0364,0.0127,0.063,-0.0677,-0.0677,0.0635,0.0561,0.0306,0.0149,-0.0668,0.0136,0.0375,-0.2046,0.099,0.1018,0.0414,0.0343,0.0468,0.0525,0.0202,-0.0468,-0.034,0.0501,-0.014,-0.0032,-0.1707,-0.0168,0.0318,0.0091,0.0417,-0.0716,-0.0111,0.0028,0.0002,0.081,0.0497,0.0462,0.0388,0.0453,-0.0408,-0.029,0.0073,-0.2458,-0.2004,-0.1926,0.0255,-0.163,0.0632,0.0203,0.0077,0.0452,-0.044,0.0862,0.0208,0.0001,0.0591,0.0838,-0.0849,-0.0531,0.0721,-0.0127,-0.0447,0.0066,0.0192,0.0248,-0.0055,-0.0161,0.0625,-0.0398,-0.0095,-0.0281,-0.0721,-0.1556,-0.0928,-0.0348,-0.0649,0.0205,0.0114,0.0134,0.0135,0.076,0.0431,0.0652,-0.0137,-0.0373,-0.0193,0.0234,0.0392,0.0721,-0.0221,-0.0585,-0.0377,0.0065,0.0259,-0.0287,0.0224,0.0226,0.0728,0.1024,0.0634,0.0367,0.0613,0.062,0.0009,-0.0026,-0.0409,-0.053,-0.0267,0.031,0.0397,-0.0899,0.0383,0.029,-0.0262,-0.0697,-0.0815,0.0741,0.0278,-0.0522,0.0802,0.0391,0.0201,0.056,0.0641,-0.0006,-0.0894,-0.09,0.0765,-0.0109,0.0077,-0.0866,-0.1521,0.0011,-0.0087,-0.0368,-0.0532,-0.0949,0.0009,-0.0414,0.0486,0.0248,0.0869,0.0781,0.0698,-0.0222,-0.0013,0.0334,0.0905,0.0054,0.0641,0.0258,0.0569,0.0158,0.0451,0.0359,0.024,-0.0314,0.0379,0.0121,0.0504,0.0658,0.0271,0.0021,0.0378,-0.0029,-0.053,0.0034,-0.0203,0.0367,0.0381,-0.0231,-0.059,-0.0675,0.0915,0.1032,-0.0156,-0.1239,-0.2208,0.0138,0.0565,0.0359,-0.0086,-0.0185,0.0018,0.0336,0.0631,-0.0067,0.1011,-0.029,-0.0142,0.0077,0.017,0.0141,0.0071,0.0526,0.0883,-0.0025,0.02,0.0346,0.0569,-0.0408,0.0502,-0.0463,0.0272,0.0067,-0.0046,0.0169,-0.0138,0.052,0.0341,0.0427,0.0023,0.0339,0.0263,0.0292,-0.0817,-0.0759,-0.1255,-0.0974,0.0352,0.0088,0.0128,-0.013,-0.0272,0.0221,0.0074,0.0009,-0.0187,-0.0062,-0.009,0.0011,-0.0517,0.0103,0.0087,-0.0674,-0.0142,0.0245,0.0523,0.0102,0.0111,-0.0105,0.0687,0.0767,0.0642,-0.0048,-0.0102,0.0178,0.0135,-0.0135,-0.0111,-0.013,-0.0325,-0.0165,0.0557,-0.0851,-0.0114,-0.0002,0.0567,-0.0239,-0.006,0.0406,-0.0582,-0.1019,-0.0671,0.0424,0.0299,-0.0013,-0.0916,-0.0829,0.0946,0.0518,-0.0143,0.0451,-0.0126,-0.0132,0.0304,0.0278,-0.0202,0.022,-0.036,-0.0035,-0.1137,0.0767,-0.0791,0.0046,-0.0496,-0.0179,-0.0497,-0.2004,0.0613,0.0034,-0.033,-0.0263,-0.0425,-0.005,0.0336,0.071,0.0715,-0.0486,-0.0278,0.0678,0.0217,0.0816,0.0147,0.0948,0.0509,0.0756,-0.055,0.0718,-0.0259,0.0391,0.0711,0.0774,-0.0069,-0.021,0.0474,0.0564,-0.0321,-0.0102,0.0066,0.0465,0.0384,0.0257,0.0345,0.0649,-0.0182,0.0415,0.0065,-0.0449,-0.1069,-0.0473,0.0472,0.0201,-0.0088,0.001,-0.0119,0.0608,0.0906,0.0561,0.0601,-0.0318,-0.0055,-0.0604,-0.0022,-0.003,-0.0168,-0.0043,0.0009,-0.0283,0.0264,-0.0344,0.0083,-0.0414,-0.0237,-0.0446,-0.0311,-0.0211,-0.028,-0.0326,0.0429,0.0187,-0.011,-0.0088,0.0578,-0.0059,0.0241,0.0432,-0.0998,-0.155,0.0762,0.0305,0.0006,0.0233,-0.0661,-0.0364,-0.035,-0.0515,-0.0619,-0.0092,0.0225,0.0576,-0.0181,0.025,-0.0168,-0.0152,-0.0031,-0.0121,-0.0084,-0.0142,0.0047,-0.0657,0.0443,0.0658,0.0372,-0.1151,0.004,-0.1545,0.0161,0.031,-0.0533,-0.0565,-0.1309,-0.0439,-0.049,0.0024,0.0121,0.0728,-0.0584,0.0124,-0.0879,0.0605,0.0505,0.0519,0.0495,0.0266,-0.0025,-0.0111,-0.2079,0.0549,-0.0769,-0.0672,-0.1006,-0.0082,0.0118,-0.0297,-0.014,-0.0536,-0.0305,-0.0539,-0.0524,-0.0241,0.0948,0.0849,0.0765,0.0108,0.0667,0.0836,0.0431,0.0575,0.0267,0.0295,0.0667,0.0274,-0.039,0.0392,0.0451,-0.0919,-0.0398,-0.0026,-0.0538,-0.0138,0.0234,-0.0598,0.0582,0.0069,0.0544,0.0515,-0.0029,0.0626,0.1058,0.0338,0.0391,0.0161,0.1078,0.058,0.0774,0.0654,0.0253,-0.0524,-0.082,0.0797,0.0722,-0.0064,-0.0023,0.0546,0.0226,-0.028,0.0345,-0.0004,-0.0522,0.014,0.0278,0.0575,0.0121,-0.0275,0.0169,0.1322,0.0378,0.0416,0.0687,0.1338,0.0121,0.0579,-0.0923,0.0546,0.0053,-0.004,-0.018,0.0665,0.0296,0.0767,0.095,0.0385,-0.0386,0.0729,-0.0316,0.1302,0.0725,0.0131,-0.0282,0.0075,0.011,0.0226,-0.048,0.0699,0.0722,0.0793,-0.0459,0.052,0.0783,0.051,0.0083,0.0288,0.0513,0.0406,0.0434,0.0812,0.013,0.0569,0.0314,0.0159,0.037,0.0854,0.0656,0.0654,0.0084,-0.0038,-0.0032,0.0731,0.0702,-0.0026,0.0885,-0.0218,0.0949,0.0898,-0.001,-0.1258,-0.0726,0.0325,-0.0139,0.0271,-0.0792,-0.0195,-0.0527,0.0816,0.0907,-0.0447,-0.0508,-0.0069,-0.0365,0.0227,0.0047,0.0482,-0.0075,0.0382,0.0403,-0.0422,0.03,0.0471,0.0175,0.0603,-0.0162,-0.0438,0.015,-0.1254,-0.0827,-0.051,0.0529,0.0528,0.054,0.0367,0.1037,0.0742,-0.0685,0.0345,0.0512,-0.2663,-0.1572,-0.2466,-0.1876,-0.159,-0.1914,-0.0844,-0.112,-0.1001,-0.0476,-0.1401,-0.2025,-0.2723,-0.2711,-0.1229,0.1002,-0.1136,-0.0229,-0.1025,0.0308,0.0575,-0.0609,0.0214,-0.0087,-0.1113,-0.0785,0.0069,0.0245,-0.0993,-0.0643,-0.0638,-0.1305,0.0232,0.0029,-0.0448,0.0024,0.0345,-0.0057,0.0187,0.0224,-0.0425,0.0434,0.0234,-0.0064,-0.0188,0.1462,0.0544,0.0637,0.0931,0.083,0.0686,0.0534,0.027,0.0304,0.0387,-0.0344,-0.1069,-0.0168,0.0091,0.1056,-0.0679,-0.0007,-0.0166,-0.0024,0.0174,-0.0484,0.0346,0.0381,0.054,-0.0017,0.0412,-0.0202,-0.0257,-0.0569,-0.0969,-0.0502,-0.0543,0.0195,0.0403,0.0407,0.0886,0.0406,0.0398,0.0387,-0.0127,0.0173,0.0418,-0.0212,-0.0116,-0.0178,-0.029,-0.0523,0.0053,0.0219,0.0414,-0.0716,-0.0456,-0.0125,0.0738,0.0035,-0.0373,0.0181,-0.0006,0.0627,-0.0149,0.0061,-0.0755,0.015,0.0475,-0.0194,-0.0144,-0.0157,-0.0431,-0.0395,-0.005,0.0607,0.0131,-0.0023,-0.1302,-0.0107,-0.0218,0.019,-0.0586,0.0803,0.0788,0.0166,-0.0334,-0.012,-0.0423,0.0172,0.0216,-0.0123,0.0066,-0.032,-0.0223,-0.0301,0.0246,-0.0143,-0.0273,0.0011,-0.0419,-0.0191,0.0843,0.0388,-0.0032,0.0404,0.013,0.0122,0.0061,0.0001,-0.0524,-0.0068,0.0129,-0.0325,0.0081,-0.088,-0.0374,-0.0766,-0.0072,0.0266,0.0168,0.008,0.022,0.0494,-0.0323,0.051,0.0961,0.0896,-0.0715,-0.0353,-0.0037,-0.0048,0.005,-0.0274,-0.0728,0.0161,-0.0267,-0.0207,0.0757,0.1145,-0.1301,0.0444,0.0492,-0.0399,-0.0528,-0.108,-0.1192,-0.0101,-0.015,0.0086,-0.0021,-0.2197,-0.0121,-0.0129,0.0051,0.0468,0.0473,-0.0677,-0.0068,0.0315,0.0308,0.0417,0.0268,0.0405,0.0201,0.0394,-0.0396,-0.0167,-0.0378,-0.0286,-0.018,0.0195,-0.0774,-0.0791,-0.0049,-0.0692,0.0824,-0.0525,-0.0284,-0.055,-0.1255,-0.0226,0.0085,0.0008,-0.0044,-0.0873,-0.0219,-0.0184,-0.0075,-0.0447,-0.0374,-0.0177,0.0023,0.0167,-0.0279,-0.0365,-0.0153,-0.0055,-0.0038,-0.1132,-0.0437,0.0212,-0.0104,0.0933,0.0339,0.0062,0.0314,0.0984,-0.0458,-0.0095,0.0241,0.0254,-0.0637,-0.0835,0.0729,-0.0028,-0.0684,0.0758,-0.0342,-0.0184,-0.0612,-0.0177,-0.073,-0.0669,-0.1587,-0.0528,-0.0063,-0.0696,-0.1202,0.0447,0.0227,-0.0216,-0.006,0.0007,-0.0924,-0.0027,-0.0045,0.076,0.0824,0.1017,0.0511,0.042,-0.0082,-0.0013,0.1033,0.014,-0.0552,-0.0301,0.0079,-0.0176,-0.0034,-0.0594,0.0378,-0.0303,-0.032,0.0268,0.0884,-0.0174,-0.0081,0.0613,0.043,-0.0713,-0.0299,-0.0298,-0.0432,0.0394,0.0047,0.0105,0.0001,0.0115,0.0813,0.0146,0.0276,0.0356,-0.0595,0.0149,-0.0311,0.017,0.062,0.0853,0.0417,0.0569,0.0324,0.0207,0.074,0.019,-0.0482,0.0304,-0.0376,0.1149,0.0439,0.0208,0.1115,0.0745,0.0548,0.0016,0.0016,0.0464,-0.019,-0.0299,0.0536,0.0351,-0.0817,-0.0481,0.0248,0.0271,0.1353,-0.0323,0.0023,0.0153,0.0391,-0.0798,-0.0033,0.0246,0.0664,0.0105,-0.0366,-0.0202,0.0299,-0.062,-0.0928,-0.1216,-0.1531,-0.0636,0.0199,-0.0034,-0.1716,-0.1053,-0.0397,0.0979,0.1122,-0.0037,0.0823,0.0139,-0.0068,-0.0037,-0.0732,0.0111,0.0061,-0.0696,-0.0078,0.045,-0.0115,0.0168,0.1414,0.0376,0.1528,0.0129,0.0391,0.001,0.0491,-0.2713,-0.2871,-0.1071,-0.1343,-0.0192,-0.047,0.0104,0.0245,-0.0201,-0.0298,-0.0189,-0.0929,0.0342,-0.0396,0.0528,-0.0052,-0.0284,0.0644,-0.0002,0.008,0.0097,-0.2021,0.0019,-0.2187,-0.0909,-0.193,-0.0719,-0.0961,-0.1119,-0.0637,0.0189,0.0507,-0.0237,-0.0335,0.0322,0.0256,0.0794,0.0383,-0.0665,0.024,0.0708,0.0515,0.0121,0.004,0.0657,-0.0078,0.0633,0.0485,-0.0361,-0.0222,-0.0816,-0.0152,0.0098,-0.1128,-0.0268,0.0364,-0.0097,0.0345,-0.0327,-0.0417,-0.0565,0.0344,-0.0916,-0.0832,-0.072,0.0028,0.0239,-0.011,-0.0425,0.0383,0.007,0.0461,0.0394,-0.0408,0.0134,0.0155,0.0629,-0.0149,-0.04,-0.0002,0.0766,0.0633,0.0716,0.0811,-0.0118,-0.0159,-0.0026,0.0707,0.0409,0.0566,-0.0083,0.0342,0.0129,0.02,-0.0917,-0.0115,0.0438,0.0329,0.0268,0.0279,0.0337,0.0434,-0.0808,-0.0927,0.0519,0.0305,-0.0355,0.0002,-0.0128,0.0011,-0.0269,0.0106,-0.0229,0.0624,-0.0638,0.0221,0.0605,-0.1239,0.0681,-0.0867,-0.1355,-0.0456,-0.0494,-0.0421,0.021,0.0799,0.0645,0.0355,-0.0036,0.0166,-0.0327,0.019,0.0292,0.0396,0.0735,0.0489,0.0473,0.0438,0.0177,0.0119,0.061,0.0912,0.1019,0.045,0.0463,0.0536,0.0503,0.1291,0.005,-0.0248,-0.0616,-0.0519,0.0163,-0.0138,-0.0653,0.0083,0.0404,0.0132,0.0281,0.014,0.0272,0.0895,0.0269,-0.0095,0.044,0.0634,-0.0141,-0.0347,0.0103,0.0321,-0.0525,0.0262,0.0059,0.065,0.0598,-0.0453,0.0453,0.0468,0.1267,0.0415,-0.0596,-0.1379,0.0627,0.0168,0.0154,-0.0319,0.0302,0.0338,0.0198,0.0615,0.0726,0.0256,0.036,0.0214,-0.0342,-0.0088,-0.0101,-0.0144,-0.0393,0.0024,-0.0433,0.0104,0.0169,0.0246,-0.0249,0.0663,0.0137,0.052,0.0115,-0.142,0.0345,-0.0291,-0.0035,-0.0543,-0.0453,-0.1326,0.033,0.0424,0.0624,0.0084,0.0214,-0.1271,-0.0659,-0.0653,0.001,0.0462,-0.0325,-0.0403,-0.0453,-0.0414,-0.0444,0.1198,0.0323,-0.0011,-0.0555,0.0306,-0.018,-0.0694,-0.0603,0.023,-0.0138,-0.0149,0.0129,-0.0091,-0.0188,-0.0014,-0.0355,-0.0423,0.0096,0.019,-0.0132,-0.0209,0.0237,-0.0457,0.0072,0.0444,-0.1084,0.0093,-0.0101,0.0538,0.0221,0.0348,0.0065,-0.0188,0.0742,0.0895,-0.11,-0.0194,-0.1,0.0146,-0.0035,0.1206,0.1061,0.0741,0.0873,0.026,-0.0261,-0.0019,0.0473,-0.0386,-0.0356,0.0684,-0.011,0.0346,0.0605,-0.1619,0.061,0.0261,0.1212,0.0589,0.0079,-0.0932,0.0042,0.0194,0.0399,-0.0633,0.0448,-0.0228,0.0592,-0.0212,0.0233,0.0144,-0.0013,-0.0293,-0.1279,-0.1328,-0.1419,0.0677,0.0837,0.0567,0.0376,0.0746,0.0173,-0.0154,0.0747,0.0425,0.0055,0.0909,0.0036,0.0427,-0.028,-0.0097,-0.0027,0.0245,0.0525,0.1241,0.0385,-0.0814,0.0038,0.0689,0.0809,-0.0678,0.0269,-0.0409,-0.0074,-0.0145,-0.1249,-0.0986,0.0506,0.0396,0.0244,0.0135,-0.0246,-0.0499,0.0243,0.0298,-0.0043,-0.0589,0.0098,-0.0408,0.0275,-0.0324,0.0713,0.086,0.0518,0.0762,0.0305,0.05,0.066,0.0224,0.0009,-0.0069,-0.004,0.0342,0.03,0.1006,-0.2253,-0.2306,-0.1316,-0.0398,0.031,-0.1338,0.0786,0.0699,0.0482,-0.0214,-0.0686,-0.0994,-0.0173,-0.0229,-0.1714,-0.091,-0.2108,-0.0504,0.0087,0.0439,0.0112,-0.0862,-0.0266,-0.0016,-0.0409,0.0538,0.0511,-0.0191,-0.0323,-0.0242,0.0203,0.0516,0.0457,0.0537,0.0208,-0.0152,0.0256,-0.0435,-0.0626,-0.035,-0.0329,-0.0274,-0.0096,-0.0372,0.0095,-0.0514,-0.0369,-0.0524,-0.0755,-0.0125,-0.0165,-0.0258,-0.1185,-0.0765,-0.0606,-0.0362,-0.0717,-0.0895,-0.0228,0.0691,-0.0084,-0.0177,0.0481,0.0049,-0.0321,-0.1027,-0.0517,0.0527,-0.0032,0.0139,-0.1544,0.0295,0.0502,0.0128,-0.0696,-0.0254,-0.086,-0.0866,-0.0929,-0.0313,-0.0396,-0.0945,0.0682,0.0907,0.0105,-0.029,-0.0759,-0.0525,-0.0419,-0.0118,0.0471,0.0089,-0.0336,-0.218,-0.0246,-0.0101,0.036,0.062,0.1221,0.0662,0.0791,0.0404,0.0586,0.0317,0.0178,0.0647,-0.1445,-0.1208,-0.1051,0.042,-0.0243,-0.005,0.0351,0.0239,0.006,-0.0133,-0.0693,-0.0602,-0.0737,-0.0276,-0.0221,-0.0227,-0.0469,0.0058,0.0093,0.0306,0.0421,-0.0371,-0.0045,0.0609,0.0764,-0.0376,-0.0231,0.0019,0.0224,0.003,0.0053,-0.03,-0.0227,-0.0496,0.0239,-0.055,0.0492,-0.075,-0.1049,-0.032,0.0602,0.0601,-0.0192,-0.053,0.0275,0.0126,0.0988,0.0916,0.0143,0.0475,-0.0797,0.024,0.0764,-0.0177,-0.0212,-0.0976,-0.0973,-0.0638,-0.0061,-0.0523,-0.088,0.0211,-0.0421,0.0677,0.065,-0.0157,0.0894,0.0674,0.0092,0.0189,-0.0857,-0.0749,-0.0215,0.0698,0.0504,0.003,0.0453,0.0761,-0.1249,0.03,-0.0082,0.0308,0.0308,0.033,0.0468,0.0217,0.0431,0.0164,0.0806,0.0269,0.0128,-0.0265,-0.014,0.015,-0.0308,-0.072,-0.0092,0.0515,-0.0853,0.0672,-0.0172,0.0747,0.0733,0.0423,-0.008,0.0131,0.0012,-0.0433,0.0627,0.0206,0.0415,-0.0571,-0.0022,-0.0366,0.0013,-0.0317,0.0833,0.1128,0.0075,-0.0471,0.0347,0.0484,0.0471,-0.0423,0.0096,0.0018,-0.0556,-0.0747,-0.0472,-0.0131,-0.022,-0.0198,-0.0668,0.0148,-0.1326,-0.0518,-0.1274,-0.0079,-0.2183,-0.2071,0.0005,0.0111,-0.0084,-0.0014,-0.0159,-0.089,-0.0854,-0.0572,-0.0009,0.0065,0.0273,-0.0606,0.0006,-0.0019,0.0601,0.0604,0.0862,-0.0299,0.0202,0.053,0.0358,0.022,-0.0563,-0.0197,0.026,0.05,-0.1313,-0.0253,0.037,-0.25,-0.091,-0.0418,0.027,-0.0594,-0.0657,-0.1243,-0.0139,0.002,-0.0174,0.0218,0.0126,-0.0604,0.0113,-0.0139,0.0135,0.0345,0.0072,-0.109,-0.0589,0.0436,0.0012,0.0167,0.0535,0.0641,0.0594,0.0477,-0.0182,0.0237,0.002,0.0961,0.052,-0.0128,0.0806,0.0581,0.0244,-0.0298,0.0202,0.0404,0.0456,0.0549,0.0547,0.0073,0.0501,0.0693,0.0557,0.0249,0.0076,-0.0039,-0.0295,0.0671,-0.0139,-0.0384,0.0214,0.0007,-0.0247,0.0611,0.0229,0.1145,0.1043,0.0147,0.0183,0.0463,0.1044,-0.0456,0.007,0.0325,0.051,0.0412,0.0549,-0.026,-0.0521,-0.0563,0.0045,-0.0379,-0.0127,-0.0635,-0.0349,-0.2076,0.0392,-0.1018,0.0924,0.017,0.0084,-0.0363,-0.0413,0.0048,-0.049,-0.0369,-0.0393,-0.0077,-0.1008,0.0903,0.0374,-0.073,0.0007,0.028,0.0411,-0.0145,-0.0039,-0.0767,-0.0987,0.0934,0.0727,-0.0799,-0.1026,-0.0041,-0.1505,-0.0029,0.0351,0.0486,0.0772,0.0213,0.0567,0.0616,0.0437,0.0285,0.024,0.0194,0.0284,0.0123,-0.0334,0.0277,-0.0228,-0.0055,0.0081,0.0423,0.0166,0.0236,0.0039,-0.0279,0.0068,0.0452,0.0482,-0.0046,0.0032,0.0218,0.0551,0.0306,-0.0137,0.0581,0.0185,0.0565,-0.0112,0.0104,0.029,-0.0659,-0.0068,0.0192,-0.0054,0.0379,0.0108,0.0112,0.0489,0.0212,0.0644,-0.069,-0.0066,-0.1413,0.0446,-0.0234,0.0583,0.0617,-0.0862,-0.0024,-0.0602,-0.0684,0.0537,0.0624,-0.0711,0.0436,-0.0034,0.0155,-0.0621,-0.1224,0.0765,0.0033,0.0134,-0.0034,-0.0442,0.0924,0.044,-0.0183,-0.0572,-0.0069,0.0042,0.0188,0.073,0.0542,-0.0235,-0.0564,-0.0311,0.0281,-0.0155,0.0174,0.0795,0.0432,-0.0143,0.0616,0.027,0.0586,-0.2305,0.0765,0.0168,0.0317,0.0429,0.1014,0.0897,-0.0304,-0.0224,0.0058,-0.0822,-0.0124,-0.1581,0.0241,0.0434,-0.1256,-0.0522,-0.0245,0.0124,0.018,0.0294,0.0149,0.0183,0.0332,-0.0372,-0.1064,-0.0418,-0.0417,-0.1009,-0.0295,-0.0281,-0.1084,-0.1217,-0.0898,-0.0428,-0.0036,-0.0033,-0.0656,-0.0665,0.0249,-0.1856,-0.0219,-0.1008,-0.1535,-0.0446,0.0628,0.0406,0.0877,-0.0471,0.0321,0.0594,0.0633,0.0218,-0.1363,-0.0915,0.1051,0.1033,0.0606,-0.0394,0.057,0.091,-0.017,0.018,0.0314,-0.0095,0.0239,0.0043,0.0125,0.0214,0.0276,-0.0399,0.09,0.0763,-0.0637,0.0163,0.0025,-0.0002,-0.006,0.0406,0.0047,0.0164,0.0622,0.0458,0.0328,0.0773,0.0126,0.0455,0.0444,-0.0238,-0.0248,0.033,0.0542,0.0052,0.0568,0.0189,0.0144,-0.0154,-0.0361,0.0004,0.0415,-0.0321,-0.0079,0.022,-0.0445,decision under uncertainty
trm_55b6b96e77df6,0.0181,0.0161,0.0174,0.0353,0.0031,-0.001,0.0227,-0.0096,-0.0205,0.0004,0.0078,0.0164,0.0232,0.0162,0.0111,0.0158,0.0141,0.0382,0.0081,0.0306,0.0059,0.0009,-0.0048,-0.0029,0.0032,0.0006,-0.0006,0.0241,0.0051,0.0053,0.0087,0.0226,-0.0173,0.0056,0.0235,0.0263,0.0102,0.0054,0.0341,0.0172,-0.001,0.0208,0.014,0.0167,0.0034,0.0108,0.025,0.0016,0.0038,0.0093,0.0211,0.0131,0.0028,0.0237,0.0227,-0.0054,0.0045,0.0125,0.0179,0.0204,-0.0031,0.022,0.0183,-0.0031,-0.0221,-0.0343,0.0461,0.0548,0.0155,-0.0008,-0.008,-0.0294,-0.0103,-0.0041,0.0254,0.005,0.0138,0.0025,-0.011,-0.0076,-0.0037,0.0088,0.0092,0.0128,0.0216,0.0004,-0.0494,0.0191,0.037,-0.0591,-0.0027,-0.0141,0.0303,-0.0686,-0.0464,-0.0417,-0.0059,-0.0213,-0.0146,-0.0477,-0.0129,-0.0199,0.0008,-0.0255,-0.0324,0.032,0.0296,-0.0183,0.0088,-0.0133,0.0092,0.0255,0.007,-0.0146,-0.0072,-0.0014,0.0107,-0.0071,0.0315,0.0289,0.0339,0.019,0.0352,0.0286,-0.0021,0.0313,0.0343,-0.006,-0.003,0.0052,0.0118,0.0107,0.0216,0.0062,-0.0127,0.0406,-0.0078,0.0249,0.0076,-0.0124,0.0202,0.0157,-0.0219,0.0153,0.0253,0.0085,-0.0123,0.0237,0.0018,-0.0044,0.0142,0.0255,0.0251,0.0283,-0.0175,-0.0111,0.0066,-0.0054,0.0328,0.0036,-0.0063,0.0165,0.0483,0.0343,-0.0124,0.0071,-0.0018,0.0418,0.0416,-0.0124,0.0214,0.0318,-0.0107,0.0171,0.0164,0.0147,0.0162,0.0292,-0.004,0.0115,0.0052,-0.0021,0.0086,0.0116,0.0045,0.008,-0.0124,-0.0078,-0.01,0.0117,0.0078,-0.0004,-0.0161,0.0526,0.0501,0.0229,0.0361,0.0146,-0.0031,-0.039,0.0219,-0.0104,0.0224,0.0097,0.0299,-0.0421,-0.007,-0.0028,0.0173,0.0094,0.0318,0.0103,-0.022,0.0013,0.0028,0.0021,0.016,0.0435,-0.0035,0.0177,-0.0048,0.0267,0.0356,-0.0028,-0.0049,-0.0264,0.036,-0.0237,-0.0048,0.0298,-0.0158,0.0126,0.0148,0.0259,0.0241,-0.0298,0.0068,0.0183,-0.0186,-0.0092,-0.0086,-0.0015,-0.001,-0.0131,-0.0099,0.0026,0.0166,0.0215,-0.0199,0.0524,0.0108,0.01,-0.0105,-0.0289,-0.0261,0.0258,0.0183,0.0003,-0.0311,-0.028,-0.0481,-0.0555,-0.0066,0.0051,0.0132,-0.0433,-0.0,0.0127,0.0032,0.0035,0.0074,-0.0096,0.0074,0.0089,-0.0608,-0.0785,-0.0645,-0.0217,-0.0484,-0.0253,-0.0842,0.0118,0.0143,0.0204,0.0189,-0.0116,-0.0214,-0.0256,0.0049,-0.0068,0.0206,0.0245,0.0159,0.0182,0.0071,0.0031,0.0202,0.0069,0.0035,-0.0107,0.0087,0.0496,-0.0085,-0.0165,-0.0072,-0.0067,0.0227,-0.0091,-0.0216,-0.0043,-0.0382,-0.0104,-0.0029,0.0225,0.0274,0.0043,0.0033,0.0177,-0.0016,0.036,-0.0105,0.0212,0.0063,0.0097,0.0239,0.0275,0.0038,-0.007,0.0086,-0.0001,0.0414,0.0342,0.0189,0.022,0.0145,-0.0158,-0.0314,0.0283,-0.0663,0.0251,0.0165,0.0313,-0.0201,-0.0177,0.0207,-0.0072,0.0271,0.0349,0.0158,-0.0047,0.0039,-0.0237,-0.004,-0.0212,-0.0056,0.0116,0.0383,0.018,-0.0069,-0.0001,-0.0078,0.0189,-0.0144,0.0315,0.0086,-0.005,-0.0245,0.0021,-0.0117,0.0245,0.014,-0.0151,0.0023,0.0073,0.021,-0.0318,0.0011,0.0023,0.0,-0.0015,0.0148,-0.0526,0.0126,0.0104,0.0005,-0.0084,0.0054,0.0073,0.0071,0.0108,0.0186,0.0149,-0.015,-0.0145,-0.0013,-0.0161,-0.0027,0.0433,-0.0003,-0.0046,0.0252,-0.0003,-0.0104,0.0071,0.0085,-0.0086,0.0265,0.0124,0.0184,0.0047,-0.0243,0.0079,0.0106,-0.0019,0.0201,0.0172,0.0156,0.0358,0.0368,0.0185,0.0064,0.0192,0.0207,0.0373,0.0372,0.0105,0.0235,0.0014,-0.0033,-0.014,0.0206,-0.0135,-0.0258,-0.0138,0.0399,0.0136,-0.0143,-0.041,0.0406,0.015,-0.0435,-0.043,0.0025,-0.0061,0.0088,0.0047,-0.0091,-0.0107,0.0321,0.0155,0.0213,-0.0098,0.0139,-0.0149,-0.0065,0.0342,0.0105,0.0131,0.0128,0.0176,0.0155,0.0002,-0.0315,-0.0008,0.0292,0.005,0.0059,0.0183,0.0143,-0.0065,-0.0223,0.0268,-0.0269,0.0063,-0.0586,0.0161,-0.028,-0.0232,0.0037,0.0351,-0.0073,0.0108,-0.022,0.0023,0.0269,0.0196,-0.0253,0.0073,0.0211,0.0111,0.0023,-0.037,0.0096,0.0139,0.0014,-0.0109,-0.0093,0.0145,0.0009,0.0565,0.0508,-0.0003,0.0049,0.0227,0.0042,0.0348,0.0216,0.0036,0.016,-0.0239,0.0186,-0.0085,0.0141,0.0198,0.0013,0.0108,0.0243,0.0286,-0.0203,0.0032,-0.0177,-0.0038,0.0029,0.0247,0.0049,0.0348,-0.0142,-0.0344,-0.0211,0.0031,-0.0298,0.0004,-0.028,0.0112,0.0137,-0.0275,0.0271,-0.004,0.0349,0.0013,0.0015,-0.0012,-0.0251,0.0369,0.0309,-0.0164,0.0274,0.0146,-0.0097,0.0174,-0.001,0.0191,-0.029,-0.044,-0.0161,0.0016,-0.0156,-0.0276,0.021,-0.0155,0.0241,0.0087,0.0193,0.0198,-0.0102,-0.0163,0.0135,0.0002,-0.0244,-0.0021,-0.0176,0.0198,-0.0156,-0.0267,-0.0233,-0.043,-0.0425,-0.0122,0.0079,-0.0193,-0.0089,0.0302,0.0125,-0.0037,-0.0196,0.0028,-0.0282,-0.0292,-0.0148,0.0097,0.005,-0.0251,0.0148,-0.016,-0.0017,-0.0033,0.0332,0.011,0.0063,0.0182,0.023,-0.0398,0.0092,-0.0462,0.0073,-0.0179,-0.0211,0.0268,0.0245,0.0314,0.024,-0.01,-0.0127,0.0263,0.0458,0.0253,0.0344,0.02,0.0226,0.0395,-0.0019,0.0093,0.0012,0.0176,0.0101,-0.0375,0.0179,0.0295,0.0003,-0.0018,0.007,-0.0174,0.0179,0.0234,0.0293,0.0002,0.0044,-0.0049,0.0146,-0.0207,0.0086,0.0036,0.002,-0.0297,0.0329,0.0014,0.0328,0.018,-0.004,0.0363,0.0269,-0.0081,-0.0033,0.0179,-0.0116,-0.0084,-0.0598,0.0123,0.0143,0.0052,0.0287,-0.0468,-0.0207,-0.029,-0.0587,-0.0087,-0.0184,0.0215,-0.0188,-0.0171,0.0111,0.0104,0.0064,-0.0124,0.0011,0.0066,-0.0681,0.029,0.006,0.0129,0.0289,0.0113,-0.0139,0.0186,-0.0182,0.0202,0.0208,0.0107,0.0246,-0.0206,0.0056,-0.04,-0.0081,-0.0402,0.0161,0.0356,0.0113,0.0152,0.0032,0.0138,-0.0138,-0.024,-0.0142,-0.0137,0.0319,-0.0038,0.0183,0.0087,0.0225,-0.0058,-0.0155,0.05,0.0526,0.0032,0.0502,0.0283,0.0163,-0.0223,0.0223,-0.0354,-0.0253,0.0122,0.0223,0.0208,0.0156,-0.0028,-0.0199,0.0066,-0.0064,-0.0159,0.0281,0.0109,0.0141,-0.0037,-0.0076,-0.0121,0.0053,0.0142,0.0103,0.0065,0.0311,-0.0029,0.0171,0.0106,0.0034,0.0208,-0.0084,-0.0073,0.0156,0.0037,-0.0023,-0.0234,0.0378,0.0575,0.058,0.0481,-0.0241,0.0122,0.0263,-0.0208,-0.0007,0.008,0.0047,-0.0021,0.0028,0.0107,0.0164,0.0048,-0.0113,-0.0215,-0.0309,-0.0049,0.0049,-0.0013,0.0126,0.0259,-0.001,0.0046,0.0174,0.0198,0.0178,0.0353,0.0095,0.0288,0.0359,0.0159,0.0049,0.0095,0.0033,0.0051,0.0032,0.0109,0.0079,-0.0071,-0.0275,0.0194,0.0116,0.0235,0.0067,0.0399,0.0369,0.031,0.0032,-0.0002,0.0291,0.0029,-0.0054,-0.0068,-0.0061,-0.0481,-0.0328,-0.0052,-0.0286,0.0226,-0.0067,0.0218,0.0083,0.0076,0.0055,0.0063,-0.0091,0.0352,0.0378,-0.0158,0.0273,-0.0138,0.0357,0.0102,0.0403,0.0195,0.036,0.0078,0.0177,0.0051,0.0173,0.0016,0.0168,0.0,-0.0401,-0.0069,-0.0137,0.0282,0.0192,0.0097,-0.0071,0.0092,-0.0088,0.0099,-0.0064,-0.0171,-0.0196,0.0117,-0.0034,0.0196,-0.0156,0.0198,0.0327,0.0217,0.0089,-0.0046,-0.018,-0.0014,0.0055,0.0139,-0.0411,-0.0488,0.0038,0.0081,0.0007,0.0187,0.0244,0.0091,-0.0311,0.0243,-0.0203,0.0175,0.0205,0.0165,0.0017,0.0019,0.0233,-0.0144,0.0422,0.0425,0.0116,-0.0102,0.0209,0.0315,0.011,0.0303,-0.0032,-0.0087,-0.049,-0.0094,-0.0383,-0.0096,0.0213,0.0147,-0.0076,0.0044,0.0051,-0.0108,0.0337,0.0179,0.0161,-0.0262,0.0017,0.0299,0.0158,0.0003,0.0186,0.0084,0.0196,0.0054,-0.0195,0.0198,0.0294,0.0157,0.0105,-0.0212,0.008,0.0039,0.0316,0.0211,-0.0156,-0.0105,0.0025,-0.015,0.0139,0.0053,-0.0023,-0.0342,-0.0211,-0.0114,-0.0011,-0.0186,-0.0176,0.0196,-0.0089,0.0248,0.0242,0.0198,0.0216,0.0144,0.0079,-0.0,-0.0148,0.0001,0.0139,-0.0038,0.0202,0.015,-0.0152,-0.0265,-0.005,-0.0166,-0.0191,-0.0064,0.0007,0.0084,-0.0158,-0.0168,0.0425,0.0414,0.0229,-0.0014,0.0006,-0.039,-0.023,-0.0245,0.0036,-0.0203,-0.0142,-0.0035,0.004,0.0053,-0.0017,-0.0018,-0.0163,-0.0331,-0.0023,0.0017,0.0151,0.0177,0.0018,0.0407,0.0278,-0.0082,-0.0458,-0.0214,-0.0178,-0.0049,0.008,-0.0029,0.0033,-0.0073,-0.0322,-0.037,0.0045,-0.0007,0.0093,0.0014,0.0166,-0.0062,-0.0047,0.0134,-0.0168,0.0308,0.0168,0.0037,0.0004,0.0011,0.0014,-0.0079,0.004,-0.0051,-0.0048,-0.0086,0.0046,-0.0091,-0.0077,0.0058,-0.002,-0.0457,-0.0099,0.0155,0.0183,0.0078,0.022,-0.0171,-0.0021,-0.0019,-0.0211,-0.058,0.0182,0.0146,0.0044,0.0127,-0.0075,0.0029,0.0167,0.0242,-0.0051,0.0005,-0.0288,-0.0096,0.0116,0.0029,0.0108,0.0091,-0.0088,-0.0012,-0.0009,0.0078,-0.003,-0.0136,0.0205,0.0014,0.017,-0.0321,-0.0042,0.0022,-0.0118,0.0026,-0.016,0.019,-0.013,-0.0111,0.0059,0.0037,-0.0102,-0.0043,0.0154,-0.0064,-0.0228,-0.0338,0.0001,-0.0003,-0.0125,-0.0216,-0.0124,-0.0225,0.0046,-0.0281,0.001,-0.0033,0.0178,-0.0085,-0.0002,0.023,0.0103,0.023,-0.0965,-0.0534,-0.0942,-0.0561,-0.0962,-0.0289,0.0509,-0.0152,0.0039,-0.0027,-0.0248,0.0084,-0.0419,-0.0472,-0.0439,0.0155,0.0169,-0.0191,-0.0365,-0.0143,0.0202,-0.0127,-0.014,0.0082,-0.0292,0.0047,0.0034,0.0216,0.0395,0.0198,-0.0142,0.0151,0.0049,-0.0017,-0.0087,0.0174,0.024,0.0072,0.0054,0.0105,0.0196,0.0029,-0.0136,0.0138,0.0016,-0.0005,0.0024,-0.0042,0.0106,-0.0054,-0.0708,0.0231,0.0095,-0.0309,-0.0248,-0.018,-0.0268,-0.029,0.0129,0.0101,-0.0152,-0.0298,0.0246,0.0395,-0.0065,0.0263,-0.0361,-0.019,0.0149,-0.0024,0.0324,-0.0129,0.0126,0.0333,-0.0135,-0.0099,0.0008,0.0024,-0.0156,0.0057,-0.015,-0.0052,-0.0185,0.0564,0.0521,0.0104,0.0011,-0.0134,0.016,0.0311,-0.0092,0.0155,-0.0369,-0.0143,-0.0385,-0.0839,-0.0208,-0.0309,0.0058,0.0097,-0.0282,-0.0062,-0.0202,0.0022,-0.01,-0.0126,-0.0117,0.0004,-0.0146,0.0184,0.0044,-0.028,0.0366,0.0332,0.0315,0.0051,-0.0147,0.0033,-0.0093,-0.043,-0.0129,-0.0194,-0.0008,-0.0013,-0.0112,0.0245,0.0003,-0.0156,0.0089,-0.0014,-0.0023,-0.0076,0.0037,0.0352,0.012,0.0249,0.0449,0.0108,-0.0118,-0.0067,-0.0414,0.0331,0.0395,0.0094,0.0141,0.0383,0.0141,0.0201,-0.0089,-0.0152,-0.0462,0.0415,0.0318,0.0239,-0.0634,-0.0106,0.0046,0.0033,0.0033,0.0216,0.0295,0.0024,0.0184,0.0076,0.0072,0.005,-0.0232,0.0206,0.0283,0.0046,-0.0129,0.0398,0.0425,0.0125,0.0004,0.0202,0.0243,0.0035,-0.0028,-0.0428,-0.0302,-0.0322,-0.0003,-0.0142,-0.0006,-0.036,-0.0155,-0.0007,0.0022,-0.0052,0.0094,-0.0128,0.0053,-0.0534,-0.0219,-0.0084,-0.0306,-0.0427,-0.0346,-0.0055,-0.016,-0.0007,-0.0014,0.0074,0.0185,-0.0235,0.018,0.0283,0.0024,0.0231,0.0273,-0.0075,0.0204,0.0247,0.0281,-0.0149,0.0078,-0.0054,-0.0207,0.0225,-0.0028,-0.0016,-0.0171,0.028,0.0284,-0.0348,-0.0305,-0.0343,0.0183,0.009,0.0191,-0.0404,-0.0353,0.0142,0.0223,-0.0027,0.0482,0.0198,0.02,0.0096,0.013,0.027,0.0295,0.0171,-0.0218,-0.0077,0.0133,0.0203,0.0074,0.0241,-0.0224,0.0375,0.0369,0.0391,0.009,0.0297,0.024,0.0229,0.0234,-0.0289,-0.0364,-0.0268,0.0064,0.0052,-0.0416,0.0266,0.032,0.005,0.0043,-0.0387,0.0223,0.0028,-0.0322,-0.007,-0.004,-0.0094,0.0106,0.0007,-0.031,-0.021,-0.0144,0.0325,0.0022,-0.004,-0.0035,-0.0483,0.0397,-0.021,-0.0287,0.002,-0.0021,0.0164,-0.018,0.0339,0.0138,-0.0001,0.0209,0.0205,0.0087,-0.0002,0.0161,0.0181,0.0095,0.0018,-0.0115,0.0053,0.004,-0.0006,0.0269,0.0175,0.0103,0.0133,-0.0006,0.0174,0.0333,0.0096,-0.0008,0.0151,-0.0145,-0.0146,-0.0321,-0.0256,0.0081,0.0198,0.0224,-0.0132,-0.0136,0.0005,0.0088,-0.0096,0.0044,-0.0024,0.0115,0.025,0.0059,-0.0212,-0.0391,-0.0327,-0.008,0.018,0.0136,0.0279,-0.0017,0.0084,-0.0025,0.0039,0.0201,0.007,0.0075,-0.0011,-0.0477,-0.0393,-0.0314,-0.0478,-0.0319,0.0234,0.0027,0.006,0.0075,0.0143,0.0211,-0.0238,-0.0178,0.0014,-0.0345,-0.0278,-0.0223,0.0005,-0.0077,-0.0116,-0.0302,-0.0538,-0.0541,0.0126,0.0197,0.0157,-0.0158,-0.01,0.0018,-0.0133,-0.0236,-0.0253,-0.0016,-0.0019,0.0155,-0.0311,-0.0276,0.0079,-0.0419,-0.0352,0.0234,0.0136,-0.011,0.0145,0.0046,-0.0125,-0.0193,-0.0268,0.0063,-0.0111,-0.0097,0.0176,-0.0036,-0.0018,0.0016,0.0163,0.017,0.0114,-0.0112,0.0131,0.0132,-0.0046,-0.0349,0.005,0.0132,-0.0422,-0.0074,-0.0248,0.0172,0.0181,-0.0077,-0.0266,-0.0206,0.012,0.0113,-0.0067,-0.0022,0.0273,0.0008,0.0209,0.0024,0.0203,0.028,-0.0037,0.0086,-0.0381,0.0189,-0.0165,-0.0023,-0.0037,-0.0342,-0.0087,-0.0113,0.0038,-0.0029,-0.0627,-0.0037,-0.0195,-0.0084,0.003,0.0334,0.0359,0.0025,-0.0154,0.0094,-0.0011,0.0204,0.0154,0.0226,-0.0577,-0.0544,-0.0466,0.0245,0.0212,0.0159,0.0188,-0.0035,-0.0028,-0.0084,0.0177,0.0023,0.0011,-0.0115,-0.0403,-0.0078,-0.0373,-0.0111,0.0079,0.0112,-0.0091,0.0113,-0.0118,0.0086,-0.0452,-0.0146,0.0193,0.0298,-0.0085,0.0203,0.022,0.0287,0.0205,0.028,-0.0037,-0.0348,-0.0482,-0.0311,0.0244,0.029,0.017,-0.0001,0.0023,0.0276,0.0307,-0.0013,0.0095,0.0056,0.0071,-0.0512,-0.0139,0.0142,0.0037,0.0091,0.019,0.0356,-0.0153,0.0003,-0.0071,-0.0045,-0.0066,-0.0201,-0.0002,0.0007,0.0343,0.039,0.0279,0.0213,0.0221,0.0195,-0.0051,0.0195,0.0175,-0.0245,0.0043,0.0105,0.0312,0.0073,-0.0086,-0.0276,-0.0187,-0.0465,0.0007,0.0005,0.0019,0.0073,0.0196,0.0252,0.0356,-0.0167,-0.0244,-0.005,0.027,-0.0055,-0.0293,-0.0248,-0.0249,-0.0186,-0.0021,0.016,0.0213,0.0229,-0.0268,0.0332,-0.0103,0.0242,0.0384,0.0287,0.0367,0.0087,-0.0139,0.0195,-0.0336,0.0181,0.0001,0.003,-0.0265,-0.0051,0.022,0.0031,-0.0051,-0.0384,0.0019,-0.0083,-0.0103,-0.0205,0.0444,0.033,0.0478,0.0114,0.0146,0.0565,0.0006,-0.0118,-0.0012,-0.02,0.0201,0.0089,0.0061,0.0122,0.0131,-0.0405,-0.0157,0.0234,-0.0018,-0.0103,-0.0005,-0.0083,0.021,0.0195,0.0088,0.0153,0.0127,-0.0031,0.0097,0.0208,-0.0007,0.0049,0.0467,0.0162,0.032,0.0285,0.0178,0.0133,-0.0115,0.0152,0.0432,0.0142,0.0078,0.0039,-0.0471,-0.0042,0.0176,0.0254,0.0158,0.025,-0.0215,0.012,0.0181,0.023,0.0193,0.0414,0.0181,0.015,0.0238,0.0305,-0.0473,0.0285,0.0122,-0.0186,0.0098,-0.0139,0.0172,0.022,-0.0069,0.026,0.0485,0.0221,-0.0007,0.0313,0.0149,0.0301,0.0383,0.0192,0.0049,0.0078,-0.0077,-0.0145,-0.0402,-0.0032,-0.0004,-0.0064,0.0288,0.02,0.0275,0.039,0.0204,0.0217,-0.0112,0.0092,0.0043,0.0439,0.0031,0.0055,0.029,-0.0121,-0.0003,-0.0222,0.0216,-0.0248,-0.0093,-0.0068,-0.0077,-0.0164,0.0368,0.0159,0.0221,-0.0113,-0.0029,-0.0078,-0.0016,-0.0244,-0.0313,0.0094,0.0116,0.0101,-0.0234,-0.0335,-0.0691,0.017,0.0224,0.0019,-0.0133,0.0112,-0.0258,-0.0059,0.0075,0.0141,-0.0105,0.0043,0.0016,-0.0081,0.0195,0.0208,0.0111,0.0113,-0.0282,-0.0056,0.0076,-0.0165,-0.0056,-0.0046,0.0388,-0.0148,0.0067,0.0001,0.0455,0.0235,-0.0636,0.0291,0.0264,-0.0613,-0.0305,-0.0362,-0.0535,-0.0344,-0.0353,-0.0583,0.0047,-0.0242,-0.0191,-0.0638,-0.038,-0.0552,-0.0704,-0.0712,0.0334,-0.0176,-0.0079,-0.0258,-0.0055,0.0316,-0.0047,-0.0428,0.0058,-0.0076,-0.0373,0.0067,-0.023,-0.0216,-0.0404,-0.0345,-0.0354,0.0145,0.0091,-0.0189,-0.0268,-0.0279,-0.0181,-0.0408,0.0164,-0.0174,0.005,0.0089,0.0166,0.0034,0.0491,0.007,0.0078,0.0215,0.0225,0.0286,0.053,0.0408,0.0106,0.0052,0.0081,0.0084,-0.0494,0.0051,0.019,-0.0215,-0.0223,-0.0329,0.0274,-0.0008,-0.0343,0.0433,0.0253,0.0288,0.0294,0.029,0.0272,-0.0068,-0.0285,0.0254,-0.0068,-0.0072,0.02,0.0213,0.0067,0.0156,0.0167,-0.0017,0.0204,0.0177,-0.0003,0.0188,0.0017,-0.0213,-0.015,-0.0173,-0.0006,-0.0225,0.0474,0.0153,0.0277,0.0206,0.0019,0.0083,0.0177,-0.004,0.0001,0.014,0.0134,-0.0128,0.016,-0.0058,0.0161,0.0132,-0.0083,-0.0053,-0.0138,0.0115,0.0037,0.0143,0.0269,0.0003,0.0094,-0.0417,-0.0066,-0.0385,-0.0152,-0.0458,0.0537,0.0534,0.014,0.0213,0.002,0.0057,-0.0308,0.0214,0.0192,-0.0214,0.0028,-0.0007,-0.0218,0.0093,-0.0305,0.0013,-0.0127,-0.0122,-0.0174,0.0272,0.0155,0.0095,0.0298,0.0292,0.0229,-0.0085,-0.014,0.0049,-0.0097,0.0124,0.0103,0.0088,-0.0178,-0.018,-0.035,0.011,0.0192,-0.0021,0.0135,0.0138,0.0196,-0.014,0.0151,0.0475,0.0447,-0.0084,-0.0226,0.0007,0.0213,0.0086,-0.0594,-0.0104,0.0258,0.0103,0.0022,0.0009,0.0284,-0.0399,0.0063,0.0296,0.0001,0.0015,-0.033,-0.0476,0.0182,0.0151,-0.0038,-0.0077,-0.0423,0.01,0.0047,0.0125,0.0235,0.0276,0.0033,0.0417,0.0027,-0.0176,0.0395,0.023,0.028,0.0256,0.0052,0.0173,0.0238,-0.012,-0.0006,-0.0122,0.0181,-0.0162,-0.0033,0.0047,-0.0197,-0.0211,-0.0036,0.027,-0.0227,-0.0362,-0.0008,0.0217,0.0017,-0.0229,-0.0008,0.0074,-0.0197,-0.0221,-0.0217,-0.018,0.035,0.0041,-0.0024,-0.0152,0.0038,-0.0192,0.011,0.0172,-0.0135,-0.0169,-0.0042,-0.0287,0.0375,0.0172,0.0184,0.009,0.045,-0.0166,0.0025,0.0024,-0.0149,-0.0474,-0.0204,0.0331,-0.0066,-0.0171,-0.0184,-0.0115,-0.0375,-0.0151,-0.0253,-0.0519,-0.012,-0.0353,0.0025,0.0254,0.0052,-0.034,0.0285,-0.0119,-0.0009,0.0195,-0.0033,-0.0246,-0.0514,0.001,0.0051,0.0229,0.0207,0.0242,-0.0132,0.012,0.0239,0.0391,0.0236,-0.0067,0.0114,-0.0299,0.0022,-0.0195,-0.0186,0.0187,-0.0161,0.0179,0.0187,0.0284,-0.0293,0.0158,0.0405,0.0233,-0.0337,-0.0684,-0.0706,-0.0117,0.0137,0.0068,-0.0094,0.0039,-0.0042,0.0094,-0.0011,0.0003,0.0347,-0.0145,-0.0244,-0.0094,0.0099,0.0205,0.0315,0.0031,0.027,0.0259,0.0181,0.0253,0.0242,-0.0504,0.0003,-0.0111,0.0433,0.0358,-0.0111,0.0463,0.0522,0.026,0.0251,0.0251,0.0221,0.005,-0.0085,0.0301,0.0105,-0.0067,-0.0049,-0.0423,0.0079,0.0375,-0.0169,-0.0079,-0.0001,-0.0359,-0.0043,-0.1496,-0.0441,0.0206,0.0165,-0.0078,-0.001,0.0123,-0.0026,-0.0114,-0.0511,-0.0711,-0.053,0.0041,-0.0116,-0.0604,-0.0328,-0.0119,0.0242,0.0024,0.0282,0.0172,0.021,0.0072,0.0027,-0.0323,-0.0261,0.035,-0.0058,-0.001,0.0199,-0.0,0.0063,0.0492,0.0247,0.0453,0.0257,0.0039,0.0113,0.008,-0.0633,-0.0717,-0.0293,-0.0434,-0.0258,0.0032,0.0011,0.0045,-0.0258,-0.0231,-0.0022,-0.0101,0.0186,-0.004,-0.0085,-0.0133,-0.0088,0.0207,-0.0049,-0.0149,-0.0102,-0.024,-0.0078,-0.0398,-0.0158,-0.0112,-0.0494,-0.0036,0.0188,0.0054,0.0236,0.0182,0.0162,-0.0033,0.0156,0.0049,0.0112,-0.0161,-0.0114,0.0015,0.0301,0.0353,0.0192,0.0073,0.0163,0.0011,0.0111,0.0021,0.0,-0.0008,-0.0302,-0.0135,-0.0102,-0.0568,-0.0011,-0.0086,0.0171,0.0193,0.0037,0.0274,-0.021,0.0028,-0.0284,-0.0363,0.0057,0.0081,0.0024,-0.0119,0.0018,0.0099,0.0057,-0.0203,-0.0063,-0.0314,0.0039,-0.0084,0.0217,-0.005,-0.0324,-0.1406,0.036,0.0291,0.014,0.0157,-0.0088,-0.003,-0.0143,-0.0033,-0.0076,0.0234,0.0012,0.0239,-0.0085,0.0273,-0.0156,0.0004,0.0202,0.0182,-0.0011,0.0211,-0.0017,-0.0553,-0.0198,-0.0437,0.0165,-0.0005,0.0031,0.0302,0.0057,-0.0218,0.0024,-0.0076,0.0145,0.002,0.0054,0.0225,0.0167,0.007,0.0155,0.0056,-0.006,0.0116,0.0113,0.0019,-0.001,0.0156,-0.0132,-0.0139,-0.0152,0.017,-0.0092,0.0019,0.0091,0.0029,0.0335,0.0175,0.0059,0.0417,-0.0095,0.0283,0.038,0.0334,0.0399,0.0112,-0.0211,-0.0031,0.0009,0.023,-0.0124,-0.0186,-0.0114,0.0032,-0.0384,-0.0565,-0.0124,-0.0232,0.0271,0.0247,0.0152,0.0294,0.0342,0.0235,0.0142,-0.0078,0.017,0.0256,-0.0117,-0.004,-0.0046,-0.0048,-0.0281,0.0281,0.0333,0.0258,0.0279,-0.036,-0.0016,-0.0199,0.0236,0.0099,-0.0203,-0.0176,0.0246,0.0087,0.003,0.0082,0.0129,0.0231,0.0355,0.0119,0.0118,-0.0016,0.0038,-0.0052,-0.0227,-0.0137,-0.0022,-0.0007,-0.0008,-0.0096,0.0174,0.0136,0.0026,0.0,-0.0302,0.0311,0.0334,0.0301,-0.0033,-0.0269,0.0036,-0.0023,0.0254,-0.0183,-0.0313,-0.0424,0.0016,0.0173,0.0178,0.0132,0.0092,-0.0432,-0.0156,-0.0075,-0.0117,-0.0036,-0.0235,0.0039,-0.0006,-0.0197,0.0157,0.0263,0.016,0.0024,-0.0146,0.0264,-0.0266,0.003,-0.0486,-0.0117,0.013,-0.0117,0.0266,0.0149,-0.01,0.016,-0.001,0.0267,0.003,0.0404,-0.0171,-0.013,-0.0104,-0.0212,0.0008,-0.0403,-0.0168,0.0063,0.0185,-0.0046,-0.007,-0.0155,-0.0025,0.0139,0.0378,0.0386,0.0067,-0.0085,-0.0211,0.0286,0.0074,0.0321,0.017,0.0271,0.0238,-0.0112,-0.0087,-0.0274,-0.011,0.0046,-0.0214,0.0345,0.0091,0.0249,0.0205,-0.0582,0.0163,0.0069,0.0601,0.0422,-0.0171,0.0021,-0.005,-0.0017,-0.0136,-0.0087,0.0173,0.0076,0.0286,-0.0104,0.0218,0.0117,0.0017,0.0055,-0.0316,-0.0639,-0.0686,0.0163,0.0131,0.0297,-0.0023,0.0211,0.0067,-0.0292,0.0352,0.0116,0.0051,0.033,0.0144,0.0039,0.0183,-0.0063,0.0361,0.031,0.0252,0.0184,0.0148,0.0097,0.0386,0.0344,-0.0104,0.0135,0.0155,-0.0053,0.0161,0.0061,-0.01,-0.0005,0.0202,0.0093,0.0019,0.0055,0.002,0.01,0.0119,0.0193,0.0134,0.0103,-0.0132,-0.0347,-0.011,0.0018,0.0213,0.0267,0.0172,0.0109,0.0197,-0.0023,0.0219,0.004,-0.0276,-0.0011,-0.005,-0.0144,-0.0088,-0.0158,-0.0353,-0.0276,-0.0429,0.0357,-0.0075,-0.0284,-0.0071,0.0009,-0.0259,-0.044,-0.0417,0.0211,-0.0062,0.0013,-0.0239,-0.0307,-0.0388,-0.0066,0.0204,0.0273,-0.0084,-0.0127,-0.0348,-0.0178,0.0087,-0.0143,0.0191,-0.0162,-0.0021,0.0103,0.0039,0.0162,0.0077,0.0249,0.0087,0.0461,0.0128,0.0007,-0.0092,0.0021,0.0081,0.0126,-0.0155,-0.0464,-0.0247,-0.074,-0.0364,-0.0069,0.002,-0.0432,0.008,0.0262,0.0067,-0.0344,-0.0246,-0.0355,-0.002,0.0001,-0.0052,-0.0548,0.0155,-0.014,0.0153,0.0227,-0.0108,-0.0125,-0.0324,0.0422,0.0105,-0.0116,-0.0209,0.0022,0.0257,-0.0338,-0.0161,-0.003,0.0155,-0.0119,0.0054,-0.0054,-0.0002,-0.0241,-0.0029,0.0016,0.0109,0.0265,-0.0122,-0.0203,0.012,0.0051,0.0292,-0.0022,0.0085,-0.0843,-0.0098,0.0036,0.0168,0.0178,-0.0104,0.0053,-0.0192,0.0005,-0.0087,0.0191,0.0059,0.0308,-0.0001,-0.0004,-0.0067,0.0143,-0.0476,-0.039,0.0116,0.0021,0.0072,0.0144,-0.0416,-0.0051,-0.0737,-0.0063,-0.0114,-0.0275,-0.0009,-0.0409,-0.0132,0.0068,-0.0246,-0.0241,0.0008,0.0135,-0.0384,-0.0126,-0.0143,-0.0101,0.0081,0.0014,0.0101,-0.0563,-0.0521,-0.0521,-0.0166,0.0129,0.0265,-0.0159,-0.0135,-0.043,0.0136,0.0083,0.016,-0.011,-0.0062,0.0079,0.0282,0.038,0.0176,0.0166,-0.0624,0.009,0.0235,-0.0047,-0.0594,-0.0337,-0.0276,-0.0022,-0.0249,-0.0439,-0.0507,-0.0526,-0.0018,-0.0405,-0.0542,-0.0062,0.0076,0.0246,0.0206,0.0047,-0.0269,-0.0034,0.0012,0.0293,0.0229,0.0102,0.0297,0.0065,-0.0264,-0.0105,0.011,-0.0041,0.0207,0.0279,0.0299,0.0181,0.039,-0.0057,0.0375,-0.0025,0.0027,-0.1113,-0.001,0.0078,-0.0159,-0.0304,-0.0073,0.0488,0.0127,0.0306,-0.0037,0.0291,0.0213,-0.0028,-0.0155,0.0079,0.0048,-0.0118,0.0218,-0.0004,0.0038,-0.0126,-0.0099,-0.0255,-0.0146,-0.0219,0.0086,0.033,-0.0007,-0.0506,0.0216,0.012,0.0102,-0.013,-0.0092,0.0099,-0.0412,-0.0965,-0.0143,-0.133,-0.1131,0.0146,-0.0926,-0.0148,-0.0195,-0.0486,-0.011,-0.0954,-0.076,-0.0751,-0.009,-0.0188,-0.0138,-0.0158,-0.0143,-0.0352,-0.0332,0.0048,-0.0374,0.0057,0.0327,-0.0106,-0.0124,-0.0105,0.0124,0.0085,0.0336,-0.0063,0.0342,-0.0123,0.0152,-0.0146,-0.0149,-0.014,0.0288,0.0292,-0.0151,0.0066,0.0312,-0.0404,-0.0342,-0.0207,-0.0048,-0.0164,0.0072,-0.0027,0.0056,0.0047,0.015,-0.0035,-0.0152,0.025,-0.0004,-0.0037,0.0088,-0.0072,0.0149,-0.0225,0.0114,0.0132,0.0052,-0.0219,-0.0541,-0.0242,0.0024,-0.0038,-0.0557,-0.034,-0.0041,0.0149,0.0176,-0.0155,-0.0053,0.0119,-0.1212,-0.0706,-0.0154,-0.0385,-0.0267,-0.0407,-0.0483,0.0019,-0.0002,0.0419,0.0357,0.014,0.0077,0.0012,0.0064,0.0337,0.0189,0.0042,0.0241,0.021,0.0153,0.0079,-0.0324,-0.0098,-0.0112,0.0239,0.0133,0.0267,-0.0036,-0.0051,0.0058,0.025,0.0096,0.0127,-0.0106,0.0114,0.0062,-0.0148,-0.0113,-0.0076,0.0178,-0.0005,-0.0005,-0.0526,0.0227,-0.0209,-0.006,0.0284,0.0076,-0.0372,-0.0268,0.0112,0.001,0.0211,0.01,0.0178,0.0047,-0.0572,-0.0172,-0.0275,0.0106,0.0034,0.0388,-0.0214,0.0211,-0.0133,-0.0205,0.0229,0.0196,-0.0172,-0.027,0.0186,-0.0353,-0.0102,0.0098,0.0222,0.0201,-0.0036,0.032,0.0508,0.0414,0.0046,-0.0058,0.0135,-0.0112,-0.0278,-0.0207,-0.0109,-0.0174,0.0244,0.0155,-0.0211,0.0036,-0.0039,-0.0171,0.0366,0.0008,0.0275,0.0044,-0.0214,-0.0137,0.0132,-0.0239,0.0358,0.0052,0.0032,0.018,0.011,0.029,-0.0326,0.0264,0.0143,-0.0311,-0.0026,0.0153,0.0068,0.0032,-0.0173,0.032,0.0274,0.0101,-0.0246,-0.0213,-0.0112,0.0161,-0.0076,0.0078,0.0241,-0.0012,0.0087,-0.0034,-0.0122,0.0394,0.0258,-0.0278,0.04,0.0102,-0.0152,-0.0054,-0.0257,0.0201,-0.0444,0.0308,-0.0162,0.0025,0.0408,0.0448,0.0095,-0.0006,0.0281,-0.0152,-0.0187,0.0079,0.0109,-0.0167,-0.0047,-0.0045,-0.0104,0.0052,0.024,0.0235,0.0093,0.0103,0.0446,0.0177,0.0266,-0.076,0.0259,0.0095,-0.0053,0.0013,0.023,0.0188,-0.0373,-0.0161,-0.0103,-0.0113,-0.0595,-0.0036,0.0023,0.0266,0.0087,-0.0361,-0.0369,-0.0565,0.0211,0.0051,-0.019,-0.0099,0.0121,-0.0006,-0.0168,-0.0115,-0.0535,0.005,0.0154,0.0158,0.0063,-0.014,-0.0211,0.0004,0.0055,-0.0177,-0.0255,-0.0117,-0.0012,-0.0554,0.0009,-0.0144,0.0059,-0.0054,0.0323,0.0008,0.0368,-0.0589,-0.0437,0.0472,0.0261,0.0219,-0.0395,-0.0022,0.0496,0.0409,0.0295,-0.0086,0.0069,0.0497,-0.0329,-0.0069,0.0054,0.0048,0.0186,0.0059,0.0045,0.0227,0.0419,-0.0005,0.0477,0.0493,0.0077,-0.027,-0.0077,0.0203,0.0195,0.0197,0.0206,0.0053,0.0035,-0.0081,0.0037,0.0227,0.0137,-0.0055,-0.0136,0.0082,0.008,-0.0083,0.0354,-0.0059,0.015,0.015,0.034,-0.0031,-0.0115,0.0321,0.0223,0.0077,0.0131,0.0125,-0.0129,left toe response execution
trm_557b49851e991,0.0794,0.1118,0.1386,0.1332,0.0246,0.0379,0.1027,0.0771,0.054,0.0746,0.026,0.0334,0.1223,0.0575,0.102,0.0364,0.0523,0.1324,0.0958,0.0682,0.0781,0.0335,0.0489,0.0004,0.0105,-0.017,-0.0132,0.104,0.1098,0.0458,0.0829,0.1231,0.0999,0.0751,0.123,0.0849,0.0385,0.075,0.1164,0.0456,0.0997,0.0629,0.0557,-0.0307,0.0762,0.0584,-0.1194,0.0679,-0.0177,0.0908,0.0074,-0.0652,-0.0333,0.0193,0.0273,0.0522,0.0604,0.0547,0.0088,0.022,-0.0388,-0.0086,0.093,-0.053,-0.059,-0.097,0.18,0.2266,0.1251,0.0064,-0.0236,-0.0402,-0.1553,0.0835,0.1136,-0.0643,0.111,-0.0127,-0.0321,0.0244,-0.0049,-0.0162,0.0398,0.1451,-0.0495,-0.094,-0.01,0.0049,0.0302,0.0858,0.0746,0.0346,0.0444,-0.2117,-0.1887,-0.1855,-0.1504,-0.0465,-0.1946,-0.1361,-0.0958,-0.0179,-0.0534,-0.0759,-0.1305,0.1716,0.1235,-0.1149,-0.0146,0.0364,0.0218,0.1334,-0.0544,-0.1255,-0.0302,-0.0214,0.0989,-0.0416,0.0859,0.1143,0.0743,0.1157,0.1088,0.0149,0.0781,0.1046,0.0618,-0.064,-0.0605,-0.0242,0.0636,0.0848,-0.0113,0.1612,0.0233,0.1634,0.033,0.1104,0.0032,0.0142,0.1131,0.1045,-0.0892,0.0075,0.0213,-0.0484,0.107,-0.0184,0.0691,-0.0256,0.0933,0.0706,0.13,0.135,-0.1274,-0.013,-0.0464,-0.0301,0.0024,0.0682,0.0607,0.0579,0.186,0.1904,0.0136,-0.0085,0.0396,0.1362,0.1314,-0.0053,0.0518,0.1029,-0.048,0.1653,0.1074,0.1449,0.0684,0.1175,0.0562,0.0228,0.0824,-0.0398,0.0633,-0.0105,0.0757,0.065,0.0663,0.05,0.0751,0.0099,-0.0016,0.0742,-0.0264,0.1844,0.1738,0.1732,0.1825,-0.0167,0.0281,0.0405,0.0085,-0.1782,0.084,0.0999,0.0212,0.0187,0.0827,0.029,0.0741,0.0272,0.1541,0.0675,0.0099,0.0112,-0.038,-0.0354,-0.0977,0.1299,0.0864,-0.0458,-0.0682,0.0592,0.1251,0.0084,-0.0304,-0.0174,0.0523,-0.1251,0.003,-0.0715,0.03,0.0923,-0.1327,0.1033,0.0943,-0.0528,-0.0141,-0.0499,-0.0631,0.002,-0.0314,0.1283,0.0494,-0.0258,0.0566,0.0616,0.0549,0.1283,0.0088,0.0955,-0.0124,-0.0011,-0.0435,-0.0435,-0.0078,0.155,0.0001,0.0642,-0.1255,-0.1953,-0.1111,-0.2492,0.0893,-0.0771,-0.1479,-0.2471,-0.0933,0.0289,-0.026,-0.0311,0.0764,0.0371,0.0469,0.0013,-0.0179,-0.1161,0.0111,0.0808,0.0779,-0.0371,-0.1176,0.0024,-0.0069,0.1076,0.0802,0.0376,-0.0702,-0.0787,0.0875,0.066,0.1223,0.07,0.0103,0.0682,0.0776,-0.019,0.0002,-0.061,0.0352,-0.0919,-0.1081,0.1692,0.0923,0.0828,0.0521,0.0448,0.1326,0.002,-0.0069,0.0349,-0.0249,0.0173,0.1122,-0.0142,-0.0043,0.0474,-0.0817,-0.0125,-0.0315,0.1228,-0.0022,-0.0012,0.0474,0.06,0.1011,0.0626,-0.0114,-0.0002,0.0608,0.0848,-0.0098,0.1115,0.0249,-0.0394,-0.0192,-0.0596,-0.0449,0.0492,-0.0781,0.1408,0.1381,0.0292,-0.0439,0.0206,-0.0345,-0.0442,0.2419,0.1718,0.1447,0.1208,0.0468,-0.0765,0.0656,0.041,0.0443,0.0536,0.0805,0.1303,0.1332,0.0657,-0.0092,0.0086,-0.0195,0.0286,0.0212,-0.078,0.0923,-0.1238,-0.0652,0.1383,-0.0125,-0.0965,-0.0315,-0.1117,0.1259,0.0008,0.0675,-0.0832,-0.1623,-0.1145,-0.1823,-0.0131,0.0986,-0.0074,0.0056,-0.0047,0.0506,0.008,0.0057,0.0044,0.0522,0.053,0.0384,0.0177,-0.0342,0.0182,0.0695,0.1651,0.106,0.0554,0.0872,-0.0086,-0.0465,0.0562,-0.0487,-0.0651,-0.0763,-0.0342,0.1168,0.0338,-0.0577,0.1572,0.0147,-0.188,0.0934,0.0311,-0.1447,0.0733,0.1348,0.0615,-0.0435,0.1992,0.117,0.2499,0.2297,0.109,0.1151,0.0707,0.1449,0.0841,0.0233,-0.0575,-0.0114,0.0145,0.027,-0.0335,-0.0543,-0.0468,0.2207,0.1217,-0.0996,-0.0681,-0.0445,-0.0388,0.0351,0.0754,-0.0582,-0.0911,0.0605,0.0412,0.021,-0.0496,0.1018,0.0553,0.0204,0.1115,-0.0197,0.0608,0.0267,-0.0074,-0.0518,0.0389,0.0175,-0.049,0.1,0.0393,-0.033,-0.2265,0.1574,0.0398,-0.0219,-0.043,-0.1162,0.021,0.0005,0.0831,-0.0544,-0.0586,0.0352,0.0621,-0.0571,0.0214,0.0316,-0.0556,-0.0639,-0.0877,-0.0085,-0.0007,0.0863,0.0405,-0.107,-0.1143,0.0691,0.1051,-0.0951,-0.0309,-0.0013,0.0526,-0.046,0.1163,0.093,0.0009,0.0691,0.0946,0.0991,0.139,-0.0332,-0.0343,0.0405,-0.0751,0.1452,-0.0255,-0.0121,0.0101,-0.0724,-0.0816,0.1282,0.134,-0.0915,0.0378,0.0578,0.031,-0.0357,-0.0552,-0.1061,0.0122,-0.1378,-0.1184,-0.0668,-0.0645,0.0588,0.0315,0.0669,0.1619,0.077,-0.0592,0.1173,0.055,0.0451,0.096,0.0503,-0.0517,-0.0187,0.0452,0.0668,-0.0361,0.0055,0.0108,-0.0545,-0.0121,-0.0651,0.0143,-0.0118,-0.0118,-0.0128,0.0862,-0.0699,-0.0378,-0.0811,0.0281,0.0372,-0.0066,0.0148,-0.0473,0.0419,-0.0525,-0.0398,-0.0034,-0.0156,0.0511,0.0304,-0.0154,0.0733,-0.0521,0.0001,-0.0049,-0.0764,-0.0622,-0.0774,-0.0577,-0.0283,0.0735,0.018,0.036,-0.0673,-0.0208,0.0046,-0.0216,-0.0358,0.0919,0.0619,-0.0227,-0.0722,-0.0632,0.01,0.0185,0.2289,0.0468,-0.1175,0.0445,0.0056,-0.0803,-0.0383,-0.1041,-0.0255,-0.0447,-0.0073,0.1382,0.1383,-0.0095,0.1906,0.0663,-0.0402,0.0898,0.2246,0.0552,0.0521,-0.0323,0.0105,0.1908,0.0881,0.1451,-0.0198,0.0258,0.0082,-0.0285,0.0809,0.1406,0.0478,-0.0006,-0.0333,-0.024,0.0606,0.0469,0.043,-0.0271,-0.0484,0.0394,0.0758,0.0299,0.0528,-0.049,-0.0085,0.0337,0.052,-0.0202,0.1426,0.1579,-0.0886,0.1351,0.0226,0.0743,-0.0972,0.0386,0.0306,-0.0265,-0.0528,0.0741,0.0391,0.0413,0.1267,-0.0357,-0.1108,0.0169,-0.1392,-0.0891,0.0798,0.1023,0.0183,0.0573,0.0472,0.0816,0.0365,0.0183,0.0463,0.0891,-0.1703,0.0587,-0.0137,0.0395,-0.0568,-0.0287,-0.0652,-0.0415,-0.1559,0.0801,0.1094,-0.0598,0.008,-0.0253,-0.0126,-0.1229,-0.1195,-0.112,-0.1082,0.0469,-0.0462,0.0532,0.1013,0.0503,-0.0249,-0.0186,0.0291,0.05,0.1044,0.0431,0.0813,0.0498,0.0329,-0.0382,-0.0979,0.034,0.1017,-0.0618,0.041,0.0202,0.0468,-0.0599,0.1042,-0.0628,-0.0826,0.0755,0.1717,0.1833,0.0793,0.0258,0.0181,0.0948,0.0014,0.0292,-0.0113,0.0295,0.0393,-0.0358,-0.0794,-0.0354,0.101,-0.0774,-0.0918,-0.1495,0.1446,0.0257,0.0636,-0.0028,-0.009,0.1157,-0.0977,-0.0988,0.023,-0.0046,0.0145,-0.0901,0.1656,0.2285,0.1936,0.1401,-0.0495,-0.1245,0.0055,0.0893,-0.0041,-0.0079,-0.0525,-0.0719,-0.0522,-0.0001,0.0528,0.0806,0.0301,-0.1067,-0.0773,-0.1259,0.0197,0.0401,-0.0406,0.0811,-0.0635,0.0492,0.0836,0.0314,0.1306,0.1368,0.0864,-0.0414,-0.0256,0.0184,0.0239,0.0929,-0.0021,-0.1178,0.0427,0.0864,-0.0593,-0.0338,-0.0559,-0.0047,-0.0748,0.0378,-0.1079,0.185,0.1794,-0.0056,-0.0436,-0.1143,0.0242,0.0172,-0.0708,-0.0183,-0.0383,-0.2301,-0.0247,-0.1114,-0.0726,-0.1216,-0.0389,0.0203,-0.1403,-0.1069,0.0848,-0.0045,-0.048,0.1867,0.1084,0.0738,0.1137,0.002,0.2353,0.0937,0.1339,0.0742,0.1422,-0.0097,-0.0019,-0.042,0.0596,0.0473,0.004,-0.0176,-0.0984,-0.033,-0.0699,-0.0513,-0.0162,-0.0536,-0.0381,-0.0056,-0.0872,-0.0916,0.0474,-0.1331,-0.0697,0.0036,0.0528,0.1015,0.0326,-0.0485,0.038,0.1645,0.081,0.0156,-0.0597,-0.1147,-0.0487,-0.0033,-0.052,-0.0376,0.0889,0.1369,-0.0642,0.0643,-0.0287,0.0916,-0.0837,0.0615,-0.1317,-0.0237,0.0027,-0.0301,0.0967,0.0779,0.1003,-0.1789,0.1131,0.1346,0.0837,-0.0796,0.0398,0.1861,0.0502,0.1391,-0.0513,0.0427,-0.0376,-0.0216,-0.044,-0.0936,0.152,0.0781,0.0667,-0.0459,0.0856,-0.0303,-0.0585,-0.0008,-0.05,-0.2573,-0.0746,0.105,0.088,0.0676,0.0944,0.0963,0.0591,-0.0232,-0.1002,-0.0234,0.0164,0.0859,-0.0989,-0.1351,-0.0477,-0.0129,0.0361,0.0355,0.1175,0.0378,0.0489,-0.0281,-0.0605,0.094,0.0298,-0.1108,-0.0399,0.0552,0.0075,-0.0881,0.0112,0.0326,0.0317,0.1553,0.1521,0.1799,0.0785,0.1706,0.0364,-0.0024,0.0458,0.0757,0.0725,0.108,0.0897,0.1505,0.0357,-0.0102,-0.0172,-0.0693,-0.0771,0.0097,-0.0448,0.0121,-0.0495,-0.0833,-0.0631,-0.1148,-0.0517,0.0404,-0.0013,-0.0265,-0.0294,-0.1215,-0.0947,-0.1108,-0.0303,-0.0522,-0.0089,-0.087,0.0375,0.0372,0.0392,-0.1531,-0.0155,-0.0609,0.1059,0.0907,0.03,0.0549,0.05,-0.0157,-0.092,-0.0013,-0.0662,-0.0932,-0.0898,0.003,-0.0172,0.0186,-0.0353,-0.0613,0.0025,0.0206,0.0576,0.105,0.0533,-0.0442,-0.0277,0.0749,0.0689,0.0693,0.1426,0.0784,-0.1406,-0.0385,-0.0953,-0.0431,-0.0438,0.0047,-0.0065,-0.0535,0.0163,0.013,0.0215,-0.0015,0.0327,0.0122,-0.0072,-0.0384,0.0701,0.0039,0.0738,-0.0562,0.1233,0.0107,-0.0478,-0.1431,-0.0133,-0.044,-0.0124,0.0165,0.0527,0.0225,0.0282,0.0984,0.0053,-0.0124,-0.0879,0.0158,0.0368,-0.0113,0.022,0.027,0.0107,0.0375,0.1345,0.0678,0.0469,-0.1408,0.0167,-0.0276,0.0957,-0.1858,-0.0835,-0.0132,0.0346,0.0221,-0.0899,-0.0039,-0.0719,0.0748,0.1376,-0.004,0.0198,0.0731,0.0238,0.0673,-0.0118,-0.0064,0.0529,0.0495,0.0565,-0.0182,-0.0085,-0.0274,-0.0168,-0.0743,0.0869,-0.006,0.0682,-0.0422,0.0415,0.081,-0.2899,-0.2231,-0.2556,-0.1283,-0.1814,-0.0746,-0.2464,-0.1675,0.181,-0.165,-0.1486,-0.0838,-0.0744,-0.1001,0.0111,-0.01,-0.0018,0.0412,-0.0178,-0.0383,-0.0484,-0.062,0.0601,-0.0513,-0.0721,0.0038,-0.0744,0.0218,0.0302,-0.1074,-0.0448,0.063,0.0063,0.0899,-0.0433,-0.0016,-0.1393,0.0498,0.1257,0.1033,0.0656,0.0309,-0.0854,-0.0965,0.0393,0.0458,0.115,0.1114,0.072,-0.1574,0.1269,-0.1312,-0.1816,0.0694,-0.0809,0.0184,-0.0437,-0.1032,-0.0419,-0.1453,-0.0406,0.0496,-0.0682,-0.0476,0.0881,0.1202,-0.066,0.0967,-0.0298,-0.009,0.0709,0.0401,0.1496,0.0436,0.0494,0.0955,0.0834,0.016,-0.1552,0.0396,0.0036,0.0583,-0.0977,-0.0364,-0.0432,0.1773,0.1816,0.0094,0.0573,0.0126,0.1056,0.0649,0.0621,0.0226,-0.1447,-0.0485,-0.0842,-0.182,-0.0338,-0.0481,0.027,-0.0514,-0.0123,-0.1374,0.0646,-0.1273,-0.2111,-0.0303,0.0683,-0.1452,-0.1238,0.0712,0.1088,-0.0512,0.183,0.0514,0.1763,0.0671,-0.078,0.0308,0.0406,-0.0312,0.0276,-0.0309,0.0753,0.0445,0.0405,0.045,0.0688,-0.111,-0.0207,-0.2441,-0.1367,-0.2064,-0.213,0.1058,0.0462,0.1078,0.1196,0.0818,0.0253,0.0449,-0.1799,0.1297,0.0977,-0.0834,-0.0403,0.0583,-0.062,-0.0207,0.0074,0.0294,-0.1219,0.1089,0.102,0.0177,-0.1624,-0.0279,-0.0254,0.0638,0.0638,0.175,-0.052,-0.0385,-0.0076,0.0344,-0.0206,0.0297,-0.1994,0.2307,0.2299,-0.0969,0.032,0.2026,0.2096,0.1862,0.028,0.042,0.0486,0.0177,-0.0123,-0.1101,-0.0608,-0.1254,0.0085,-0.09,0.0126,-0.0705,-0.0569,0.0392,0.0258,-0.0023,0.0283,-0.0144,0.0214,-0.0316,-0.0475,-0.0313,-0.0827,-0.0256,-0.0728,0.0173,-0.1187,0.1009,0.0935,0.0047,0.1303,0.0152,0.1476,0.2644,0.0433,0.0864,0.2002,0.0225,0.0753,0.1311,0.0285,0.0535,-0.0019,0.0825,0.0193,0.0993,0.1279,0.0604,-0.0545,0.0626,-0.1449,-0.13,-0.0387,-0.1157,-0.0354,-0.0689,-0.0113,0.0923,0.0954,0.0429,0.0553,0.0253,0.131,0.0312,-0.0616,-0.0187,0.0228,0.1645,0.0743,0.0662,-0.0109,0.0189,0.0247,0.0722,-0.058,0.0483,0.0653,0.0437,0.1175,0.1182,0.0299,0.1477,0.1513,0.0069,0.0055,-0.0266,-0.0309,-0.0228,0.115,0.0877,-0.0399,0.156,-0.0003,0.0084,0.0261,0.0923,0.1129,0.0026,-0.1131,-0.055,-0.0387,-0.0049,-0.0016,-0.1018,-0.0633,-0.0161,-0.0051,0.17,-0.0655,-0.0333,-0.0696,-0.1335,-0.0628,-0.0289,0.0137,-0.0142,-0.1296,0.077,-0.0661,0.1133,0.0303,0.0828,0.0713,0.0388,-0.0544,-0.0001,0.0666,0.0915,0.018,-0.0247,0.0039,0.0443,0.1416,0.0253,-0.0024,0.0353,-0.0137,0.0668,0.0543,0.0636,0.104,0.0873,0.0767,0.0497,0.0297,-0.0181,-0.0509,-0.0865,0.0504,0.0338,0.0344,0.0039,0.0162,0.0007,0.1112,-0.0586,0.0883,0.016,-0.0132,-0.0551,-0.0352,-0.032,-0.0582,0.0628,0.011,0.0683,0.0304,0.1373,0.0384,0.1182,0.0226,0.0178,0.0864,0.0025,0.0243,0.0359,-0.1519,-0.119,0.0006,-0.1839,-0.0878,-0.0195,-0.0184,-0.1208,0.0204,0.0617,-0.0261,-0.2336,-0.0074,-0.0046,0.0212,0.0637,0.0121,0.0439,-0.0215,0.002,0.0352,-0.0687,-0.1091,0.0089,0.0532,-0.0012,-0.072,-0.0824,-0.0546,0.1505,0.0853,0.0096,0.1408,0.1183,-0.0421,-0.1035,-0.0465,-0.0316,-0.0714,-0.0349,0.1672,0.0666,0.0109,0.0834,0.1577,0.0058,0.0017,-0.0079,0.0747,-0.1117,0.0166,0.0102,0.0202,-0.0367,-0.0942,-0.1269,0.0474,-0.0777,-0.0213,0.0512,0.0737,0.0342,-0.0682,-0.0037,0.0284,-0.1209,-0.0523,-0.0419,0.102,0.1021,-0.0357,-0.2825,-0.2727,0.1065,0.0949,-0.0497,0.0658,0.0818,0.0583,0.1246,-0.0376,0.0114,0.0565,0.013,0.0015,-0.1684,0.073,-0.1014,-0.069,0.0219,-0.0931,-0.2225,0.0589,0.066,-0.224,-0.0856,-0.0364,-0.0609,-0.0655,0.033,-0.0626,-0.0237,0.0277,-0.0142,-0.0484,-0.0388,-0.0873,-0.0464,-0.0128,-0.0918,-0.043,-0.1325,0.1009,-0.0242,-0.1081,0.0492,-0.0079,-0.0149,-0.0301,0.1,0.02,-0.0652,0.0383,-0.0815,0.0354,-0.1087,-0.094,0.0113,0.0102,-0.0587,-0.034,0.0247,-0.0861,-0.0913,-0.0498,0.011,-0.1092,-0.0373,-0.0506,-0.2978,0.138,0.0723,0.006,0.0501,-0.0332,-0.068,-0.1024,0.0747,0.0447,0.0008,0.0107,-0.0277,0.031,0.061,-0.0119,0.0024,0.0064,-0.0047,-0.0984,-0.1574,-0.1312,0.0823,0.1429,0.103,0.0077,-0.1012,-0.0573,-0.0117,-0.0323,-0.079,-0.0248,-0.0428,0.0304,0.2025,0.1242,-0.0049,-0.0689,0.0066,-0.0456,-0.0305,-0.1936,-0.1372,-0.0842,0.0031,0.0785,0.0262,-0.0327,-0.0811,0.0281,0.068,0.0722,-0.0063,-0.0018,-0.0044,-0.1287,0.037,0.0309,-0.0212,-0.0904,-0.0633,-0.0891,0.039,0.0257,-0.0073,0.0026,-0.0664,-0.133,-0.1487,0.0478,-0.0068,-0.0345,-0.0581,0.1208,-0.0169,0.22,0.0984,0.0852,0.1171,0.0054,-0.0693,0.0434,0.0238,0.0602,0.0319,0.0221,0.0206,0.0492,0.0582,0.044,0.0161,0.0669,-0.0495,-0.1573,-0.0709,-0.1356,0.1844,0.1276,0.1482,0.0479,-0.0343,0.1038,0.113,0.044,0.0906,0.0337,-0.0912,0.0121,-0.1248,-0.0474,-0.0411,-0.0724,0.0024,0.0055,-0.0131,0.0165,0.1628,0.0171,0.1049,0.0309,0.0637,0.0401,-0.0545,-0.1878,-0.0927,-0.092,-0.058,0.077,0.2805,0.1572,0.2044,0.1513,-0.0152,0.067,-0.0319,0.0807,0.1439,0.1545,0.066,-0.0316,-0.0733,0.0182,0.0702,0.0442,0.0552,0.1674,0.0491,0.0738,-0.0247,0.0196,0.0275,0.1595,0.0143,0.104,0.1429,0.2098,-0.0684,0.0124,0.0458,0.0654,0.0552,0.0359,0.0319,0.1237,0.0443,0.065,-0.0738,-0.0398,-0.0861,0.0047,-0.0584,0.0679,0.0191,-0.052,-0.1265,0.0513,0.0167,-0.0466,-0.1551,0.0395,0.0594,0.0146,0.0685,0.0669,0.1162,0.1114,0.0815,0.0507,0.0396,0.0134,0.002,0.2476,0.0063,0.0264,0.129,0.091,0.1052,-0.0541,0.0864,-0.0294,-0.0145,-0.1777,0.0019,-0.0454,0.1351,0.0674,0.0885,0.076,0.078,0.0365,-0.0322,-0.1215,-0.0921,0.0245,0.0935,-0.0284,-0.1685,-0.2162,-0.189,0.1714,0.1833,0.0389,-0.0131,0.0087,0.0343,-0.0315,0.036,-0.0215,0.0334,0.0834,0.1018,0.009,0.0858,0.1055,0.0353,0.0629,-0.018,0.0443,-0.0348,-0.1095,-0.0933,0.0734,0.1397,0.0937,0.1157,0.1034,0.2628,0.1617,-0.2923,0.0716,0.1216,-0.0566,-0.0122,0.0346,-0.091,-0.0083,0.0013,-0.1548,0.0379,-0.0531,-0.0402,0.0297,0.0039,-0.0136,-0.1243,-0.2048,0.145,0.0648,-0.0489,-0.233,-0.0261,0.0279,-0.0346,-0.0449,0.0168,-0.0066,-0.108,0.0055,-0.0286,0.097,0.0658,0.0833,-0.0138,0.0837,-0.0344,-0.0956,-0.135,-0.0619,-0.0994,-0.0807,-0.191,-0.063,-0.0063,0.0037,0.0059,0.0142,0.2382,0.0994,0.1425,0.1249,0.0437,0.1155,0.1486,0.117,0.0268,0.0394,0.1628,0.0621,-0.111,0.0604,0.1737,-0.0949,0.0213,-0.0249,-0.0337,0.0631,-0.0132,0.1804,0.0719,0.0175,0.1138,0.0565,-0.0178,0.0831,-0.0839,-0.0213,-0.036,-0.0595,0.1264,0.005,0.0044,0.1006,0.0483,0.0518,0.069,-0.0494,-0.0156,0.0594,0.1347,0.0018,0.0119,-0.0238,0.0271,0.0131,0.1388,0.0952,0.0612,0.0664,-0.0463,0.0582,0.04,-0.0258,-0.0517,-0.0682,-0.0386,-0.058,0.1375,0.0519,0.1215,0.1431,-0.0761,-0.148,-0.1277,0.0317,-0.3414,-0.1605,0.124,0.0971,-0.312,-0.1806,-0.0159,-0.1514,-0.1473,-0.184,0.109,0.104,0.0986,0.0948,-0.333,-0.2494,-0.2373,-0.0358,-0.1108,-0.1729,-0.3077,-0.3009,-0.2882,-0.0151,-0.0012,0.0323,-0.0156,0.0088,-0.0386,0.1709,0.0957,-0.013,0.0084,0.0649,0.0513,-0.0662,-0.0144,-0.047,0.0903,-0.0768,-0.0818,-0.1271,-0.0122,-0.0095,0.0433,0.032,-0.0327,-0.0053,0.0449,0.1075,0.0436,0.0724,0.1345,0.2172,0.1984,-0.0193,0.0482,-0.0024,-0.1354,-0.042,-0.1876,-0.0254,-0.0969,-0.1549,0.049,0.1614,0.1784,0.0229,-0.0632,0.0124,-0.1374,-0.0774,-0.1905,-0.0639,0.1491,0.1449,0.1248,0.1095,-0.0424,0.1603,0.1102,-0.0116,0.0647,-0.1114,0.0638,0.0221,-0.0869,-0.0113,-0.0433,-0.0814,-0.001,0.1071,0.1332,0.0055,0.0185,0.0803,0.0355,0.0422,-0.0614,-0.2177,-0.1428,-0.0857,-0.1599,-0.0164,-0.0448,-0.0296,-0.1065,-0.1712,-0.1961,-0.031,-0.0438,-0.0301,-0.1126,-0.0764,0.0465,0.0488,0.0067,-0.0095,0.0624,-0.0279,0.0226,0.0111,0.0343,-0.0458,-0.0139,-0.0045,-0.1129,-0.0381,-0.1235,-0.1234,0.0745,0.1318,0.1286,0.1126,0.1921,-0.1053,0.0473,0.0796,0.0531,-0.1574,-0.0351,0.1498,0.0971,-0.0066,0.0393,-0.0497,-0.0315,-0.0922,-0.1186,-0.1838,-0.3005,-0.1421,-0.0823,0.0393,-0.0037,-0.0852,0.1025,0.0974,0.0281,0.0059,-0.0083,-0.0141,-0.0308,0.0565,0.001,0.1109,0.1754,0.1233,0.0708,-0.0059,0.1461,0.0519,0.0842,-0.0017,0.0193,0.0103,0.0372,0.0102,-0.1075,-0.0264,-0.0117,0.0923,-0.0811,-0.0123,0.0655,-0.1363,0.1977,0.1029,-0.106,-0.0119,-0.0083,0.0724,-0.0205,0.0212,-0.0366,0.06,0.0688,0.0051,-0.0164,-0.0097,0.1198,-0.0699,-0.0327,-0.0838,-0.0226,0.1747,0.117,0.0223,0.0734,0.0797,0.0471,0.0871,0.0176,-0.0887,-0.0311,-0.0426,0.2506,0.1461,0.089,0.1886,0.1762,0.1328,0.1512,0.1512,0.0731,0.0332,-0.0571,0.1495,0.0285,0.0918,0.1057,-0.0573,0.0161,0.1977,-0.1093,0.1379,-0.0762,-0.0668,-0.1293,-0.1335,-0.0494,0.1427,0.0617,-0.0064,-0.0363,0.0232,-0.0994,-0.0297,-0.0849,-0.1912,-0.1435,-0.0093,-0.0457,-0.0221,0.0286,0.0301,0.0457,0.0322,0.0802,0.0802,0.0378,0.0185,0.0284,-0.0438,0.002,0.0197,-0.0783,-0.0822,0.0482,-0.0807,-0.0487,0.1132,0.0249,0.1503,0.0434,0.0305,-0.0605,0.0565,-0.1296,-0.1262,-0.0141,-0.1474,-0.1112,-0.0185,-0.1078,-0.0227,-0.2543,-0.1057,-0.019,-0.087,0.1215,-0.0681,-0.0746,-0.0804,0.0263,0.007,-0.0415,0.0026,0.008,0.0836,0.0935,0.0485,0.078,0.0146,0.0075,0.1182,-0.1742,0.0174,-0.0262,-0.0472,0.0267,-0.0461,0.0119,0.0101,0.1164,0.0407,-0.0392,-0.0498,0.0435,0.0273,0.0781,0.0214,-0.0792,-0.0818,-0.077,-0.0142,-0.043,0.0748,-0.0611,0.0512,0.0248,-0.0001,0.0082,-0.0041,0.0729,0.1099,0.0878,0.0325,-0.0247,0.0549,-0.0845,0.0083,-0.0791,-0.0094,-0.0195,-0.0926,-0.0243,0.0209,0.082,0.0519,0.0455,-0.0512,-0.0494,0.014,0.0825,-0.0063,-0.0642,-0.0839,0.1225,0.1085,0.1372,0.1288,-0.012,0.03,-0.0004,0.0679,0.0556,0.1014,-0.0019,0.1097,-0.0047,-0.0284,0.0974,-0.1203,0.0904,0.0941,0.0701,-0.0128,0.0937,-0.0006,-0.0907,-0.0691,0.1746,0.0005,0.028,0.0479,-0.0489,-0.0616,-0.0245,-0.0483,0.0967,0.0903,0.0203,0.1673,0.1394,0.0253,0.1027,-0.0213,-0.0132,-0.0942,-0.0902,-0.0881,0.1091,0.122,-0.0308,-0.1307,-0.1752,-0.0738,-0.0052,-0.0147,-0.0218,0.016,-0.0264,0.0452,0.0987,0.1084,-0.0043,0.0824,0.1846,-0.115,0.0153,-0.0224,-0.1112,-0.0224,-0.0328,0.0702,0.0453,-0.0133,-0.0247,0.059,-0.0544,-0.1333,-0.0863,-0.018,0.0701,0.0642,0.1153,0.0444,0.0003,0.1364,0.0056,0.0139,-0.008,0.0348,-0.0556,-0.0344,-0.0173,0.0469,-0.1073,0.1896,0.1378,0.1496,0.156,-0.0026,0.0815,0.0695,0.1949,0.0624,0.03,-0.1099,0.1521,0.0689,0.0618,-0.0303,-0.0998,-0.0552,0.1133,0.1436,0.0727,0.0178,-0.0555,-0.0972,0.0346,0.0123,0.0147,-0.0775,-0.0536,-0.0896,-0.1162,0.0515,0.0442,-0.0677,-0.0039,0.0073,0.0023,-0.0057,0.0534,-0.0089,0.011,-0.1052,0.0121,-0.108,-0.1105,-0.0115,0.0145,0.018,0.1041,0.0627,0.0449,-0.1107,-0.2127,-0.069,-0.0363,0.0093,-0.0309,-0.2049,-0.1327,-0.094,-0.1109,0.1178,0.0195,0.0224,-0.0791,0.0911,-0.0363,0.0196,-0.0263,-0.0102,-0.0263,-0.0729,0.0784,0.0025,-0.0445,0.1197,-0.1489,-0.0891,-0.0066,0.0349,-0.0829,-0.1018,-0.0078,-0.0455,-0.0217,-0.0295,-0.1096,-0.1309,-0.1109,0.0118,0.0095,-0.0549,0.0295,0.1097,0.2686,0.2569,-0.0236,-0.0597,-0.0987,0.0228,-0.0115,-0.0265,0.0131,-0.0238,0.0289,-0.077,0.0093,-0.0309,0.0179,-0.0703,-0.0135,0.1603,0.0352,0.1302,0.1114,-0.0233,0.0684,0.0142,0.2002,0.1127,-0.0391,0.0467,0.02,-0.0701,-0.0076,0.0693,0.1027,-0.1939,0.1169,-0.101,-0.0167,-0.0266,0.0001,-0.0705,0.0766,-0.1607,-0.1467,0.1295,0.083,0.0469,0.0011,0.1236,0.1135,0.1242,0.1776,0.0842,0.0234,0.0427,-0.032,0.013,0.0479,0.068,0.2052,-0.1388,-0.1326,0.1314,0.0357,0.0379,0.1215,0.1816,-0.1102,-0.1311,0.1222,-0.0065,-0.0688,-0.055,0.0946,0.1011,0.0801,0.1702,0.068,0.1224,-0.0521,-0.0456,-0.0346,-0.068,0.0374,-0.0759,-0.2257,-0.1468,-0.1042,-0.2597,0.1526,0.1376,0.1014,-0.0396,-0.0081,0.0455,0.0587,-0.0092,-0.0585,0.1069,0.1128,-0.0053,-0.1589,0.1003,0.0207,0.0332,-0.034,-0.0689,-0.1366,-0.0118,-0.005,-0.0039,-0.0063,-0.0862,-0.1267,-0.0386,-0.046,0.0113,-0.0362,-0.1044,-0.0988,-0.0443,0.0157,0.1172,-0.0403,0.0182,-0.0166,-0.0052,-0.0047,-0.0914,-0.0138,-0.0214,-0.053,0.0308,0.046,0.1531,0.1247,0.1129,0.0829,-0.2025,0.0327,-0.148,-0.158,-0.0734,0.0062,0.0189,-0.0723,-0.0034,-0.1398,-0.1924,-0.0771,-0.0585,-0.0463,-0.061,0.0418,0.0769,0.0805,-0.0811,-0.1689,-0.1389,0.0844,0.0476,0.012,-0.0187,-0.0029,-0.0035,0.0539,0.0834,0.0002,0.1099,-0.02,0.0923,-0.0962,-0.046,-0.0748,-0.0519,0.0676,-0.032,0.0393,0.0395,-0.0554,-0.1071,-0.0213,-0.0265,0.0604,-0.0666,-0.0187,0.085,0.0178,-0.0467,-0.0841,-0.0112,0.0979,0.0353,0.127,0.0677,-0.0326,-0.0879,0.0806,0.045,0.0432,0.0829,0.0822,0.0307,0.0643,0.0338,0.035,0.029,0.0705,-0.0403,0.1133,0.1211,0.074,0.0388,-0.0074,0.0496,0.07,-0.0194,-0.096,-0.0256,0.0723,-0.2257,-0.2268,-0.1511,-0.0317,-0.0553,-0.0126,0.027,-0.0117,0.0257,-0.0436,-0.153,-0.1308,0.0105,-0.0391,-0.0667,-0.0467,0.0926,0.0394,0.027,-0.01,0.0691,0.0186,0.0716,0.0613,-0.0242,0.1175,0.1045,-0.0795,-0.0327,0.1539,0.005,-0.0567,-0.0815,0.0318,0.06,0.2647,0.249,0.1156,0.1161,-0.1721,0.1139,0.0759,-0.0671,-0.0098,0.0404,0.1107,0.0315,-0.1545,-0.1665,-0.2412,-0.1383,-0.1235,0.0131,-0.0096,-0.1061,0.0159,-0.0445,-0.0328,-0.0133,-0.2046,-0.1056,0.0989,0.1893,0.0965,0.1027,0.1571,0.0182,0.0458,-0.0659,-0.0542,-0.0762,-0.028,-0.0015,0.2317,0.0664,0.166,0.025,0.1543,0.1327,-0.007,-0.1086,0.0267,0.0518,0.002,0.1164,0.0628,0.1648,0.0531,0.1075,0.0346,0.0377,0.0146,0.0373,0.0371,-0.0707,-0.0635,-0.0223,0.1014,0.0779,0.0593,0.0057,-0.0974,-0.0338,0.0245,-0.1292,0.0141,0.0621,-0.0534,-0.0311,0.029,0.0243,-0.0504,-0.0241,-0.0293,0.0336,-0.1522,-0.2845,-0.2234,-0.1009,-0.118,0.0385,-0.1173,-0.0134,-0.1461,-0.0514,-0.1655,-0.0296,-0.0648,-0.0566,-0.0524,-0.0437,-0.0073,0.0048,-0.0418,-0.0619,-0.0662,-0.0305,-0.095,0.0325,0.1115,-0.0704,-0.0952,-0.0859,0.1635,0.0988,0.1644,-0.0066,0.1683,0.0002,-0.0005,-0.0716,-0.0251,0.0354,0.1612,0.163,-0.0574,0.0045,0.105,-0.0399,-0.2033,-0.0831,0.0434,-0.1055,-0.2093,-0.0775,-0.0646,-0.139,0.064,-0.0014,-0.1875,-0.0588,0.0619,-0.1717,-0.0589,-0.02,-0.0267,-0.2555,-0.0703,0.1413,0.1251,0.0876,-0.0423,-0.0991,0.05,-0.0549,-0.0143,0.0084,-0.0051,0.0702,0.0274,-0.0777,0.0325,0.15,-0.0954,-0.0083,0.0696,-0.078,-0.0328,-0.0342,-0.0334,0.0379,0.0468,0.1895,0.1492,-0.0801,-0.1783,0.0035,0.0365,0.0255,0.0157,0.0407,0.0865,0.0882,0.1414,-0.0352,-0.07,0.0406,0.0667,0.0913,0.0454,0.1117,0.0811,-0.0015,0.0812,0.0283,0.0657,0.072,0.0501,0.1005,0.0026,-0.0307,0.0199,-0.1137,0.0605,-0.0156,-0.0965,-0.0777,0.1418,-0.0008,0.0409,0.163,0.0903,0.0136,0.0361,-0.0439,-0.1112,-0.1235,0.0154,0.1213,-0.0561,-0.0424,-0.0197,-0.1006,0.1662,0.0677,0.1552,-0.0464,0.0034,-0.0934,0.0088,0.1972,0.1391,0.0363,0.0184,0.003,-0.0874,-0.0933,-0.0073,0.0991,0.1087,0.0565,0.1341,0.2618,0.0891,0.0804,-0.0804,-0.0165,-0.1096,-0.0044,-0.1196,-0.0244,-0.0743,0.0102,-0.1064,-0.1817,-0.0488,0.0078,-0.001,0.0727,0.0016,0.0488,0.0201,0.0277,0.0232,0.0275,-0.0274,0.0774,0.0699,0.0375,0.0207,0.1058,0.032,-0.0088,-0.1156,0.0848,-0.0674,-0.0625,-0.0375,0.0278,0.0064,-0.0179,0.0485,0.1157,0.0326,-0.1611,-0.0921,0.0051,0.0451,0.0595,0.0672,0.0697,0.0114,0.0888,-0.0433,-0.0628,0.1657,0.1807,-0.0067,0.1073,0.0677,0.0475,-0.2654,-0.2412,0.1273,-0.1241,0.0901,-0.0006,0.023,0.1822,0.1907,0.1492,-0.0327,0.0195,0.0741,-0.0019,0.116,0.0279,-0.1201,0.0444,-0.0303,-0.0519,-0.0047,-0.0095,0.1754,0.0266,-0.0288,0.099,-0.0521,0.1215,-0.1444,0.1706,-0.2289,-0.0612,-0.0739,0.1798,0.1563,-0.1077,-0.1125,-0.0027,-0.0995,-0.0974,-0.0039,-0.0123,-0.0447,-0.0093,-0.1224,-0.1185,-0.1203,-0.0774,-0.1221,-0.1736,0.0197,-0.1329,-0.2226,-0.4245,-0.1951,-0.1698,-0.2682,-0.1353,-0.1533,-0.1835,-0.1617,-0.2229,-0.1741,-0.1471,-0.192,-0.151,-0.1967,-0.1826,-0.2676,-0.1586,-0.203,-0.1034,-0.1624,0.1979,0.0342,0.1334,0.1028,0.0293,0.2582,0.2108,0.1196,-0.0235,0.047,0.2859,0.2535,0.1314,0.0128,-0.023,0.1292,-0.1682,-0.0334,0.0382,-0.0388,0.0353,0.1164,0.1067,0.074,0.1741,-0.0838,0.2066,0.2179,-0.0901,-0.0074,0.052,0.006,0.0059,0.0989,-0.0435,-0.0525,0.1114,-0.1319,-0.1618,-0.0134,-0.0569,-0.0797,0.047,-0.154,-0.1538,-0.0112,0.0609,-0.0925,0.0189,-0.047,0.1314,0.0377,-0.1128,0.0397,0.0471,0.0267,-0.0245,0.0122,0.021,proactive control
trm_4a3fd79d0b4b5,-0.0279,-0.0595,-0.0136,-0.177,-0.0371,-0.0617,-0.0277,-0.0995,-0.0673,-0.0436,0.0355,0.0573,0.0094,0.0354,-0.0709,-0.071,-0.0544,-0.065,-0.0488,0.0285,-0.0023,0.0202,0.0159,0.0138,0.0167,0.0225,0.0222,0.0066,-0.0184,0.0114,-0.0174,0.0028,0.0038,-0.0121,0.0316,-0.0287,0.05,-0.0403,-0.1012,-0.0583,-0.0354,-0.0707,0.029,0.0326,-0.0789,-0.0203,0.1623,-0.0068,-0.0225,-0.0278,-0.0168,0.0375,0.0273,-0.1406,-0.0696,-0.0002,0.0239,0.0461,0.0092,0.0007,0.0724,0.0068,-0.0575,-0.0076,-0.0943,0.0339,-0.0689,-0.0057,-0.0489,0.0597,-0.0523,0.0196,0.0547,0.0758,-0.2337,0.0577,-0.0241,0.0117,-0.0671,0.0666,0.1137,-0.0163,-0.0624,0.0241,-0.1154,0.0046,-0.0742,0.0105,0.0336,0.0629,-0.01,0.0346,-0.0216,-0.0655,0.108,0.0026,0.0796,0.0211,-0.041,-0.0767,-0.0085,-0.0462,-0.0202,-0.0456,-0.0058,-0.0628,-0.0103,0.1182,-0.0148,-0.1211,-0.0144,-0.0271,-0.0394,0.0236,0.0067,-0.0044,-0.0594,-0.0411,0.0088,-0.0181,-0.0173,-0.0781,-0.0413,0.0086,-0.0382,0.0144,-0.083,-0.032,0.0157,0.0847,0.1052,-0.0388,0.039,0.0814,-0.0525,-0.0496,-0.0186,-0.0135,-0.0517,0.0409,-0.0193,-0.0824,0.0598,0.0154,-0.1045,-0.1201,-0.0384,-0.021,-0.0337,0.0131,-0.0444,0.021,0.0221,-0.0185,0.0092,0.0293,-0.0077,-0.0521,0.0145,0.0153,-0.0533,-0.0112,-0.0464,-0.0451,0.0105,-0.0416,0.032,0.0228,0.0198,0.0505,0.0833,0.0057,0.0059,0.1956,0.0501,0.1327,0.1055,0.0864,0.1024,-0.0183,-0.0141,0.0671,-0.0177,-0.0728,0.0959,0.031,0.0782,0.1587,0.149,-0.0559,-0.0562,0.1086,0.0672,0.054,0.0636,-0.2005,-0.2341,0.0998,0.0289,-0.1547,-0.083,-0.0335,0.0025,-0.0429,-0.255,0.0963,0.1965,-0.0959,-0.0571,-0.0572,0.0268,0.0569,0.0143,0.0386,0.0662,0.0451,0.0589,-0.0696,-0.0808,0.0262,0.063,0.0125,-0.0432,-0.029,-0.0357,0.0451,-0.115,0.059,0.0559,-0.108,-0.0101,0.0879,0.0619,-0.054,-0.0595,-0.0284,0.0613,-0.0039,-0.0039,0.0594,-0.0608,0.0381,-0.0801,0.0232,-0.0034,0.018,-0.0088,-0.0308,-0.0481,0.0199,0.0661,0.0497,0.0188,-0.0248,0.0631,0.025,-0.0644,-0.1189,0.1042,0.097,-0.0039,-0.0649,-0.0618,-0.0808,-0.0626,-0.1235,-0.1293,0.0128,0.0533,0.033,-0.0929,-0.017,0.0744,0.061,0.0565,0.1874,0.0694,0.1019,-0.0207,0.0395,0.1021,0.0933,0.0784,0.0674,0.0537,-0.0007,0.045,0.1122,-0.0227,0.0238,0.0161,0.0536,0.0034,0.0524,0.0035,-0.0138,0.1078,-0.1108,-0.1492,-0.1131,0.0529,-0.003,-0.0068,0.0232,-0.0879,-0.1046,-0.0086,0.0366,0.0327,-0.0157,-0.0389,0.0327,-0.1895,-0.0307,-0.0274,-0.0558,-0.0698,0.0225,-0.0273,-0.0257,-0.022,0.0153,-0.0279,-0.0582,-0.0015,-0.1002,-0.0549,-0.0161,-0.0169,-0.0133,-0.0109,0.0394,0.0581,0.0365,-0.0087,0.0409,-0.0553,0.0274,0.1571,-0.0326,-0.0379,0.0918,0.0196,0.0437,0.0414,-0.0153,-0.0042,-0.0034,0.007,-0.0109,0.0676,0.1426,-0.0182,-0.0009,0.0129,-0.0357,-0.0475,0.0478,-0.0244,-0.0409,0.0038,0.0065,-0.0362,-0.0938,-0.0597,-0.0668,-0.0404,-0.1649,-0.0078,0.0216,-0.0191,-0.0598,0.0127,0.0296,-0.0299,-0.0155,-0.0159,0.0456,0.2059,0.0089,0.162,-0.074,-0.0915,-0.1348,-0.0137,-0.0395,-0.0135,-0.0118,-0.0453,-0.0224,-0.0179,-0.0476,-0.0773,-0.0347,0.0663,0.0355,-0.0203,0.0216,-0.0307,-0.0956,-0.0391,-0.0039,0.0204,0.0247,-0.0269,-0.1121,0.0755,-0.0088,0.0317,0.0329,-0.034,-0.0587,0.0,0.0829,0.0718,0.0288,0.029,-0.1831,-0.1701,-0.1372,-0.0081,-0.0437,-0.0476,-0.2531,-0.2281,-0.1446,-0.0646,-0.0184,-0.0686,-0.1405,-0.0005,0.0399,0.0044,0.0287,0.0773,0.0158,0.033,-0.013,-0.0299,-0.0521,0.1022,-0.0349,-0.0012,-0.0599,0.1364,-0.0123,0.0219,-0.0223,-0.0172,-0.2553,-0.2968,-0.0219,-0.0509,-0.0705,-0.0573,-0.025,0.0292,-0.1159,-0.1522,0.0052,-0.0334,-0.0788,-0.0106,-0.0285,0.0596,-0.0886,-0.0788,0.0061,-0.0153,0.0466,-0.0301,0.0493,-0.1378,0.062,0.1267,-0.0716,-0.0222,0.0198,-0.0023,-0.0302,-0.0303,-0.0711,-0.1584,-0.0943,-0.1292,-0.0617,-0.0267,-0.0514,-0.0412,-0.0296,0.1357,-0.0394,-0.1544,-0.1591,-0.0575,0.1049,0.054,-0.0974,-0.0265,-0.0788,-0.0841,-0.0059,-0.0089,-0.0788,-0.0424,0.011,0.0155,0.0951,-0.0526,-0.013,-0.0119,-0.0398,0.0289,-0.0009,0.0771,-0.0719,0.0535,0.0677,-0.0081,0.0237,-0.0614,0.0478,0.0808,-0.2248,0.0077,0.0223,-0.0005,0.0615,0.0608,-0.0365,-0.0855,0.0097,-0.0235,-0.089,0.1397,-0.0014,-0.0282,-0.1822,-0.0385,0.037,-0.0353,0.0114,0.0428,-0.0154,-0.0208,0.0759,-0.0406,0.0203,0.0485,0.0214,0.0156,-0.02,-0.0646,-0.0499,-0.0148,0.0368,0.088,0.0067,0.0595,0.0217,0.0295,-0.0481,0.0128,0.0756,0.0417,0.0959,0.0986,0.0999,0.0071,0.0175,-0.022,-0.0182,-0.0599,0.0076,-0.0022,0.0173,0.0202,-0.0451,0.0482,-0.0185,0.0875,0.0141,0.0148,-0.0574,-0.104,-0.0696,-0.293,-0.0723,-0.0652,-0.0407,0.0099,-0.1778,-0.1932,-0.067,-0.182,-0.0265,-0.0534,-0.0107,0.0003,0.005,0.0487,0.098,0.0399,0.0741,0.0041,-0.012,0.0112,0.0318,0.0216,-0.1752,-0.01,-0.0173,-0.0933,-0.0572,-0.0241,0.0281,0.0127,-0.1038,0.0209,-0.0476,-0.0442,-0.0693,-0.0197,0.0107,0.0138,-0.016,-0.1695,0.0526,-0.1034,-0.0781,-0.0022,-0.0293,-0.0252,-0.1407,-0.3144,-0.0883,-0.1004,-0.1033,0.0475,-0.1178,-0.0505,-0.0266,-0.0488,-0.0277,-0.0888,0.0069,-0.0092,0.0863,-0.0576,-0.0115,-0.195,-0.0381,-0.0934,-0.0022,0.0321,-0.0327,-0.0329,-0.0654,-0.0216,-0.0861,0.0255,-0.0313,0.1061,-0.0374,0.0053,-0.0654,-0.0348,0.0059,-0.1348,-0.0767,-0.0591,0.0372,-0.0106,-0.0918,-0.0768,-0.0616,0.0732,0.0411,0.0764,0.0057,-0.0686,-0.0219,-0.0037,0.0258,0.1009,-0.0348,-0.0143,0.0304,-0.0189,-0.0187,0.0905,-0.1316,-0.0802,-0.0029,-0.0324,-0.0357,-0.0059,-0.0131,-0.0046,-0.1685,-0.0723,-0.0355,0.0365,0.0371,0.0392,-0.015,-0.004,-0.0504,-0.0276,-0.0291,0.0388,-0.1313,-0.1689,0.0314,-0.093,-0.0001,-0.0322,0.1015,0.0236,0.024,0.087,0.0838,-0.0919,-0.1042,-0.0191,-0.0665,-0.018,-0.06,-0.0411,-0.046,0.0804,0.0479,-0.0159,-0.0323,-0.0912,0.0123,-0.0013,-0.0672,-0.0931,-0.1116,0.0833,0.0084,-0.0645,0.0148,0.0366,0.0822,-0.0128,0.0494,0.0153,-0.0111,0.0136,0.1126,-0.0119,0.0204,0.0236,0.0174,0.0375,0.0819,0.0109,-0.0159,0.044,0.0223,-0.012,0.0527,-0.0076,0.0077,0.0357,-0.0028,-0.0898,-0.0522,-0.0297,0.0491,0.0136,-0.0077,0.0161,0.0273,0.0074,0.0044,0.0454,-0.0337,0.0051,0.0269,0.0082,0.0138,-0.0321,-0.0536,-0.0373,0.0505,-0.0316,-0.0288,-0.0115,-0.0596,0.0981,0.0098,-0.0174,-0.0184,-0.0374,-0.0224,-0.095,0.0639,0.0581,-0.0645,0.0581,0.0925,0.0338,0.0532,0.0161,-0.0183,-0.0806,0.0826,0.0584,-0.0576,0.0344,0.0256,0.0411,-0.0525,0.0961,0.0934,-0.0481,-0.0133,-0.026,-0.072,-0.0152,-0.1313,0.0246,0.1345,-0.0704,-0.0486,0.0168,0.0082,0.0232,0.0676,0.0269,0.1434,-0.0343,-0.0152,-0.1024,-0.0552,0.0119,-0.034,-0.0259,0.0004,0.0645,-0.0659,-0.0405,-0.0812,-0.0068,0.0176,0.0091,-0.0652,-0.0218,0.0458,-0.0171,-0.0012,-0.015,-0.0242,-0.3455,-0.0606,-0.0321,-0.0004,0.0777,-0.0389,-0.1331,-0.0124,0.0262,-0.0113,-0.1255,-0.0541,-0.1992,-0.201,-0.0871,-0.0005,-0.0508,-0.0025,0.0168,-0.3851,-0.1186,-0.3734,-0.0259,-0.0012,-0.0176,0.0329,-0.0652,-0.0274,0.0007,-0.0064,0.0155,-0.0473,-0.0269,0.0585,-0.0442,-0.0027,0.1385,-0.0031,0.0487,0.017,-0.1297,-0.0074,-0.0209,0.0599,-0.0107,-0.01,0.1067,0.0134,-0.026,0.1695,-0.0082,0.0688,0.0235,-0.0256,-0.0504,0.02,0.0075,0.0102,0.0002,-0.0118,0.058,0.0075,-0.0645,-0.0077,-0.0761,-0.0187,-0.1065,-0.0193,-0.0119,-0.0192,0.0156,0.082,-0.0158,0.0597,-0.0091,0.1215,0.0179,-0.0769,0.0053,0.0183,0.0472,0.0586,0.0335,0.0433,0.0333,0.1399,-0.0325,0.1675,0.0956,0.093,0.0589,0.0011,0.1054,0.1031,0.1667,0.128,0.0313,0.0632,-0.0788,0.0204,-0.0404,-0.0235,-0.0295,-0.0716,0.0384,0.062,0.0083,0.0767,-0.0144,-0.0564,-0.0243,-0.0668,-0.0021,0.0131,0.0005,0.0093,0.0182,0.0104,0.1405,0.1197,0.0678,0.0067,-0.0384,0.0332,-0.0131,0.0038,0.0357,-0.0031,-0.0205,-0.0349,-0.018,0.0259,0.0128,-0.0858,-0.0264,0.019,0.0729,-0.2461,-0.1737,0.0006,-0.0344,0.0246,0.0217,-0.002,0.0324,-0.081,-0.0215,0.0024,0.0112,-0.0706,-0.0461,0.0336,-0.0264,0.002,-0.075,-0.0216,-0.0881,0.0347,0.0195,0.0136,0.0043,0.0064,-0.0354,0.0429,0.0169,0.0261,0.0506,0.0889,0.0108,-0.0412,-0.0965,0.0258,-0.0633,-0.0409,-0.1093,-0.0479,0.0203,-0.1137,-0.3372,-0.154,-0.1347,-0.2318,-0.0094,-0.0216,-0.0473,-0.0165,0.0075,-0.0154,0.0604,-0.1222,-0.0835,-0.1316,-0.0136,0.0197,-0.0272,0.0901,-0.004,0.0442,-0.0153,0.0227,-0.0425,0.0445,0.0143,0.1022,0.0619,0.0036,0.0599,0.0078,0.0754,-0.0218,0.0285,0.0021,-0.0548,-0.0106,-0.0473,0.024,0.0122,0.024,0.1364,0.2133,0.051,0.0315,0.0638,0.0567,0.0198,0.0297,0.0325,-0.0605,-0.0484,-0.1399,0.0613,0.0945,0.0383,0.1183,0.2368,0.156,0.0466,-0.0758,-0.0407,0.014,0.0895,0.1372,0.0555,0.3366,0.2614,0.2154,0.1948,0.3169,0.2334,0.1438,0.2006,0.0498,0.055,0.0155,-0.0152,-0.0333,0.0601,0.0909,0.1129,0.0429,0.004,-0.078,-0.0451,0.1218,0.0743,-0.0345,-0.0725,0.0826,0.0027,0.0668,0.0472,-0.0452,-0.0336,0.159,0.1736,0.136,0.0747,0.1083,-0.0483,0.014,0.0376,0.0677,-0.0067,0.2515,0.0591,0.0648,0.0353,0.0429,0.0929,-0.0014,-0.0237,-0.0469,-0.0046,0.0814,0.0843,-0.0952,-0.0646,-0.0662,0.0452,-0.0407,-0.0435,0.0537,-0.0281,-0.0004,-0.0314,-0.0271,0.0256,0.0139,0.0013,0.0692,-0.0507,0.0177,0.0998,0.1202,-0.0261,-0.0939,-0.0106,0.0787,0.005,0.0485,0.0519,0.0167,-0.1099,0.0224,0.0165,0.0442,-0.0411,-0.0182,-0.2198,-0.1309,-0.1084,-0.08,-0.0497,-0.1132,-0.0589,-0.0572,-0.0796,-0.2147,-0.0136,-0.2081,-0.1908,-0.132,0.0537,-0.2521,-0.1995,-0.1253,0.0497,0.05,-0.0407,0.0224,-0.1001,0.0043,-0.0342,-0.1412,-0.1013,0.0044,-0.065,0.0835,-0.0041,-0.036,-0.092,-0.0251,-0.1345,0.0287,0.0297,0.3202,0.2578,0.1907,0.2909,-0.0104,-0.0373,-0.0294,-0.0442,-0.1532,0.0337,-0.109,0.1597,0.0379,0.0033,-0.0458,0.0053,-0.0828,-0.0057,0.0214,-0.0645,-0.0081,-0.0514,-0.0453,-0.0299,-0.0668,0.1175,-0.0473,-0.0221,-0.0469,-0.0469,0.0343,-0.1011,-0.0897,-0.0429,-0.0143,0.0158,-0.0704,0.0354,0.0009,-0.008,-0.0098,0.0238,0.0349,0.0329,-0.0606,-0.0147,0.0314,-0.0292,0.0115,-0.0568,-0.0588,0.0886,0.103,-0.0121,0.0172,0.0298,0.0369,0.0283,0.002,-0.0285,-0.0962,0.0024,-0.0028,-0.0006,0.1007,0.0381,0.0861,-0.0142,0.0456,0.0049,-0.0215,0.0673,0.1888,0.1353,-0.0486,-0.0009,0.0514,-0.0487,-0.1002,-0.0688,0.0194,-0.0757,-0.0535,-0.0027,-0.0031,0.0413,-0.0507,0.0276,0.0458,0.1001,0.004,-0.0947,0.0183,-0.0722,0.0148,0.1075,0.0757,-0.0072,0.0014,0.0381,0.0108,0.0667,0.0882,0.0909,-0.0088,0.0063,-0.0075,0.01,0.049,0.0174,-0.0456,0.0177,0.1191,-0.0168,-0.0632,0.017,-0.0032,-0.0085,0.059,0.0201,0.0726,-0.0134,0.0983,0.1267,-0.0323,0.0477,-0.0348,-0.048,-0.0065,0.0029,0.1751,0.0658,-0.0995,-0.0469,-0.0636,-0.0253,0.0762,-0.0302,0.008,-0.0541,-0.0307,-0.1659,0.0313,0.0363,0.1328,-0.056,0.0269,0.0081,0.1541,0.0209,0.0634,0.0593,0.0289,0.1083,-0.0027,0.1888,-0.0307,0.1849,-0.0112,0.0021,-0.0279,0.0338,-0.0037,0.0395,0.0297,-0.0474,-0.0752,0.0454,-0.038,-0.1086,-0.1002,0.038,0.0413,0.0036,0.0447,-0.0421,0.0852,0.0183,0.0247,-0.0322,0.0103,-0.0234,0.007,-0.0631,-0.0193,-0.0961,0.0049,-0.0041,-0.0437,-0.0145,0.0471,0.0433,0.0022,-0.023,-0.05,-0.016,-0.0485,-0.0383,-0.1396,-0.1814,0.009,0.0034,0.019,-0.0245,0.0501,-0.0154,-0.0311,0.0046,0.0142,0.0239,0.0071,-0.005,0.0132,-0.0029,-0.0035,-0.0118,0.0734,-0.0327,-0.0164,-0.0066,-0.0145,-0.0725,-0.0069,-0.0459,0.1963,-0.2682,-0.0166,-0.0365,0.1924,-0.0172,-0.0147,0.1347,0.068,-0.166,-0.1336,-0.2586,-0.1897,-0.1324,0.0954,0.0094,-0.0481,-0.0823,0.1234,0.1949,0.0008,0.0195,-0.0409,-0.0952,-0.0745,0.0109,-0.0839,-0.1269,-0.0684,-0.0814,-0.1011,0.0793,0.0249,0.074,0.0063,0.1192,0.0176,-0.0126,-0.0571,-0.1266,-0.0859,-0.0445,-0.0302,-0.0724,0.0026,-0.1159,0.0167,0.0527,0.0328,0.0277,0.0088,0.0559,-0.145,0.0188,-0.0056,-0.0128,-0.1039,-0.0072,0.0009,0.0299,0.0079,0.0221,0.0706,-0.0193,-0.0066,-0.0075,0.0288,-0.1594,-0.0731,-0.0832,-0.0782,-0.1364,-0.0491,-0.0428,0.0096,-0.0049,0.0074,0.0171,-0.0009,0.0136,0.01,-0.1159,-0.0188,-0.1089,-0.079,0.0487,-0.0798,-0.146,-0.0707,0.0126,-0.0145,0.061,0.0708,-0.0812,0.0448,0.0138,-0.0264,-0.0828,-0.0921,-0.0229,0.0011,0.0095,0.0591,0.0277,0.0647,-0.0204,-0.0027,-0.0404,0.0374,-0.0002,0.0176,0.0283,0.0204,0.028,0.0489,0.045,-0.0118,0.0163,0.0531,0.0778,0.0717,0.0323,0.0962,0.0406,-0.0555,-0.0385,-0.0442,0.0842,0.0226,0.0466,0.0424,0.0302,0.0559,-0.0434,-0.1509,-0.1198,0.2483,0.0089,-0.1035,-0.2655,0.1082,-0.002,0.0876,0.0059,0.0024,-0.0033,0.0409,-0.0027,-0.0258,0.0184,0.0122,-0.0276,-0.0252,0.0033,0.0877,0.0334,-0.0064,0.0363,0.0276,-0.0007,0.0415,-0.0035,0.0073,0.0579,0.0839,0.1308,0.0815,-0.0768,0.0236,0.0083,0.0647,-0.0031,0.0961,-0.0477,-0.0177,0.0061,-0.0401,0.073,0.0433,0.0612,0.0391,-0.0899,0.0389,-0.013,-0.0388,0.0917,0.0785,0.0683,0.0131,-0.0094,-0.0242,-0.1727,0.1049,0.0956,0.1044,-0.1194,-0.1467,0.042,0.0695,0.0389,0.0666,0.0234,0.0749,-0.0062,0.0319,0.0113,0.0015,0.0042,-0.0814,0.0735,-0.0614,0.0318,-0.0798,-0.0409,-0.0413,-0.0271,0.091,-0.0918,-0.0274,-0.0222,-0.0241,-0.0108,-0.0469,0.0268,-0.0714,-0.0097,0.0,-0.0693,-0.1125,-0.0495,-0.1591,-0.2158,-0.0009,-0.0431,0.0137,0.0312,-0.1591,-0.1488,0.0347,0.1169,0.0042,-0.0182,-0.003,-0.0445,-0.075,-0.0151,-0.0414,0.011,-0.0184,0.0029,0.033,-0.0815,-0.0597,0.0842,0.0182,-0.0541,0.0446,0.0382,-0.0213,0.0871,0.0983,-0.0182,-0.0352,-0.0605,0.0159,0.0292,0.0017,0.0215,-0.0234,0.0009,0.0168,0.0536,0.0127,-0.0545,-0.0584,0.0484,0.0785,-0.0407,-0.0415,0.0277,0.0294,-0.007,-0.0166,-0.0051,-0.0444,-0.0092,-0.0066,-0.0195,-0.1568,-0.0634,0.0565,-0.015,-0.0554,0.1071,0.0487,-0.0518,-0.0927,-0.0395,-0.0029,-0.102,0.0439,0.0812,-0.163,0.0969,-0.2088,-0.0382,-0.0293,-0.1432,-0.1522,-0.1258,-0.2243,-0.0107,-0.0104,-0.0285,0.0279,0.0589,0.0808,0.0637,-0.0239,0.0215,-0.009,0.0434,-0.0255,0.047,-0.0536,-0.1013,-0.0999,0.0061,0.048,-0.1023,-0.0219,-0.0529,-0.0164,-0.0086,-0.0305,-0.2638,0.0132,0.1079,0.0171,0.1532,-0.0505,-0.025,-0.0117,-0.0324,0.0542,0.0499,-0.0488,0.1062,0.1088,-0.0859,0.0002,-0.0501,0.0711,0.0534,0.0688,-0.1139,-0.0771,-0.0892,-0.0537,0.0072,-0.1007,-0.091,0.0471,0.0438,-0.0674,-0.0445,0.0147,0.0232,-0.0139,-0.0128,-0.0058,-0.0343,-0.0827,0.0147,-0.2804,0.0413,0.0769,-0.0175,0.0462,0.0236,-0.0091,0.0488,0.0593,0.0339,0.2305,-0.0086,-0.0409,-0.0849,-0.0613,-0.0191,-0.0477,-0.013,0.0122,-0.0941,-0.0431,-0.0534,-0.0345,-0.0838,-0.0394,-0.0231,0.0164,0.1268,-0.0231,0.0755,0.0492,0.1685,0.1072,0.1071,0.0055,0.0814,-0.032,-0.0203,0.137,0.0164,0.111,0.0309,0.0628,0.0294,-0.046,-0.008,0.0526,0.0164,0.0782,0.1293,0.1292,0.0222,0.0148,0.0301,0.0086,-0.0513,0.0227,0.0509,0.0348,-0.0161,-0.0567,0.0583,0.0913,0.0284,0.0259,0.0058,-0.0132,0.052,-0.0142,-0.0268,-0.2191,-0.1572,-0.0475,-0.0772,-0.2652,-0.0809,0.0038,-0.0308,-0.0011,-0.0554,-0.0021,-0.0091,0.0571,-0.0591,-0.0232,-0.0352,0.0953,0.0276,0.0413,0.0037,0.015,-0.0008,0.0025,0.2014,0.1723,0.1149,0.0514,-0.0314,-0.0165,-0.024,-0.1081,0.0062,-0.0622,-0.1426,0.1918,0.0665,-0.0121,-0.0817,0.0346,-0.0172,0.0046,-0.0322,0.0074,-0.0142,0.0001,0.0425,-0.0098,0.0575,-0.1459,0.0458,-0.0432,0.0215,-0.1138,-0.1128,-0.0818,0.0004,0.1948,0.1731,-0.0451,-0.0309,0.2432,0.1155,0.0435,0.1248,0.1255,0.1018,-0.0887,-0.0911,0.0009,-0.044,0.2686,0.2291,0.1809,0.0326,0.0613,0.185,0.2156,0.2055,0.2431,0.0462,0.0353,-0.0491,0.051,-0.0209,-0.0069,0.0788,0.0115,-0.0256,-0.071,-0.1015,-0.0835,0.0037,-0.0716,-0.0331,-0.0184,0.0204,-0.0664,-0.0757,-0.0194,0.0255,-0.0847,0.0253,-0.0319,-0.0043,-0.0841,0.0313,-0.0416,0.0085,0.0862,0.0305,0.0256,-0.074,-0.0548,-0.0323,0.1344,-0.021,-0.0751,-0.0083,0.0355,0.1087,0.0016,-0.0417,-0.08,-0.0051,-0.0099,0.0417,0.0457,0.0252,-0.0129,-0.0776,0.0087,0.0044,-0.0176,-0.0195,-0.0453,-0.0895,-0.1333,0.0153,0.0088,0.0426,-0.0469,0.0158,-0.0711,-0.0817,0.1519,0.0992,0.1042,0.0429,0.0289,-0.0849,0.0356,0.0312,-0.1115,-0.0819,0.0174,-0.2642,-0.2587,-0.1357,-0.0422,0.0106,-0.0757,-0.0123,-0.1774,-0.0678,-0.2009,0.0324,-0.0656,-0.0287,-0.0431,-0.0206,-0.1432,-0.1455,0.0214,0.0255,-0.0103,0.0634,0.02,-0.0847,0.0163,0.0241,0.0251,0.0031,0.073,0.1295,0.143,0.1561,-0.0107,-0.0032,0.0462,-0.0277,-0.0415,0.1193,0.0933,0.036,-0.0433,-0.0181,-0.0867,-0.0453,-0.1161,0.0905,0.0892,0.0836,0.0707,0.1347,0.0849,0.269,0.2043,-0.0844,-0.2633,-0.1344,-0.0212,-0.0532,-0.0189,0.0193,-0.0936,-0.0081,-0.0678,0.0254,0.0253,-0.0032,0.0725,0.0106,-0.0094,0.0609,-0.0457,-0.0035,0.0849,-0.2149,-0.0557,-0.0607,-0.0015,-0.0289,-0.0188,0.0279,0.0407,0.1208,0.1104,0.069,0.103,0.1572,-0.0106,0.1178,-0.0579,-0.0728,-0.1822,0.1184,0.1173,0.0622,-0.0122,0.0319,-0.0297,-0.0937,-0.0078,0.0452,0.0131,0.0206,0.1253,0.0623,0.0459,-0.06,0.0557,0.0965,-0.0221,-0.0637,-0.0416,-0.0706,-0.044,0.0428,0.0233,0.0156,-0.0802,0.0288,0.0567,-0.0081,-0.0265,0.0336,-0.0121,-0.0387,0.0407,0.0407,0.027,0.0099,-0.065,-0.007,0.0584,-0.0658,-0.0576,0.0238,0.0935,-0.1029,0.047,-0.0505,-0.0874,0.0751,-0.1603,0.1617,0.0668,0.002,-0.1071,0.0232,0.0084,-0.0457,-0.0997,0.0045,-0.1632,-0.1431,-0.1209,-0.0053,-0.0015,-0.0679,-0.0521,0.015,-0.17,-0.0847,0.0257,-0.0057,-0.0138,-0.0069,-0.0391,0.0078,0.0024,0.0543,-0.0391,0.0986,-0.0147,0.04,0.112,-0.3149,-0.1623,-0.2892,-0.0552,-0.1977,-0.2648,0.0468,-0.0617,-0.0445,-0.015,-0.0887,-0.1374,0.0924,0.0776,0.0572,0.169,0.1446,-0.0149,-0.0558,-0.0563,0.0101,-0.0551,0.0419,0.0371,0.0174,-0.0326,-0.0132,0.0131,-0.0049,0.0932,-0.0445,-0.0218,-0.0204,-0.0203,-0.0704,0.1789,0.0285,0.0691,0.1056,-0.102,0.0668,-0.0477,0.0191,-0.0189,-0.0611,0.015,-0.0238,-0.0737,-0.0763,0.0101,-0.0933,-0.0025,0.1496,-0.1935,-0.0819,0.0346,-0.0466,0.0628,-0.0109,-0.0223,-0.0306,0.0265,0.0365,0.0409,-0.0042,0.0414,-0.0423,0.0654,-0.0363,0.054,-0.0443,0.1624,-0.0704,-0.0639,0.0027,-0.077,-0.0914,0.0142,-0.0626,-0.0425,-0.0668,0.0369,0.0225,-0.0257,0.0569,0.0906,0.1438,-0.0325,-0.0318,-0.0516,-0.0355,0.0846,-0.006,-0.0342,-0.0201,-0.0068,0.0151,-0.0308,-0.0382,0.0279,0.0349,-0.0342,0.0346,0.0419,0.0636,0.0112,-0.0123,-0.1049,0.0141,-0.0206,-0.0342,-0.0215,0.0267,0.0065,-0.0567,0.0634,0.0478,0.0051,-0.0335,-0.0247,0.0818,-0.0609,-0.0037,0.0454,0.0648,-0.0217,-0.034,-0.0839,-0.0788,-0.0699,-0.0401,0.003,0.1091,0.0339,0.0709,0.1236,0.0381,0.0522,0.0133,-0.0709,-0.0831,-0.1238,-0.0503,0.0048,-0.0635,-0.0431,-0.0126,-0.0454,0.1086,-0.0382,-0.0612,0.1565,0.0589,0.0573,-0.0872,0.0182,-0.0248,0.0951,-0.0385,-0.0651,-0.1349,-0.0661,-0.0415,-0.0171,-0.0481,-0.0223,0.009,-0.0237,-0.0221,0.0388,-0.0115,-0.0718,0.012,0.0464,-0.009,-0.0389,-0.0849,0.0797,-0.0307,0.0451,0.0189,-0.0451,0.0363,-0.0249,0.0046,-0.0507,-0.0369,0.0012,-0.0574,-0.0516,0.0223,-0.0744,0.0193,-0.0588,-0.0305,-0.0674,-0.0241,-0.0237,0.0527,0.0672,-0.0433,-0.009,0.0761,0.0184,0.0415,-0.05,-0.0102,-0.0068,0.006,-0.0474,-0.0525,0.058,-0.1002,0.0419,0.005,0.0045,-0.043,-0.0451,0.1369,-0.0336,0.117,0.0883,-0.0502,-0.0312,0.0693,-0.0369,0.041,0.0126,0.0471,0.0944,0.0489,0.0863,0.0092,0.0048,-0.1432,0.0473,-0.0557,-0.0934,0.0173,-0.0112,-0.0328,0.0942,0.0546,-0.1157,-0.0058,-0.0352,0.0651,-0.0586,0.0408,-0.0116,0.0427,-0.1071,0.0207,-0.0714,0.0319,-0.0142,-0.079,0.0002,0.1003,0.0075,0.1186,-0.0027,-0.2375,-0.1413,-0.0341,-0.0913,0.1261,0.0021,0.1853,-0.014,-0.0442,-0.1099,-0.1119,0.0401,0.0067,-0.0047,0.0691,-0.054,-0.1333,-0.0684,0.0179,0.0045,0.0441,0.0809,-0.0036,-0.0779,-0.012,-0.0052,-0.0132,0.0383,0.0262,-0.0689,0.0168,0.1245,0.0439,-0.1103,-0.0775,0.0036,0.0199,-0.0759,0.0281,-0.0631,-0.1143,-0.0307,0.0373,-0.064,-0.0852,-0.1722,-0.1722,0.0617,0.1178,-0.1175,-0.0279,0.0069,0.0511,-0.0432,-0.1599,0.047,0.0425,-0.0453,-0.0811,-0.0264,-0.011,0.0088,0.118,0.0526,-0.0003,0.0374,0.0317,0.0258,0.2065,0.1786,-0.0383,0.0068,-0.0193,0.0254,0.0083,0.2223,0.0045,-0.0063,-0.0295,0.0497,0.0147,-0.0352,-0.0574,-0.0348,-0.1168,-0.0105,-0.0736,0.0422,-0.0535,0.016,-0.0807,-0.0772,-0.2175,0.2447,0.0096,0.014,0.2344,-0.0369,-0.0213,0.014,0.0774,0.0242,-0.0104,0.0085,0.0473,0.0333,-0.0802,-0.0369,0.0072,0.1889,0.029,-0.0303,-0.0124,0.0419,0.016,0.065,-0.0668,0.0218,-0.0466,0.0649,-0.0208,0.0061,-0.0871,-0.0009,0.0559,-0.0773,-0.0518,-0.055,0.0009,0.0002,-0.0299,0.021,0.0042,-0.0402,0.0265,-0.0115,-0.1693,-0.077,-0.0192,-0.0388,0.0177,0.0001,-0.0199,0.0353,0.0505,-0.0903,0.1018,0.0207,0.0823,-0.0391,-0.0474,0.1005,0.1078,-0.0441,-0.0545,-0.139,-0.0153,0.0433,-0.033,0.0073,0.0084,-0.0195,0.0457,-0.0611,-0.0389,0.137,0.115,-0.0239,0.0132,-0.0304,-0.167,0.0076,0.0882,-0.037,-0.0361,0.0194,-0.032,0.0875,-0.0557,0.0957,-0.0614,-0.0025,-0.0633,-0.0118,0.048,-0.0025,0.001,0.0076,0.0282,0.0502,-0.016,-0.0219,0.1308,-0.0807,-0.1338,-0.0322,0.09,-0.0326,0.0328,-0.0507,0.0227,0.0053,-0.0245,-0.0629,-0.1136,0.0739,0.0108,-0.0754,-0.0224,0.1403,0.0839,0.056,0.0882,0.0686,0.1404,0.0218,-0.1156,-0.0689,-0.04,-0.0945,-0.0472,0.0596,0.1229,-0.0335,0.0625,0.0879,0.004,-0.0789,-0.028,0.0243,0.0064,-0.0831,0.0249,0.0384,0.0977,0.0136,0.0446,0.0978,0.1011,0.1138,0.0297,0.0076,0.0867,-0.052,0.042,0.0706,0.0822,0.0486,0.063,0.0533,-0.0293,0.0182,-0.0627,-0.0623,-0.0061,-0.0564,0.1334,-0.0428,-0.0647,-0.0548,-0.0168,0.0237,0.0267,-0.0817,-0.0846,-0.0829,-0.0161,0.1879,0.0914,0.0218,0.0365,0.1089,-0.0227,-0.0281,0.0342,0.246,0.0611,0.0941,-0.0512,-0.1453,-0.1868,-0.1952,-0.1432,-0.0027,-0.1093,-0.0815,-0.1092,0.1394,0.0724,0.0085,0.0265,0.0284,-0.0855,-0.0284,-0.0053,0.0184,0.0064,0.0994,0.0441,-0.1526,-0.1126,0.04,0.0194,0.0756,0.1111,-0.0137,0.0547,-0.0005,0.2534,-0.0856,-0.0035,-0.0581,0.0028,0.0015,0.044,0.0345,0.0285,-0.0247,0.0528,0.0934,0.015,-0.0366,-0.0212,-0.1648,-0.0467,-0.0582,0.0326,-0.0264,0.0394,0.0352,-0.0546,-0.0237,-0.1013,-0.1248,-0.0789,0.0638,-0.0215,0.1,0.0666,-0.0082,-0.0946,-0.0512,0.0622,0.0788,0.0925,-0.0689,0.1357,0.2399,-0.0168,0.0987,-0.1654,-0.0161,0.0224,-0.1176,0.2098,-0.1233,-0.125,-0.0024,-0.0398,-0.0134,-0.0631,-0.012,-0.0529,-0.0555,0.0612,0.0902,0.018,0.0252,-0.034,-0.1375,-0.169,-0.0095,0.0087,-0.027,0.0368,0.0232,-0.0065,0.0646,-0.0853,0.004,0.0384,0.0487,0.0431,0.0164,0.0518,-0.064,-0.0324,-0.0685,-0.0054,0.0049,-0.0429,-0.2318,-0.0611,-0.038,-0.0558,-0.082,-0.0885,0.0758,-0.17,0.0021,-0.0196,-0.0936,-0.1375,0.0399,-0.1613,0.0092,0.0229,-0.0194,-0.0282,0.2641,0.2472,0.0826,0.1009,0.1506,0.1682,-0.0156,0.1512,0.1557,0.1244,0.0396,0.1337,0.2462,0.1173,-0.1275,0.0618,0.0176,-0.0088,-0.0096,-0.0484,-0.0278,0.071,0.0605,0.0069,0.0144,-0.0659,-0.0215,-0.0714,0.0332,0.0155,0.0262,-0.0517,-0.0512,0.0363,-0.04,0.0276,0.075,0.0029,0.0216,0.0213,0.0069,-0.0272,-0.0443,-0.0546,-0.1209,0.0608,0.0845,0.0225,-0.0536,0.0327,-0.1018,-0.0747,0.001,-0.0234,-0.0686,0.0707,0.0472,0.0315,0.0465,0.0363,0.0501,-0.0165,0.0114,0.0017,0.0483,0.1001,-0.0308,0.006,0.0348,-0.0166,-0.0696,-0.045,0.0269,0.0756,0.0568,0.086,0.0178,0.0254,0.0091,-0.0271,-0.0093,-0.0555,-0.0447,0.0518,0.0185,0.0725,-0.0028,0.0354,0.0244,-0.0225,0.0036,-0.035,-0.007,-0.106,-0.1182,-0.0508,-0.1902,-0.0086,-0.0001,-0.0217,-0.0116,-0.0459,-0.0004,0.0302,0.0113,-0.051,0.0124,-0.091,-0.119,-0.1276,-0.0791,-0.0482,-0.0346,-0.0028,-0.0241,-0.0739,-0.0379,-0.0413,0.0693,0.11,-0.0574,-0.0537,0.1502,0.074,0.1233,0.0401,0.0066,0.0109,0.1393,-0.0191,-0.0284,0.0751,0.0125,-0.0465,-0.1136,0.0317,-0.0508,-0.0575,-0.0274,0.0307,0.0168,0.0575,-0.0476,0.1085,-0.0534,0.0047,-0.0307,0.0137,-0.018,0.0067,0.1973,0.2164,0.1545,-0.0022,0.0367,0.0333,-0.0322,0.0192,-0.0011,0.0062,0.0528,0.0148,-0.0622,0.0126,-0.0253,-0.0099,0.0426,-0.0065,0.0553,-0.023,0.0096,0.0141,0.0361,0.0446,0.1382,-0.0172,-0.0032,0.0286,0.0237,-0.0039,0.2463,-0.1977,-0.1733,0.0579,0.0316,0.0131,-0.0741,-0.0658,-0.0708,0.0394,0.0824,-0.1662,0.0354,0.0939,0.1456,0.1283,0.1937,0.1064,0.2661,0.2789,-0.0119,-0.0337,0.1479,0.2726,0.0404,0.1233,0.2223,0.1525,0.1219,0.1308,0.0377,0.1828,0.1589,0.0088,0.1391,0.0438,0.1934,0.1461,0.0748,0.1068,0.0488,-0.0319,0.0028,0.0044,-0.1336,0.0368,0.0281,0.0926,0.0518,-0.0145,0.0255,-0.1107,0.0179,0.0481,0.0461,-0.0204,0.0303,0.0275,0.0451,0.1108,0.0045,-0.0758,-0.0801,-0.0419,0.0058,-0.069,0.0375,0.0363,0.0356,0.0544,0.0404,-0.0056,-0.04,-0.0712,-0.0014,-0.0081,0.0141,-0.1896,-0.1364,0.0393,0.0211,0.1558,-0.1137,0.0936,0.065,-0.0228,-0.2645,-0.2663,0.0517,-0.0599,0.1251,0.0891,0.0421,-0.0149,0.0341,0.1171,-0.0435,-0.0178,-0.0637,-0.0947,-0.0744,-0.0277,visual perception
trm_558c7ae1eaf86,0.0415,-0.0078,0.075,0.104,0.053,0.0171,0.0767,0.0438,0.0357,0.0561,-0.0081,0.0231,0.0219,0.0375,0.0813,0.0,0.0199,0.1746,0.0737,0.0819,0.0593,0.0104,-0.0082,0.0219,-0.0267,-0.0313,-0.0262,0.081,0.0212,0.0022,0.0658,0.1128,0.0357,0.0388,0.1021,0.0823,0.006,0.0399,0.068,0.0666,0.0685,0.028,0.005,0.0098,0.0851,0.0582,-0.0668,0.0305,-0.0381,0.0451,0.0231,0.0048,0.0444,0.0879,0.1037,0.0064,0.0159,0.0264,0.0109,0.01,0.0034,0.0006,0.0762,0.021,0.024,-0.1315,0.1595,0.1834,0.1345,-0.0325,-0.0073,-0.0033,-0.0119,0.0339,0.1151,-0.0344,-0.0077,-0.0051,0.0224,-0.0807,0.0104,0.0624,0.0621,0.0649,0.0237,-0.1014,-0.0471,-0.0626,-0.0008,-0.1307,0.0104,-0.0687,0.002,-0.2651,-0.2435,-0.2779,-0.1086,-0.0677,-0.1187,-0.1353,-0.0759,0.033,-0.0395,-0.128,-0.0723,0.1301,0.0752,-0.124,-0.0152,-0.0061,0.0396,0.1036,-0.0053,-0.0875,0.0001,-0.0118,0.096,-0.1578,0.1093,0.0748,0.0914,0.0787,0.1152,0.0197,0.1083,0.0706,0.1331,-0.0343,-0.0014,-0.0627,0.0586,0.054,0.012,0.1113,0.0308,0.1545,0.0033,0.0871,0.0104,-0.0074,0.0443,0.0869,-0.0209,0.0403,0.0914,-0.0194,0.0268,0.0652,0.016,0.0018,0.07,0.0816,0.0386,0.0993,-0.0364,-0.035,-0.0473,-0.0183,-0.0037,0.0102,0.0235,0.066,0.172,0.0854,0.0059,-0.0132,0.0122,0.1017,0.1013,0.0495,-0.0149,0.105,-0.0858,0.1082,0.0787,0.0723,0.0542,0.1104,0.0561,-0.0441,0.0035,-0.0359,0.0199,0.0478,-0.0159,0.0234,-0.0526,0.0441,0.0672,0.0288,0.0298,0.0425,-0.0357,0.1431,0.1435,0.1385,0.1847,0.027,0.0623,0.0134,0.0113,-0.217,0.093,0.0161,0.116,-0.0923,0.0609,0.0594,0.0399,0.0484,0.171,0.0823,-0.0201,0.0153,0.0019,0.0209,-0.0346,0.0478,-0.0848,0.009,-0.103,0.1004,0.0524,0.0301,-0.0504,-0.0414,0.0411,-0.1122,-0.0054,0.0824,-0.1571,0.0633,-0.0631,0.0232,0.0164,-0.0728,0.018,0.069,-0.0111,-0.0005,-0.0352,0.0427,-0.0013,-0.0197,0.0819,0.0819,0.0818,0.0571,-0.0418,0.1583,0.0162,-0.0105,-0.0157,0.0023,-0.0411,0.0933,-0.0021,0.0369,-0.0732,-0.0722,-0.0476,-0.1033,0.0772,0.0121,-0.0711,-0.0716,0.0098,0.0883,-0.0001,-0.0029,0.0034,-0.0253,0.0184,0.0284,-0.1557,-0.2019,-0.1936,-0.1263,-0.1256,-0.1065,-0.1597,0.0021,0.0218,0.1026,0.0904,-0.017,-0.056,-0.0615,0.0219,0.0311,0.0681,0.0734,0.0216,0.0332,-0.0029,-0.0323,0.0351,0.0114,0.0446,-0.0434,-0.0083,0.1966,0.0325,-0.0084,-0.0711,-0.085,0.021,-0.0152,-0.0743,0.0415,-0.0176,0.021,0.0835,0.1155,0.0279,0.0264,-0.0076,0.0055,0.0454,0.0835,0.0185,0.0488,0.0165,0.0554,0.0264,0.0447,-0.0029,-0.012,0.0346,-0.0378,0.0076,0.0693,0.0677,0.0445,0.0633,-0.0698,-0.0039,0.0931,-0.0961,0.1493,0.1376,0.0132,-0.0891,-0.0312,-0.0412,-0.0281,0.0556,0.0392,0.0094,0.0224,-0.0504,-0.1568,-0.0782,-0.0908,-0.0109,-0.0406,0.0234,0.0305,0.0646,0.0418,0.0066,-0.0141,0.0496,0.0382,-0.035,-0.0847,0.0643,0.0405,-0.0842,0.0541,0.0189,-0.0255,-0.0367,-0.0905,0.0624,-0.0589,0.0394,-0.036,-0.1011,-0.0895,-0.0824,-0.0758,0.0884,0.0537,-0.0244,-0.0162,0.0006,0.0167,0.059,0.0173,-0.0246,0.0073,-0.0697,0.04,-0.05,-0.0836,-0.0948,0.0476,0.0026,0.0227,0.0668,-0.0014,-0.028,-0.0383,-0.0448,0.0445,-0.0064,0.0175,0.06,-0.0082,-0.0409,0.104,0.0554,-0.0847,0.0833,0.0741,0.0115,0.1419,0.1663,0.1338,-0.0355,0.073,0.0452,0.1832,0.1918,0.0721,0.0445,-0.0581,0.0833,0.0056,0.013,-0.0719,-0.0561,-0.0324,0.0566,0.0425,-0.1005,-0.0732,0.1035,0.0848,-0.1625,-0.0233,-0.0466,-0.0252,-0.0018,0.0125,-0.0942,-0.0819,0.116,0.2044,0.1601,0.0357,0.0492,0.0711,0.0191,0.1318,-0.0691,0.0921,0.1045,0.0391,0.0335,0.0384,-0.0076,-0.0018,0.0486,0.0238,-0.0039,-0.0486,-0.0091,-0.0289,0.0003,-0.0555,-0.0357,-0.0309,-0.0484,0.0374,-0.0927,-0.0897,-0.0052,0.0212,-0.1218,-0.0194,-0.0762,-0.0026,0.0834,0.0117,-0.0344,-0.0099,0.123,0.024,-0.1572,-0.1029,0.0236,0.0617,-0.0561,-0.0097,0.0454,0.0267,-0.0012,0.1205,0.1057,0.0427,0.0143,0.0596,0.0617,0.0576,0.0201,0.0455,0.0746,-0.0862,0.079,-0.0665,0.0619,0.029,-0.0508,-0.0301,0.1008,0.0807,-0.1771,0.0456,0.0272,-0.0325,0.0262,0.0729,0.0101,0.0404,-0.0821,-0.111,-0.0983,-0.0314,0.0183,-0.0074,-0.0414,0.0786,0.0519,-0.0764,0.086,0.0312,-0.0017,0.0314,0.0273,-0.0143,-0.0962,0.015,0.0505,-0.0768,0.0462,0.052,-0.0135,0.0295,-0.0548,0.0551,0.0012,-0.0762,-0.0193,0.0414,-0.0377,-0.0126,-0.0583,-0.0345,0.0469,0.0336,0.0663,-0.0646,0.0397,-0.0617,-0.032,0.083,0.0191,0.0333,0.03,0.0853,-0.0306,-0.0433,-0.2141,-0.1616,-0.1085,-0.0581,-0.0637,-0.0038,-0.0179,0.08,0.0691,0.0447,-0.0114,0.0489,0.0556,-0.009,-0.0521,0.0547,0.0139,0.061,0.0527,0.0393,-0.011,0.0119,0.1566,0.0944,-0.0873,0.0005,-0.0559,-0.0381,0.0169,-0.0625,-0.0437,-0.1813,0.0311,0.055,0.0541,0.1176,0.081,0.0141,0.0748,0.0989,0.1564,0.1075,0.0665,0.0667,0.0176,0.1134,0.0446,0.0831,-0.0594,-0.0168,-0.0407,-0.0501,0.0946,0.0729,0.0046,-0.0056,-0.0266,-0.0567,0.0205,0.1238,0.1199,-0.0538,0.0304,-0.0282,0.104,0.0352,0.0347,-0.0189,-0.0028,-0.1703,0.0456,0.0094,0.1388,0.1421,-0.0516,0.0788,0.1857,0.0298,-0.0499,-0.0011,0.0627,-0.08,-0.1744,0.0047,0.0279,0.058,0.1285,-0.1651,-0.0612,-0.1086,-0.0901,-0.0305,-0.0745,0.0799,-0.0912,0.0213,0.0336,0.0217,-0.0128,-0.0637,0.0293,0.1073,-0.1484,0.0571,-0.0475,0.0549,0.0272,-0.0542,-0.0275,-0.0405,-0.1316,0.0657,0.0787,-0.0115,0.0081,-0.0358,0.028,-0.014,-0.0379,-0.0582,-0.0511,0.1295,-0.0215,0.0422,0.0564,0.1322,0.0328,0.0377,0.0272,0.0241,0.0904,0.0355,0.048,-0.015,-0.0081,0.0161,0.028,0.1543,0.1758,-0.0159,0.1869,0.0779,0.047,-0.0537,0.0664,-0.0233,-0.0832,0.0475,0.1081,0.1013,0.0697,0.0445,0.0186,0.0765,0.1191,-0.027,-0.0353,0.0114,-0.0458,-0.0329,-0.0446,-0.062,-0.0291,0.0347,0.0245,0.0575,0.0995,0.0123,0.0089,0.0148,0.0838,0.0441,-0.0058,-0.073,0.0357,0.0122,0.0429,-0.0815,0.1652,0.2059,0.1866,0.1519,-0.0637,-0.0454,-0.0036,0.0092,0.0009,-0.0766,-0.0041,-0.0868,-0.0404,-0.0448,0.09,0.0508,-0.0547,0.0178,-0.1056,-0.1286,-0.064,0.0499,-0.0461,0.0535,-0.0443,0.0382,0.0152,0.0598,0.115,0.0733,0.0751,-0.0399,0.0303,0.0312,0.0129,0.0114,0.0379,0.0248,-0.0398,0.0551,0.0073,-0.0236,-0.0703,-0.0254,-0.0149,0.0922,0.0316,0.1275,0.1214,0.0429,0.0251,-0.0595,0.0369,0.002,-0.0522,-0.0167,-0.0741,-0.172,-0.0876,-0.0476,-0.0418,-0.0457,-0.0843,-0.017,-0.1403,-0.0567,-0.0254,-0.0149,-0.004,0.1038,0.088,-0.0034,0.0229,0.0158,0.2459,0.0977,0.1267,0.0991,0.1478,0.0025,-0.0162,0.0036,0.0349,0.0205,0.099,-0.0568,-0.0271,0.037,0.0115,0.0109,-0.0334,-0.058,-0.0382,0.0146,-0.0476,0.0057,0.0362,-0.0664,-0.0332,-0.0791,0.0313,0.0553,0.0225,0.0713,0.1476,0.0988,0.1161,0.0088,-0.0586,0.0438,0.0522,0.1124,-0.0899,-0.1483,0.0862,0.0922,-0.0561,0.1385,0.0067,0.0657,-0.2618,0.0378,-0.0598,0.1629,0.1315,0.1427,0.1521,0.1324,0.097,-0.084,0.0741,0.1042,0.0074,-0.065,0.0175,0.1156,0.0418,0.0851,-0.0607,-0.0236,-0.1325,-0.0646,-0.0146,-0.0895,0.105,0.0644,0.0315,-0.0009,0.075,-0.0229,0.0131,0.0026,0.037,-0.106,-0.0298,0.0915,0.062,0.1003,0.11,0.0217,0.0992,-0.0345,-0.0709,0.0044,0.0201,0.0421,-0.0122,-0.0545,-0.0335,-0.035,0.0683,0.0424,-0.077,-0.0126,-0.0242,-0.1014,0.0087,0.0618,-0.0269,-0.0594,-0.0566,0.0051,0.0239,-0.0555,0.0177,0.0162,-0.0094,0.0728,0.0702,0.1327,0.1259,0.1665,0.079,0.0511,0.0344,0.0738,0.0834,0.088,0.1014,0.1192,-0.0216,-0.0256,0.0055,0.0051,-0.0171,-0.0228,-0.0058,-0.0324,-0.0512,-0.0884,0.0578,0.1024,0.0774,0.0265,-0.0318,-0.0123,-0.0198,-0.0511,0.0297,-0.0751,-0.0244,-0.0385,0.0138,-0.0313,-0.0114,0.0174,-0.0283,-0.0749,-0.0265,-0.0108,0.098,0.1298,0.0969,0.1468,0.1377,-0.0302,-0.0741,-0.048,-0.0131,0.0011,-0.0331,0.0658,0.0664,0.018,-0.0387,-0.0183,0.0101,-0.0129,0.0125,0.0036,0.0256,-0.0085,0.0002,0.0007,0.0473,0.132,0.1238,0.0813,-0.0471,-0.0575,-0.0077,0.0081,0.0159,0.0213,-0.0009,-0.0175,0.0222,0.0063,-0.02,0.0172,-0.0176,-0.1208,-0.0524,0.0122,0.0896,0.0038,0.0589,0.0168,0.0548,-0.0073,-0.1339,-0.206,0.1433,0.0899,0.0768,0.0518,0.0668,0.0786,0.0506,0.0905,-0.049,0.0312,-0.0929,-0.0067,0.0081,0.0679,0.008,-0.0119,-0.0811,-0.0134,0.0406,0.064,0.052,-0.0453,-0.0094,-0.0725,0.0891,-0.145,-0.061,0.0588,-0.0142,0.0484,0.0338,0.0549,-0.0681,0.0221,0.0762,-0.0159,0.041,0.0861,0.0418,0.0289,-0.0155,-0.0153,0.0507,-0.0395,-0.0104,-0.0394,-0.1588,-0.0367,-0.0408,-0.048,-0.0114,-0.0233,0.0782,0.0188,0.0047,0.027,-0.185,-0.1305,-0.211,-0.128,-0.156,-0.0987,-0.1956,-0.108,0.1541,-0.0357,-0.0662,-0.0104,-0.0101,0.022,-0.0105,-0.0512,-0.0361,0.0592,-0.0157,0.0334,-0.0114,-0.0504,0.0485,-0.0969,-0.1024,-0.0106,-0.0606,0.0469,0.0632,-0.0293,0.0299,0.0931,0.0163,0.0692,-0.0523,-0.0459,-0.0933,0.0816,0.0965,0.0714,0.07,0.0398,0.0071,-0.0689,-0.1293,0.0269,0.0283,0.0713,0.0519,-0.0712,0.0514,-0.1041,-0.1681,0.0365,-0.095,-0.1587,-0.2551,-0.2056,-0.1961,-0.1123,-0.0423,0.0606,-0.0224,-0.0215,-0.0146,0.094,0.0133,0.068,-0.1512,-0.0444,0.0406,-0.017,0.0702,0.01,0.0054,0.0832,-0.0458,-0.1632,-0.1087,0.0553,0.004,0.0701,-0.0213,-0.105,-0.0569,0.1449,0.1433,0.0246,0.0732,-0.0754,-0.0346,0.0852,0.0426,0.0831,0.053,0.0673,-0.0196,-0.1538,0.0131,0.0504,0.1401,0.0577,-0.0244,0.0179,0.0627,-0.011,-0.0972,0.032,0.0627,-0.0025,-0.0242,0.1555,0.0658,-0.016,0.1366,0.0838,0.1087,0.0388,-0.0789,0.0124,-0.0154,-0.0654,-0.0344,-0.0462,0.0539,-0.0493,0.0145,0.1251,0.0803,-0.0153,-0.0182,-0.0843,-0.0762,-0.0661,-0.087,0.1391,0.0358,0.0803,0.1204,0.1091,0.01,-0.0843,-0.147,0.1272,0.0983,-0.0226,-0.0985,0.1157,0.0032,0.0007,-0.0497,-0.0068,-0.1101,0.1253,0.1097,0.0653,-0.2041,0.0558,0.0132,-0.0203,-0.0203,0.1074,-0.0004,-0.0604,-0.0271,-0.0223,0.0442,-0.0094,-0.2689,0.1389,0.153,-0.0053,0.0305,0.1328,0.1486,0.0857,-0.0408,-0.0264,0.121,0.0469,-0.0346,-0.1586,-0.0547,-0.0732,-0.0112,-0.0192,-0.0154,0.0114,-0.0695,-0.0049,0.0703,0.0546,0.044,0.0482,0.0454,-0.1585,-0.0952,-0.0084,-0.277,-0.2112,-0.1877,-0.0006,-0.2349,0.0866,0.1035,0.0536,0.1498,-0.0459,0.1059,0.1457,0.0448,0.1294,0.1515,-0.1028,-0.0117,0.0779,0.0394,-0.0384,0.0578,-0.0107,-0.1129,0.0564,0.0246,0.0217,-0.0135,0.0525,-0.0455,-0.1392,-0.1378,-0.0817,-0.0905,-0.1301,0.0062,-0.1063,-0.1103,0.0814,0.0321,-0.016,0.1252,-0.0118,0.0231,0.0101,0.0363,0.0757,0.0737,0.0226,-0.0443,-0.0994,-0.0024,0.0515,-0.0267,0.0337,-0.0068,0.1209,0.1432,0.1489,-0.0432,0.0559,0.0506,-0.0023,-0.0039,-0.1386,-0.0388,-0.0252,0.0802,0.0732,-0.0477,0.0503,0.0753,-0.0493,0.0277,-0.1391,0.0629,0.0226,-0.0848,-0.0005,-0.0651,-0.0127,0.041,-0.0092,0.0202,-0.0344,-0.0314,0.1138,-0.0991,0.0015,-0.0644,-0.1601,0.0246,0.0085,-0.0469,-0.0432,-0.1284,0.0257,-0.0841,0.0973,0.07,0.1163,0.0891,0.0871,0.0205,-0.0273,0.0782,0.0952,0.0085,0.0377,-0.0196,0.0589,0.0478,0.0315,-0.0001,0.0166,0.0368,0.0396,0.0435,-0.0383,0.1244,0.0526,0.0233,0.0924,0.0285,-0.039,-0.0367,-0.0664,0.0281,0.0714,0.0757,-0.0584,-0.037,0.051,0.0438,-0.0485,-0.0825,-0.2067,0.0527,0.0328,0.0634,0.0086,-0.0296,-0.0244,0.0065,0.049,-0.0152,0.1511,0.0079,-0.0654,0.0184,-0.0184,0.0469,-0.0073,0.0336,0.085,-0.0304,0.0008,0.0223,-0.0874,-0.0556,0.0868,-0.015,-0.0467,-0.0195,-0.0122,-0.0026,-0.0905,-0.001,0.0329,0.045,0.0257,0.0121,0.0604,0.0149,-0.0614,0.006,-0.2119,-0.1853,0.0124,0.0175,-0.0567,-0.0307,-0.0416,0.0077,0.0294,0.0263,-0.0538,0.038,-0.0017,-0.0362,-0.1257,-0.0297,0.0374,-0.1775,-0.0164,0.1131,0.0995,-0.0656,0.0289,0.0117,0.005,0.0598,-0.069,0.0048,-0.0631,-0.0545,0.0358,-0.0358,-0.0041,-0.1102,0.0126,0.0022,0.0257,-0.072,0.0559,-0.0102,0.0607,-0.1114,-0.0047,0.0098,-0.0896,-0.0238,-0.0438,0.0595,0.0226,-0.0195,-0.1684,-0.1524,0.0346,0.0628,0.0041,0.0309,-0.041,0.0194,0.0854,-0.036,0.0035,0.0516,-0.0051,-0.0254,-0.1085,0.1295,-0.0523,-0.0411,0.0193,-0.0746,-0.0698,-0.1561,0.0654,-0.0693,-0.1297,-0.0028,-0.0187,-0.0009,0.0405,0.0675,0.0982,0.0395,-0.1031,0.0366,-0.0236,0.0993,0.0421,0.1158,-0.0915,-0.0084,-0.1079,0.1065,0.0085,0.0108,0.0238,0.0317,0.02,-0.0237,0.0133,0.0014,-0.0205,0.0093,-0.0392,0.0399,-0.0288,-0.0622,-0.0275,0.0307,-0.013,0.0226,-0.0124,0.0417,-0.0774,-0.0515,0.0895,-0.0139,0.0343,0.0405,-0.1728,0.1682,0.0932,0.1579,-0.0396,-0.0739,-0.0548,-0.0953,0.0437,0.0023,0.009,-0.0159,-0.0264,0.0444,0.0741,-0.0342,-0.0359,0.0346,0.0123,-0.078,-0.0416,-0.0412,0.0501,0.0146,0.0451,0.0199,-0.07,-0.0312,0.056,-0.0189,-0.0226,0.004,-0.0633,-0.1671,0.0761,0.0847,-0.064,-0.0313,-0.0309,-0.0886,0.0227,-0.0123,0.003,-0.0389,0.0389,0.0988,0.0328,-0.0071,-0.0137,-0.0921,-0.0554,-0.0877,0.0109,0.036,0.079,0.0404,0.0814,0.0943,0.0578,-0.0926,-0.0334,-0.0423,-0.0029,-0.0554,-0.12,-0.0112,-0.138,-0.1469,-0.046,0.0546,0.0401,0.0719,-0.0594,0.0784,-0.0327,0.055,0.1091,0.1042,0.0742,0.0259,-0.0946,0.0416,-0.1935,0.0315,-0.0275,-0.0234,-0.1032,-0.0466,0.0416,0.0211,-0.0028,-0.0152,-0.0183,-0.0791,-0.0253,0.016,0.1993,0.0969,0.1634,0.0314,0.0865,0.1673,0.0524,-0.0236,0.028,0.0123,-0.001,0.0794,-0.0702,-0.0517,-0.0079,-0.1643,-0.0981,-0.0039,-0.0272,-0.0096,0.0051,-0.0534,0.1113,0.0759,0.046,0.0498,-0.0356,-0.0231,0.0291,0.0993,0.0645,-0.0153,0.2036,0.0935,0.1489,0.1165,0.0466,-0.03,-0.0156,0.0948,0.1365,0.0769,0.0354,-0.0161,-0.0989,-0.0155,0.057,0.0031,-0.0118,0.1057,-0.0266,0.1007,0.0074,0.0179,0.0663,0.2124,0.0995,0.0904,0.1076,0.1831,-0.0731,0.1048,-0.0646,-0.0001,0.0277,0.028,0.0314,0.1306,-0.056,0.1275,0.2058,0.0585,0.0379,0.1372,0.0768,0.1353,0.1812,0.0814,0.0307,0.0203,0.0289,0.0168,-0.0713,0.0271,0.0371,0.011,0.0145,0.0515,0.1179,0.0974,0.0957,-0.0195,0.0117,0.0199,0.0146,0.1893,0.0402,0.0763,0.112,0.0324,0.073,0.0009,0.0529,0.0789,0.0573,-0.0421,-0.0211,-0.0447,0.059,0.0593,0.0948,-0.0341,0.0718,0.0024,-0.0407,-0.1921,-0.1292,-0.0066,0.0668,0.0614,-0.1389,-0.1134,-0.1792,0.0884,0.0977,-0.0267,-0.0411,-0.0167,0.0086,0.031,-0.0048,-0.0176,0.032,0.0312,0.0554,-0.0508,0.0334,0.0693,0.0327,0.0555,-0.0393,-0.0318,0.0388,-0.1397,-0.0998,0.0303,0.1799,0.0586,0.0765,0.0366,0.1695,0.1147,-0.2848,0.0777,0.0565,-0.2529,-0.1263,-0.2127,-0.1911,-0.1243,-0.1385,-0.0808,-0.0988,-0.084,-0.0439,-0.1366,-0.1729,-0.2508,-0.2864,-0.2345,0.1497,-0.0043,-0.0387,-0.2125,-0.0485,0.107,-0.0665,-0.0693,0.0336,-0.0228,-0.2262,-0.0176,-0.0448,-0.0974,-0.0455,-0.0334,-0.0948,0.0753,0.0476,-0.0749,-0.1024,-0.0777,-0.078,-0.0605,-0.0036,-0.0866,0.0386,-0.0011,0.0362,-0.0035,0.2345,0.0972,0.1083,0.1195,0.0741,0.1023,0.173,0.1079,0.088,0.0434,-0.016,-0.0696,-0.0976,0.0308,0.1004,-0.0657,0.0182,-0.0094,0.0088,0.0659,-0.0982,0.113,0.0545,0.1084,0.0194,0.1052,0.0358,0.0108,-0.1106,-0.0744,-0.1074,-0.0856,0.0693,0.0833,0.0318,0.075,0.0635,0.0603,0.0728,-0.0033,0.0162,0.1241,0.0224,-0.0368,-0.0049,-0.0225,-0.0965,-0.0583,0.0795,0.0712,0.0494,-0.0033,-0.0223,0.0261,0.0426,-0.0585,-0.0463,-0.0164,-0.0106,-0.0656,0.0531,0.0022,0.0737,0.0644,0.0086,0.0063,0.0091,0.0289,-0.1883,-0.1111,0.0975,0.0847,-0.1475,-0.278,-0.0375,-0.1706,-0.133,-0.2201,0.1146,0.1127,0.0494,0.0189,-0.1399,-0.1133,-0.0917,0.0244,-0.0072,-0.0888,-0.1496,-0.1413,-0.1962,0.0375,-0.023,0.0181,-0.0498,-0.0121,-0.134,0.1588,0.0435,0.0191,0.0643,0.0972,0.0982,0.0124,0.0198,-0.0529,-0.0829,-0.0394,0.0079,-0.0025,-0.1589,-0.0176,-0.0872,-0.0077,-0.0374,-0.0238,0.0526,0.0441,0.0892,-0.0046,0.1133,0.2075,0.19,-0.0563,-0.0986,0.0287,-0.0022,0.0153,-0.0994,-0.0501,-0.0106,-0.1076,0.0226,0.139,0.1568,-0.134,-0.0377,-0.0067,-0.0574,-0.0636,-0.1452,-0.1144,0.0137,0.0093,0.0283,0.0206,-0.1814,0.0007,0.0095,0.003,0.046,0.0103,-0.0203,-0.023,-0.0246,-0.0122,0.0959,0.0371,0.0775,0.0557,0.0517,-0.0454,0.0172,-0.0298,0.0387,0.0572,-0.0251,-0.1078,-0.0343,-0.0086,-0.0891,-0.0274,-0.0844,0.0154,-0.095,-0.0961,-0.0536,-0.0212,0.0178,-0.0318,-0.1128,-0.0744,0.003,0.0175,-0.005,-0.0176,0.039,-0.0368,0.0152,-0.0133,0.0619,-0.0548,-0.0217,-0.0051,-0.1552,-0.1756,-0.091,-0.1226,0.1532,0.0647,0.1166,0.0961,0.154,-0.1084,0.0448,0.0657,0.0576,-0.068,-0.0957,0.0423,0.0216,-0.0989,0.0385,-0.0264,-0.1341,-0.1411,-0.1442,-0.2491,-0.1353,-0.1286,0.061,0.0641,0.0286,-0.1043,0.0665,0.025,-0.029,0.0003,-0.0475,-0.0854,-0.0564,0.023,0.0105,0.1244,0.194,0.1298,0.0456,0.0371,0.0538,0.2204,0.0542,-0.0397,0.0025,-0.0603,-0.0732,-0.0477,-0.0709,0.0351,-0.1061,0.0608,0.0245,0.0692,-0.0876,-0.0133,0.1249,0.0517,-0.063,-0.1879,-0.1861,-0.0345,0.0101,0.033,-0.0264,0.0429,0.019,0.039,-0.0065,0.0671,0.0896,-0.0782,-0.0288,-0.062,-0.0204,0.1283,0.1072,0.0364,0.1237,0.0892,0.0723,0.0785,0.0264,-0.1214,-0.0663,-0.1073,0.1868,0.0767,0.0444,0.1796,0.1709,0.1135,0.0692,0.0692,0.0377,0.0258,-0.016,0.0683,-0.0449,-0.0808,-0.0649,-0.1183,-0.0413,0.133,-0.0799,-0.0054,0.0267,-0.0665,-0.0783,-0.267,-0.0873,0.0845,0.0419,-0.0183,-0.0621,-0.0393,-0.0439,-0.0659,-0.1136,-0.0901,-0.0659,0.0179,0.0018,-0.1321,-0.0511,-0.0128,0.0188,0.0338,0.0174,0.0794,0.0118,0.0437,0.0603,-0.0704,0.0366,0.0149,-0.0754,-0.0382,0.066,-0.0207,-0.0359,0.302,0.0743,0.3039,0.1181,0.0535,0.0932,0.0858,-0.2908,-0.2987,-0.1754,-0.1488,-0.1104,-0.0864,-0.0357,0.0246,-0.1033,-0.0763,-0.0007,-0.0648,0.0145,-0.0461,0.0432,-0.0376,-0.0441,0.0667,0.0338,-0.0128,-0.0167,-0.2226,-0.1121,-0.1974,-0.1052,-0.1504,-0.1242,-0.1509,-0.0656,-0.0574,0.0011,0.0332,-0.0221,-0.0623,0.0553,0.0168,0.1237,0.0394,-0.0153,0.0214,0.062,0.1017,0.038,0.0358,0.0288,-0.0161,0.0791,0.0485,-0.0179,-0.0062,-0.1084,-0.0185,-0.0731,-0.1115,0.0087,-0.0429,0.0512,0.062,-0.0299,-0.0111,-0.0362,0.0369,-0.0765,-0.0723,-0.1865,0.0307,0.0239,-0.0912,0.0036,0.0255,0.024,0.004,0.0357,-0.0208,-0.0191,-0.0102,0.0408,-0.0298,-0.0962,-0.2247,0.1454,0.1227,0.1511,0.0947,-0.0756,0.0261,0.0392,0.1141,0.0441,0.1095,-0.0475,0.0955,-0.0457,-0.0087,-0.0975,-0.0717,0.0355,0.0708,0.0032,0.0401,0.066,0.0123,-0.0616,-0.092,0.0237,-0.012,-0.0083,0.011,-0.0609,-0.0547,-0.1017,0.0249,0.0533,0.0709,0.0098,0.0914,0.1032,-0.0491,0.0944,-0.0513,-0.1297,0.006,0.0219,-0.0202,0.0637,0.0719,0.0091,-0.0105,-0.062,-0.0647,-0.0564,0.0114,0.0094,0.1044,0.1411,0.0777,0.0675,0.0572,0.0444,0.0842,0.1303,0.0255,0.1212,0.0367,-0.0448,0.0106,-0.026,0.1563,-0.0376,-0.0498,-0.0908,-0.0204,-0.0367,-0.0431,-0.068,0.0127,0.0616,0.0598,0.0766,0.0744,-0.0092,0.1202,-0.019,0.0027,0.0557,0.0783,-0.0349,-0.0212,0.0243,0.0521,-0.0722,0.0941,0.0186,0.1086,0.0537,-0.0252,0.1093,0.0652,0.197,0.0916,-0.0993,-0.0394,0.0537,0.0793,-0.0018,0.0114,0.0796,0.0582,0.1248,0.1081,0.036,0.0397,-0.0069,-0.0069,-0.0316,-0.0307,0.0163,-0.0206,-0.0412,-0.0175,-0.1,0.0552,0.0409,-0.0103,-0.0369,0.0934,0.0896,0.1125,-0.0108,-0.1135,0.0251,-0.0527,0.0277,-0.0962,-0.1159,-0.1192,0.0201,-0.0035,0.15,-0.0548,0.0185,-0.1665,-0.1785,-0.045,-0.032,-0.0078,-0.0637,-0.061,-0.0343,-0.0361,0.0098,0.1399,0.0497,0.0213,-0.0628,0.0652,0.0084,-0.0306,-0.0463,-0.0129,-0.0101,-0.0511,0.0577,-0.0084,-0.0171,0.0526,-0.0323,-0.068,0.0094,0.133,-0.1433,-0.0817,-0.0008,-0.089,-0.0321,0.0332,-0.0805,-0.0314,-0.0145,-0.0043,0.0307,-0.0876,0.0174,0.012,0.1301,0.1414,-0.0726,-0.0358,-0.0566,-0.0108,0.0304,0.1411,0.0402,0.0665,0.0921,-0.0662,-0.0511,-0.0229,0.0742,-0.063,-0.0309,0.1231,0.0133,0.0603,0.1026,-0.0893,0.0437,0.0007,0.1974,0.1173,-0.0425,-0.0805,0.0308,0.0078,-0.0078,0.0313,0.1061,-0.0665,0.0667,-0.0348,0.086,0.0777,-0.0132,-0.0584,-0.1523,-0.0868,-0.1173,0.082,0.0963,0.0562,0.04,0.1323,0.0571,-0.0721,0.0992,0.0563,0.0264,0.0513,-0.0227,0.0128,-0.0069,0.0176,0.0863,-0.0232,0.0052,0.141,-0.009,0.0204,0.0904,0.1603,-0.1066,-0.0883,0.037,-0.0168,-0.0022,-0.0327,-0.1326,-0.1301,0.0657,0.0611,0.0835,0.0792,-0.0564,-0.0021,-0.0362,0.045,0.0419,0.0132,-0.1432,-0.0724,-0.0415,-0.1709,0.0925,0.1202,0.0987,0.0704,0.0187,0.0403,0.0824,0.0366,-0.0175,-0.0429,0.0106,-0.0647,-0.1322,-0.0007,-0.2176,-0.1845,-0.2199,-0.0647,-0.0547,-0.1341,0.0548,0.0642,0.0066,-0.0448,-0.1043,-0.0821,-0.047,-0.0428,-0.1571,-0.0874,-0.1634,-0.0366,-0.0124,0.1214,-0.0112,-0.0658,-0.0554,0.0205,-0.0035,-0.0341,0.0504,0.0108,-0.0037,0.0292,0.0289,0.0749,0.0329,0.0524,0.0164,-0.0556,-0.0191,-0.0824,-0.0415,-0.0296,0.0132,0.0218,-0.044,-0.1119,-0.021,-0.119,-0.0889,-0.019,-0.0761,-0.0657,0.0206,-0.0157,-0.1395,-0.0382,-0.1006,-0.1551,-0.06,-0.0646,0.0081,-0.0131,0.0434,-0.0869,-0.0082,0.0132,-0.0676,-0.1458,-0.1377,0.0914,-0.0416,-0.0161,-0.146,-0.0197,0.0133,-0.0914,-0.0931,-0.033,-0.072,-0.1213,-0.1266,-0.0458,-0.0535,-0.1586,0.0314,0.0886,0.0114,-0.0313,-0.1006,-0.0768,0.0007,0.0434,0.063,0.0145,-0.0151,-0.1842,-0.0418,0.0293,0.0557,0.06,0.077,0.0038,0.0547,-0.0228,-0.0017,-0.0077,0.0203,0.0787,-0.1862,-0.1485,-0.1227,0.0921,-0.183,-0.1761,0.0004,-0.0592,-0.0482,0.0226,-0.1394,-0.0994,-0.1358,-0.0498,-0.0201,-0.1347,-0.036,-0.0753,-0.0527,-0.0386,-0.0024,-0.1042,-0.1017,0.0027,0.0216,-0.034,-0.0345,-0.0954,0.0364,0.0218,0.0245,-0.1118,-0.0942,-0.1103,-0.0717,-0.0277,0.0334,-0.0296,-0.1105,-0.1072,0.0887,0.0139,-0.0061,-0.0901,-0.0171,0.0332,0.1251,0.1473,0.0459,0.0443,-0.22,0.0729,0.0782,-0.039,-0.1546,-0.1527,-0.1208,-0.0941,-0.1449,-0.1196,-0.2091,-0.0607,-0.0249,-0.001,-0.0106,0.0397,-0.0043,0.1299,0.1036,0.0679,-0.18,-0.096,0.0218,0.0992,0.1057,0.0347,0.0948,0.0282,-0.1109,-0.0089,-0.0207,-0.0737,0.0694,0.0805,0.1462,0.0487,0.1102,0.0073,0.0628,0.0519,0.0011,-0.2317,0.0455,0.011,0.0019,-0.0826,0.001,0.1092,-0.0755,0.086,0.0034,0.0701,0.1034,0.0376,0.0317,0.043,0.021,-0.0485,0.1098,0.0646,0.0007,-0.0649,-0.0227,-0.0491,0.0121,-0.0053,0.1393,0.0787,-0.031,-0.0894,0.0011,0.0045,0.051,-0.0004,0.0513,0.0376,-0.0976,-0.3158,-0.072,-0.2338,-0.2184,0.0174,-0.2628,0.0704,-0.0908,-0.1579,-0.1518,-0.2288,-0.2005,-0.1974,-0.0365,0.026,-0.0408,-0.0245,-0.0233,-0.1924,-0.1946,-0.0795,-0.1202,-0.0277,0.0708,-0.0633,-0.0203,0.0314,0.1093,0.0525,0.1506,-0.0127,0.0426,0.0542,0.0191,-0.0341,-0.015,0.0251,0.077,0.0937,-0.2197,0.0346,0.1202,-0.2197,-0.1459,-0.1448,0.0318,-0.0735,-0.0058,-0.065,0.0003,0.0069,0.033,-0.0049,-0.0713,0.0323,0.0389,-0.0777,0.0209,0.0446,0.0368,-0.079,-0.0497,0.1036,-0.0221,0.018,-0.1148,-0.1411,0.0171,-0.0871,-0.1401,-0.0904,-0.065,0.1003,0.0315,-0.0663,0.0481,0.1074,-0.2468,-0.1861,0.0443,-0.1126,-0.0656,-0.0633,-0.041,0.0875,0.0692,0.1332,0.0876,0.0553,0.0099,0.0031,-0.0115,0.1159,0.0206,0.0082,0.0916,-0.0321,-0.0397,0.0506,0.0248,0.0682,0.0436,0.0689,0.0222,0.0922,0.1204,-0.016,0.0545,0.068,0.0883,0.056,0.0261,0.0181,-0.0272,-0.0983,-0.0676,-0.0408,-0.0219,-0.0466,-0.0031,-0.1367,0.0483,-0.1399,0.0068,0.0787,0.0176,-0.0808,-0.1277,0.0346,-0.1588,-0.1348,0.0123,0.0939,-0.203,-0.0378,0.0303,-0.0824,0.0911,0.0711,0.1071,-0.0461,0.0054,-0.0858,-0.1048,0.161,0.1657,-0.0791,-0.1069,-0.0047,-0.1075,-0.0353,-0.0091,0.073,0.1293,0.0628,0.0917,0.1638,0.0821,0.0566,-0.0211,0.0093,0.0102,-0.063,-0.1272,0.0369,-0.0387,0.0652,-0.0462,-0.059,0.0145,0.0096,-0.0096,0.0579,0.0316,0.0951,0.026,0.0835,0.0763,0.088,0.0403,0.078,-0.0002,0.0494,-0.0296,0.0207,0.0538,-0.0634,-0.0666,-0.0527,-0.1233,-0.0242,0.019,0.0092,-0.0204,-0.0033,0.0795,0.0769,0.0388,-0.0941,0.0316,-0.1058,0.0296,-0.0034,0.0404,0.0555,-0.008,-0.0378,-0.01,-0.1044,0.0415,0.1042,-0.0456,0.0648,0.0334,0.0134,-0.096,-0.2418,0.121,-0.0232,0.0848,0.0047,-0.06,0.1433,0.1433,0.0499,-0.0518,0.0301,0.0226,0.0372,0.1299,0.0376,-0.1122,-0.0329,-0.0314,0.01,-0.0267,-0.0439,0.1188,0.0244,-0.0321,0.0798,0.007,0.0717,-0.2795,0.1279,-0.0288,0.1202,0.0994,0.143,0.1241,-0.0152,0.0931,0.0448,0.0308,-0.1154,-0.069,0.0937,0.0638,-0.0007,-0.1707,-0.1738,-0.1625,-0.0355,-0.0556,-0.1028,0.0395,-0.0177,-0.1435,-0.2363,-0.0838,-0.1479,-0.1333,-0.0359,-0.0642,-0.1039,-0.1044,-0.2151,-0.1407,-0.0045,-0.0894,-0.1097,-0.0976,-0.1169,-0.2451,-0.0612,-0.1579,-0.1466,-0.0319,0.0731,0.0943,0.1195,-0.0992,-0.0738,0.1546,0.1361,0.0795,-0.1877,-0.0658,0.1592,0.1666,0.0534,-0.0486,0.0353,0.1446,-0.1472,-0.0317,0.0674,-0.0331,0.0186,0.0362,0.0391,0.0718,0.0801,-0.023,0.1532,0.1575,-0.0903,-0.0522,0.0224,0.0035,0.0003,0.0594,0.0927,0.0182,0.0896,0.0033,-0.093,0.0761,-0.0455,-0.0114,0.0102,0.096,0.0918,0.0012,0.1094,-0.0813,0.0344,-0.0226,0.0872,0.0369,-0.1141,0.1415,0.0884,0.0694,0.0293,0.0478,-0.0115,arithmetic processing
trm_557b4b154e0d9,-0.0699,0.0135,-0.0341,-0.0274,-0.0147,0.0132,-0.0626,-0.0409,-0.0461,-0.0516,0.0128,-0.0229,-0.0319,-0.0264,-0.0252,0.0346,0.0002,-0.0374,-0.0328,0.0381,-0.0079,-0.0068,0.0026,-0.0049,0.0251,0.0139,0.0074,-0.0484,-0.0548,-0.0316,-0.0463,-0.0325,-0.0457,-0.0489,-0.0622,-0.0015,-0.0022,-0.0482,-0.0329,0.0124,-0.0176,0.02,-0.0052,0.0566,-0.0167,-0.0066,0.0936,-0.0893,-0.0029,-0.082,-0.0302,-0.0461,-0.0073,-0.0258,-0.0032,-0.0555,-0.0583,-0.0261,-0.0063,-0.0095,0.04,0.0352,-0.0213,-0.0057,0.0013,-0.0116,-0.0271,-0.0932,-0.0755,-0.0217,-0.0047,0.0294,0.0241,-0.0342,-0.0689,0.0377,-0.0377,0.0227,0.0537,0.0262,-0.0044,-0.0111,-0.0252,-0.0439,-0.0039,0.0125,-0.0285,0.0194,-0.0176,-0.0706,0.0171,-0.0542,0.0458,0.1216,0.0996,0.1207,0.0307,-0.0172,0.0094,0.0264,0.0878,0.0189,0.006,0.026,0.028,-0.0424,-0.0217,0.0005,-0.0002,0.0204,-0.0022,-0.0405,0.0449,0.0375,0.0302,0.0605,-0.0453,0.0475,-0.0664,-0.0636,0.0046,-0.0224,-0.0277,-0.0354,-0.0477,-0.0167,-0.0154,0.0243,0.0055,-0.0387,-0.0274,-0.0594,-0.0293,-0.0972,0.0246,-0.0491,-0.0456,-0.0359,0.0538,-0.0364,-0.0329,-0.0729,0.0205,0.0001,0.0217,0.0675,-0.0995,-0.0006,-0.003,0.0055,-0.0271,0.0445,-0.0292,-0.0609,0.0256,0.0149,0.055,0.064,0.044,0.0087,0.0053,-0.0073,-0.0547,-0.0699,0.006,0.0546,0.0014,-0.035,-0.0302,-0.0017,0.0607,0.0285,0.0516,-0.1097,-0.0983,-0.028,-0.0665,-0.074,-0.0718,0.0096,-0.0434,0.0189,0.0131,-0.032,-0.0227,-0.0488,-0.0163,-0.0324,-0.0455,0.0228,0.0258,-0.0407,0.0162,-0.0937,-0.0969,-0.0791,-0.0919,0.0081,0.0501,-0.0806,-0.1029,0.1433,-0.042,0.0185,0.0189,-0.0483,-0.0597,-0.0201,-0.0236,-0.0235,-0.0721,-0.06,-0.0105,-0.0448,0.0112,-0.0035,0.0387,0.0001,-0.0282,0.0567,0.0338,-0.0545,0.015,-0.0064,0.065,0.013,0.0502,0.0391,-0.0206,0.0384,0.1264,-0.0339,0.053,0.0167,0.0161,-0.0157,-0.0303,-0.051,-0.0065,-0.0321,0.0247,-0.07,0.0187,0.0117,-0.0381,-0.0167,-0.0185,-0.0139,-0.0149,-0.0404,-0.0144,-0.0021,-0.0046,0.0152,-0.0013,-0.0468,0.0181,-0.0377,0.0238,0.0866,0.0235,0.0812,-0.0431,0.0549,0.0554,0.0593,0.0192,-0.0454,0.0764,0.0327,0.0339,-0.032,-0.0435,-0.026,-0.0416,0.0136,-0.0541,-0.0666,-0.0503,0.0259,-0.0138,-0.0215,-0.0235,-0.0528,-0.0265,0.0073,0.0422,0.0126,-0.0507,-0.0381,-0.0238,-0.0636,-0.013,0.0196,-0.0179,0.0274,-0.0436,0.0329,0.019,0.0199,-0.031,-0.0824,0.0186,0.0394,-0.0497,-0.038,-0.048,-0.0306,-0.0333,-0.0415,-0.0319,-0.0183,0.0067,-0.0541,0.0044,-0.0184,0.0178,-0.0009,0.0054,-0.0443,-0.0194,-0.0314,-0.0117,-0.0176,-0.0106,-0.0093,0.0347,0.0067,-0.0649,0.0657,0.0132,-0.0804,-0.0678,-0.0032,-0.0148,0.0109,0.0243,-0.0163,0.0161,-0.0887,-0.0808,0.0283,-0.0033,-0.0729,0.0395,-0.024,-0.0905,-0.0265,-0.0705,-0.039,0.0035,0.0664,-0.0243,-0.0176,-0.0274,0.0139,-0.0116,-0.0556,-0.0908,-0.0511,-0.0061,-0.0091,-0.0851,-0.0056,-0.0124,0.0155,-0.0273,0.0441,0.1021,-0.0727,0.0594,0.0225,0.0653,0.0078,-0.0423,0.0158,0.0386,0.0261,0.0387,0.0553,0.058,0.0354,-0.0277,0.024,0.0285,0.0098,-0.0075,-0.0356,-0.0208,-0.0226,-0.0629,0.0691,0.0823,0.0457,-0.0611,-0.063,-0.0163,-0.0262,-0.0285,0.0044,-0.0568,0.0178,-0.0294,-0.0125,0.027,-0.0139,0.0175,-0.0096,-0.039,0.0261,0.0239,-0.007,0.0005,0.1003,-0.0126,-0.0295,0.0522,-0.0067,-0.0331,-0.0486,-0.0284,-0.0838,-0.049,-0.0737,-0.081,-0.0398,-0.0612,-0.0299,-0.0632,-0.0198,0.0277,0.0326,-0.028,-0.0396,-0.0088,-0.0088,0.0697,0.0198,-0.0684,-0.0946,0.0979,0.0181,0.0569,0.0333,-0.0051,-0.0247,0.023,0.0395,-0.0336,-0.073,-0.0264,0.0183,0.0003,-0.0406,-0.0407,-0.065,0.0266,-0.0273,-0.0168,-0.0487,-0.0062,0.0039,-0.0165,0.1146,-0.0109,0.0163,0.0802,0.0982,0.0091,-0.0126,0.0057,-0.0274,-0.0069,-0.0326,-0.0197,0.0181,0.0296,0.031,-0.0248,-0.0288,0.0958,-0.017,0.0633,-0.0106,0.0163,0.0385,-0.0086,0.0322,0.0058,-0.0313,0.0644,0.0009,0.0938,0.054,0.0954,0.0243,-0.0321,-0.0178,0.0631,-0.0513,-0.0472,0.0434,-0.0338,0.0123,-0.0755,-0.0112,0.0269,0.0273,0.0018,0.062,-0.0746,0.0119,-0.004,-0.0037,0.0178,0.0084,-0.1163,-0.1092,0.0358,-0.0653,-0.0734,-0.0049,0.0355,0.0169,-0.002,0.0155,0.0174,-0.007,-0.0433,0.0203,-0.0474,-0.0137,0.0138,-0.0093,-0.049,0.0269,0.0092,0.0568,0.0462,-0.0361,-0.0055,0.0115,-0.0126,-0.0311,-0.0598,0.0115,0.0014,-0.0275,-0.007,0.0283,-0.0229,-0.0252,0.0316,-0.0371,0.0003,0.0109,-0.0234,-0.0234,0.0092,-0.0265,0.0212,0.0516,0.0061,0.0286,0.0016,0.0496,0.0555,0.0022,-0.0216,-0.0391,-0.0037,0.0033,-0.0235,-0.0158,0.0694,0.0383,-0.0171,0.0314,0.037,0.0107,-0.0495,-0.0119,0.0032,-0.0099,0.0056,0.0534,-0.0475,0.0158,-0.0,-0.0091,-0.0267,0.0169,0.0012,-0.0163,-0.0028,-0.0134,-0.0727,-0.0398,0.0746,0.0262,0.0816,-0.0134,-0.0104,-0.0044,0.0708,0.024,-0.0285,-0.0754,-0.0727,0.013,-0.0577,-0.0448,0.0028,-0.0491,-0.0716,-0.004,-0.0032,-0.0272,0.0164,0.0017,-0.0389,-0.0128,0.0834,0.0314,0.0279,0.0426,-0.0708,-0.0754,-0.0295,0.039,0.0507,-0.0229,0.0118,-0.0688,-0.0332,0.0262,0.0074,0.0487,-0.0751,-0.0517,-0.0348,0.0397,0.0139,0.0782,0.0186,-0.029,-0.0939,-0.0803,0.0097,0.0028,-0.0517,0.0179,0.1022,0.0601,-0.0225,-0.0326,0.0519,-0.0273,-0.0145,-0.0156,-0.0394,0.054,0.0348,0.0173,-0.009,0.0595,-0.0473,0.0241,0.0292,-0.0638,0.0026,-0.0131,0.0126,0.1145,0.0218,-0.0373,0.0336,0.0071,0.0535,-0.0305,0.0283,0.0252,0.0625,0.0427,0.0532,-0.0327,-0.0554,0.015,0.011,0.0242,-0.0794,0.0945,0.0512,0.0605,0.1282,0.0296,0.0319,-0.0425,-0.0668,-0.0737,0.0138,0.0176,-0.0201,0.0041,-0.0601,-0.0578,0.0082,0.0576,0.0693,-0.0087,0.0346,-0.01,-0.0177,0.0263,-0.0055,-0.0158,0.0164,0.01,-0.0032,0.0106,0.0185,-0.0556,0.0226,0.0331,-0.0045,0.01,-0.0108,-0.0519,-0.0596,-0.0113,0.0517,-0.0114,0.0111,0.0379,0.0491,0.0152,-0.0667,-0.0249,0.0248,0.0107,-0.0601,0.0111,-0.0118,0.0155,-0.0086,-0.0428,0.0436,0.0036,-0.0009,0.0279,-0.0279,0.0128,-0.0988,-0.0797,-0.0623,-0.051,0.0768,0.1068,0.0379,0.0004,0.0315,-0.039,0.0048,0.078,-0.005,0.0766,-0.0306,-0.0329,0.0263,-0.0256,0.0594,0.0809,-0.0222,-0.0517,-0.0063,-0.0266,0.0583,-0.02,0.0213,0.0213,-0.0664,-0.0618,-0.0301,0.0323,0.0813,0.0255,0.0096,-0.0612,0.005,0.0476,0.0272,-0.0439,0.0505,0.013,0.0446,0.0018,0.0441,-0.01,0.0091,-0.0941,-0.0976,0.0287,0.0774,0.1206,0.0117,-0.0466,0.0371,0.0,0.0906,0.0392,0.0245,0.0432,0.0495,0.008,0.0355,0.0461,0.0252,-0.0027,0.0219,0.008,-0.003,-0.0255,-0.0162,0.0395,-0.0115,-0.0228,-0.1139,-0.0542,-0.0354,-0.0398,-0.0903,0.0286,0.0026,0.0342,-0.007,-0.0098,-0.0198,-0.034,0.0133,0.0561,0.0329,0.0768,0.0229,0.0866,0.0172,0.0377,0.0472,0.0089,0.0006,0.0769,0.0453,0.0156,-0.0438,-0.056,-0.0201,-0.0337,-0.0431,0.0057,-0.0864,-0.0226,0.0495,0.0174,0.0269,-0.0262,0.0155,0.0346,-0.0273,-0.0305,0.0848,-0.0842,0.0312,-0.0351,0.1085,-0.0306,0.05,-0.0558,-0.0147,-0.0469,-0.089,-0.0789,-0.0227,0.1376,-0.0314,-0.0658,0.0183,0.0146,0.0226,-0.0762,0.0064,-0.0666,0.0425,-0.0442,0.0328,0.0211,-0.0186,0.0964,-0.0632,-0.0262,-0.009,-0.0341,-0.087,-0.0179,0.1089,0.0153,0.0292,0.1595,0.0403,-0.0535,-0.0691,-0.0117,0.0119,-0.0053,-0.061,0.0479,0.0796,-0.0349,-0.01,-0.0256,0.0496,0.0487,-0.0305,0.0041,-0.0473,0.037,-0.0054,-0.0152,0.0005,0.0469,0.043,-0.0529,-0.0324,0.0426,0.0276,0.0149,-0.0274,0.0424,0.0358,-0.0103,-0.0268,-0.0337,-0.0313,-0.1049,-0.0861,-0.1188,-0.0401,-0.0374,-0.0157,-0.0735,-0.0497,-0.0911,-0.0623,-0.0828,-0.0188,-0.0454,0.0036,0.0153,0.0449,-0.0069,0.0305,0.0396,0.0665,0.0331,0.0504,0.0281,0.0477,-0.0355,-0.0008,-0.0393,-0.0122,0.0556,-0.0099,0.0598,-0.0066,0.0132,-0.0073,0.0369,0.02,0.0089,-0.0058,0.0691,-0.0177,0.0525,-0.0882,-0.0265,-0.022,0.0278,0.0236,-0.0446,0.0081,-0.0117,0.0297,0.0846,0.0615,-0.0081,-0.0141,-0.0134,-0.0083,-0.0052,0.037,-0.036,-0.0163,0.0194,-0.0295,0.0046,0.0071,-0.0192,-0.0187,-0.0312,-0.0853,-0.04,0.0611,0.0327,0.0261,0.0367,0.0196,-0.0006,0.0376,0.0393,-0.0162,-0.0319,-0.0211,0.0002,-0.0294,-0.0176,0.0008,0.0249,0.0041,0.0083,-0.0073,0.0163,-0.0165,-0.0128,0.0605,0.0811,0.0062,0.0111,-0.0281,-0.0023,-0.0121,-0.0865,-0.0276,-0.044,0.0193,-0.0284,0.0108,0.014,-0.0059,-0.0288,-0.0279,-0.0206,-0.0144,0.0208,-0.0496,-0.0135,-0.0395,0.0353,0.0342,0.0624,-0.0387,0.0824,0.0303,-0.0405,0.0222,0.0099,0.0158,-0.0175,0.0066,-0.0363,-0.0106,0.0161,-0.0465,-0.0394,0.0329,-0.064,-0.0251,-0.0626,-0.0516,-0.0151,0.0067,0.0115,0.0626,0.0691,0.0329,0.0221,0.0068,0.0078,-0.0677,0.0371,-0.0013,-0.0167,0.1715,0.1204,0.089,0.0497,0.0574,0.046,0.076,0.0635,-0.1031,-0.0125,0.0344,-0.0031,-0.0148,-0.0205,-0.0696,-0.0143,-0.0515,0.0221,0.006,-0.0245,-0.0327,0.0564,-0.0376,0.0091,0.0258,0.0079,0.0295,0.0087,-0.029,0.0308,0.0268,-0.0335,0.0108,-0.0878,-0.0412,0.0126,0.0305,0.0014,0.011,-0.0794,-0.0563,-0.0152,0.0364,0.0502,-0.0129,-0.0032,-0.0332,-0.0575,-0.079,0.0234,-0.1098,0.0806,0.0782,-0.0181,0.0244,0.0304,0.0264,0.0255,-0.0088,0.1205,0.0028,-0.0102,0.035,0.0007,0.0526,0.0339,-0.0243,-0.0476,0.0593,0.0387,-0.0447,-0.0266,-0.034,0.0059,-0.0263,-0.042,0.0185,0.023,0.1262,-0.0249,0.0424,-0.0008,0.0288,0.0236,-0.0203,-0.0757,-0.0934,0.022,-0.0323,-0.0002,0.0455,0.0081,-0.0564,-0.0277,-0.034,-0.0162,-0.0196,0.0465,-0.0171,-0.0644,-0.0732,0.0037,-0.0509,0.0651,-0.0349,0.0563,0.1021,0.0024,-0.0553,0.1097,0.0711,-0.0064,-0.0608,-0.0107,-0.058,-0.07,-0.0134,0.022,0.0061,0.0636,0.0387,-0.035,0.0496,0.0067,-0.0622,0.0599,0.0248,-0.0304,-0.0782,-0.0324,0.0197,0.0713,0.0137,0.0755,0.0748,-0.0714,-0.0079,-0.034,-0.0501,-0.0153,0.049,-0.0373,0.0623,-0.0663,-0.0409,0.0346,0.0751,-0.0156,0.0488,0.047,0.0324,0.0107,0.0356,-0.0422,-0.0305,-0.0291,0.1184,-0.0317,0.0173,-0.0451,-0.0451,-0.0642,0.088,0.0523,0.0393,-0.0276,-0.0061,0.0475,0.1934,-0.0923,-0.0723,0.0042,-0.0525,-0.1013,-0.1021,-0.0858,-0.0414,0.0034,-0.0354,-0.0468,-0.0052,0.0922,0.0049,-0.034,-0.0213,0.0268,-0.0062,-0.0803,0.0022,-0.0477,-0.0454,-0.0444,-0.0327,0.0161,-0.0172,-0.0592,-0.028,-0.013,0.1209,0.0697,0.0174,0.0455,0.1117,-0.1107,-0.0715,0.0089,-0.0716,0.0351,-0.0475,-0.1191,-0.0107,-0.056,-0.0401,0.0107,-0.0051,-0.0668,-0.0455,-0.0519,-0.0595,-0.1089,-0.0195,-0.0607,-0.0735,0.0065,-0.0158,-0.0335,0.1131,-0.0017,0.0034,0.0113,0.0142,0.0712,-0.0359,-0.0701,-0.069,-0.0376,-0.0263,-0.0268,-0.0271,0.0386,0.0232,-0.0148,0.0399,-0.0659,-0.0362,-0.0027,-0.0245,0.0093,-0.053,-0.0464,0.0542,0.0234,0.0354,-0.0315,-0.0456,-0.0764,-0.0006,0.0185,0.0139,0.0555,0.0553,0.0543,-0.0103,0.0413,-0.0496,-0.0508,0.0118,-0.073,0.0233,0.0007,-0.0333,0.0399,0.0668,0.007,-0.0078,0.0098,0.1163,0.0262,0.0027,-0.0111,-0.0685,-0.056,-0.0694,-0.0487,0.0901,-0.0419,0.0029,0.0661,0.0148,-0.0178,-0.0447,0.0039,0.0714,-0.0208,0.0271,-0.0722,-0.0294,-0.0729,-0.0347,-0.0009,0.0072,-0.0065,-0.0201,-0.0638,-0.0145,0.0039,0.0325,-0.0505,-0.0626,-0.0035,0.0197,-0.0219,-0.0191,-0.0312,-0.0248,0.0531,-0.0064,-0.0195,-0.0151,0.0048,-0.013,-0.0146,-0.0479,-0.0117,-0.0132,0.0057,-0.0052,0.0147,0.0024,0.0815,0.099,-0.0168,-0.0218,0.0531,-0.03,0.0147,0.0447,-0.01,0.0027,-0.0257,0.0004,-0.036,-0.0287,-0.0895,-0.0019,-0.0354,0.006,0.0212,0.0171,-0.0477,-0.0023,-0.0279,-0.0072,-0.0369,-0.008,0.0979,-0.0069,0.016,0.026,0.1093,0.0068,0.0257,-0.0108,0.0565,0.0097,0.0195,-0.0197,-0.0376,-0.0302,-0.0601,0.0218,0.017,-0.0491,0.0301,0.0564,0.0123,-0.0056,0.06,-0.0232,0.0739,0.004,-0.1164,-0.0666,-0.0202,-0.1081,-0.0899,0.052,0.0742,0.0026,-0.0133,0.0428,-0.0037,-0.0804,-0.0382,0.0706,-0.0176,-0.0751,0.022,0.0182,0.0147,0.0347,0.0343,-0.024,-0.052,0.0296,-0.0261,0.0536,0.0135,0.0109,0.0136,-0.0088,0.0059,-0.0044,-0.0317,0.0295,-0.0224,0.0185,0.016,0.0022,-0.0465,-0.0359,-0.0574,0.0825,0.1626,0.1567,0.0603,0.0576,-0.0142,-0.0484,0.0093,-0.009,-0.0663,0.0244,-0.0131,-0.024,-0.0242,0.0632,0.0028,-0.0108,0.024,-0.0026,0.0456,0.0299,0.1118,0.0165,-0.0264,0.0909,0.0175,-0.004,0.0393,0.0309,0.0051,0.0885,0.0577,-0.0608,0.035,0.0153,0.0233,0.0332,0.0415,0.0139,0.017,-0.0026,0.034,-0.0782,0.0108,0.0645,0.0373,0.0511,-0.0767,-0.0501,-0.0231,0.0054,-0.0091,-0.063,-0.0274,-0.0211,0.0081,0.0303,0.0549,0.0332,0.0596,0.0066,-0.0263,0.0577,-0.0262,0.0211,0.0041,0.0845,0.0117,0.0225,0.2147,-0.0776,0.0386,-0.005,-0.052,-0.0332,-0.0226,-0.0067,-0.0075,-0.0107,-0.0353,-0.0193,0.0455,-0.026,-0.0274,-0.0193,0.0221,-0.0017,0.0313,0.0556,0.0744,0.0783,-0.0748,-0.0635,-0.0454,-0.0399,0.0353,0.0188,0.0486,-0.0339,-0.0286,0.0116,-0.0199,0.0355,-0.0694,-0.0132,0.0183,0.0541,0.0433,0.0735,0.0144,0.0658,0.0519,-0.0165,-0.0051,-0.0203,-0.0289,0.0608,-0.0127,-0.0671,-0.0779,-0.099,0.0458,-0.0237,-0.0456,-0.0204,-0.0676,-0.049,0.0015,0.0287,0.03,-0.0411,0.0391,0.0532,-0.0351,-0.0103,0.0369,0.1507,0.1087,-0.0452,0.0035,0.0046,0.0271,-0.0997,-0.007,-0.0348,-0.0294,-0.0003,0.0717,0.0091,0.0206,0.0012,0.0662,-0.0005,-0.0106,-0.0153,0.0368,-0.0007,-0.0316,-0.0232,-0.0176,-0.0261,0.0091,0.0601,0.0495,-0.0113,-0.0781,-0.0299,-0.0528,-0.0391,0.0343,-0.015,-0.0354,-0.0208,-0.0614,0.0143,0.0166,-0.0152,0.0671,0.0232,0.0559,0.0647,0.0536,0.0553,-0.0101,0.007,-0.0293,-0.0245,-0.0704,-0.0305,-0.0391,0.0019,0.0586,0.0732,0.0346,-0.0107,-0.0094,-0.0464,-0.1211,-0.0518,-0.0959,-0.0305,0.0128,0.0238,0.0021,-0.0406,-0.044,-0.0601,-0.0475,0.0343,0.079,0.0023,0.0131,0.0222,-0.0006,-0.058,-0.0073,-0.006,0.0231,-0.012,-0.0512,-0.0789,-0.0438,-0.0277,-0.0728,-0.0826,0.0732,-0.0331,0.0195,-0.0003,-0.0124,0.0098,-0.0488,-0.0724,-0.0076,-0.0143,0.0053,0.0378,-0.0084,0.0191,0.0049,0.0116,-0.0599,-0.0395,0.0096,-0.0515,-0.051,0.004,0.0483,-0.0351,-0.0565,-0.0266,-0.0241,-0.0379,-0.0426,-0.0406,-0.0167,0.0089,-0.0057,0.0242,0.0313,-0.0994,-0.0172,-0.0611,-0.0563,-0.0525,-0.0905,-0.0194,-0.0608,-0.0106,-0.0376,0.0961,-0.0143,-0.0045,0.0407,-0.0337,-0.0195,-0.0124,-0.0737,-0.0286,0.0594,0.0471,0.0429,0.0481,-0.0362,0.0074,0.0574,0.066,0.0536,0.044,0.0143,-0.0084,0.0393,0.0165,-0.0289,0.0199,0.0089,0.0477,-0.0144,-0.0234,-0.0284,-0.0169,-0.0432,-0.0207,-0.0062,0.0127,-0.0201,-0.0038,0.0121,0.0849,0.0372,-0.0868,-0.1188,-0.0371,-0.0372,-0.0487,-0.1004,-0.0649,0.1871,-0.046,-0.0295,0.0426,-0.0045,0.0539,0.0239,0.0049,0.0078,-0.0001,0.0051,0.0103,-0.0331,0.0237,0.0438,0.049,0.0665,0.1213,-0.0848,-0.0539,-0.0017,0.1831,-0.0211,-0.0433,0.0319,0.0324,-0.0205,-0.0571,0.1221,0.0428,-0.0243,-0.011,-0.1242,-0.1145,-0.0469,-0.0582,-0.0076,0.0603,0.0401,0.0422,-0.0024,0.0421,0.0802,0.1202,0.0388,0.0149,-0.0035,0.0443,-0.1023,-0.0493,-0.0286,-0.0616,-0.0425,-0.0644,-0.0593,-0.0403,-0.0629,-0.0522,-0.0547,0.0164,0.0673,0.0793,-0.0098,0.0131,0.0699,0.0344,0.0117,-0.0317,-0.0156,-0.039,-0.0341,-0.025,-0.0345,-0.0192,0.03,-0.0249,0.0404,0.0088,0.0671,0.0259,-0.0149,0.0056,0.0169,-0.0629,-0.0497,-0.0296,-0.0429,0.0556,-0.0014,-0.0762,-0.0643,0.0034,0.0548,0.0179,-0.086,-0.0155,-0.0557,-0.0361,-0.0457,0.0076,0.0427,-0.0029,-0.0328,0.0082,0.0417,-0.0186,0.0314,0.0529,-0.1142,-0.0798,-0.0533,-0.0422,0.0761,0.0495,0.0303,-0.0406,0.2091,0.136,-0.0498,-0.0269,0.157,0.0995,0.0126,0.0766,0.068,0.0334,-0.0561,-0.0537,-0.0301,-0.0303,0.2185,0.144,0.1137,0.0378,0.1341,0.0502,0.1761,0.1744,0.1368,-0.0301,0.0016,-0.0121,0.0265,0.0079,0.0412,-0.0676,-0.0273,0.0269,0.0536,-0.0125,-0.0174,0.0325,0.0179,0.0143,-0.0109,0.0773,0.0382,0.0169,0.013,-0.0518,-0.0666,0.0371,0.0676,0.0088,-0.0457,-0.065,0.0115,-0.0857,-0.1018,-0.116,-0.1119,0.0095,0.0351,0.0229,0.0605,0.018,0.0698,0.0579,0.039,0.0686,0.0564,-0.0559,-0.056,-0.042,0.0433,0.0282,0.0365,0.0776,0.069,-0.0269,-0.0735,-0.0708,-0.0409,-0.0325,0.019,-0.0787,-0.0589,0.0595,0.0089,0.0444,-0.0451,0.0785,0.0104,0.0197,-0.0323,-0.0102,-0.0211,-0.0473,-0.0469,0.113,-0.0166,-0.025,-0.0571,-0.0653,-0.0093,0.1424,0.0945,0.0589,0.0828,-0.0424,0.0545,0.0059,0.0805,0.0114,0.0988,0.0647,0.02,0.0411,0.1363,0.1944,0.0544,0.0468,-0.0828,-0.0518,0.0222,0.0337,0.0108,0.0293,-0.0986,0.075,0.026,0.0437,0.0723,0.0147,0.0347,0.048,-0.0499,-0.0155,-0.0904,-0.0454,-0.0518,0.0344,-0.0362,-0.0346,-0.0414,0.0287,0.0445,0.0245,0.0447,0.0711,-0.0041,-0.0679,-0.0205,0.0275,0.0378,0.0258,0.1046,0.0722,0.0202,-0.0353,-0.0294,0.0391,-0.0167,-0.0742,-0.0115,0.0383,0.0224,0.0633,-0.0097,-0.0388,0.0101,-0.0642,-0.0953,-0.0982,-0.0373,-0.0122,-0.077,-0.0219,-0.0381,0.0131,-0.0364,0.0191,0.0126,-0.0688,-0.0163,0.0281,-0.0048,-0.0409,0.0382,0.0183,-0.0735,0.0212,-0.0807,-0.0398,0.066,-0.0733,-0.0749,0.0272,0.0064,-0.0277,0.0401,-0.054,-0.0497,0.0335,0.005,0.0069,-0.1064,0.0424,0.0682,0.0785,-0.0028,-0.0941,-0.0242,-0.0224,-0.0718,-0.0281,-0.0268,-0.0495,0.0095,-0.0112,0.0307,0.0503,-0.1021,-0.0406,-0.0133,-0.0848,-0.0605,-0.0519,-0.033,-0.033,-0.0008,-0.0025,0.016,-0.0572,0.0009,0.0437,0.0359,0.0985,-0.013,0.0109,0.08,-0.0441,0.0561,0.0074,0.1377,-0.0072,0.0389,-0.035,0.0495,0.019,0.1167,0.0701,0.0983,0.0068,-0.0106,-0.0043,-0.0028,-0.0098,0.0048,-0.0158,-0.0531,-0.0363,0.121,0.0602,-0.0332,-0.0656,0.0112,-0.0219,-0.0315,0.0072,-0.0662,-0.0139,0.012,0.0648,-0.0388,-0.0017,0.0389,-0.0852,0.0642,-0.1006,-0.0704,0.021,-0.0362,-0.0549,0.0611,0.067,0.0068,0.0782,0.0906,-0.0014,-0.0061,-0.0158,0.0995,0.0302,0.0306,0.0144,-0.0728,-0.0101,-0.0232,0.0351,-0.0138,-0.027,-0.035,-0.0206,0.0487,0.0435,-0.0712,0.0446,-0.0238,0.0345,0.0638,0.0494,0.117,0.0351,0.017,0.0243,0.0406,0.036,0.01,-0.0168,-0.0588,-0.028,0.0165,0.0102,-0.0412,-0.0212,-0.0105,-0.0434,0.0271,-0.004,0.0493,0.0008,0.0135,-0.0066,-0.0304,0.0017,0.0181,-0.0522,-0.0496,0.0062,-0.0284,-0.0496,-0.0539,0.0168,-0.0254,-0.0359,0.021,-0.0306,0.0619,0.0178,0.0564,0.0429,0.0082,0.0022,-0.0102,0.0058,-0.0139,0.0027,-0.0051,0.0104,-0.0142,-0.0176,0.0092,-0.01,-0.0388,-0.0481,-0.0784,-0.0048,0.0096,-0.0268,-0.0384,-0.0511,-0.0165,-0.0504,-0.0081,-0.0327,-0.0285,0.0326,-0.0571,0.0943,-0.038,-0.0692,-0.0397,0.0184,-0.042,-0.0239,0.0524,-0.0,-0.0391,0.0038,0.0292,0.0299,0.0076,0.0056,0.032,0.0487,-0.0748,-0.054,-0.0311,-0.0656,-0.098,-0.0473,-0.0242,0.1113,0.1208,0.0287,0.0031,0.0485,-0.049,-0.0432,0.0049,0.0179,0.0415,0.0554,-0.0236,0.0082,0.0342,-0.0497,0.0303,-0.0557,-0.0666,-0.0217,-0.0542,-0.0359,-0.0793,0.0803,0.0419,0.0061,0.0149,0.0525,0.0156,0.0184,0.0556,0.0781,0.0262,0.0162,0.0166,0.0119,0.046,-0.0344,-0.0417,-0.0353,-0.0107,-0.0211,0.0391,-0.0104,-0.0315,0.0012,0.0031,-0.016,-0.0197,0.0227,0.0308,-0.0081,0.0252,-0.0458,-0.0268,-0.0643,0.0137,-0.0411,-0.0858,-0.0569,-0.1282,-0.0757,0.0097,-0.0739,0.0136,-0.0311,0.0419,0.0127,0.0377,0.0375,-0.0116,-0.0357,0.0056,0.0271,0.0589,0.0547,-0.0123,0.0066,-0.0499,0.0407,0.0491,-0.0151,0.0934,-0.019,-0.014,0.0636,-0.0351,0.0492,0.0534,0.0009,-0.0066,0.0241,0.023,0.0207,0.0183,0.0242,0.0525,-0.0034,-0.0088,0.0071,-0.1167,-0.0274,-0.0023,0.0705,0.1382,0.0258,0.0117,0.0501,0.0239,0.0953,0.0607,0.0667,0.0638,-0.0332,0.0517,-0.0331,0.0619,-0.0714,-0.0219,-0.0125,-0.025,0.0117,0.0074,0.0157,-0.0127,0.0619,-0.0137,-0.0399,0.0381,0.0686,-0.0156,0.0039,0.0257,0.0594,-0.0375,-0.0402,-0.0327,-0.0423,0.0001,-0.0024,0.0536,-0.0829,-0.0288,0.0477,-0.0425,0.0025,0.0022,0.012,0.0224,0.0127,0.0119,-0.0204,0.0077,0.052,0.0364,0.024,-0.0062,-0.0013,-0.0267,-0.0068,0.0104,0.0327,0.0313,-0.0552,-0.0058,-0.0551,-0.0236,-0.0509,-0.0714,0.0028,-0.0655,0.0027,0.026,-0.017,0.0079,0.0145,-0.013,-0.0308,-0.0368,0.0813,0.0388,0.041,0.0554,0.0465,0.0195,0.0474,0.012,0.0592,0.0543,-0.0692,0.0004,0.0428,-0.0041,-0.0547,-0.0268,-0.0433,-0.0151,-0.0198,0.0166,-0.0187,-0.0116,-0.0267,-0.052,-0.0828,-0.07,0.0279,0.0474,-0.0489,-0.0157,-0.0793,-0.064,-0.0948,0.0531,0.0492,-0.0492,0.0156,0.0081,-0.018,-0.028,-0.018,-0.0327,0.0093,-0.0437,-0.0382,0.0099,0.008,0.0373,0.0861,0.0342,0.0353,0.1174,0.0605,0.0444,0.1224,-0.0481,-0.006,-0.0887,-0.0041,0.0044,0.0104,-0.0363,-0.016,-0.0008,-0.026,-0.0235,0.027,0.0769,-0.0445,0.062,0.0569,0.0597,0.0288,0.0314,0.0736,-0.0346,-0.0108,-0.0521,-0.0096,0.0561,0.1142,0.0364,0.0297,-0.0051,-0.0649,0.0018,-0.0506,0.0107,-0.0777,-0.0413,-0.0073,0.0014,-0.0565,-0.0119,0.0726,0.0251,-0.0016,-0.0028,-0.0406,0.0135,-0.0218,-0.0548,-0.0215,0.0115,0.178,0.0406,0.0978,0.047,0.011,-0.0689,-0.068,0.0664,-0.0137,0.1142,0.0323,0.015,-0.0045,-0.0047,0.0172,-0.0294,-0.0172,0.0188,-0.0426,0.1415,0.052,-0.044,0.0094,-0.0483,-0.0149,-0.0015,0.0402,-0.0198,-0.0249,-0.0049,-0.0135,0.0282,0.0119,0.0596,0.0753,0.0924,0.0307,0.077,-0.0024,-0.0206,0.0121,0.0227,0.0948,0.04,0.027,-0.0327,0.0149,0.0036,-0.0145,-0.0266,0.0856,0.0511,-0.0056,-0.0641,-0.0641,-0.0261,0.0039,-0.0172,0.0179,0.0121,-0.0105,0.0384,-0.018,-0.0758,-0.0226,-0.0572,-0.0344,-0.0229,-0.0232,-0.0356,0.0042,0.0204,0.0153,0.0033,-0.0259,-0.0057,-0.0537,0.0511,0.0466,0.0712,-0.0153,0.0043,0.1109,0.0818,0.0842,-0.004,0.0661,0.0069,-0.0682,-0.0327,-0.0261,-0.0094,0.0778,0.0912,0.0098,0.0025,0.0092,0.0371,0.0155,-0.032,-0.0158,-0.0381,-0.0867,-0.0872,-0.066,-0.0361,-0.0372,0.0032,-0.0126,0.0692,-0.058,0.0066,0.0534,0.0186,0.0341,-0.0322,-0.0451,-0.0221,-0.0141,0.0426,-0.0305,0.0939,-0.0644,-0.0511,0.0124,-0.0696,0.0526,-0.0147,0.0415,0.0229,0.0149,0.0496,0.0175,0.0591,-0.0261,-0.0278,-0.0202,0.0799,0.0268,-0.041,-0.0453,0.1207,0.0181,-0.0009,-0.0737,-0.0496,-0.0361,-0.0484,0.0233,0.0288,0.01,-0.0065,0.0656,0.0005,-0.0176,-0.0929,-0.0346,-0.0631,-0.0524,-0.02,-0.0788,-0.0545,-0.0301,0.0146,0.0166,-0.0016,-0.0503,-0.0365,-0.0896,0.0074,-0.0248,-0.0311,0.024,0.0059,0.0495,-0.0371,0.0032,0.0136,0.0296,-0.0539,-0.0288,-0.0058,-0.0116,0.0243,0.0077,-0.0645,-0.0,-0.0015,0.0442,0.0374,0.0057,0.0163,0.0099,0.0145,0.0176,0.0091,-0.0123,0.0348,0.1385,0.1033,-0.0026,-0.0302,0.017,0.0023,-0.0415,0.0391,-0.0124,0.1419,-0.0492,0.03,0.0224,0.0159,-0.0239,-0.0006,0.0274,0.0149,0.0238,0.0258,0.0426,0.0389,0.0178,-0.0161,0.0378,0.066,0.0784,-0.0604,-0.0284,-0.0652,-0.0245,-0.0578,-0.0462,0.0041,0.0242,-0.0285,-0.0216,-0.0852,-0.0753,0.0748,-0.0046,-0.0529,0.0059,0.0964,0.0612,-0.0258,0.0767,0.0567,0.0495,-0.0273,0.0206,-0.0318,0.0494,0.0464,0.0244,-0.0099,0.0898,0.0027,0.0143,0.0166,0.0623,0.045,-0.0886,-0.0139,-0.0107,-0.0343,0.0474,0.0175,0.0109,-0.0203,-0.0589,0.0059,-0.082,-0.0119,0.0508,-0.0156,-0.1167,-0.0158,-0.0749,-0.0018,0.0145,-0.0009,0.0255,0.009,-0.0311,-0.0173,-0.1063,-0.0648,-0.0037,0.0208,0.0072,-0.0067,0.008,0.0046,-0.0229,-0.0701,0.0248,-0.0486,0.0106,-0.002,-0.0727,-0.0693,-0.0376,-0.0009,0.0059,-0.0626,-0.0155,-0.001,0.009,-0.0002,-0.0467,-0.0504,-0.083,0.0063,0.0547,0.1231,0.0529,-0.0069,0.0078,0.0408,-0.0415,-0.0282,0.0214,-0.0278,-0.03,-0.044,-0.0428,-0.0572,0.0272,0.1316,0.1321,-0.0236,-0.0616,0.0992,0.0085,-0.0118,0.0599,-0.1223,-0.057,-0.0888,0.0529,0.0089,0.0564,-0.0168,-0.0627,-0.1007,0.0393,0.0369,0.0222,0.0204,0.0403,0.0218,-0.0665,-0.0466,-0.0376,-0.0172,-0.1072,-0.0494,-0.0014,0.0416,-0.0019,0.03,0.0693,0.0323,-0.0029,-0.0413,-0.0266,0.0338,0.0549,-0.0069,0.0338,0.0023,-0.0687,-0.0067,-0.0646,0.0332,-0.0169,-0.0025,0.0196,-0.0456,-0.0238,0.0505,-0.0397,-0.0018,-0.0419,-0.0198,-0.0033,0.023,-0.0167,0.0351,-0.0225,-0.0139,0.0241,-0.0299,-0.0058,-0.0585,-0.1001,0.0058,0.0612,0.0205,0.0362,0.0437,0.0074,0.0171,-0.0207,-0.0502,-0.0282,-0.0053,-0.0066,0.023,-0.0567,0.0153,-0.0419,-0.0581,-0.006,0.1594,0.1408,-0.0865,0.0072,-0.051,0.0079,0.0268,-0.0176,-0.0568,-0.0655,0.0166,-0.0048,0.0037,-0.0225,-0.0602,-0.0145,0.0273,-0.0136,-0.0158,0.0332,-0.0086,-0.03,-0.0777,-0.0172,0.0741,-0.0339,0.0419,0.0178,0.0634,-0.05,0.0854,-0.0171,0.011,-0.0692,-0.0518,-0.0011,-0.1008,-0.0228,-0.0714,0.0522,-0.0539,-0.0198,0.0338,-0.0784,0.0837,0.1111,0.0811,0.0611,0.0533,0.0408,-0.0476,0.0899,0.1814,0.2208,0.1243,0.0554,0.1221,0.127,0.0857,0.131,0.0361,0.1396,0.0974,0.0595,0.0922,0.0379,0.0885,0.1265,0.1627,0.0905,0.1248,0.1221,0.0831,-0.0604,-0.0372,-0.0352,-0.1154,-0.0683,-0.1022,-0.0456,-0.056,0.0594,-0.0473,-0.0679,-0.0902,-0.0288,0.0366,0.0396,-0.0791,0.0798,0.0613,-0.056,0.0215,-0.0287,-0.0571,-0.0237,-0.0201,-0.0758,0.0158,-0.0949,-0.0944,0.0327,0.017,-0.0604,0.0461,0.0383,-0.0119,-0.026,0.0456,-0.0826,0.0407,0.1242,0.0559,0.0412,0.024,-0.006,-0.0317,-0.029,0.0241,-0.0119,0.0247,-0.0035,0.0071,-0.0645,-0.0377,0.0707,-0.0541,-0.0449,-0.0031,0.0456,0.0401,-0.057,visual face recognition
trm_4a3fd79d0a398,-0.1159,-0.1235,-0.1203,-0.091,0.0153,-0.0476,-0.1067,-0.0382,-0.0509,-0.0935,-0.0245,-0.0118,-0.1071,-0.0818,-0.1487,-0.064,-0.0762,-0.1227,-0.077,-0.0833,-0.0747,0.0136,-0.0617,0.0201,-0.0035,0.0289,0.0256,-0.1146,-0.1676,-0.0865,-0.1348,-0.1217,-0.1566,-0.0809,-0.1558,-0.0933,-0.0656,-0.0403,-0.1482,-0.0088,-0.1024,-0.103,-0.0578,0.063,-0.0886,-0.0878,0.1128,-0.0799,0.0615,-0.0677,-0.022,0.0725,0.0663,0.0729,-0.0273,-0.0626,-0.091,-0.0389,-0.0021,-0.0351,0.018,0.0475,-0.141,0.1139,0.0517,0.1033,-0.2153,-0.265,-0.1403,0.0081,0.0597,0.035,0.1935,-0.1267,-0.1111,0.0646,-0.1305,0.0494,0.038,-0.0398,0.0103,0.1048,-0.0311,-0.1785,0.0731,0.0633,0.0159,0.0164,-0.0032,-0.1395,-0.088,-0.0199,-0.0035,0.1425,0.1266,0.1184,0.1477,0.0093,0.2662,0.1418,0.0632,0.0581,0.137,0.0587,0.0778,-0.1559,-0.1692,0.1442,-0.007,-0.0513,0.0229,-0.1323,0.1347,0.1859,0.0515,0.0219,-0.1208,0.0329,-0.0202,-0.0809,-0.1161,-0.1766,-0.13,-0.0045,-0.0491,-0.1517,-0.0675,0.0609,0.1057,0.0481,-0.0925,-0.0703,-0.0419,-0.2683,0.0183,-0.1835,-0.0098,-0.14,-0.0259,-0.0452,-0.1035,-0.108,0.0215,-0.0209,-0.0312,0.0916,-0.0777,0.0123,-0.0939,0.1101,-0.0742,-0.0974,-0.1743,-0.1661,0.169,0.0185,0.0563,0.0278,0.0108,-0.0558,-0.0598,-0.1003,-0.2475,-0.2417,-0.0194,0.0083,-0.0235,-0.1962,-0.1891,-0.0189,-0.0343,-0.1227,0.0916,-0.2433,-0.1481,-0.1996,-0.1543,-0.1636,-0.0984,-0.0548,-0.1263,0.0855,-0.0402,0.0239,-0.0705,-0.061,-0.1062,-0.1035,-0.086,-0.0375,-0.0339,-0.0766,-0.0301,-0.224,-0.2067,-0.2131,-0.1825,-0.056,-0.0362,-0.0797,-0.0177,0.1894,-0.1576,-0.1385,0.077,-0.0688,-0.1569,-0.0124,-0.0979,0.0039,-0.1903,-0.1095,-0.0028,0.0437,0.0494,0.0201,0.1121,-0.1202,-0.0844,0.0567,0.0854,-0.1355,-0.1278,-0.0501,0.0798,0.0059,-0.0552,0.1417,-0.0198,0.2315,-0.0686,-0.1608,0.1522,-0.1514,-0.1404,0.1265,-0.0673,0.0535,0.0441,-0.1074,0.0068,-0.21,-0.0478,0.0303,-0.0971,-0.0888,-0.0906,-0.0973,-0.032,-0.0917,0.013,0.0222,-0.0101,0.0608,0.0418,-0.208,0.0129,-0.0671,0.1037,0.2416,0.0637,0.2801,-0.1363,0.1527,0.1993,0.3483,0.1493,-0.0399,0.014,-0.0403,-0.0635,-0.0065,-0.1832,-0.0339,-0.0556,0.0543,-0.0284,-0.1074,-0.0725,0.0695,0.0721,-0.1032,-0.07,-0.216,-0.1763,-0.0824,0.0181,0.0595,-0.1208,-0.1411,-0.1122,-0.1165,-0.0192,-0.0894,-0.1007,0.0235,-0.0322,0.127,-0.0036,0.1761,0.0891,-0.1831,-0.1241,-0.1097,-0.0684,-0.0485,-0.123,-0.0055,-0.0358,-0.0265,0.0073,-0.0204,-0.1304,0.0615,0.0734,-0.0472,0.155,0.0186,0.0863,-0.1597,-0.0145,0.0478,-0.1438,-0.1694,-0.104,-0.0547,0.0054,-0.0559,-0.0971,-0.1155,0.0765,-0.0827,-0.0331,-0.0021,0.0452,0.1349,0.1049,-0.0028,-0.0394,-0.1554,-0.1266,0.0526,0.0715,0.0184,0.0709,0.0592,-0.247,-0.1898,-0.1525,-0.1168,-0.1231,0.0225,-0.0579,-0.0341,-0.0696,-0.0606,-0.0267,-0.1454,-0.1415,-0.0972,-0.0113,-0.0602,0.0303,-0.0052,-0.0032,0.0836,-0.0992,0.2793,0.0478,-0.1775,0.0072,0.1066,0.0174,0.1104,-0.1642,-0.0299,-0.1067,0.1044,0.1238,0.1866,0.212,0.0299,-0.1057,0.0426,0.011,0.0522,-0.1208,-0.0426,0.0486,-0.0403,-0.0521,-0.0209,-0.0199,-0.0502,0.1464,0.0858,-0.0501,-0.1802,-0.0726,-0.0497,-0.0573,0.037,-0.0132,-0.0502,0.0616,0.0838,0.0317,-0.0285,-0.1292,-0.0271,-0.0158,-0.1805,-0.0416,0.2014,-0.1428,-0.0346,0.2428,0.019,-0.0868,-0.0161,0.0092,-0.2304,-0.1327,-0.3119,-0.28,-0.0947,-0.1597,-0.1114,-0.1801,-0.1118,-0.0386,0.0857,-0.0129,0.0065,-0.0292,0.064,0.008,0.0436,-0.2784,-0.1501,-0.0304,0.063,0.034,0.0596,-0.0623,-0.1046,0.0528,0.1344,-0.1099,0.009,0.0691,0.0817,-0.113,-0.0481,0.0398,-0.1487,0.0494,-0.0321,-0.0016,0.0451,0.0833,-0.063,-0.0652,0.0658,-0.1608,-0.0955,0.0366,0.3681,-0.1162,-0.0156,0.0291,0.0196,0.1274,-0.038,-0.118,-0.0355,0.0605,0.0672,-0.0188,-0.071,0.0817,0.0596,0.0354,0.061,0.1528,0.1657,-0.0184,0.0128,-0.0844,-0.0273,0.0447,0.1482,-0.0924,-0.1106,0.117,-0.006,-0.1007,-0.0065,0.0486,-0.121,-0.1102,0.0386,-0.0546,-0.1198,-0.0982,-0.1187,0.029,-0.008,-0.0317,0.1159,-0.1898,0.042,-0.0309,0.0271,0.0645,0.0695,-0.1327,-0.1036,0.1322,-0.0883,-0.0942,-0.0589,0.084,0.1327,0.1876,0.0315,0.1719,0.1475,0.0804,0.0912,-0.0493,-0.0424,-0.0813,-0.2207,-0.0939,0.0259,-0.161,-0.0801,-0.0314,-0.1345,-0.0384,0.0097,0.0396,-0.0467,-0.1054,-0.0152,0.0353,0.0298,0.0097,-0.0247,0.0748,-0.0218,-0.0218,0.0142,-0.0201,-0.1652,0.1325,0.0388,0.082,-0.0461,-0.1017,-0.0036,-0.1146,0.0484,-0.0838,0.063,0.1067,-0.0489,0.0124,-0.0621,-0.0961,-0.0334,-0.0881,0.0055,0.0244,0.021,0.0676,0.0483,0.0921,0.0889,0.0161,-0.1304,-0.0236,-0.0658,0.1528,0.045,0.0638,0.0591,0.0833,-0.0418,-0.095,0.0409,0.1325,0.1279,-0.0147,0.0093,-0.233,-0.0529,0.1712,-0.0374,0.0193,0.0709,0.0775,0.0578,0.0498,0.0549,-0.0192,-0.1813,-0.1775,0.1119,-0.1629,-0.0456,0.0565,-0.0808,-0.2995,-0.0848,-0.1143,0.0699,0.0239,-0.2371,-0.0736,-0.2256,0.0719,-0.0041,-0.0399,0.077,-0.099,-0.1637,-0.0536,0.0533,0.0969,0.0872,-0.0928,0.0144,0.0587,0.0629,0.0849,-0.0261,-0.0493,-0.0539,-0.0553,0.0961,0.0174,-0.0356,-0.0739,-0.0282,-0.2163,-0.1891,0.1275,-0.1907,0.0611,-0.1536,0.1848,-0.141,-0.0487,-0.0409,0.043,-0.0835,-0.0528,-0.0835,-0.1898,0.034,0.1909,-0.014,0.0333,0.134,-0.1299,-0.1502,0.0013,-0.0021,-0.034,-0.0961,-0.0633,-0.0237,-0.0246,-0.0847,0.2405,-0.1312,0.011,-0.035,0.0379,0.0416,0.0466,0.0596,0.1578,-0.1656,-0.0987,0.0075,0.0179,0.0003,0.1121,0.1923,0.1542,0.0783,0.1778,-0.0427,0.0565,-0.0609,-0.0932,0.0103,0.0418,0.0053,-0.0298,-0.1077,-0.1029,-0.0574,-0.1324,-0.0985,-0.0961,0.0697,0.108,0.0593,-0.0161,0.0929,0.0371,-0.0191,-0.0198,0.0436,-0.127,0.0312,0.1466,-0.0959,-0.2588,-0.2552,-0.1935,-0.0201,-0.0457,-0.1382,0.0065,-0.0342,0.0375,-0.0325,-0.0536,0.1312,0.1162,0.0111,-0.1407,0.134,0.139,0.2841,-0.1864,-0.0479,-0.1009,-0.0135,-0.013,-0.16,0.0996,0.0732,-0.0704,0.0234,0.0047,0.0313,-0.1977,-0.2826,-0.2301,-0.1638,0.0578,0.1632,-0.0003,-0.103,-0.0427,0.0854,0.0821,0.0741,0.0752,0.0138,-0.1047,-0.1178,-0.0405,0.1219,0.0938,0.1365,-0.038,-0.05,0.03,-0.0831,0.0576,-0.0824,-0.1586,0.0161,-0.1851,-0.1733,-0.1063,0.0734,0.1055,0.0605,-0.0069,-0.0311,0.0239,0.1636,-0.032,-0.1012,0.0433,-0.0024,0.0304,0.0159,0.1001,-0.0647,0.151,-0.2279,-0.2271,0.1199,0.1017,0.1608,-0.0518,-0.0321,0.0574,0.0129,0.0013,0.2018,0.026,0.0861,0.1002,0.139,0.0054,0.0057,0.1659,0.1879,-0.1069,0.0421,0.0832,-0.2179,-0.1462,-0.042,-0.1408,-0.0439,-0.2646,-0.1132,-0.1683,-0.1178,-0.243,-0.0056,-0.039,0.0691,-0.0578,-0.0198,0.0221,0.0995,0.145,0.0439,0.0736,0.1498,0.0416,0.0647,0.0493,0.004,0.114,0.1387,-0.1244,0.1732,0.0706,-0.0485,-0.0652,-0.113,-0.0579,0.1201,0.0629,-0.2821,-0.1545,-0.026,0.0843,0.2069,0.0675,0.0529,0.0461,0.0268,-0.0573,-0.1102,0.1283,-0.0323,0.0633,-0.1925,0.09,-0.0997,0.1142,0.1531,0.024,0.1576,-0.2264,-0.2177,-0.1153,0.2083,-0.0621,-0.0883,-0.1485,0.0743,-0.0271,-0.1808,-0.0559,-0.1658,0.092,-0.0836,-0.0046,0.0686,-0.0226,0.1231,-0.1916,-0.1251,-0.0522,0.1134,-0.1352,0.0481,0.1085,0.0615,0.1213,0.338,0.1243,-0.1236,-0.0706,-0.117,-0.0588,-0.0788,-0.0322,0.0145,0.1554,0.0866,0.0141,-0.1236,0.09,0.2373,0.1017,0.0009,-0.0088,-0.0451,-0.123,-0.0431,-0.0338,-0.023,0.0263,-0.1478,-0.0124,0.1351,-0.0053,-0.0688,-0.0395,0.0738,-0.0616,-0.0574,-0.0944,-0.142,-0.1439,-0.2698,-0.1756,-0.2903,-0.0118,-0.0332,-0.1014,-0.1521,-0.1158,-0.1838,-0.1324,-0.2285,-0.153,-0.172,0.0249,0.0515,0.1095,-0.011,0.0332,0.0241,0.0585,0.1171,0.1088,0.1648,0.1244,-0.0382,-0.0226,0.0123,0.0055,0.1058,0.0952,0.1149,-0.0183,0.1442,-0.044,0.0936,-0.0656,-0.0667,-0.0329,0.0688,-0.0212,0.0847,-0.1779,-0.0747,-0.0646,-0.0742,-0.048,0.0348,0.1202,0.0686,0.1104,0.1482,0.1097,0.0435,0.0264,-0.0297,-0.033,0.0448,-0.0288,-0.0299,-0.0618,-0.1167,-0.0379,0.1261,0.1126,-0.1295,-0.0854,-0.0923,-0.214,-0.1179,0.1925,0.0985,0.1481,0.1354,0.0476,-0.115,-0.0331,0.0641,-0.017,-0.0255,-0.016,0.0342,-0.0669,-0.0395,0.01,0.0668,-0.1099,-0.0209,-0.0904,0.0547,-0.1235,0.0713,0.0962,0.221,0.1491,0.0998,0.0371,0.0536,-0.016,-0.0379,-0.0582,-0.091,-0.0012,0.0202,0.0655,0.0049,-0.0265,0.058,-0.0283,-0.0689,-0.0314,-0.1572,-0.1845,-0.1865,-0.1534,0.2261,0.0542,0.109,-0.158,0.2107,0.1253,-0.0207,-0.0352,-0.016,0.0425,-0.0285,0.1003,-0.1324,-0.1126,-0.0072,-0.0193,-0.1493,-0.0483,-0.0924,-0.0298,-0.0758,-0.0486,-0.081,-0.0558,-0.0011,-0.0233,-0.0113,0.0267,0.0575,-0.102,0.0378,-0.0909,0.0245,-0.0258,-0.0938,0.3623,0.2607,0.3189,0.2246,0.2422,0.0872,0.2871,0.1896,-0.2006,0.1805,0.1825,0.1116,0.1076,0.119,-0.0716,-0.0097,-0.0864,-0.0116,-0.0048,0.0098,0.0597,0.0407,-0.1456,0.0673,0.0552,0.0161,0.0959,-0.0448,-0.0878,0.0791,0.0447,-0.0987,-0.0309,-0.1,0.0942,0.0323,0.1563,-0.0418,-0.1715,-0.1641,-0.0873,-0.0228,0.0982,0.0992,-0.0637,-0.0943,-0.2384,-0.162,-0.0925,0.1923,-0.0891,0.2575,0.2242,-0.0723,-0.0103,-0.0471,0.0638,0.1274,0.07,0.1734,0.1128,0.0201,0.0839,0.0744,-0.1082,-0.1685,0.1015,-0.1101,0.0933,-0.0075,-0.0729,-0.0256,-0.17,-0.0656,-0.0308,-0.0875,-0.1183,-0.0166,0.1643,-0.0406,0.0149,0.0012,0.1676,0.0386,0.0699,-0.2167,-0.2236,-0.0435,-0.0582,-0.0472,-0.1301,-0.0742,-0.0275,-0.0283,0.1919,0.103,0.1028,0.2676,0.0191,0.0275,-0.0074,0.1465,0.0448,0.2038,-0.069,0.2038,0.3287,0.0626,-0.1246,0.2858,0.2231,-0.0485,-0.1545,0.0224,-0.1951,-0.0786,-0.2311,-0.0546,0.1129,-0.0514,-0.0387,0.0479,-0.0661,0.0048,-0.0683,-0.0293,-0.0225,-0.0832,0.0377,0.1074,-0.035,0.2878,0.1766,0.2337,0.2482,-0.1334,-0.0391,-0.0951,-0.0979,-0.0794,-0.0535,-0.0496,0.1501,-0.1286,-0.1223,0.1221,0.0493,-0.033,0.1118,0.0726,0.0368,-0.0052,0.157,-0.0563,-0.0982,-0.0028,0.082,0.0519,-0.005,-0.0397,-0.0397,-0.2045,0.0507,0.011,0.0402,-0.0226,0.0757,-0.0526,0.1949,-0.2963,-0.2744,0.1024,-0.0325,-0.2467,-0.2524,-0.1861,-0.0344,-0.066,-0.055,-0.0215,-0.0226,0.1518,0.0108,0.1025,-0.0847,0.0935,0.0133,0.0595,0.0545,-0.0741,-0.0803,0.0017,-0.0523,-0.0422,-0.059,0.0111,0.083,-0.0099,0.0737,0.0258,0.1207,0.0213,0.1027,-0.1527,-0.0925,0.0233,-0.1443,0.0011,-0.1688,-0.2693,0.0007,-0.1,-0.2177,-0.0165,-0.0753,-0.1932,-0.0071,-0.0633,0.0407,-0.1743,-0.0536,-0.1032,-0.1475,-0.0595,0.0697,-0.0606,0.2333,0.1177,0.1149,0.137,-0.0213,0.068,-0.0607,-0.1168,-0.1152,0.0153,-0.1091,-0.0121,-0.1339,-0.0276,0.0358,0.0425,0.0038,-0.1896,-0.1262,0.0019,0.0212,-0.0078,-0.003,-0.0255,0.0659,-0.0694,-0.1131,-0.0847,-0.1854,-0.1143,-0.0526,-0.1453,-0.1657,0.0286,0.0336,-0.0471,-0.0213,0.0158,-0.1468,-0.1287,0.0703,-0.1944,0.0626,-0.01,0.0122,-0.1262,-0.1133,0.0224,0.1484,-0.037,0.0274,0.0308,-0.0512,0.1753,0.0603,0.0581,0.0332,-0.2114,0.0629,-0.0069,0.0869,0.1683,0.0516,0.0044,-0.0825,-0.0154,0.1296,-0.0794,-0.0028,-0.1395,-0.054,-0.1197,-0.1141,-0.0209,0.115,-0.019,-0.0899,-0.1524,0.0196,-0.0255,-0.0024,-0.0182,-0.1452,-0.004,-0.0175,-0.0931,0.0711,-0.0639,-0.054,-0.0542,-0.0791,-0.1101,-0.0886,-0.0603,-0.0214,0.034,-0.0242,0.1193,-0.0757,-0.0021,-0.0176,0.0671,0.0117,-0.0166,-0.1425,0.0662,-0.1131,-0.0281,0.0054,0.0343,0.0473,0.0388,0.0375,-0.0601,-0.047,-0.1119,-0.0462,-0.2494,0.0165,-0.1783,-0.0196,-0.0511,-0.0486,-0.0759,-0.1365,-0.1259,0.1751,0.0822,0.0155,0.2578,0.1159,0.0945,0.0623,0.1653,-0.017,-0.0351,0.0123,0.2358,-0.0151,0.0176,-0.0386,-0.0722,-0.0662,-0.0897,0.03,0.0028,-0.0094,0.0746,0.0944,-0.0851,-0.0751,-0.0537,0.0756,0.1472,0.1003,-0.2289,-0.0961,-0.0278,-0.1843,-0.1313,0.0345,0.1044,0.0384,0.0137,0.0508,-0.0026,-0.1931,-0.0493,-0.0292,-0.0692,-0.1978,-0.0761,-0.0342,-0.1522,-0.0644,0.1223,-0.0333,-0.0499,-0.0318,0.0319,0.0826,0.2366,-0.0667,0.0808,0.0004,-0.015,-0.1159,-0.0609,0.0476,0.0114,0.0127,0.1671,0.1006,0.0554,-0.0707,-0.0984,0.0401,0.4017,0.3972,-0.1689,-0.1296,0.0818,-0.0754,-0.0824,-0.0274,-0.1975,0.0655,-0.0352,-0.0626,-0.0068,0.0241,0.2591,-0.0308,0.2082,0.0342,0.0394,0.1072,0.3709,-0.0574,-0.0626,0.2509,0.0224,0.0812,0.101,0.0461,-0.0905,0.1604,0.124,0.014,-0.0451,-0.0039,0.0079,0.1082,0.0857,-0.0229,-0.059,-0.0566,0.1129,-0.1408,0.0267,0.1509,-0.0665,-0.0381,-0.0134,0.018,-0.1456,-0.0445,0.0229,-0.0862,0.0667,-0.0976,0.0881,0.1457,-0.0416,-0.0462,0.0271,-0.001,-0.0009,0.143,0.1477,0.1354,0.003,0.1405,0.0596,0.0368,0.3087,-0.1491,-0.1114,0.079,-0.141,0.074,0.1029,0.1546,-0.0682,0.0199,0.0091,-0.0073,0.0248,0.0494,-0.0413,-0.0011,0.0355,0.0635,0.0458,0.1227,0.2984,0.2888,-0.0417,-0.1327,-0.1251,-0.0311,0.1096,0.0473,-0.041,0.0195,0.0268,0.03,0.124,-0.038,-0.2979,-0.1124,-0.0514,0.1131,0.0143,0.0508,0.0452,0.2587,0.2357,0.0467,-0.0465,-0.0799,0.0251,0.0061,0.1356,-0.0898,-0.1329,-0.1424,0.0613,-0.021,0.0176,0.3021,-0.0742,-0.0666,0.0604,0.1945,0.0895,0.2095,-0.0388,-0.0281,-0.001,0.0271,0.139,0.1663,0.1767,-0.0312,0.0612,0.0703,0.0675,-0.1454,0.1148,-0.2484,-0.0672,-0.0175,-0.1179,-0.0061,0.0834,-0.0251,-0.0345,-0.0693,-0.0056,-0.0026,-0.0144,-0.0736,-0.0351,-0.0369,-0.0045,-0.0259,0.1085,0.209,0.1712,0.2625,-0.2448,-0.164,-0.1825,-0.0308,0.0562,-0.0472,-0.128,-0.0999,-0.1365,-0.0689,0.1502,0.0256,0.1815,0.1019,0.0103,0.0462,-0.0195,0.0336,0.0148,0.0026,-0.2132,-0.0063,-0.1263,-0.0255,-0.1016,-0.0229,0.1233,0.2599,0.1283,0.1076,0.0924,-0.1017,-0.3305,-0.1878,-0.2457,-0.175,0.013,-0.0408,0.0401,-0.1338,-0.1908,-0.1575,-0.0629,0.0021,0.0063,-0.0377,-0.0742,-0.0081,-0.0456,-0.1995,-0.1371,-0.1263,0.0695,0.0315,-0.0342,-0.2694,-0.044,-0.1227,-0.1652,-0.3565,0.0472,-0.0339,-0.0763,-0.0735,-0.0272,-0.0205,-0.044,-0.1471,-0.0869,-0.1355,0.1994,0.0526,0.1926,0.0429,0.129,-0.0577,0.1122,0.1275,0.2833,-0.0791,-0.0428,-0.0202,0.1913,-0.2063,-0.2447,-0.2123,-0.0832,-0.1126,-0.142,-0.1194,-0.0624,-0.0786,-0.0357,0.0239,0.0318,-0.2724,0.0002,-0.0219,-0.0974,-0.0841,-0.1001,0.0098,-0.1571,0.0868,-0.0093,0.1487,-0.0121,-0.0604,-0.2234,-0.0978,-0.1433,-0.0867,-0.2582,-0.2003,0.0394,0.03,0.0051,0.0084,-0.0948,0.012,0.1667,0.225,0.1916,-0.2423,-0.2736,-0.0291,0.084,-0.0117,-0.0652,0.0591,-0.1019,-0.0068,-0.0358,-0.0792,-0.1181,-0.037,-0.093,-0.1173,-0.0101,-0.1109,0.0601,-0.0402,0.0819,0.0904,0.0915,-0.0754,-0.1676,-0.1985,-0.1686,-0.1181,-0.2885,-0.1456,0.228,-0.0877,-0.142,0.0771,0.0356,-0.0348,0.0958,0.0029,0.0115,0.1765,-0.0101,0.0724,0.0603,-0.0236,-0.0005,0.0281,0.1328,0.1699,-0.2062,0.0191,0.0478,0.2309,-0.0491,-0.0547,0.0588,-0.0534,0.0132,0.0362,0.0778,-0.004,-0.0049,-0.1317,-0.0749,-0.0915,0.0343,-0.102,0.117,0.1677,0.2173,-0.0143,-0.0007,0.0911,0.1528,0.0607,0.0609,0.0335,0.0007,0.0277,-0.3504,-0.1437,-0.1814,-0.1818,-0.1119,-0.1685,-0.197,-0.119,-0.0065,-0.0723,-0.2009,-0.0989,0.068,-0.0787,-0.2978,0.0815,-0.0455,0.0069,0.053,-0.1111,0.0209,-0.156,-0.1104,0.0164,-0.1255,-0.0692,0.0522,-0.1214,0.0106,0.0897,0.06,-0.0099,-0.1471,0.0655,-0.0236,-0.1872,-0.0307,-0.1066,-0.0948,0.1265,0.0298,-0.0008,-0.1024,-0.0984,-0.0293,0.014,-0.0348,-0.0978,-0.1257,-0.0834,-0.0052,-0.0682,0.0941,-0.1181,-0.07,0.053,0.0528,0.0358,0.0436,0.0199,-0.1561,-0.0167,-0.1165,-0.1764,0.2097,0.3011,0.2795,-0.0522,0.3288,0.195,-0.1818,-0.0974,0.2896,0.1353,0.057,0.0713,0.0524,0.062,-0.1271,-0.1196,-0.0841,-0.0821,0.4058,0.3404,0.2503,0.0705,0.1693,0.1791,0.3676,0.3578,0.3159,-0.013,-0.0355,-0.0306,-0.0076,-0.0391,0.019,-0.204,-0.0958,0.0038,-0.0231,-0.0826,-0.0832,0.1279,0.0162,0.0348,-0.0795,0.0877,0.1863,0.2531,0.0041,-0.0477,-0.0526,-0.0125,-0.0061,-0.0472,-0.0198,-0.0716,-0.0295,-0.0169,-0.1723,-0.2673,-0.239,0.0601,-0.0465,-0.0027,0.1536,0.038,0.2092,0.0786,0.1154,0.2743,-0.0548,-0.1896,-0.2069,0.0239,0.1025,-0.0877,0.1548,0.0797,0.1694,0.109,-0.1559,-0.1506,-0.1196,-0.1068,0.0853,-0.2334,-0.1302,0.0423,-0.0047,0.1668,-0.0397,-0.0075,0.1232,0.0514,-0.0722,0.0172,-0.1119,-0.1544,-0.1746,0.0306,-0.0154,-0.0802,0.0391,-0.0416,0.0655,0.3173,0.2972,0.1207,0.2173,-0.0971,0.0346,0.1103,0.1796,0.2463,0.2842,0.0266,0.06,-0.0335,0.1749,0.1503,-0.0155,-0.0194,-0.0481,-0.0477,-0.0711,0.0189,-0.0322,0.0366,0.0337,0.0188,0.0612,-0.0036,0.1396,-0.0408,0.0749,0.0527,-0.1484,-0.1492,-0.0823,-0.1216,-0.2167,0.0898,-0.0744,-0.0857,-0.0595,0.2086,0.0607,-0.2165,-0.0524,0.0184,-0.1557,0.0039,-0.0045,0.0223,0.1188,0.1066,0.3293,0.2474,0.2293,0.0008,0.043,0.1358,-0.1396,-0.1442,-0.0119,0.0371,-0.0167,-0.0007,-0.0506,-0.1016,-0.127,-0.2056,-0.2354,-0.2129,-0.0906,-0.0711,-0.1271,-0.0147,-0.0779,0.0215,0.011,-0.0772,-0.1024,-0.0465,0.2404,0.0122,-0.0196,-0.1226,0.0795,-0.0373,-0.0433,0.0419,-0.179,-0.0931,0.1716,-0.0793,-0.0826,-0.0394,0.0176,0.0373,0.017,-0.0544,-0.0489,-0.0527,-0.0049,0.0227,-0.1825,0.0586,-0.0212,0.1152,0.0171,-0.2174,-0.1133,-0.0169,-0.0776,-0.0558,-0.0426,-0.1506,-0.0144,0.0542,0.004,0.0408,-0.3581,-0.1538,-0.1396,-0.2776,-0.2214,-0.155,-0.1334,-0.1334,-0.088,-0.0408,0.0987,-0.2155,-0.0515,-0.1334,-0.1222,-0.0131,-0.033,-0.3126,0.1186,-0.1694,0.0644,0.0197,0.2603,0.0099,-0.0266,-0.1747,-0.0757,-0.0029,0.0537,-0.0306,0.1896,0.0506,0.1038,0.2461,0.2061,0.0002,0.0364,0.0153,-0.0174,-0.0156,-0.1122,-0.1304,-0.0637,-0.1206,-0.0286,-0.0362,-0.0015,0.0672,-0.0396,-0.0535,0.0709,0.0802,-0.0694,0.1181,-0.0597,-0.1052,0.0071,-0.1495,-0.0138,-0.0441,0.1243,-0.1013,0.1492,0.1411,-0.0006,0.1711,0.1651,-0.0341,0.1446,0.0045,0.2709,0.1383,0.0223,0.1428,-0.1227,0.0548,0.134,0.0547,-0.0195,-0.0493,0.0561,-0.0291,0.015,-0.0696,-0.116,-0.0467,-0.07,0.0071,-0.0032,-0.1415,0.2632,-0.0167,0.0486,0.054,0.0342,-0.0312,0.0346,-0.0626,-0.1534,-0.04,0.0985,0.1319,0.0195,0.0501,-0.1202,0.0442,0.0884,0.0923,0.1623,0.0613,0.014,-0.0666,0.0935,-0.0935,-0.0365,0.0863,-0.0284,-0.0493,-0.0968,-0.1114,-0.1027,-0.0274,0.0275,-0.1115,0.0751,-0.0064,0.0455,0.0629,0.0748,0.1065,0.0571,-0.0619,-0.0636,-0.1092,-0.0706,0.0452,0.0238,-0.0278,-0.0384,-0.018,0.073,-0.0735,-0.1683,-0.1196,-0.1586,-0.1393,-0.008,-0.0291,0.0266,-0.1301,-0.1333,-0.1439,-0.0259,-0.0956,0.0128,0.0703,-0.1008,0.103,-0.1396,-0.1373,-0.0531,0.0448,-0.0754,-0.067,0.0977,0.0705,-0.1653,0.0421,0.0071,-0.0584,0.0589,0.0494,0.0278,0.0654,-0.074,-0.1947,-0.0573,-0.1802,-0.2407,0.0151,-0.1176,0.058,0.0599,0.1268,0.1155,0.1396,-0.1286,-0.2024,0.0233,0.183,0.2618,0.0037,-0.0629,-0.0365,0.0129,-0.0969,0.0277,-0.0836,-0.1489,-0.0617,-0.0029,-0.0913,-0.1787,0.1299,0.0074,0.0312,0.1149,-0.0121,0.046,-0.0818,-0.0175,-0.0445,0.0001,-0.0638,0.0393,0.1009,0.081,-0.0225,-0.0654,-0.0465,-0.1367,-0.06,-0.0261,-0.2352,-0.0502,-0.0145,-0.0102,-0.0475,0.0232,0.0171,0.052,-0.0442,0.0908,-0.2178,-0.126,-0.1668,-0.1547,0.016,-0.1796,-0.1554,-0.3064,-0.1301,-0.0658,0.2111,-0.1644,-0.0577,-0.0101,0.0483,0.1099,0.118,-0.114,-0.186,-0.0781,-0.0549,0.0282,0.0965,-0.0333,-0.0669,-0.0685,0.0981,0.0854,0.0641,0.1742,0.0049,-0.0224,0.088,-0.0335,0.0687,0.0178,-0.0255,-0.0518,0.026,0.0112,0.1081,0.0112,0.1273,0.1284,0.0141,0.0489,-0.0214,-0.1751,-0.1165,-0.057,0.167,0.2252,0.0986,-0.002,0.0048,0.0357,0.2952,0.151,0.1432,0.1944,-0.2392,-0.0305,-0.0506,0.0468,-0.0909,0.0685,-0.0024,-0.0043,0.0477,0.0361,0.0847,-0.0711,0.0776,0.0757,-0.1446,0.2255,0.1095,0.0357,0.0295,0.0623,0.0417,-0.0013,-0.0375,-0.0113,0.0223,0.1388,0.1862,0.2317,-0.09,0.0239,-0.0026,-0.0745,-0.1514,-0.3368,-0.3202,0.0358,0.0757,0.0907,-0.0461,0.0344,0.0616,-0.0513,-0.1037,-0.1486,0.0645,-0.0497,-0.0077,0.0168,0.0616,0.0175,-0.192,-0.0514,-0.1768,-0.1326,-0.0016,-0.1375,-0.0061,-0.2068,-0.0968,-0.0396,-0.0513,0.012,0.1202,0.0231,-0.0827,-0.1076,0.2208,-0.1058,0.1243,0.1666,0.1478,-0.0042,0.0312,-0.0865,0.2512,0.2198,-0.1562,-0.0989,-0.0054,-0.0154,-0.1251,-0.1159,-0.1485,-0.2397,-0.0793,-0.0067,-0.0942,0.0491,-0.0343,-0.035,-0.1274,-0.1821,0.0122,-0.0211,-0.1729,-0.0984,-0.0143,-0.1053,-0.2017,0.0865,0.1326,-0.1041,0.057,0.1335,0.0916,-0.1187,-0.1331,-0.1656,-0.201,-0.0907,-0.0943,-0.0117,0.1094,0.036,0.1028,-0.0007,0.2048,0.2714,0.2196,0.1153,0.2171,-0.3143,-0.232,-0.1522,0.034,-0.0182,-0.0418,-0.0914,0.0024,0.0757,-0.1389,-0.1389,-0.087,0.1465,-0.1595,-0.03,-0.0425,0.0352,0.0859,0.1132,0.0024,-0.0793,-0.0346,-0.0833,0.0386,0.1611,0.1343,0.0429,0.027,0.0951,0.1388,0.1237,0.1228,0.006,-0.1463,0.0019,-0.0132,0.0279,0.0098,0.0359,0.1638,0.0567,0.0396,0.0386,-0.0434,-0.0342,-0.2185,-0.1608,-0.1267,-0.1408,0.3205,0.0127,0.1991,0.1665,0.12,-0.0188,-0.0206,0.1498,-0.0384,0.2605,0.1985,0.0509,0.1374,0.0612,0.0409,-0.0868,-0.0612,-0.0836,0.0469,0.2089,0.1117,-0.0822,-0.031,0.0181,0.0051,0.0106,-0.034,-0.0794,-0.0927,-0.0097,-0.1243,0.0456,-0.0806,0.1005,0.055,0.1057,0.0449,-0.0563,-0.0459,0.0051,-0.0313,0.1007,0.2166,-0.03,0.0662,-0.0485,0.0637,-0.0585,-0.0873,-0.0075,0.0823,0.0919,-0.0033,-0.1432,-0.0852,-0.1426,-0.1122,0.0556,0.1356,-0.0899,-0.0116,-0.1058,-0.1709,-0.2604,-0.1638,-0.14,-0.1484,-0.1558,-0.0906,-0.0839,0.1132,-0.1429,-0.1587,-0.1089,-0.0497,0.0187,-0.1096,-0.0834,0.0559,0.0886,0.0802,-0.0414,0.2834,0.2824,0.1596,-0.0286,0.0614,-0.0269,-0.1171,0.0521,-0.0296,0.0165,0.1773,0.1674,-0.0501,0.0249,0.0851,0.149,-0.1332,-0.1212,-0.0871,-0.0601,-0.0851,-0.053,-0.0214,-0.0735,0.0458,-0.1669,-0.1305,0.1825,-0.0053,-0.2408,-0.0024,0.1408,0.1477,-0.0687,-0.097,-0.3693,-0.3033,-0.1243,-0.291,0.0979,-0.1063,-0.1045,0.0333,-0.038,-0.0313,-0.0962,-0.0728,0.1569,0.1328,0.2686,0.1461,0.1965,-0.0294,-0.0024,0.1862,0.0215,0.1019,0.054,0.0437,0.2193,0.1737,-0.1333,-0.2695,-0.141,-0.0986,-0.1823,-0.0591,-0.0586,0.0363,0.0424,-0.0181,0.1158,0.0683,-0.2109,-0.0311,-0.184,-0.067,-0.1806,-0.2382,0.0073,-0.013,-0.0152,-0.0751,-0.0158,-0.1601,-0.0994,-0.2144,-0.0666,-0.1695,-0.0573,-0.0386,-0.0281,-0.055,-0.0717,0.0663,0.0775,0.0607,-0.1071,-0.1205,-0.1442,-0.026,0.0851,0.1221,-0.0717,0.2876,-0.0296,-0.0568,0.0513,0.0867,-0.0686,-0.0425,-0.0134,0.0546,-0.011,-0.0347,0.1373,0.2745,0.3611,-0.0517,-0.0185,0.0396,0.1098,0.0008,0.2059,-0.0162,0.3082,-0.0811,0.1055,0.0879,0.1045,0.0114,0.0233,0.012,0.0286,0.0032,0.0087,0.0711,0.0284,-0.0493,-0.1147,0.0992,0.1968,0.1957,-0.2218,-0.1727,-0.1992,0.0078,-0.1935,-0.0836,-0.0345,0.0555,0.0243,-0.0587,-0.1629,-0.1822,0.018,0.0056,-0.1141,0.0421,0.2636,0.0361,-0.0839,0.157,0.3971,0.1705,0.0885,0.1927,-0.0752,0.0459,0.2136,0.2127,-0.1068,0.2497,0.0864,0.0671,0.0971,0.3895,0.0733,-0.1569,-0.1185,-0.0721,-0.0663,0.0436,-0.1054,0.0129,-0.0985,-0.0584,0.007,-0.1618,-0.0675,0.0953,-0.1038,-0.2032,-0.0702,-0.0826,-0.0366,-0.0723,-0.1067,-0.1409,-0.1334,-0.0574,-0.0818,-0.2421,-0.1694,0.1496,0.2627,0.0064,-0.0285,0.0338,0.0344,-0.0164,-0.0744,-0.1209,-0.1767,0.0334,0.0588,-0.2194,-0.2702,-0.1062,-0.0688,-0.1313,-0.1581,0.0135,-0.0914,-0.0719,-0.1463,-0.0991,-0.0846,-0.0978,-0.037,-0.0158,-0.0333,0.1438,-0.0893,0.0455,0.1937,0.0992,-0.1771,-0.048,-0.2042,-0.168,-0.1056,-0.0231,-0.0355,0.0373,0.0864,0.0859,-0.0099,-0.0672,0.0047,-0.0876,0.0092,0.1287,-0.1757,-0.1199,-0.1858,0.0404,0.0427,0.1404,0.0011,-0.2537,-0.2256,-0.0315,-0.0207,-0.0308,0.1373,0.1088,-0.0351,-0.1296,-0.1482,-0.074,-0.1706,-0.3143,-0.1344,-0.0668,0.1228,-0.016,0.1764,-0.0239,0.1391,0.0444,0.0192,0.0361,0.0759,0.1311,0.0519,0.0096,0.0136,-0.0819,0.0401,-0.0369,-0.0056,-0.0777,-0.0558,-0.0299,0.0099,-0.1042,-0.0675,-0.0847,-0.0665,-0.1885,-0.0252,0.0297,0.077,-0.067,0.0921,0.0357,0.0893,-0.0269,-0.0348,0.0241,-0.0837,-0.1848,-0.0925,0.1989,0.171,0.0191,-0.0953,-0.063,-0.13,-0.1004,-0.0172,-0.0786,0.104,0.0918,-0.193,-0.2075,0.0433,-0.1703,-0.0616,-0.0359,0.3701,0.2252,-0.2508,0.0412,-0.0837,-0.033,-0.0998,-0.1962,-0.1967,-0.1531,0.0495,-0.0046,-0.1018,-0.027,-0.134,-0.0184,0.1721,0.002,0.0358,-0.0093,-0.0215,0.0594,-0.1816,-0.0487,0.0163,-0.1617,0.0631,-0.2246,0.1536,-0.213,0.2542,0.0963,0.1168,-0.2585,-0.2246,0.1022,0.2614,0.0647,0.2356,0.0299,0.0749,0.1206,0.0369,0.1138,0.0161,-0.0104,0.0355,0.1031,0.0229,0.0717,-0.0788,0.1114,0.2564,0.4936,0.2217,0.2266,0.3673,0.1575,0.2206,0.2786,0.1968,0.2208,0.1133,0.2343,0.2391,0.185,0.1953,0.2703,0.3094,0.2584,0.2698,0.1509,0.209,-0.2341,-0.0689,-0.2143,-0.1198,-0.0475,-0.2765,-0.2379,-0.1117,0.034,-0.0476,-0.3283,-0.2726,-0.1785,-0.0532,-0.0172,-0.2065,0.0575,-0.0189,-0.0805,0.0149,-0.118,-0.0927,-0.0677,-0.0828,-0.1804,0.1179,-0.2462,-0.2624,0.0941,-0.0119,-0.0591,0.0271,0.0371,-0.1761,0.1911,0.1747,-0.149,0.2193,0.2661,0.0707,0.082,0.1586,-0.0931,0.3614,0.3658,-0.0811,-0.063,0.0989,-0.0789,-0.0103,-0.1337,-0.0596,0.1131,-0.0102,-0.0825,0.0778,0.0235,-0.0207,-0.0294,form perception
trm_4a3fd79d0b5a7,-0.0206,0.0309,0.0478,0.0221,-0.0238,-0.0045,-0.0072,0.0199,-0.0085,0.0042,-0.003,0.0065,-0.0002,0.019,0.008,0.0149,0.0685,0.0343,0.0066,0.0274,0.0327,0.0022,-0.0093,0.0049,0.0272,0.0059,0.0088,0.0361,0.0044,0.0029,0.0186,0.0211,0.0387,0.02,0.0444,0.0482,0.0285,0.0228,-0.0144,0.0093,0.0321,0.0456,0.0037,-0.0213,0.0259,0.0271,-0.0251,-0.0094,-0.065,0.0069,0.0176,-0.0477,-0.0657,-0.0823,-0.0113,0.0054,0.0237,0.0246,-0.0398,0.0124,0.0339,0.0079,0.0376,-0.0136,-0.0245,-0.0212,0.0931,0.0642,-0.0037,0.0108,-0.0545,0.0154,-0.0496,0.0362,-0.0614,-0.0157,0.0482,-0.0006,-0.0237,0.0391,0.0116,-0.0342,0.0215,0.0025,-0.033,-0.0428,-0.0219,0.0476,0.0099,0.1112,0.0658,0.0159,0.0443,-0.0738,-0.0518,-0.0415,-0.0456,-0.0321,-0.1137,0.0002,-0.0286,0.0358,-0.0418,-0.0384,-0.0807,0.0449,0.0817,-0.0609,-0.0107,-0.0053,-0.0028,-0.0018,-0.0589,-0.037,-0.0278,-0.0102,-0.0157,-0.0269,-0.0175,-0.0004,0.047,0.0449,0.044,0.0024,0.0435,0.0346,0.0013,0.0037,-0.0062,-0.0091,0.0154,0.0343,0.015,0.0608,0.0018,0.077,-0.0057,0.0459,0.0439,0.0221,0.0102,0.0174,0.0161,-0.0314,0.039,-0.0126,-0.013,-0.0271,0.0412,0.0041,0.0308,0.0699,0.0689,0.033,-0.0669,0.0632,-0.0002,0.0063,0.0326,0.0319,-0.0027,0.0726,0.0675,0.0351,0.0107,0.0483,0.0273,0.0717,0.0685,-0.0049,0.1011,0.0695,0.0153,0.0562,0.0012,0.0975,0.0403,-0.0001,0.0131,-0.005,0.0905,-0.0058,0.0508,-0.009,0.0078,0.0039,0.049,0.0206,0.0036,-0.0131,-0.009,0.0263,0.0075,0.0022,-0.0046,-0.0317,-0.0412,0.0263,0.0169,-0.0947,-0.0731,-0.0989,0.0491,0.0533,-0.0659,0.1217,0.0924,0.0074,-0.022,-0.0284,0.0301,0.0003,0.0339,-0.0112,0.02,-0.0196,-0.0162,0.0433,0.0461,0.007,-0.017,0.0252,0.0909,0.0765,-0.0138,-0.0133,0.0113,0.0057,0.0233,-0.1145,0.0958,0.0406,-0.059,0.0336,0.0295,-0.0388,0.0206,-0.0709,0.0019,0.0331,-0.0157,0.0492,0.0146,0.0257,0.0008,0.0504,0.0224,0.0364,0.0003,0.035,-0.0094,-0.0172,0.0229,-0.0095,-0.0256,0.0657,0.0061,0.0256,-0.0274,-0.0508,-0.0083,-0.1189,-0.002,-0.0364,-0.0961,-0.1549,-0.103,-0.0282,0.0616,0.0126,-0.0015,-0.0009,0.0255,-0.0123,0.021,0.0133,0.0598,0.0781,0.0355,0.0123,0.0016,0.0467,0.0336,0.1206,0.1146,0.0539,-0.007,0.0256,0.0079,0.0263,0.0475,-0.0166,0.0247,0.0181,0.026,-0.0108,0.0168,-0.0808,0.0183,-0.1316,-0.0518,0.0081,0.0662,0.0636,-0.0284,-0.0309,0.0486,0.0242,0.0231,-0.0421,0.008,-0.0008,-0.0191,-0.1,-0.0438,0.0063,-0.0818,-0.0159,-0.0249,0.0196,-0.023,-0.022,0.0169,0.0222,0.0265,0.0245,0.02,0.0264,0.0287,0.0994,-0.011,0.017,-0.0243,0.0161,-0.0205,-0.034,-0.057,-0.0458,0.0406,-0.0321,-0.0376,0.0206,0.008,0.0141,-0.0288,-0.0482,0.0776,0.0682,0.047,0.0503,0.0224,-0.0013,0.0599,0.0181,0.0379,0.0527,0.0366,0.0538,0.0109,0.0495,-0.0202,-0.021,-0.0292,-0.0248,-0.0325,-0.0084,0.0566,-0.1341,0.0354,-0.0078,-0.0098,-0.0593,0.0538,-0.0421,0.0495,0.0218,0.0723,-0.0293,-0.0144,-0.0256,-0.0083,0.0111,-0.0264,-0.0574,0.008,-0.0206,0.0363,-0.0045,-0.0346,-0.001,-0.0393,0.018,0.0397,0.0217,-0.0402,-0.0119,0.0274,0.068,0.0384,0.0418,0.0089,-0.0114,-0.0149,0.0136,-0.0272,-0.0708,-0.0616,-0.0479,0.0353,0.0362,-0.0073,0.0637,0.0091,-0.0875,0.0809,-0.0157,-0.108,-0.0315,-0.0282,-0.0647,-0.0052,0.0531,0.0046,0.0353,0.0281,-0.0276,0.0198,-0.006,0.0211,-0.0013,0.0127,0.0091,0.0,-0.0076,0.0217,-0.0366,0.061,-0.0322,0.0909,0.0479,-0.002,-0.0008,0.0466,0.0069,0.0352,0.0106,-0.0371,-0.0756,0.0266,-0.0792,-0.117,-0.0527,0.044,-0.0072,-0.0212,0.0353,0.0397,-0.0115,-0.0188,-0.0062,-0.0504,0.0011,-0.0013,0.0231,0.0343,0.0559,0.0053,-0.1355,0.0588,0.027,0.0088,-0.0135,-0.0665,0.0524,0.0742,-0.0057,0.0077,-0.0082,0.0316,0.0061,0.0157,-0.0026,0.0231,-0.0199,-0.0342,-0.0596,-0.0037,0.0244,0.0319,0.0052,0.0545,-0.0381,0.0902,0.1212,0.0174,0.0094,0.0976,0.0017,-0.0089,-0.004,-0.0135,-0.0042,0.0097,0.0467,-0.0026,0.0375,-0.0282,0.0043,0.0534,-0.041,0.0346,-0.0036,0.0071,-0.0129,-0.0302,-0.0518,-0.0259,-0.0334,-0.0348,0.0064,-0.0296,0.0488,0.0001,-0.1373,-0.1161,-0.0126,-0.101,-0.0713,-0.0288,-0.0147,0.0378,-0.0096,0.0472,0.1108,0.0356,0.0197,0.0708,0.0446,0.0273,0.0822,-0.0099,-0.0037,0.0048,0.0108,0.0118,0.0416,0.0035,-0.0093,0.0494,0.0301,-0.0309,-0.0106,-0.0048,-0.0181,0.0355,0.1073,0.0053,-0.0494,0.0339,0.0265,0.0094,0.0109,0.0756,-0.031,0.0494,0.0109,0.0562,0.0351,-0.0085,-0.003,-0.019,-0.0107,0.0401,-0.0166,0.0588,0.0412,-0.0279,-0.0053,-0.0243,-0.0275,-0.0246,0.0141,0.0202,0.0173,-0.0782,-0.0308,-0.1077,-0.0202,-0.0197,0.003,0.0566,-0.045,-0.1059,-0.0681,-0.0372,0.0287,0.054,-0.0196,-0.0356,0.0529,0.0113,-0.0192,-0.027,-0.0093,-0.0087,0.0117,0.0387,-0.0012,-0.0078,-0.0971,0.0486,0.0154,-0.0534,-0.009,0.0548,-0.0015,-0.0123,-0.0411,0.0151,0.1052,0.0059,0.0632,0.0061,-0.0034,0.0682,0.0318,-0.0632,0.0218,-0.0095,-0.0072,-0.0339,-0.0195,0.0247,-0.0569,-0.1003,-0.0346,-0.0382,-0.0116,0.0123,-0.025,0.0159,-0.0667,0.0233,0.1068,0.0204,0.0098,0.0505,0.0306,-0.0546,0.0905,-0.0828,0.0987,-0.0614,0.0796,0.0114,0.0375,-0.0246,0.0117,-0.0059,0.0177,0.0755,0.0259,-0.0168,0.0524,-0.0606,-0.0283,0.0139,0.0713,-0.0109,-0.0023,0.049,0.0238,0.0345,0.071,0.0151,0.0334,-0.0075,0.0607,0.0159,-0.0095,-0.0562,-0.0337,-0.0317,-0.0241,-0.0495,0.0488,-0.0012,-0.0151,-0.0283,0.0208,-0.0586,-0.0878,-0.0669,-0.0685,-0.0081,0.0514,0.0186,0.0107,0.0151,-0.0663,-0.0542,-0.0387,0.0155,0.0609,0.0378,0.0175,0.0568,0.0921,0.065,-0.0411,0.0067,-0.0304,-0.018,0.0281,-0.0273,-0.0405,0.0047,0.0558,0.0555,-0.0322,0.0081,0.0419,0.1486,0.1467,0.0871,0.0,-0.02,-0.003,-0.0481,0.0299,0.025,0.0215,0.0177,-0.0377,-0.0492,-0.0019,-0.0118,-0.0596,-0.0551,-0.125,0.0361,0.0505,0.0143,0.0425,0.0156,0.0283,-0.0385,0.0456,-0.0034,0.0078,0.0035,-0.0104,0.0359,0.0607,0.0749,0.0598,0.0008,-0.0228,0.0183,0.0718,0.04,-0.0073,-0.0095,-0.0189,-0.006,0.0206,0.0524,0.0109,0.0402,-0.0488,-0.048,-0.0429,-0.0035,-0.009,-0.0324,0.0207,0.0028,0.0245,0.0261,-0.0077,0.0376,0.0266,0.0123,-0.0557,0.0105,0.0021,-0.005,-0.0003,-0.0528,-0.0794,-0.0039,0.0062,0.0159,-0.0132,0.006,-0.0282,-0.0506,0.0654,-0.0777,0.0018,0.0106,-0.0462,-0.0196,-0.0134,-0.0092,-0.008,-0.0322,-0.036,0.0017,-0.0733,0.0241,-0.031,-0.0172,-0.0484,-0.0205,0.0036,-0.0888,-0.0556,0.0529,0.0329,-0.0048,0.0748,0.0736,0.01,0.039,0.0005,0.0351,-0.0197,0.0631,0.0576,0.0747,0.005,-0.0336,0.0228,0.0227,0.0395,-0.0537,-0.0375,-0.0297,0.0008,-0.0458,-0.0461,0.0157,-0.0298,-0.0326,-0.037,-0.0801,-0.093,0.033,-0.0385,-0.0206,0.0456,0.0018,0.005,0.0383,-0.0746,-0.1178,0.1386,0.0475,-0.0091,-0.0286,-0.0844,-0.0508,-0.0343,0.0464,0.0508,-0.0146,-0.0,-0.0652,-0.0583,0.0008,0.0801,0.0035,-0.0109,-0.0269,-0.1713,-0.0778,-0.1554,0.0417,0.056,0.0087,-0.0695,0.0036,-0.0002,0.0152,-0.0009,0.0349,-0.0068,0.0284,0.0202,-0.0091,0.0375,0.06,-0.0039,-0.0113,0.0018,-0.0043,0.0057,-0.0334,-0.0238,0.0125,-0.0569,0.0228,-0.0216,-0.022,-0.0229,-0.0517,0.0453,0.0322,0.0346,0.0333,0.0844,-0.0132,0.0017,-0.0409,-0.0247,0.0128,0.0037,-0.0277,-0.0583,-0.0568,-0.0309,0.0155,0.0348,0.0505,0.017,0.0285,0.0014,-0.0107,0.0172,0.0168,0.0042,0.0051,0.0176,-0.004,0.0036,0.0874,0.0167,0.0395,0.031,0.025,0.0658,0.0102,0.0737,-0.0142,-0.0045,0.0669,0.0272,0.0425,0.0385,0.0415,0.0982,0.018,-0.0005,0.0354,-0.0362,-0.0639,0.0221,-0.0195,0.0206,0.0461,0.0,-0.0296,-0.0482,-0.0227,0.0444,-0.0454,-0.0158,0.0143,-0.0038,-0.0459,-0.0109,0.0029,-0.052,0.0526,-0.033,0.0423,-0.013,-0.0092,-0.0339,-0.0001,-0.0223,0.0405,0.004,0.0309,0.0346,0.0162,-0.0592,-0.0301,-0.0251,0.0197,-0.0176,0.0181,-0.0938,-0.0976,0.0045,-0.0378,-0.027,-0.0079,-0.0113,0.078,0.0656,-0.0049,-0.0051,0.0036,0.0483,0.0455,0.0378,0.0314,0.0477,-0.0918,-0.0248,-0.1321,0.0081,0.0016,0.0291,0.0255,-0.0398,-0.0125,0.0217,0.0016,0.0224,0.0097,0.0491,0.0096,-0.0347,0.0239,0.022,0.0281,-0.003,0.036,-0.0171,0.0036,-0.0367,-0.1152,-0.0686,-0.0765,-0.0924,-0.0018,-0.0432,-0.0181,0.0104,0.0021,-0.0067,-0.0056,-0.029,-0.0047,-0.0545,-0.036,0.0105,-0.0071,0.0635,0.0439,0.0864,0.0317,-0.0446,0.0153,0.0375,0.0732,-0.03,-0.0149,-0.0093,0.0244,-0.0054,0.0178,0.0026,-0.0279,0.0687,0.0423,0.0488,-0.0153,0.0334,0.0207,0.0546,0.0219,0.0085,0.026,0.0416,0.0525,-0.0033,0.0733,0.0475,0.0073,-0.049,0.0012,-0.0237,0.01,-0.0163,0.0509,0.0722,-0.0577,-0.0382,-0.0791,-0.082,-0.0568,-0.0027,-0.0604,-0.0006,-0.0002,-0.0202,0.0153,0.0008,-0.0268,-0.0081,0.0149,0.0233,-0.0045,0.0171,-0.0047,-0.0247,-0.0233,-0.0309,0.0196,-0.0009,-0.0009,-0.0318,-0.0448,-0.0026,0.007,-0.0347,-0.0015,0.0271,-0.021,-0.0367,-0.0497,0.0012,-0.0653,0.0087,0.0774,0.0099,0.0144,0.0251,0.0001,0.0107,-0.022,0.0331,0.0763,0.0382,-0.0245,0.0006,-0.0218,-0.0573,-0.0404,0.0289,0.0127,0.0063,-0.0055,-0.0302,-0.0256,-0.0287,-0.0027,-0.0401,-0.0618,-0.0696,0.0681,0.0781,-0.0595,0.0215,-0.0223,0.0033,0.0421,0.0002,0.0211,0.0601,0.0286,0.0131,0.1522,0.0207,-0.0055,0.0255,-0.0077,-0.0044,-0.0896,0.024,-0.0225,0.0191,0.0018,0.0566,0.0172,0.034,0.0941,0.0339,0.0154,-0.0117,-0.1163,-0.067,-0.1028,-0.0855,-0.0082,-0.061,-0.0178,-0.049,-0.0404,-0.0889,0.0358,-0.1121,-0.138,-0.0327,0.0801,-0.1138,-0.1168,0.0054,0.0395,0.0128,0.0452,0.0185,0.1084,0.0033,-0.0627,0.051,0.0536,-0.0016,0.044,0.0152,0.0129,0.0754,0.0129,0.0487,-0.0559,-0.014,-0.0111,-0.034,-0.0074,-0.0342,-0.0334,0.0276,-0.0136,0.0051,0.0404,-0.0227,0.0598,-0.0302,0.0053,0.0402,-0.0089,-0.0331,0.0708,-0.002,-0.0502,-0.0231,0.021,0.0284,-0.0223,-0.022,-0.003,-0.0337,-0.0052,-0.0253,0.0188,-0.0187,-0.0187,0.0315,-0.0173,-0.0044,-0.0228,0.0452,-0.0099,0.0556,-0.0628,0.0674,0.0726,-0.024,0.0414,0.0479,0.0484,0.0287,-0.0188,0.0702,0.0333,-0.0369,-0.0181,-0.0402,0.0352,-0.0057,0.0034,-0.0373,0.0274,-0.0669,-0.0478,-0.0212,0.0008,-0.0334,0.0391,0.0186,0.0113,0.0336,-0.0012,-0.0241,0.0181,0.024,-0.0195,-0.0081,-0.0331,0.046,0.0342,-0.0416,0.0086,0.0454,0.0616,0.0531,0.0285,0.0084,0.0463,0.0163,0.0262,0.0738,-0.0154,0.0202,-0.0345,0.1082,0.0147,0.027,-0.0089,0.0176,-0.0522,0.0302,-0.0422,-0.0235,-0.0344,-0.0393,0.0479,0.015,0.0238,0.046,0.0413,-0.0499,0.0136,0.0066,-0.0079,0.0475,0.0062,-0.059,-0.0101,0.0557,-0.0076,-0.0372,0.0011,0.0053,-0.0022,0.0055,0.0043,0.0909,0.0469,0.0614,0.084,0.0155,0.0079,0.0518,0.0451,0.0287,0.0394,0.0282,-0.0292,-0.0214,0.0126,-0.0042,-0.0223,0.037,0.0287,-0.0191,-0.0006,0.0519,0.1251,0.0023,-0.0384,0.0316,0.0637,0.0326,0.0171,-0.0548,-0.0705,0.0031,0.0198,0.066,-0.0183,-0.0136,0.0286,0.021,-0.0098,0.0019,0.0441,0.0142,0.0152,0.0342,0.0085,-0.0142,-0.0158,0.0049,0.0204,-0.0295,-0.0765,-0.021,0.0337,0.0103,0.0267,0.0359,0.0024,0.0702,0.0414,-0.0002,-0.0167,0.0199,-0.0332,0.0424,0.0054,0.03,-0.0113,-0.0061,0.0008,0.0114,0.0218,-0.0033,0.0112,-0.0749,-0.0124,0.0044,0.0025,-0.0322,-0.0032,0.0637,0.1284,-0.0325,0.0212,-0.0076,-0.0301,0.0091,-0.0258,-0.0327,-0.0665,0.0314,0.0124,0.0161,-0.0142,0.0843,0.0243,0.047,0.0314,0.032,0.0157,-0.0008,0.0623,0.0099,-0.1366,-0.0787,-0.0284,-0.0193,-0.1468,-0.041,-0.041,-0.0047,-0.0499,0.0191,0.0033,-0.1062,-0.0497,-0.0698,-0.0326,0.0027,-0.033,0.033,0.0283,-0.002,-0.0154,-0.0046,-0.043,0.0663,0.02,0.0197,-0.0594,-0.0291,-0.0271,-0.0218,-0.0632,-0.0646,-0.0279,-0.0292,0.0368,-0.0524,0.0059,-0.01,0.0412,0.0058,0.0499,-0.0389,0.0314,-0.0137,0.0516,0.0514,-0.0102,0.043,0.0587,-0.0353,0.0329,0.0134,0.0466,0.0023,-0.0438,-0.172,0.0551,-0.0293,-0.0097,0.0101,-0.0002,-0.0231,-0.0179,0.0165,0.0188,-0.0541,-0.0578,-0.0391,-0.012,0.0309,-0.0453,-0.1679,-0.1744,0.095,0.0442,-0.062,0.0302,0.0318,0.0044,0.0806,-0.0158,0.0467,0.031,-0.0234,-0.0252,-0.0977,-0.022,-0.0636,-0.0115,0.04,-0.1268,-0.178,0.0657,0.0003,-0.0984,-0.0015,-0.0169,0.013,-0.0058,0.0167,-0.0662,-0.0524,-0.0047,0.0913,-0.0462,0.0217,-0.0499,-0.039,-0.0172,-0.0141,0.0031,-0.0089,0.0455,0.0401,-0.0248,0.0403,0.0219,-0.0003,0.0128,0.0176,0.0174,-0.0155,0.026,0.0073,0.086,0.0355,-0.054,0.0384,0.0423,0.0268,0.0127,-0.0054,0.0087,-0.0177,-0.0086,-0.0002,-0.0937,-0.076,0.0103,-0.0498,0.0036,0.0439,-0.1334,0.0655,0.0196,0.013,-0.0253,0.0194,-0.0073,-0.0224,0.0168,0.0022,-0.0316,-0.0157,-0.0249,-0.0101,-0.0113,0.0171,0.0079,-0.0636,-0.1036,0.0388,0.0666,0.0209,-0.032,-0.009,0.0293,0.046,-0.0084,-0.0235,-0.0621,-0.0185,0.0808,0.0783,0.0253,-0.0016,-0.0783,0.048,0.0596,-0.0186,-0.021,-0.0149,0.0228,-0.0103,-0.0141,-0.0114,-0.0241,-0.0438,0.0768,0.0804,0.1082,0.0038,0.0076,-0.0195,-0.1493,0.0549,0.0232,0.0422,-0.085,-0.1173,-0.0816,0.0771,0.0172,0.0264,0.018,-0.0243,-0.0271,-0.0553,0.0212,-0.0179,-0.0003,-0.0149,0.0001,-0.0337,0.0973,-0.0099,0.0083,0.0676,-0.0132,0.0246,0.007,0.11,0.0253,-0.0295,-0.0346,0.0582,0.0528,-0.0064,-0.0094,-0.011,0.0259,-0.0638,-0.0637,-0.0203,-0.1551,0.0553,0.009,0.0577,0.0211,-0.086,-0.0102,0.0323,0.0388,0.0363,-0.0006,-0.0491,0.0094,-0.1098,-0.0233,0.0294,-0.005,0.0168,0.0394,0.0131,0.0316,0.0944,-0.0295,0.0073,-0.0126,0.0271,0.0477,-0.0171,-0.0824,-0.0563,-0.0447,-0.0239,-0.0016,0.0494,0.0396,0.0462,0.0729,-0.0179,0.033,0.0227,0.0304,0.0611,0.0381,0.0068,0.0363,0.0433,-0.0015,0.0224,0.056,0.0311,0.0772,0.0608,0.0539,-0.0793,-0.0122,-0.0117,0.0888,-0.0259,0.004,0.0457,0.1146,-0.0083,0.0361,0.0719,0.0238,-0.0172,-0.0189,-0.0439,0.0293,0.051,0.0729,-0.0852,0.0085,-0.1095,0.0017,-0.0795,-0.014,-0.0479,-0.0743,-0.1475,0.0061,-0.0135,0.0308,-0.007,0.066,0.0888,0.0442,0.0072,-0.0101,0.0438,0.0108,0.0218,0.0946,-0.0195,-0.0046,-0.0108,0.0733,-0.0468,-0.0405,0.002,0.0078,-0.0278,0.0169,0.0337,-0.0584,-0.0393,-0.0063,0.0526,0.0633,0.1218,0.0336,0.0428,0.0403,0.0806,0.0574,0.0293,0.0033,-0.0032,0.0415,0.0041,-0.0298,-0.0467,-0.0559,-0.0883,0.142,0.1381,0.0161,0.0099,0.0297,0.0114,-0.0474,-0.0062,-0.0165,0.0048,0.0151,0.0497,-0.0116,-0.0006,0.0158,-0.0305,0.0413,-0.0542,-0.0091,-0.082,-0.0239,-0.046,0.0423,0.02,0.0749,0.0465,0.0462,0.0631,0.0377,-0.0284,-0.0257,-0.0111,0.0202,0.0134,0.1044,0.0343,0.035,0.0216,-0.1089,0.0294,-0.0569,0.0063,0.0683,0.031,0.0491,0.011,-0.058,0.0455,0.0164,0.0007,-0.0521,0.0446,0.0229,0.0291,0.041,0.021,-0.0357,-0.0186,0.0644,0.0225,0.0734,0.0576,0.0712,-0.0161,0.011,-0.0339,-0.023,-0.0604,0.0476,0.0582,0.0217,-0.0117,0.0116,-0.0015,-0.0112,-0.0373,0.0007,0.0723,0.0291,0.0589,0.0371,0.0334,0.0255,0.0349,0.0167,-0.0239,0.0222,0.0698,0.0494,-0.015,0.0822,0.1353,-0.0531,0.0455,-0.0115,-0.0264,0.037,0.0008,0.0358,0.0116,0.0194,0.0266,-0.0068,-0.0269,0.0831,-0.0119,-0.0455,-0.042,0.0065,0.0539,-0.0112,0.044,0.0423,0.0071,0.0233,0.0481,-0.0262,0.0071,-0.0062,0.0339,0.0709,0.0323,-0.0269,0.0504,0.0173,0.0706,0.0042,-0.0221,0.0322,0.0089,0.0558,0.0242,-0.0533,-0.0006,-0.0245,-0.0055,-0.0087,-0.0084,-0.0388,-0.031,0.0017,-0.0566,-0.1448,-0.1183,-0.0193,-0.0736,-0.0146,0.0251,0.0308,-0.0656,-0.0305,-0.0359,-0.0276,-0.0199,-0.0234,-0.0089,-0.0119,0.0009,0.0214,-0.0387,-0.0354,-0.0281,0.0346,0.0049,-0.0328,-0.0642,-0.0608,-0.0482,-0.0037,0.0002,-0.0046,0.0347,0.0182,0.0022,0.0443,0.0276,0.0168,0.042,0.0591,0.0407,-0.0379,-0.0008,-0.0227,0.0355,0.0178,-0.0729,-0.1084,0.0037,0.0035,-0.0254,0.0109,-0.0025,0.0185,-0.0206,0.03,0.0387,0.0191,0.0306,0.0188,0.012,-0.0472,0.0408,0.0423,-0.0431,-0.043,-0.0777,-0.0075,-0.0075,-0.106,0.04,0.0376,0.0384,0.0365,-0.0439,0.0394,-0.0571,-0.0484,-0.0525,0.0146,0.0454,0.0468,0.0482,0.048,-0.0249,0.0114,-0.0113,-0.0021,0.0278,-0.063,-0.0187,0.0649,-0.0535,-0.0217,0.0584,-0.0098,0.0657,0.0601,0.0577,0.0264,-0.0028,0.0448,-0.0331,0.009,-0.0462,-0.1576,-0.137,-0.0729,-0.0754,0.006,-0.0226,-0.033,-0.0961,-0.1044,-0.1257,0.0191,-0.0463,0.0265,-0.0365,0.0001,0.0121,0.0157,0.0199,0.0035,0.0564,-0.005,0.0464,0.0458,-0.0377,0.0133,-0.0289,0.0156,-0.0329,0.0976,-0.0271,0.0121,0.0775,0.1053,0.0104,0.0106,0.0441,-0.0159,0.0158,0.0806,-0.0089,-0.0281,0.011,0.0918,0.0093,0.0756,0.0372,-0.0242,-0.0193,-0.002,-0.0202,-0.0058,-0.0673,-0.1152,-0.1341,-0.0106,-0.0319,-0.0437,0.0156,0.0334,-0.0066,0.0267,0.0378,0.0094,0.0147,0.004,0.0423,0.0806,0.0487,0.0305,0.0363,-0.0225,0.0295,-0.0566,0.002,0.0038,-0.0257,0.0133,0.0234,0.0193,-0.0821,0.0426,0.0483,0.0432,-0.014,-0.0038,0.0033,-0.0021,0.008,0.0086,-0.072,0.0528,0.0591,0.0624,-0.0073,0.0133,0.0117,-0.0098,0.0388,0.0219,-0.0071,-0.008,0.0519,0.0269,-0.0131,-0.0485,0.02,0.0977,-0.0029,-0.0099,0.0042,0.0018,-0.005,0.0829,0.052,0.0041,-0.0001,-0.0316,0.1115,0.0455,0.074,0.0812,0.0374,0.0285,0.0243,0.0243,0.0345,-0.0069,-0.0317,0.0871,0.0112,0.0635,0.0523,0.0307,0.0787,0.1343,-0.026,0.0119,-0.0356,0.0106,-0.0941,0.0031,0.0391,0.069,0.0045,0.0603,0.0838,0.0209,-0.0698,0.0246,-0.061,-0.1379,-0.1182,0.0042,-0.0594,0.0151,0.0311,0.0046,0.0601,0.0266,-0.0137,-0.0041,0.0021,-0.024,-0.0352,-0.047,-0.0354,0.0215,-0.0074,0.0058,0.0128,-0.0433,0.0458,-0.0731,-0.0324,-0.0474,-0.0346,-0.0274,-0.1276,0.0086,-0.0246,-0.0247,0.0243,-0.0092,-0.062,0.043,-0.0635,-0.0218,-0.1023,0.0073,0.0527,-0.0403,0.0066,-0.0287,-0.0381,-0.0011,0.0298,0.0285,-0.0202,-0.0019,0.0251,0.109,0.0728,0.1067,0.0161,0.0711,0.0626,0.0751,0.0035,0.0035,0.0027,0.0233,0.047,0.0016,-0.0165,0.0234,0.0414,-0.0237,-0.0046,-0.0735,-0.0431,-0.0419,0.0048,-0.0437,-0.0318,-0.0202,-0.0765,-0.0671,0.0161,0.0216,0.0052,0.023,0.0081,0.0438,-0.0082,0.0096,0.0277,-0.025,0.035,-0.0005,-0.0218,0.0287,-0.0114,0.0229,0.0348,-0.0399,-0.0461,-0.0445,-0.0234,0.0347,0.0245,-0.0084,0.0081,-0.0342,-0.0372,0.0509,0.021,0.0305,0.0054,0.0361,0.0505,0.042,0.0396,0.0124,-0.0109,-0.0001,-0.0227,0.0014,0.0051,0.0593,-0.0051,-0.001,-0.0308,0.0021,-0.0175,-0.0781,0.0589,0.045,-0.0087,-0.0309,-0.0228,0.0447,-0.024,-0.0291,0.075,0.0153,0.0298,0.0383,-0.0098,-0.0594,0.0145,-0.0073,-0.0073,0.0477,0.0053,0.036,0.023,0.0016,0.0413,0.0143,-0.0301,-0.0535,-0.062,-0.0395,0.0268,0.0284,-0.0133,-0.0527,-0.0273,0.025,0.0334,0.0214,-0.0152,0.009,-0.0395,-0.0049,0.0568,-0.0475,0.0007,0.0107,0.0073,-0.033,-0.0182,0.0025,-0.0514,-0.0056,0.0094,0.017,0.0897,0.0291,0.0041,0.1033,0.0025,-0.0662,0.0163,-0.0224,0.03,-0.0074,0.0246,-0.0013,0.0491,0.0912,0.0604,0.0363,0.0199,0.0028,0.0191,-0.0108,-0.0179,0.0272,-0.0011,0.0512,0.0303,0.0405,0.0529,-0.0256,0.0302,0.0156,0.0491,-0.0226,0.052,-0.0823,0.0408,0.0054,0.0413,-0.0386,-0.0808,-0.0466,0.0397,0.043,-0.0143,0.0418,0.0276,-0.018,0.0541,0.0463,0.0165,-0.0272,-0.0406,-0.0368,-0.0518,0.0016,-0.019,-0.0149,0.0241,-0.0058,0.0193,0.0495,0.0665,0.0452,-0.0032,0.0078,-0.0046,0.0217,-0.0025,0.0045,0.0002,0.0047,0.0215,0.0462,-0.0067,0.0016,-0.046,0.0026,0.0074,0.0168,-0.0162,-0.111,-0.0736,-0.0617,-0.0746,0.0638,0.0146,-0.0203,0.0503,0.0352,-0.0509,-0.0361,-0.0268,-0.0045,-0.0278,-0.0132,0.0209,0.0051,-0.058,0.049,-0.0851,-0.0403,-0.007,-0.0309,-0.0335,-0.0198,0.0072,0.0179,-0.0481,-0.083,-0.0886,-0.0541,-0.0961,0.0013,-0.0141,-0.009,0.0212,0.0799,0.1621,0.1592,0.0244,-0.0417,-0.0385,0.0614,-0.044,-0.0352,0.0286,0.0655,0.0667,-0.02,0.0281,0.0076,-0.0067,-0.0462,0.0599,0.0203,0.0303,0.0367,0.0267,0.0053,0.0753,-0.0043,0.0234,0.0101,0.0421,0.0302,-0.0061,-0.0392,-0.0303,0.0038,0.0185,-0.046,0.0357,-0.0677,-0.0714,-0.0992,-0.0007,-0.0325,0.0485,-0.0286,-0.0461,0.0548,0.036,0.0133,-0.0146,0.0518,0.0349,0.0509,0.0802,0.0154,0.0644,0.0656,-0.0273,-0.0002,-0.0083,0.0378,0.0849,0.0092,0.0123,0.0333,0.0411,-0.0341,0.0411,0.0447,0.006,-0.0558,0.0261,-0.0251,-0.0506,-0.0506,0.0252,0.0228,0.0488,0.0929,0.0169,-0.005,0.034,-0.0347,-0.0213,-0.0313,-0.0252,-0.1144,-0.0567,-0.082,-0.0749,-0.0193,0.0738,0.089,0.0441,0.0313,0.0074,0.0256,0.0434,0.0022,-0.0316,-0.0063,0.0489,0.0119,0.0263,0.0344,0.0955,0.0984,0.0157,-0.0516,-0.0439,0.0292,0.0555,0.0185,0.0885,-0.0326,-0.03,-0.0449,-0.0059,0.0346,-0.0541,-0.0966,-0.0623,-0.0269,0.0442,-0.0054,0.0014,0.0026,-0.0147,0.0224,-0.0009,-0.0665,-0.0478,-0.0274,-0.0357,-0.0069,0.0324,0.0704,0.0217,0.0036,0.0433,-0.0988,0.024,-0.059,-0.0274,-0.0192,-0.0182,-0.0166,-0.0736,-0.0026,-0.0955,-0.0685,-0.0167,-0.0666,-0.0272,0.0065,0.0263,0.0279,0.0454,-0.0716,-0.0154,-0.0468,0.0391,0.0409,-0.0157,-0.0285,-0.0386,0.0246,0.0252,0.0492,0.0023,0.0373,0.0628,0.0418,0.0131,-0.0381,-0.0267,-0.0864,0.0151,0.0375,-0.0019,0.0388,-0.0639,0.004,0.068,0.0155,0.0118,-0.0055,-0.0202,-0.0517,-0.0145,-0.0429,-0.0101,0.0099,-0.0111,0.0055,0.0594,0.0362,-0.0507,-0.0191,0.0231,0.0089,0.0336,0.0409,0.0622,0.0577,0.0409,0.0285,0.0376,0.0371,0.0397,-0.0687,0.0739,0.0663,0.0397,0.0035,0.0044,0.0914,0.0466,0.0291,-0.0273,-0.0276,0.0634,-0.1123,-0.1016,-0.0381,-0.0317,0.0523,0.0303,0.1137,-0.0151,0.0687,-0.0113,-0.0231,-0.0501,0.0073,-0.0108,0.0046,-0.0247,0.128,0.0689,0.0226,0.0302,0.1168,0.0742,0.0764,0.0751,0.003,0.0402,0.0621,-0.0415,0.0971,0.0889,0.0493,-0.0298,-0.0099,0.0602,0.0315,0.1621,0.1062,0.0755,0.12,-0.0406,0.0262,0.0249,-0.0179,0.0621,0.0365,0.042,0.0878,-0.0526,-0.0423,-0.0863,-0.0871,-0.0921,-0.0562,-0.0603,-0.0842,0.0084,-0.04,-0.0557,-0.0441,-0.0249,-0.0261,0.0956,0.0813,0.0629,-0.014,-0.0047,0.0134,0.0974,-0.0048,0.0351,-0.0038,-0.1258,-0.1056,0.0548,0.0054,0.027,-0.0027,0.0605,0.0744,0.0047,0.091,-0.0158,0.0473,0.0008,0.0253,0.0269,0.0221,0.0974,0.0476,-0.0051,-0.0055,0.0473,0.0246,0.0098,-0.0238,-0.0457,0.0014,-0.0042,-0.0028,0.0071,-0.0234,-0.055,-0.018,0.0272,-0.1223,-0.0535,-0.0001,-0.0207,-0.0463,0.0312,0.0317,-0.0008,-0.0083,0.0097,0.0219,-0.0101,-0.0685,-0.1793,0.0281,0.0519,0.0142,0.0316,-0.0194,-0.0606,0.0136,-0.0788,0.0982,-0.0126,-0.0033,-0.0654,-0.0247,0.0213,0.0289,0.014,-0.0272,-0.0223,0.027,0.034,0.0487,0.0131,-0.0566,-0.0937,-0.1001,0.0558,0.0669,0.0245,-0.0199,0.055,0.0338,0.0317,-0.0162,0.0184,-0.0005,0.0164,0.0224,-0.0329,-0.0053,0.005,-0.0223,-0.0804,0.0038,0.0312,-0.0586,-0.1615,-0.0942,-0.0751,-0.0653,0.0093,0.0027,-0.0935,-0.0996,0.0534,-0.1007,-0.044,-0.0711,-0.0126,-0.1478,-0.0127,0.0094,0.0789,0.0179,0.094,0.0299,0.0483,0.0607,0.0453,0.0861,-0.0057,0.0922,0.0942,-0.0017,-0.0,0.096,0.0827,0.0591,0.0514,0.0034,0.0093,0.0345,0.0307,-0.0089,0.0101,0.0184,0.0138,-0.0406,-0.0742,0.0369,0.0106,-0.0259,-0.0274,0.015,-0.008,0.0374,0.0085,-0.0075,-0.0285,0.055,0.0846,0.0135,0.0351,0.0659,0.0627,-0.0201,0.0582,0.0331,0.032,-0.0176,-0.0132,-0.0041,0.028,0.0298,0.0728,-0.0681,0.0575,-0.0439,-0.0585,-0.0151,0.0803,0.0639,0.0573,0.0427,0.0148,-0.0031,-0.0017,-0.0288,0.0171,-0.0196,-0.0106,0.018,-0.0172,0.0152,0.008,-0.0117,0.021,0.0179,0.0198,0.0139,-0.0243,-0.0228,0.0197,0.0546,0.0298,0.0542,0.0576,0.0127,-0.0444,-0.008,0.0009,0.0053,0.0709,0.0372,0.0632,0.0515,0.0177,0.0244,-0.0657,0.0017,-0.1614,0.0105,-0.0454,0.0225,-0.08,0.0069,-0.0033,-0.0725,-0.0246,0.0017,0.0019,-0.0062,-0.0279,-0.0384,-0.0138,0.0013,0.0127,0.0234,-0.0161,0.0042,0.0123,-0.0022,0.0581,0.0907,0.0019,-0.05,-0.0263,0.075,0.0032,0.0066,0.0179,0.0429,0.0141,-0.0261,-0.0416,0.0343,0.0245,-0.0621,-0.0451,0.0734,0.0649,0.0426,0.0937,0.0344,0.0037,0.0526,-0.0662,-0.0071,0.106,0.043,-0.0137,0.0409,-0.0097,0.0311,-0.018,-0.0435,0.0453,-0.0204,0.0262,0.0078,0.0267,0.0466,0.0836,0.0865,-0.0034,-0.0043,0.0225,-0.0452,-0.0007,0.0577,-0.0726,-0.0198,-0.0222,-0.0115,-0.0275,-0.0066,0.0341,0.0292,0.003,0.051,-0.0431,0.0883,-0.04,0.036,-0.0133,-0.0973,-0.0866,0.0923,0.0779,-0.0026,-0.113,-0.0358,-0.1241,0.033,-0.0315,-0.0504,-0.0216,-0.0262,-0.0167,-0.0223,0.0099,-0.0004,0.0019,-0.0108,0.0078,-0.0282,-0.0213,-0.0808,-0.0372,-0.0318,-0.0315,-0.0283,-0.0464,-0.0232,-0.0677,-0.0381,-0.0068,-0.0793,-0.0713,-0.0477,-0.0155,-0.0525,-0.06,-0.0408,-0.0823,-0.0235,-0.0497,0.0739,-0.0252,0.0838,0.0735,0.0822,0.0796,0.0859,0.0191,0.0147,0.0327,0.0893,0.0602,0.0521,0.0434,0.0175,0.0313,-0.0023,0.0396,-0.0123,-0.0139,0.0233,0.0211,-0.0172,0.0398,0.0205,0.0124,0.0178,0.017,0.0129,-0.0114,-0.0158,0.0345,0.0267,0.0874,-0.1299,-0.0637,0.011,-0.0632,-0.0323,0.0152,-0.0163,-0.0048,0.0328,-0.1913,-0.1928,0.0558,-0.0098,-0.0045,0.0435,0.0172,0.0447,0.0144,0.0012,0.038,0.0203,-0.0026,0.0291,0.0266,-0.0354,working memory
trm_557b4993a0fdd,0.0227,0.0785,-0.0041,0.0633,-0.0507,-0.012,0.003,0.0298,0.0264,0.0401,-0.0141,-0.0525,0.05,0.0168,0.0555,0.0811,0.044,0.0241,0.0132,0.0014,0.0039,-0.0502,0.0001,-0.0108,0.005,-0.0213,-0.019,0.0478,0.0689,0.0398,0.0431,0.0183,0.0734,0.0143,0.0759,0.0411,-0.0122,-0.0024,0.0702,0.0114,0.0673,0.1225,0.0489,-0.0588,0.0493,0.0363,-0.1308,0.0656,-0.0246,0.0389,0.0292,0.0004,-0.0481,-0.0199,0.013,0.0151,0.0539,-0.0136,-0.0388,0.0285,-0.0279,-0.062,0.0846,-0.0438,-0.004,-0.0071,0.0783,0.0827,0.0741,-0.0307,-0.0395,-0.0604,-0.0693,0.0364,0.0738,-0.0013,0.0918,-0.0733,-0.0138,0.0285,-0.0283,-0.0714,0.0394,0.1005,-0.0173,-0.0213,0.0311,-0.0002,-0.0226,0.1664,0.0585,0.0134,-0.0021,-0.0341,-0.0462,-0.0348,-0.0447,0.0002,-0.1057,-0.0013,-0.0099,-0.0369,-0.0406,-0.0029,-0.0163,0.0501,0.1152,-0.0441,0.0349,0.0501,-0.0147,0.0544,-0.0597,-0.0543,-0.0077,0.0109,0.007,0.0046,-0.0092,0.0183,0.0186,0.0909,0.0218,-0.0083,0.0691,0.0507,0.0563,-0.0183,-0.0652,-0.0404,0.0162,0.03,0.0192,0.0845,0.0077,0.0666,-0.0,0.0333,0.034,0.0092,0.0455,0.0438,-0.0265,-0.0333,0.0345,0.0125,-0.0028,-0.0388,0.0562,-0.0466,0.0503,0.0135,0.0578,0.0836,-0.0639,0.0019,-0.0537,-0.0279,-0.0517,-0.0396,0.0712,0.0175,0.0567,0.0965,-0.0074,0.0176,-0.0331,0.1142,0.1074,-0.0057,-0.0347,0.0292,-0.0756,0.0548,0.0372,0.0939,0.0553,0.0148,0.0175,-0.0093,0.121,-0.0724,-0.0039,-0.0034,0.0152,-0.0264,0.0506,-0.0071,-0.0045,0.0585,0.0654,0.0137,0.038,0.0498,0.0397,0.1447,0.0977,0.0234,0.0144,0.1046,0.009,-0.0918,0.0513,0.0982,-0.0264,0.0753,0.056,0.0077,0.0467,-0.011,0.0509,0.0278,0.0392,-0.0673,-0.0204,-0.0308,-0.0856,0.0512,0.057,-0.0278,-0.0511,0.0374,0.0465,0.018,-0.0132,-0.0422,0.0825,-0.0412,-0.0063,-0.0557,0.0421,0.0453,-0.1106,0.0458,0.0443,0.0248,0.009,-0.0198,-0.007,0.0489,-0.0161,0.0783,0.0436,0.0155,0.0173,0.0574,0.0448,0.0913,0.0715,0.0322,-0.0076,-0.015,0.0518,-0.0027,-0.0082,0.0848,0.0185,0.0808,-0.0384,-0.1706,-0.0338,-0.1196,0.0277,-0.0484,-0.0998,-0.1381,-0.0414,-0.004,-0.0134,0.0165,0.0555,0.0177,0.0769,-0.0373,0.0809,-0.0068,0.1064,0.0982,0.1174,0.0186,0.003,0.0067,-0.0023,0.0804,0.0829,0.0545,0.0178,-0.0178,0.0613,0.0264,0.0285,0.022,-0.0305,0.0468,0.052,-0.0046,-0.0269,-0.0172,0.0036,-0.0352,-0.0189,0.0172,0.0704,-0.0031,0.0349,0.0325,0.0411,-0.0045,0.0275,0.0077,0.0078,0.0183,0.0897,-0.0207,-0.0232,0.0826,-0.0338,-0.0098,-0.0394,0.0809,0.0016,-0.0611,0.0548,0.0604,0.0385,0.0565,0.0238,0.0915,0.0306,0.0477,0.0078,0.0029,-0.0528,-0.0492,-0.0455,-0.0259,-0.0227,-0.0005,0.0022,0.0428,0.0323,-0.094,-0.0085,-0.0167,-0.0169,-0.0141,0.0947,0.0754,0.0541,0.0582,0.0508,-0.0205,0.0413,0.0288,0.0445,0.0353,-0.0043,0.0681,0.0454,0.071,-0.0274,0.031,0.0313,-0.0473,-0.0095,-0.0408,0.048,-0.0349,-0.0113,0.0465,-0.0049,-0.0596,0.0315,-0.085,0.0919,0.0775,0.0789,-0.0564,-0.077,-0.0515,-0.1157,-0.0151,0.066,0.0176,0.0008,0.0008,0.0379,-0.0164,-0.0435,-0.0162,0.001,0.0247,0.0106,0.0283,-0.1061,-0.0698,0.0397,0.066,0.0505,0.0267,0.022,-0.0223,0.0122,0.0035,-0.0518,-0.0363,-0.0138,0.0034,-0.0011,0.0195,0.0225,0.0831,0.0108,-0.0517,0.0166,0.0142,-0.0915,-0.0011,0.0695,0.0087,-0.0106,0.0903,0.0607,0.19,0.1587,0.0849,0.086,0.0277,0.0802,0.0811,0.0013,-0.0029,-0.0031,0.0317,-0.0377,-0.0736,0.0598,0.004,0.1046,0.0815,0.0017,-0.0014,-0.013,-0.0076,-0.0364,-0.0052,0.01,-0.023,0.0524,0.0397,0.0123,-0.0028,0.0735,0.0438,-0.0223,0.0728,-0.0022,0.0586,0.0531,-0.015,-0.063,0.0669,-0.0039,-0.0261,0.0682,0.1056,0.0032,-0.1811,0.0774,0.0362,-0.0038,-0.0774,-0.0083,0.0337,0.0596,0.0449,-0.0006,0.0045,-0.0147,0.0119,0.0074,0.0064,0.0656,0.0023,-0.0691,-0.067,0.0131,-0.0193,0.0403,0.0328,-0.0269,-0.0459,0.0553,0.0673,-0.0555,-0.0165,0.1022,-0.025,-0.0305,0.0441,0.0465,0.0375,0.0315,0.069,0.0599,0.0581,0.0281,0.0281,0.0105,-0.0459,0.0733,0.0064,0.0103,-0.0207,-0.0828,-0.0098,0.0249,-0.0043,-0.0393,0.0215,0.0221,0.0364,-0.0604,-0.0347,-0.0794,-0.0502,-0.0481,-0.0245,-0.0225,-0.007,0.0406,0.0189,0.0258,0.105,-0.0122,0.0367,0.0803,0.0698,0.0145,0.0241,0.0189,-0.0385,0.0131,0.0245,0.0128,-0.0023,0.0042,-0.0054,-0.0021,-0.0334,-0.057,0.0203,0.0372,0.0487,0.0113,0.0947,-0.0766,-0.0198,-0.0565,0.0383,0.038,0.0045,0.0708,-0.0221,0.0794,0.0083,-0.0579,0.0021,-0.0045,0.0188,0.0256,-0.0066,0.0182,-0.0347,-0.0414,-0.0411,-0.0245,0.0292,-0.0372,-0.027,0.0302,0.0541,0.0236,0.0318,-0.0596,-0.0203,0.007,-0.0141,-0.0213,-0.0064,0.0339,0.0253,-0.0182,-0.0195,0.0413,0.0145,0.0777,-0.0218,-0.0626,0.0156,0.044,-0.0511,-0.0661,-0.0423,-0.0334,-0.0338,0.0305,0.0386,0.0465,-0.0252,0.0244,0.0442,-0.0253,0.0389,0.1159,0.0254,0.0341,-0.0262,0.0014,0.0937,0.0315,0.1074,-0.0025,-0.0151,-0.0203,-0.0306,0.044,0.0505,0.0649,-0.0084,-0.0206,-0.0386,0.0828,-0.0141,0.0123,-0.0005,-0.0376,0.0458,-0.0103,0.07,0.0591,-0.074,0.0132,0.031,0.0365,0.0149,0.0443,0.0559,-0.0542,0.0697,-0.0264,0.0753,-0.0409,0.0752,-0.0142,0.0431,-0.0302,0.0364,0.0152,0.0767,0.0724,-0.0293,-0.1171,0.0187,-0.0069,-0.0109,0.0713,0.0354,0.0467,-0.0044,0.0095,0.0149,0.0338,0.0751,0.0482,0.0323,-0.0723,0.0351,-0.029,0.0128,-0.0104,-0.0136,-0.0007,-0.0151,-0.0883,0.0929,0.0355,0.0262,-0.0002,0.0113,-0.0879,-0.0479,-0.0505,-0.01,-0.1295,0.0158,-0.0331,0.0239,0.0539,-0.0099,-0.0171,-0.0082,0.0185,0.0322,0.0377,0.0461,0.0921,0.0893,0.0523,-0.0323,-0.045,-0.024,-0.013,-0.0113,-0.0377,-0.0016,0.0034,-0.0151,0.0069,-0.0213,-0.0807,0.004,0.1226,0.1231,0.0859,0.0266,0.0387,0.0274,0.0084,0.0589,-0.1043,-0.0289,0.0292,-0.0521,-0.039,0.0224,0.0446,-0.0968,-0.0421,-0.0692,0.0697,0.0204,0.0575,0.0187,-0.0212,0.0355,-0.0426,0.0235,-0.0087,-0.0253,-0.0195,-0.0809,0.0368,0.0707,0.0675,0.0369,-0.0127,-0.129,-0.0352,0.0745,0.0371,-0.0355,-0.0101,-0.061,-0.0074,-0.0193,0.0219,0.0483,0.023,-0.0411,-0.048,-0.0777,0.0067,-0.0172,-0.0331,0.0387,-0.0351,0.0115,0.0404,0.0341,0.0743,0.0531,0.0231,-0.0056,-0.0379,0.0009,0.0046,-0.0289,0.0037,-0.0611,0.0112,0.0608,-0.0692,0.0073,0.0005,-0.0316,-0.0242,0.0804,-0.0277,0.0488,0.0476,-0.07,-0.0637,-0.13,0.0287,-0.0234,-0.0045,0.0353,0.0165,-0.1748,-0.0369,-0.0324,-0.0813,-0.1328,-0.0028,-0.0032,-0.1115,-0.1371,0.0581,-0.005,-0.0045,0.1282,0.1019,0.0507,0.0219,-0.0535,0.0798,-0.0038,0.0489,0.035,0.0716,-0.0177,-0.031,-0.0835,0.013,-0.0041,0.0194,0.0153,-0.0165,0.0036,0.0034,-0.0381,-0.0265,0.0326,-0.0017,0.0545,-0.0596,-0.1091,0.0854,-0.0887,-0.0359,0.0125,0.0013,0.0279,0.0618,-0.0678,0.006,0.1383,0.031,0.0232,-0.0655,-0.0453,0.0311,-0.0156,0.0352,-0.0081,0.049,0.0599,-0.0341,0.0092,-0.0635,0.0583,-0.0179,0.059,-0.0522,-0.0511,0.0066,-0.0542,0.0737,0.083,0.0385,-0.1462,0.0505,0.0353,0.059,-0.0555,0.0082,0.0654,0.0462,0.0363,0.0119,0.0515,-0.0164,-0.0053,0.0064,-0.0836,0.0788,0.0562,0.0152,-0.0195,0.0249,-0.0544,-0.1514,-0.0614,-0.0745,-0.2924,-0.1294,0.0131,-0.0129,0.0672,0.0719,-0.0167,0.0354,0.0008,-0.0641,-0.0888,-0.0216,0.0419,-0.038,-0.085,-0.0493,0.0182,0.0012,0.0106,0.0669,-0.0116,-0.0044,-0.0306,-0.0157,0.0474,0.0211,-0.081,0.0145,0.076,-0.0303,-0.0114,0.0401,0.0112,0.0183,0.0434,0.0421,0.0693,0.0595,0.0544,-0.0528,-0.0216,0.041,0.0351,-0.0289,0.0583,-0.0152,0.0402,0.0702,0.0538,-0.024,0.0035,-0.05,0.0102,-0.0019,-0.0028,-0.0638,-0.0203,-0.075,-0.0938,-0.0598,0.0315,0.0116,0.0276,0.0407,0.0002,-0.0223,-0.0446,0.0406,0.0013,0.0109,-0.0901,0.0425,0.075,0.0446,-0.0099,0.0419,-0.0429,0.0789,0.0235,0.0191,0.0387,0.0193,-0.0666,-0.0283,-0.0394,-0.0352,-0.1202,-0.1068,0.0035,-0.0076,0.0369,0.0237,-0.0273,-0.0056,-0.0156,0.0136,0.0841,-0.0149,-0.0596,-0.047,0.0817,0.0204,0.0112,0.0783,0.0316,-0.0399,-0.0289,-0.0372,-0.0852,-0.0614,0.0651,0.0526,-0.0134,0.055,0.0024,0.0361,-0.0347,0.0361,-0.0009,0.0101,-0.0174,0.0307,0.0151,0.0722,-0.047,0.0655,-0.0468,-0.0643,-0.0766,-0.0148,-0.0228,-0.0292,0.0226,0.0061,-0.0144,0.0669,0.0623,0.0381,-0.0213,-0.0288,0.0155,-0.0064,-0.0188,-0.0276,0.0419,-0.0058,0.1013,0.1027,0.0809,0.0611,-0.0675,-0.0458,-0.0914,0.0495,-0.0952,-0.0469,-0.0224,0.0127,-0.0189,-0.0352,0.0154,-0.0874,0.0532,0.0571,-0.0116,0.031,0.0847,0.0185,0.0191,-0.0148,-0.0417,0.0013,0.0353,0.0407,-0.0144,-0.0403,0.0251,0.015,0.0153,0.0534,-0.0219,-0.0167,-0.0536,-0.0153,0.0061,-0.2656,-0.1949,-0.1404,-0.0681,-0.0655,-0.049,-0.1508,-0.1174,0.0347,-0.1297,-0.1045,-0.0936,-0.0804,-0.1216,-0.0077,-0.0148,-0.0132,-0.0092,0.0134,-0.0076,0.0142,0.0099,0.0394,-0.0261,-0.0294,0.0019,-0.0175,0.0617,0.0478,-0.0214,-0.0074,0.0051,0.0275,0.0014,-0.0257,-0.0512,-0.0883,0.0168,0.0849,0.0194,-0.0132,-0.0175,-0.0937,-0.0409,0.033,0.0392,0.1258,0.0778,0.0081,-0.1092,0.0185,-0.2012,-0.0986,0.0223,0.0023,0.0343,-0.0637,-0.0725,-0.052,-0.1002,-0.117,0.0148,-0.007,-0.0177,0.017,0.0295,0.0005,0.0118,-0.0324,-0.0185,0.0437,0.0448,0.0635,0.0342,0.0077,-0.0025,0.1048,-0.0231,-0.0359,0.0081,0.0004,0.0021,-0.0549,-0.0364,-0.0182,0.0409,0.0498,0.0443,0.0419,-0.0103,0.0489,-0.0102,0.0418,-0.0036,-0.0178,-0.0295,-0.0107,-0.07,0.0397,0.0492,0.0109,-0.0367,0.0226,-0.0713,0.0697,-0.044,-0.1059,-0.0305,0.0888,-0.0869,-0.0671,-0.0061,0.0791,0.0149,0.0543,0.0182,0.1056,-0.0016,-0.0499,0.0634,0.0607,0.023,0.0722,0.0151,0.0218,0.0537,0.0537,0.0545,-0.0029,-0.0876,0.0162,-0.1632,-0.1066,-0.1322,-0.1359,0.0179,-0.0085,0.0542,0.0418,0.0597,-0.0189,0.0353,-0.0967,0.0153,0.0236,-0.0128,-0.0209,0.0065,-0.0222,-0.0366,-0.0144,-0.0058,-0.0177,0.0133,0.0231,0.0623,-0.0038,0.0245,-0.0169,-0.0103,-0.0103,0.0564,-0.0026,0.0211,-0.0078,0.0085,-0.0979,0.0499,-0.1067,0.1147,0.1017,0.0083,0.0254,0.0747,0.0704,0.0726,-0.0175,-0.0068,-0.0352,-0.0424,0.0464,-0.053,0.0274,0.0041,0.1037,-0.0338,-0.022,-0.0075,0.0201,0.0432,0.0234,0.0243,0.0625,0.0415,0.0211,0.0652,-0.018,-0.0308,-0.0441,-0.0147,-0.0611,-0.0022,-0.059,0.0082,-0.0398,-0.0364,0.0267,-0.0265,0.0733,0.0913,0.0326,0.0036,0.0663,0.0097,0.0266,0.1014,-0.0209,0.029,-0.0646,0.1429,0.0585,0.0231,0.0979,0.0241,-0.0046,0.0099,-0.1924,-0.0266,-0.0523,-0.0135,-0.0047,-0.0338,0.014,0.0916,0.0911,-0.0424,0.0459,0.0273,-0.0138,-0.0214,-0.0417,-0.046,-0.0036,0.0265,0.03,-0.0104,0.0065,0.0391,0.0125,-0.0214,-0.0723,-0.0152,0.0971,0.0329,0.0713,0.0308,0.0171,0.049,0.0618,-0.0232,-0.0244,-0.0168,-0.0155,0.0496,0.0303,0.0221,-0.0053,0.0756,-0.0262,0.0157,-0.0348,0.0429,0.0547,0.0221,-0.1136,0.0247,0.0412,-0.01,0.0151,-0.0929,0.0003,-0.0339,0.0048,0.0846,-0.0239,0.0027,-0.0897,-0.0406,-0.1076,-0.0079,0.0514,0.0224,-0.087,0.008,0.006,-0.013,-0.001,0.0744,0.0605,0.0167,-0.0674,0.0316,-0.0127,0.0719,-0.0,0.012,0.0108,-0.0053,0.0611,0.029,0.0325,0.0331,-0.0283,-0.019,0.0007,0.0492,0.038,0.0699,0.0525,0.0134,0.0247,-0.0172,-0.0101,0.0115,0.0461,0.0228,-0.029,-0.0203,-0.0045,0.0363,0.0837,-0.0386,0.0187,-0.0446,-0.0042,-0.0382,-0.0272,-0.0245,-0.0209,0.0565,0.0271,0.0222,0.0046,0.0988,-0.0296,0.0654,-0.0052,-0.0194,0.0217,0.0075,0.0758,0.0278,0.0026,0.032,0.05,-0.1244,0.0187,-0.0204,-0.0151,-0.0668,0.005,0.0389,-0.0528,-0.1102,0.0582,-0.0068,0.0443,0.0533,0.0488,0.0305,-0.0035,-0.0141,-0.0001,-0.0347,-0.0712,0.029,0.015,0.0559,-0.0213,-0.0118,-0.0578,0.1353,0.0835,0.054,0.0938,0.0789,0.007,-0.0582,-0.0229,-0.0235,0.0071,-0.0128,0.0781,-0.0116,0.0746,0.0543,0.0854,0.0198,-0.0098,0.0837,0.0545,-0.0556,-0.0059,0.0308,0.0239,-0.0189,-0.0523,-0.0717,-0.0028,-0.0567,0.0057,-0.0013,0.032,0.008,-0.0133,-0.011,-0.0022,-0.0393,-0.0853,-0.0487,0.0137,0.0244,0.0205,-0.1361,-0.1408,0.0942,0.0832,-0.0445,0.0647,0.0366,-0.0074,0.0999,-0.0218,0.0144,0.0213,-0.0215,0.0482,-0.069,0.0108,-0.0369,-0.0135,0.0108,0.0065,-0.1472,-0.0056,0.02,-0.1012,0.0163,-0.0189,-0.0242,-0.0149,0.0248,-0.0494,-0.0157,0.0024,0.0034,-0.0046,-0.026,-0.0498,-0.0374,0.0278,0.057,0.0436,-0.0524,0.0575,-0.05,-0.0925,0.0459,0.0584,-0.0374,0.034,0.0274,0.0273,-0.0064,-0.0028,0.054,0.1124,0.0238,0.0119,0.0434,0.0075,-0.0045,-0.0298,0.0052,-0.1625,-0.0575,-0.1149,-0.0508,-0.0646,-0.0071,0.0234,-0.2013,-0.0007,0.0898,-0.0271,0.0964,0.0286,-0.0149,-0.0232,0.0192,-0.0379,-0.028,0.0207,0.0208,-0.015,0.0178,-0.0166,0.0433,-0.023,-0.0493,-0.0449,-0.0845,-0.0979,-0.0057,0.0508,0.0591,0.0147,0.0529,0.0209,-0.0061,-0.0738,-0.0299,0.0186,-0.0934,0.0122,0.1355,0.0156,0.0005,-0.0153,-0.0339,-0.0391,-0.0378,-0.1866,-0.1746,0.0525,0.0021,0.0482,-0.0023,0.0003,-0.0463,0.1014,0.1245,0.1542,-0.0455,-0.0309,-0.0561,-0.0711,0.044,0.0048,-0.0302,-0.0408,0.012,-0.1117,-0.0633,0.0098,0.0179,-0.0449,-0.0572,-0.0575,-0.1073,-0.0075,-0.0229,-0.0067,0.0152,0.0013,-0.0417,0.1263,0.0265,-0.0198,0.053,-0.0193,-0.0318,0.0133,0.004,0.0261,-0.017,-0.0186,0.0146,-0.0251,0.0314,-0.0036,0.0061,0.0221,0.0003,-0.0711,-0.018,-0.0506,0.0416,0.0381,0.0419,-0.0084,-0.0162,0.0023,0.065,0.0537,0.0373,0.0354,-0.0309,0.0049,-0.0557,-0.0371,0.0215,0.0016,0.0423,-0.0244,-0.019,0.0241,0.1155,0.0005,0.0327,0.0141,0.0197,-0.0286,-0.0475,-0.1763,-0.0842,-0.0657,-0.0331,0.0715,0.0998,0.0524,0.0812,0.0376,-0.0721,0.006,-0.0796,0.0724,0.0528,0.0572,0.0343,0.0498,0.0231,0.0088,0.0014,-0.039,-0.0495,0.0745,0.0911,0.0481,-0.0187,0.0155,-0.0252,0.0907,0.0403,0.0518,0.0636,0.1324,0.0074,-0.0181,0.0549,0.0817,0.0141,0.0263,0.001,0.0495,0.0098,0.0423,-0.0388,-0.0573,-0.0244,-0.0299,-0.0624,0.0703,-0.0186,-0.0141,-0.0531,-0.0,-0.0153,0.044,-0.0875,0.0955,0.0785,0.0808,0.0193,0.0386,0.0842,0.0252,-0.0038,0.0013,0.066,-0.0056,0.0104,0.0733,-0.0156,0.0313,0.0422,0.0843,0.0186,0.0899,0.1092,0.0342,0.0268,-0.1147,0.0471,0.0803,0.1461,0.0712,0.0874,0.0413,0.1018,0.0798,0.034,-0.0251,-0.0334,0.0222,0.001,0.0042,-0.0894,-0.1197,-0.045,0.1207,0.1197,0.0286,-0.0222,0.0235,0.036,-0.0135,0.0465,0.0188,0.0287,0.0409,0.041,0.0154,0.0507,0.0524,0.0001,0.0759,0.0348,0.0118,0.0038,-0.0324,-0.06,0.0392,0.0107,0.0691,0.0975,0.0578,0.072,0.0473,-0.1528,0.0396,0.0837,-0.0132,-0.0162,0.0242,0.0277,0.0002,-0.0259,-0.0428,0.0089,-0.0292,-0.0178,0.0644,-0.0233,-0.0087,-0.063,-0.1395,0.0435,-0.0527,-0.0825,-0.2031,0.0835,-0.0094,-0.0209,0.0175,-0.0048,-0.021,0.0097,0.0176,0.0009,0.0708,0.0804,0.107,0.0157,-0.0147,-0.0839,-0.0482,-0.0433,0.0167,-0.0157,-0.0462,-0.0632,-0.0465,-0.0447,-0.0026,-0.021,0.0135,0.0846,0.0525,0.059,0.0441,0.0043,0.0653,0.0315,0.0143,-0.0828,0.0385,0.0889,0.0618,0.0805,0.0657,0.1357,-0.0158,0.0991,0.033,-0.0315,0.0463,0.0341,0.0929,0.0256,-0.0261,0.0457,-0.0069,0.0206,0.0571,-0.034,-0.0766,-0.0533,0.0119,0.0601,-0.006,0.0282,0.0107,-0.0398,-0.0186,0.0165,-0.0673,-0.0073,-0.0537,0.0732,0.0751,0.0201,0.0102,-0.0203,0.0555,0.0605,0.0365,-0.0279,0.0304,-0.053,0.1008,-0.0073,-0.0015,0.0721,0.0251,0.0059,0.0062,0.1054,-0.0386,0.0641,0.1005,-0.0423,-0.1049,-0.0726,0.0233,-0.1877,-0.1,0.0771,0.0244,-0.1888,-0.0563,-0.0244,-0.0386,-0.0562,-0.0121,0.0541,0.0518,-0.0034,0.038,-0.3038,-0.3035,-0.1646,-0.1005,-0.1137,-0.1354,-0.2209,-0.2074,-0.158,-0.0193,-0.0114,0.0022,0.0271,0.0331,0.0317,0.0671,0.0377,-0.029,0.0219,0.0561,0.0353,-0.0727,-0.0154,-0.0106,0.0358,-0.0592,-0.0402,-0.0971,0.0572,0.0551,0.0611,-0.0153,0.027,0.0446,0.0142,0.029,-0.0124,0.0101,0.0348,0.0852,0.0811,-0.0186,0.0797,0.0276,-0.1373,-0.0512,-0.0422,-0.0803,-0.048,-0.0781,-0.04,0.0788,0.0858,0.0384,-0.0279,0.0457,-0.076,-0.0311,-0.0282,0.0227,0.0506,0.0544,0.0586,0.056,-0.0295,0.1278,0.0808,-0.0009,0.0226,0.0163,-0.0103,-0.0235,-0.0023,0.023,-0.0113,-0.0272,0.0331,0.0609,0.0973,0.0001,-0.0637,-0.0192,0.0048,0.0237,-0.0113,-0.077,-0.0795,-0.0171,-0.0785,0.0489,0.0421,-0.0544,-0.0209,-0.0752,-0.0731,-0.0387,-0.0273,0.0203,-0.0658,-0.0773,0.0218,0.0269,0.0602,0.0551,0.0326,-0.0128,-0.0115,0.0061,-0.0389,0.0403,-0.038,0.0096,-0.055,0.073,-0.0491,-0.0449,0.0533,0.0767,-0.0015,0.0706,0.0425,-0.054,-0.0369,0.0316,0.033,-0.0781,0.0074,0.1108,0.0421,-0.0349,0.0556,-0.0332,0.0161,-0.0221,-0.0323,-0.0791,-0.2061,-0.0853,-0.049,0.0196,-0.0333,-0.0222,0.0244,0.0644,0.0439,-0.0241,0.0481,-0.0212,0.071,0.0192,0.0453,0.0932,0.0689,0.031,0.0334,-0.0331,0.0311,0.0191,0.0562,0.0166,-0.0095,0.0594,0.0883,0.0638,-0.0074,-0.0491,0.0437,-0.0105,-0.0538,-0.0371,0.0789,-0.0396,0.0621,0.0397,-0.0582,0.1197,0.1251,-0.0052,-0.0189,-0.0153,-0.0038,0.0439,0.0283,0.05,0.0133,-0.022,0.0303,-0.0172,-0.0072,-0.0593,-0.0389,0.0757,0.0398,-0.0104,0.0078,-0.0074,-0.0194,0.05,-0.007,0.0081,0.0564,-0.0028,0.1079,0.0368,0.073,0.0865,0.0768,0.0622,0.0371,0.0371,0.0291,0.0108,-0.0251,0.1234,0.0148,0.047,0.0346,0.1024,0.0435,0.1958,-0.0065,0.0816,-0.0004,0.0631,-0.0733,0.0998,0.0899,0.0452,0.0761,-0.0404,-0.0656,0.0104,-0.0431,-0.0378,0.016,-0.0672,-0.0547,0.0245,-0.0529,0.0376,0.0336,0.0067,0.1206,0.1021,0.0205,0.058,0.0262,0.0049,-0.0079,-0.0215,-0.0007,0.0429,-0.0265,-0.0351,0.0374,-0.0458,0.0185,0.042,0.0192,0.0583,-0.0367,0.0554,-0.0289,0.0279,-0.0144,-0.0061,0.0532,-0.0526,-0.0134,0.0055,-0.0758,-0.0118,-0.1302,-0.0424,0.0155,-0.0618,0.0512,-0.0268,-0.0183,-0.0116,-0.0106,0.0259,-0.0291,0.0077,0.0454,0.0237,0.089,0.0371,0.0427,-0.0369,0.046,0.0748,-0.2686,0.0345,-0.0158,-0.0035,0.0228,0.0081,-0.0107,-0.0127,0.0781,0.052,-0.0927,-0.0555,0.0422,-0.0082,0.0192,-0.0297,-0.0321,-0.0809,0.0167,-0.0228,0.0275,0.0372,-0.0306,0.0617,0.0634,0.0552,0.0336,0.0416,0.0304,0.036,0.0402,0.0076,-0.0261,0.0503,-0.0519,0.0479,-0.0299,-0.0212,-0.0103,-0.0484,-0.002,0.0538,-0.0308,0.0789,0.0686,-0.0187,-0.0474,0.0312,0.0269,-0.0104,0.0392,0.1051,0.0468,0.0388,0.0545,0.072,-0.0068,0.0254,-0.0071,0.0404,0.052,0.0442,0.062,0.049,0.0252,-0.0463,0.039,-0.0609,0.0708,0.0187,-0.0037,-0.0167,0.0646,0.0199,-0.0752,-0.0356,0.114,-0.0135,-0.0362,0.0423,-0.0309,-0.0562,0.0119,-0.0317,-0.0142,0.0792,0.0332,0.0532,0.0618,-0.0525,0.0627,-0.0266,-0.0096,-0.0313,-0.0576,-0.0422,0.0465,0.0465,0.0232,-0.0541,-0.0592,0.0065,0.0051,-0.0101,-0.0061,0.0406,-0.0451,0.0733,0.0522,0.0216,0.0015,0.0317,0.0692,-0.0421,0.0021,0.0061,-0.0803,0.0283,0.0271,0.0699,0.0025,0.0079,-0.0466,0.0462,0.0393,0.0045,0.009,0.0462,0.0339,-0.0007,0.0658,0.0034,0.0082,0.1013,0.0193,0.0142,-0.0212,0.0119,-0.0186,-0.0032,-0.0346,0.0194,-0.0425,0.0554,0.0413,0.0411,0.0575,0.0317,0.0532,0.0435,0.1239,0.0565,0.0331,-0.0526,0.0626,0.0121,0.0568,-0.0738,-0.0613,-0.0505,0.0256,0.0684,0.0691,-0.0117,-0.0008,-0.048,0.0656,0.0489,0.0351,-0.0283,-0.0465,-0.0086,-0.024,-0.0517,0.006,0.0058,0.0053,-0.0114,-0.0574,-0.0083,0.0253,0.0204,0.0284,-0.0404,0.0142,-0.0088,0.0039,-0.0323,0.0192,-0.005,0.0677,0.0319,-0.0325,-0.0486,-0.0565,-0.0604,0.0047,-0.0036,0.0259,-0.0918,-0.094,-0.0452,-0.0603,0.1124,0.0116,0.0056,-0.0605,-0.0072,-0.0206,-0.0177,0.0228,-0.0097,-0.062,-0.0276,0.0393,-0.064,-0.036,0.0419,-0.0616,-0.0307,-0.0419,-0.0481,-0.0134,-0.0289,-0.002,0.0143,-0.0103,0.0229,-0.037,-0.0711,-0.0726,0.0268,-0.0023,0.0082,0.0517,0.0414,0.1318,0.1248,-0.0164,-0.0467,-0.058,-0.018,-0.0053,0.0354,0.0854,0.035,0.0438,0.005,0.0275,0.05,0.0125,-0.0119,0.0595,0.0849,0.0304,0.0824,0.0669,-0.0168,0.0427,-0.0472,0.0781,0.0517,-0.0041,0.0099,0.004,-0.0375,0.0118,0.0073,0.018,-0.0942,0.0501,-0.0198,-0.0514,-0.0289,0.003,-0.0511,0.049,-0.0906,-0.0754,0.0478,0.0347,0.035,-0.0251,0.0097,0.0356,0.1241,0.1021,0.0252,-0.0111,0.0091,-0.0207,0.014,-0.0039,0.0787,0.0718,-0.0764,-0.0334,0.0601,0.0315,-0.0046,0.0074,0.0689,-0.0604,-0.0958,0.0671,-0.0183,-0.0943,-0.0448,0.0561,0.0799,0.0929,0.1047,0.0118,0.0338,-0.0153,-0.0463,0.0134,-0.0619,0.011,-0.0652,-0.1688,-0.1152,-0.0186,-0.1074,0.1216,0.097,0.0333,0.0359,0.0249,0.0212,0.0684,0.0286,-0.002,0.0917,0.0732,0.0468,-0.082,0.0996,0.0281,-0.0136,-0.0299,-0.0822,-0.064,0.0305,0.1028,0.0783,0.104,-0.0159,-0.028,-0.0583,-0.0525,0.0176,-0.0369,-0.0529,-0.0325,-0.0269,0.0377,0.0159,-0.0473,0.0135,0.003,-0.0172,-0.0337,-0.0086,0.0131,-0.0275,-0.0494,-0.0311,0.0157,0.1011,0.0774,0.0356,0.0679,-0.2188,-0.0292,-0.1398,-0.0596,-0.0357,-0.0496,-0.0616,-0.0286,0.073,-0.117,-0.0806,-0.0022,-0.0056,-0.0255,0.0157,0.0243,0.0019,0.0611,-0.013,-0.185,-0.0236,0.0256,-0.0136,-0.0336,0.0379,-0.0493,0.0229,0.0787,0.0655,0.0434,0.0899,0.0256,0.0151,0.0093,-0.0299,-0.077,-0.0012,-0.0163,0.025,0.0361,0.0043,-0.063,-0.084,0.0256,-0.0474,0.0639,-0.0408,0.0601,0.0159,0.0202,-0.0841,-0.027,0.0211,0.0697,0.0207,0.0568,0.0445,0.0042,-0.0061,0.0195,-0.0234,0.0484,0.0731,0.0773,0.0746,0.0467,0.0637,0.0656,0.0056,0.0462,-0.0303,0.0867,0.0706,0.0799,0.0076,0.0733,0.1398,0.0597,-0.0386,-0.0648,-0.0167,0.072,-0.1541,-0.1236,-0.0588,-0.0056,-0.0064,-0.0528,0.1069,0.0312,0.0684,-0.009,-0.0986,-0.088,0.0278,0.0076,-0.0486,-0.0283,0.104,0.0261,-0.0004,0.002,0.1431,0.1007,0.1053,0.116,-0.0292,0.0554,0.0537,-0.05,0.0761,0.0766,0.0046,-0.0571,-0.0367,0.0223,0.0466,0.1633,0.1146,0.045,0.1346,-0.0569,0.0098,0.054,-0.0153,0.0876,0.0324,0.0345,0.0286,-0.1175,-0.0581,-0.1396,-0.072,-0.0592,0.0752,0.05,-0.0324,0.0666,-0.0314,-0.0327,-0.0113,-0.08,-0.062,0.0753,0.1006,0.0414,0.0568,0.0782,0.0344,0.0367,0.0115,-0.0231,0.0434,-0.0196,-0.0171,0.0376,-0.0365,0.0339,0.0001,0.0784,0.1232,-0.0147,0.0626,0.027,0.0338,0.042,0.0763,0.0445,0.0809,0.0515,0.0416,0.03,0.0352,0.0199,0.0262,0.0381,-0.0386,-0.0182,0.0023,0.0332,0.0338,0.0986,0.007,-0.0225,-0.036,0.0648,-0.0919,0.0318,0.085,-0.0439,-0.0203,0.0019,-0.0018,-0.0029,-0.0063,0.0607,-0.0224,-0.035,-0.0341,-0.1365,0.0954,0.044,-0.0185,0.0713,0.0093,-0.0838,0.0756,-0.0855,0.132,-0.0078,-0.003,-0.0034,0.037,0.0527,0.0125,0.0201,0.0937,0.0905,-0.0715,0.004,0.0053,0.0332,-0.0356,-0.0494,-0.053,0.0945,0.0904,0.0833,-0.0306,0.0814,0.1264,0.0096,0.0255,-0.0248,0.0062,0.0556,0.0489,-0.0225,-0.0265,0.0301,-0.0048,-0.1128,0.0029,0.0067,-0.0554,-0.1186,-0.0751,-0.0128,-0.0621,0.0511,0.0141,-0.0889,-0.0762,0.0257,-0.0727,-0.0439,-0.0017,-0.0477,-0.0945,-0.0507,0.0476,0.0509,0.0176,0.0746,0.0037,0.0729,0.005,0.0888,0.107,0.0529,0.0804,0.031,-0.1068,0.064,0.0591,0.1084,0.1251,0.0616,0.0549,0.0786,0.1124,0.0805,0.0161,0.032,0.0482,0.0222,-0.0352,-0.0873,0.0282,0.0193,0.0086,-0.0347,0.0111,0.0434,0.0495,0.0683,-0.0196,-0.021,0.1183,0.1053,0.004,0.0239,0.0235,0.0691,-0.014,0.0409,0.0358,0.0625,0.025,-0.0048,0.022,0.0102,0.0044,0.1044,-0.0393,0.047,-0.0228,-0.0484,-0.0635,0.0972,0.0145,0.0775,0.0467,0.0349,0.0513,0.0538,-0.0629,-0.0633,-0.1007,-0.0153,-0.005,-0.0287,0.0585,0.0106,-0.0483,0.0421,0.0113,0.038,-0.0313,-0.0604,-0.0378,0.0262,0.09,0.041,0.0223,0.0203,-0.0168,-0.0889,-0.0688,-0.0008,0.0304,0.0523,0.0191,0.0775,0.0945,0.0401,0.0725,-0.0173,0.0002,-0.0345,0.0451,-0.0519,-0.0291,-0.0219,-0.0367,-0.0232,-0.0297,-0.0298,0.0457,-0.0296,0.0333,0.0007,-0.0104,0.0413,-0.0085,-0.0151,0.0298,-0.0047,0.0463,0.0501,0.0558,0.0334,0.036,-0.042,0.0169,-0.029,-0.0218,-0.0127,0.0138,-0.0379,0.0262,-0.0149,0.0032,0.001,0.0609,0.0523,-0.0671,-0.0362,-0.0307,0.0651,0.0592,0.0642,0.0288,-0.0604,0.0283,-0.0187,-0.0504,0.0868,0.0761,-0.004,0.049,-0.0027,-0.0034,-0.3621,-0.1909,0.0668,-0.0426,-0.0153,0.0163,0.0514,0.0699,0.0592,0.0648,-0.0645,-0.0189,0.0412,0.0104,0.0537,0.0374,-0.0734,-0.0253,-0.0413,0.0198,0.0336,0.0127,0.0666,-0.0058,-0.0082,0.0593,-0.0139,0.1037,-0.0226,0.1064,-0.1704,-0.0331,-0.0468,0.0934,0.093,0.018,-0.0594,0.0253,-0.0844,0.0964,-0.0823,-0.0096,-0.0425,-0.0732,-0.0426,-0.0202,-0.0359,-0.0602,-0.1127,-0.1071,0.0415,-0.0195,-0.2117,-0.3187,-0.113,-0.0823,-0.3194,-0.2018,-0.1802,-0.2327,-0.1333,-0.1615,-0.099,-0.124,-0.1978,-0.1359,-0.1436,-0.0626,-0.1535,-0.1185,-0.1265,-0.106,-0.119,0.0957,0.0667,0.0866,0.1358,0.1043,0.0805,0.0821,0.0251,0.0284,0.0076,0.1075,0.0706,0.0766,0.022,0.0721,0.0473,-0.0612,0.0486,0.051,0.0228,0.0506,0.0248,0.0126,-0.027,0.0463,-0.034,0.0359,0.0477,-0.0571,0.0278,0.0248,-0.0169,-0.0241,0.062,-0.0468,0.0125,0.0371,-0.0161,-0.0743,0.0384,-0.0069,0.0171,0.0633,-0.097,-0.0991,0.0131,0.0343,-0.0187,0.0156,-0.0015,0.0291,0.0337,-0.0608,-0.0162,0.0184,-0.0419,0.0062,0.0325,0.0186,reinforcement learning
trm_4a3fd79d0b802,-0.0943,-0.0774,-0.1087,-0.1551,-0.0691,-0.0684,-0.0786,-0.1006,-0.0431,-0.0556,0.0234,-0.0142,-0.091,-0.0351,-0.1007,-0.0548,-0.0899,-0.1157,-0.087,0.0323,-0.0421,0.0104,-0.0366,0.0522,-0.0181,0.0021,-0.0003,-0.067,-0.1017,-0.0558,-0.0778,-0.0972,-0.0813,-0.0756,-0.0747,-0.1023,-0.0688,-0.0769,-0.1099,-0.0671,-0.0804,-0.04,-0.0369,0.08,-0.0699,-0.007,0.1212,-0.0595,0.0147,-0.0868,-0.0204,0.0499,0.055,0.0074,-0.0255,-0.0496,-0.0808,0.008,0.0365,-0.0277,-0.0044,-0.0323,-0.1029,0.0564,0.0102,0.0193,-0.165,-0.1858,-0.1041,0.0035,0.0561,-0.0205,0.204,-0.0349,-0.1175,0.1501,-0.1161,0.0034,0.0286,-0.0185,0.047,0.0528,-0.0039,-0.0838,0.0143,0.0122,-0.0072,-0.0473,0.0285,-0.1651,-0.0888,-0.0778,-0.0128,0.0769,0.1327,0.0983,0.1071,0.0145,0.0933,-0.0167,0.0502,-0.0004,0.0415,-0.0636,0.0747,-0.127,-0.0607,0.2189,-0.0179,-0.0556,-0.0347,-0.0877,0.0783,0.1276,0.0162,0.0827,-0.0742,-0.0386,-0.0011,-0.0822,-0.0591,-0.0921,-0.0667,0.0053,-0.0529,-0.0396,-0.0251,-0.0176,0.0296,0.0145,0.0401,-0.0885,-0.0019,-0.122,-0.0055,-0.1201,-0.0279,-0.0715,-0.0048,-0.0693,-0.0817,-0.1037,0.0797,-0.0139,0.0098,-0.0009,-0.103,0.0209,-0.0818,0.105,-0.0516,-0.0767,-0.1449,-0.0791,0.1472,-0.0422,0.024,0.0118,-0.035,-0.0886,-0.0503,-0.0796,-0.1492,-0.1531,-0.0163,0.0242,-0.0289,-0.0599,-0.0511,0.069,-0.0859,-0.0977,-0.0309,-0.0339,-0.0253,-0.0674,-0.0419,-0.0363,-0.0055,-0.0547,-0.0425,0.0409,-0.0896,-0.0155,-0.0672,-0.0532,-0.1006,0.0067,0.0288,0.004,0.0289,-0.0034,0.0147,-0.128,-0.1082,-0.1552,-0.1622,0.0545,0.086,-0.1028,-0.1036,0.0388,-0.0287,-0.0933,-0.0455,-0.0458,0.0435,-0.1075,-0.0804,-0.0211,-0.0903,-0.0371,0.0151,-0.0355,0.0922,0.0548,0.0745,-0.1222,-0.2051,0.0331,0.0633,-0.0608,-0.1035,-0.0641,0.0192,0.0145,-0.0331,0.1164,0.0223,0.1145,-0.1469,-0.0686,0.0791,-0.1489,-0.1506,0.0117,0.0527,0.0768,0.0102,0.0203,-0.0408,-0.1038,-0.0744,0.0011,-0.0538,-0.0261,-0.0202,-0.101,-0.0611,-0.0205,0.0649,0.0549,0.0031,0.0566,-0.0017,-0.0759,0.0225,-0.0807,0.1874,0.1912,0.0257,0.1392,-0.0798,0.0757,0.0526,0.1895,0.067,0.0171,0.037,0.0521,-0.0406,-0.035,0.0147,0.0637,-0.0413,0.044,-0.1206,-0.1426,-0.1313,-0.0403,0.0373,0.0374,0.0397,-0.0305,0.0132,-0.0822,0.0901,0.1125,-0.1072,-0.0794,-0.1002,-0.0409,-0.0749,-0.0444,-0.0532,-0.0671,0.0251,0.0645,-0.051,0.0971,0.0846,-0.1028,-0.1043,-0.1047,-0.1175,-0.116,-0.1236,-0.0155,-0.0376,0.0206,-0.0099,-0.0145,-0.1113,0.0846,0.0578,-0.0493,0.1081,0.0264,0.0447,-0.0738,0.0137,0.0028,-0.067,-0.0603,-0.0883,-0.0563,0.017,-0.0084,-0.1011,-0.1358,0.0348,-0.0672,-0.0221,0.0075,-0.003,0.0621,0.0671,0.0288,0.0769,-0.0886,-0.0829,-0.0295,-0.0227,-0.0237,0.0716,0.0183,-0.2249,-0.1666,-0.1489,-0.1148,-0.0598,0.0723,-0.1471,-0.057,-0.0596,-0.1251,-0.096,-0.0475,-0.112,-0.0903,0.0251,0.0178,-0.0142,-0.0848,-0.0433,-0.0097,-0.1348,0.1106,0.0402,-0.1288,0.0376,0.0501,-0.0207,0.0487,-0.0886,-0.0272,-0.074,0.1019,0.2275,0.0918,0.2582,-0.0446,-0.0958,-0.0486,-0.0117,0.0405,-0.0779,-0.0073,0.0106,-0.0655,-0.0788,-0.025,-0.1517,-0.0268,0.0549,-0.0245,-0.1161,-0.1458,-0.1154,-0.1022,-0.0364,0.0358,0.0147,-0.0493,-0.0023,0.0039,0.1469,0.0213,-0.0947,-0.0071,-0.0096,-0.1066,-0.0243,0.2901,-0.046,0.0399,0.2603,-0.0369,-0.0829,-0.0306,0.0171,-0.2085,-0.137,-0.2392,-0.1967,-0.1135,-0.1287,-0.0877,-0.1031,-0.1439,-0.0139,0.0659,0.0287,-0.0059,0.0303,0.0589,0.0265,0.0325,-0.2204,-0.1126,0.0825,0.0153,-0.0552,0.0689,-0.0289,-0.0982,0.0259,0.0615,0.0001,-0.0101,-0.0059,0.0486,-0.0839,-0.0368,0.0073,-0.0531,0.0486,-0.0399,-0.0023,0.0441,0.0293,-0.0215,-0.0667,0.054,-0.0313,-0.092,0.0306,0.2782,-0.1099,-0.0599,-0.0336,-0.0085,0.0538,0.0317,0.044,-0.0303,-0.0249,0.0395,-0.0385,-0.048,-0.0185,-0.0559,-0.0562,0.0361,0.0127,0.0565,-0.0222,-0.0759,-0.068,-0.0372,0.1026,0.0129,-0.0997,-0.1353,0.0448,0.0648,0.0036,-0.1079,0.0376,-0.0858,-0.0719,0.0427,-0.0949,-0.1267,-0.069,-0.0657,0.1228,0.1559,-0.0276,0.0002,-0.1256,-0.0488,0.0659,-0.0459,0.0529,0.0605,-0.0508,-0.0542,0.03,-0.0657,-0.0494,-0.0603,0.0607,0.0119,0.1309,0.0238,0.1006,0.1022,0.0448,0.0473,-0.0715,-0.0016,-0.1193,-0.1224,0.0079,0.0834,-0.058,-0.0751,0.0024,-0.0777,0.0123,0.0678,0.0313,-0.0504,-0.0707,-0.0201,-0.0001,0.0651,0.0188,-0.0615,0.0634,0.0022,0.0194,-0.0526,-0.0218,-0.0666,0.0891,0.0193,0.0507,-0.0449,0.0276,0.0038,0.0338,0.024,-0.0111,0.0576,0.054,0.0547,0.0063,0.0209,-0.0204,0.066,-0.188,-0.0208,-0.1737,-0.1274,0.0313,0.0305,0.1148,0.1273,0.0744,-0.0455,0.037,-0.0753,0.062,0.0445,-0.0904,0.0295,-0.0106,-0.0576,-0.0713,0.0035,0.0657,0.0928,-0.0791,-0.0663,-0.1749,-0.0209,0.1136,-0.0746,0.0435,0.0465,0.0249,0.0328,0.0201,-0.1008,0.0299,-0.1317,-0.1288,0.0479,-0.1394,-0.0707,0.0371,-0.0349,-0.1852,-0.0196,-0.0472,0.0151,0.0359,-0.1588,-0.0817,-0.1513,-0.0135,0.0123,-0.0671,-0.0418,-0.0806,-0.0558,-0.0513,0.0088,-0.0012,-0.0451,0.0181,0.0073,-0.0477,-0.0253,0.0151,-0.0822,-0.0287,-0.0068,-0.0642,0.0179,-0.0186,-0.1753,-0.0643,-0.0074,-0.1066,-0.0778,0.0149,-0.0943,-0.0338,-0.0647,-0.0029,-0.0163,-0.0071,-0.0969,-0.05,-0.0959,-0.0376,-0.0692,-0.0756,-0.125,0.1031,-0.123,-0.0077,0.0444,-0.1289,-0.1304,-0.1052,-0.0555,-0.097,-0.0448,-0.0493,-0.057,-0.0252,-0.0856,0.0731,-0.0427,0.0168,-0.0066,0.0178,0.0142,0.075,0.0291,0.0874,-0.1012,-0.074,0.0757,0.01,-0.0459,0.0967,0.0762,0.0761,0.0886,-0.0308,0.0083,0.023,-0.0589,-0.0575,0.0014,0.0379,0.0306,0.0106,-0.0531,-0.0484,-0.06,-0.0398,-0.0613,-0.1055,0.0526,0.0975,0.0047,-0.0902,0.125,0.0358,0.067,-0.023,0.0325,-0.0978,0.028,0.0981,-0.024,-0.1239,-0.1382,-0.0476,-0.0335,0.0188,-0.0834,0.0741,-0.0244,-0.0058,0.0239,-0.0821,0.0002,0.0249,-0.0017,-0.123,0.0481,0.0931,0.2113,-0.0309,-0.0195,-0.08,-0.0093,0.0402,-0.0763,0.0903,0.044,-0.0315,-0.0074,-0.008,0.069,-0.0992,-0.1406,-0.1089,-0.0955,0.0481,0.1469,0.0052,-0.1054,0.0235,-0.048,0.0318,0.0226,0.0613,0.0026,0.0074,-0.0659,-0.1212,0.0925,0.0322,0.0866,-0.0798,-0.0478,0.0057,-0.0726,0.0385,-0.0487,-0.0644,-0.0023,-0.0883,-0.0605,-0.0603,0.1096,0.0958,0.0548,-0.0404,-0.0278,0.0015,0.1164,-0.0305,-0.0421,0.094,0.0275,0.038,0.0162,0.0752,0.0073,0.1316,-0.1182,-0.1249,-0.0026,0.1509,0.0595,0.0513,0.0281,0.084,0.0236,-0.0084,0.0281,-0.0458,0.0322,0.0852,0.1048,0.0591,-0.022,0.1167,0.077,-0.1035,0.007,0.0791,-0.1461,-0.0506,-0.0938,-0.0856,0.0556,-0.1626,-0.0624,-0.1072,-0.0748,-0.0945,0.0252,-0.0172,0.0883,-0.028,-0.0568,0.0336,0.0367,0.0981,0.0568,0.1192,0.0568,0.0398,0.0542,0.0185,0.0346,0.0611,0.0693,-0.0402,0.092,0.0856,-0.0566,-0.0335,-0.0514,-0.033,0.074,-0.0518,-0.1154,-0.1,-0.0319,0.0715,0.1175,0.0202,0.0557,0.0606,-0.0477,-0.1002,-0.0764,-0.0509,-0.0718,0.034,-0.0866,-0.1058,-0.0365,0.1048,0.0039,0.0,0.0013,-0.0957,-0.0647,-0.0356,0.0591,-0.0549,-0.0666,-0.0776,0.0403,-0.0406,-0.1227,-0.0286,-0.0917,0.0589,-0.0835,0.0432,0.0265,0.0639,0.0318,-0.1394,-0.0513,-0.0442,0.0796,-0.0801,-0.0182,0.0362,0.0182,0.0447,0.1803,-0.0091,-0.0398,-0.0746,-0.0456,-0.0407,-0.1313,0.0129,0.0522,0.1245,-0.0202,0.0387,-0.0999,0.059,0.1546,-0.0214,-0.0158,-0.0532,0.0154,-0.1663,-0.1191,-0.0844,-0.0245,0.0563,-0.0496,-0.0613,0.1099,0.0205,-0.1003,-0.0278,0.0674,-0.0208,-0.0157,-0.0535,-0.0783,-0.0835,-0.0618,-0.0593,-0.062,0.0196,0.0237,-0.0251,-0.0923,-0.0179,-0.0459,0.0247,-0.0777,-0.0395,-0.0119,-0.0164,0.0716,0.058,-0.015,0.0308,-0.0956,0.009,0.0649,0.1044,0.1944,0.1189,-0.0329,-0.0737,-0.041,0.056,0.142,0.1388,0.0744,0.0399,0.1204,0.0465,0.1254,-0.0014,0.0048,-0.0133,0.0739,0.0037,0.04,-0.1204,-0.0011,-0.0638,0.0685,0.0698,0.0122,0.0652,-0.0208,0.1025,0.1047,0.1052,-0.0819,-0.0129,-0.0181,0.0011,0.0105,0.0047,-0.0669,-0.0915,-0.1201,-0.0807,0.1072,0.1062,-0.1258,-0.1035,-0.0231,-0.1166,-0.0427,0.1465,0.0217,0.1505,0.0653,0.0857,0.0277,0.0545,0.0778,0.0418,-0.0058,0.0154,0.0192,-0.022,-0.1028,-0.034,0.0828,-0.0977,0.0212,-0.0591,0.0363,-0.1524,-0.0267,-0.0572,-0.0187,0.0071,0.0591,-0.011,-0.0453,-0.0213,0.0374,0.0207,-0.0034,0.0443,0.0057,0.013,-0.0362,-0.076,-0.0056,-0.0688,-0.0283,-0.0768,-0.005,-0.0958,-0.0148,-0.0368,0.1617,-0.0456,-0.0229,-0.1046,0.1468,0.1284,-0.0074,0.0298,0.0001,0.0881,-0.0088,-0.0045,-0.0904,-0.0671,-0.0169,-0.0062,-0.0276,0.0159,-0.0298,0.0964,0.0831,-0.0,-0.0251,0.0025,0.0371,-0.1298,-0.0015,0.0262,0.0615,-0.0827,-0.0363,-0.0387,0.052,-0.0324,0.0139,0.2926,0.1576,0.0769,0.0044,0.0213,-0.0612,0.0585,0.1142,-0.1152,0.4054,0.3855,0.2852,0.1784,0.3301,0.1124,0.0872,0.0674,0.0767,0.0815,0.0121,0.0495,0.0117,-0.0663,0.0559,0.055,0.0343,0.0831,0.0061,0.0006,0.2607,0.1424,-0.0418,-0.0314,-0.0555,0.0655,-0.0332,0.0735,-0.0311,-0.0723,0.002,0.0427,0.0541,0.0598,0.1837,-0.1436,-0.0645,-0.1012,-0.0542,-0.0661,0.3935,-0.033,0.0338,0.015,-0.0074,0.0438,-0.0668,-0.1278,-0.0742,-0.0805,0.0545,-0.0192,-0.0117,0.0445,0.0218,-0.1265,-0.1172,0.06,-0.0255,-0.0323,0.0133,-0.0919,-0.0466,-0.0911,-0.0035,-0.0382,0.0019,-0.1785,-0.1019,0.2582,0.0616,0.0208,-0.0297,0.1753,-0.0079,0.0041,-0.1424,-0.1253,0.0282,-0.09,-0.1435,-0.1441,-0.0328,-0.0217,-0.0094,0.0845,0.0401,0.05,0.0305,0.0165,0.0431,0.0049,0.0757,-0.0303,0.0765,-0.0111,0.0899,0.1468,-0.0286,-0.0084,0.0805,0.0637,-0.0473,-0.0426,0.033,-0.1203,-0.0736,-0.1214,-0.0278,-0.0163,-0.0527,-0.086,0.0259,-0.0449,0.0471,-0.045,-0.056,-0.0456,-0.0465,-0.0378,0.0695,-0.0193,0.4894,0.3897,0.2936,0.4358,-0.0512,-0.0726,-0.0645,-0.0763,-0.0862,-0.0457,-0.1164,0.0792,-0.0402,-0.0517,0.0604,-0.0654,-0.0029,0.1068,0.0567,-0.0299,-0.036,0.0267,-0.0354,-0.0165,0.0053,0.164,0.0425,-0.0128,-0.1118,-0.1118,-0.0921,0.0477,0.0103,0.0054,-0.0958,0.0279,-0.0284,0.0843,-0.1779,-0.1584,0.1265,-0.0172,-0.152,-0.146,-0.1761,-0.0236,-0.0683,-0.0427,-0.0355,-0.0374,-0.0206,0.0663,0.1577,-0.0067,0.1252,-0.0075,0.0493,0.1264,-0.0218,0.0,-0.0206,0.0165,0.0431,-0.0269,-0.0484,0.0302,0.0851,-0.0955,-0.0706,-0.0497,-0.029,-0.0132,-0.015,-0.0458,-0.0047,-0.084,-0.0736,-0.1188,-0.2286,-0.0644,-0.049,-0.1686,-0.1018,-0.0863,-0.1035,0.0196,-0.0856,0.0356,-0.1139,0.0078,-0.0839,-0.1576,-0.0112,0.0276,-0.0526,0.1215,0.0992,-0.0004,0.0869,-0.0849,-0.0308,-0.013,-0.1451,-0.1432,0.0358,-0.0572,0.0037,-0.0508,-0.0173,0.0252,0.0481,0.0355,-0.0681,-0.0437,-0.0483,0.0513,-0.0489,-0.0372,-0.0157,0.0268,-0.0169,-0.0408,0.0682,-0.006,-0.0686,-0.0114,-0.1338,-0.1317,-0.0223,-0.0231,0.0146,-0.0078,0.0068,-0.1038,-0.0781,0.0228,-0.0878,-0.0077,0.0162,-0.0873,-0.1954,-0.137,0.0518,0.082,0.1076,0.0296,-0.0003,0.0016,0.247,0.0665,0.0477,0.0347,-0.1177,0.0888,-0.0081,0.0869,-0.0453,0.19,0.0212,-0.0597,-0.0336,0.0826,-0.0958,0.0005,-0.0481,0.0073,-0.0579,-0.0183,0.0719,0.0122,-0.033,-0.0585,-0.0034,0.0288,0.0399,-0.0183,0.0102,-0.1212,0.0302,0.0473,-0.0912,0.0097,-0.0986,-0.0828,-0.0354,-0.0633,-0.0568,-0.0663,-0.0118,-0.0177,0.0163,-0.0043,0.0789,0.0074,-0.0101,-0.0549,-0.0287,-0.0315,-0.009,-0.1504,0.0059,-0.1359,-0.1248,0.002,0.0775,0.1079,-0.0171,0.029,-0.0513,-0.0014,-0.0421,-0.0374,-0.1149,-0.0403,-0.1915,-0.0612,-0.0276,-0.0651,-0.0561,-0.0693,-0.034,0.1934,0.1282,0.0284,0.3175,0.0366,0.0844,-0.0335,0.3087,0.002,-0.0585,0.0848,0.1765,-0.0321,0.0047,-0.1184,-0.1552,-0.0609,-0.0272,0.0591,-0.0427,-0.0846,0.0355,0.1309,-0.0473,-0.0471,-0.0092,0.0007,0.0258,0.0849,-0.2021,-0.0904,-0.0275,-0.2117,-0.1819,0.1257,0.0436,0.0277,-0.0096,0.0182,0.0436,-0.1297,-0.0621,-0.079,-0.0633,-0.1914,-0.0199,-0.0543,0.005,-0.0885,0.1218,0.0025,0.0165,0.023,0.0132,0.0946,0.093,-0.1012,0.0541,-0.0319,-0.0264,-0.0868,-0.0028,0.0241,-0.0205,0.0113,0.1471,-0.0074,-0.0266,-0.057,-0.0861,-0.0099,0.1969,0.1814,-0.1142,-0.0969,-0.0454,-0.0366,-0.1062,-0.0301,-0.1389,0.03,0.0082,-0.0096,0.0506,-0.0153,0.1268,-0.026,0.061,0.0854,-0.0328,0.0678,0.1645,-0.1951,-0.0514,0.2132,0.0758,0.0314,0.1032,0.1036,-0.0429,0.1191,0.1023,-0.0042,-0.0765,0.0986,0.0664,0.1661,0.1169,0.0637,0.0544,0.0357,0.0808,-0.0575,0.0027,0.1613,0.009,0.094,0.0191,0.0241,-0.1276,-0.0189,0.0893,-0.0434,0.1123,-0.0226,0.0944,0.1736,-0.0024,0.0357,0.0211,0.0648,-0.002,0.04,-0.0275,0.0363,0.0413,0.1857,0.0195,0.0148,0.3843,-0.0784,-0.0349,0.0283,0.0194,0.0133,0.1081,0.1045,-0.1135,-0.0456,0.0254,-0.0517,-0.0174,0.0055,-0.0108,-0.03,-0.0008,0.0242,0.0475,0.1017,0.2043,0.2318,-0.0706,-0.1498,-0.0414,0.0122,0.144,0.1105,0.0669,0.0596,0.1102,0.0174,0.0621,-0.1619,-0.1668,-0.0921,0.0443,0.0968,-0.0909,-0.0594,0.0064,0.0539,0.0098,0.0831,-0.0132,-0.0245,0.0191,0.0365,0.0253,-0.087,-0.0895,-0.144,0.0642,-0.0225,-0.0132,0.1172,0.058,0.0718,0.0906,0.038,0.0733,0.1408,-0.083,-0.0194,-0.0182,-0.0492,0.0673,0.055,0.1353,-0.0938,0.0351,0.1039,-0.0144,-0.0759,0.0324,-0.139,-0.0672,-0.0548,-0.099,-0.0215,0.0822,-0.094,-0.1897,-0.0509,-0.1072,-0.0878,-0.1698,-0.1635,-0.0422,-0.0131,-0.005,-0.0945,-0.0013,0.0899,-0.0079,0.0831,-0.1378,-0.0624,-0.1014,-0.014,0.0217,-0.0955,-0.0491,0.0034,-0.1073,-0.0196,0.1377,0.0404,0.1199,0.0401,0.0069,-0.0256,-0.0152,-0.0231,-0.0098,-0.0838,-0.1853,-0.0008,-0.1091,-0.0322,-0.0317,0.0006,0.0551,0.2729,0.2429,0.107,0.0491,-0.043,-0.1914,-0.0832,-0.1708,-0.1222,-0.0129,-0.0387,-0.018,-0.0313,-0.1188,-0.1618,-0.0532,0.1189,0.0521,-0.0592,-0.1002,-0.0575,-0.0892,-0.1548,-0.1317,-0.0612,0.0526,0.0002,-0.0488,-0.0686,-0.0305,-0.0647,-0.09,-0.1315,0.0061,0.106,-0.0875,-0.0624,-0.0646,-0.0187,-0.0333,-0.1199,-0.1472,0.0363,0.1694,0.1579,0.0516,0.0651,0.1174,0.004,0.0418,0.0669,0.1067,-0.0796,-0.0308,0.0054,0.0799,-0.0254,-0.0801,0.004,-0.0874,-0.0279,-0.063,-0.0551,-0.084,-0.0564,-0.031,0.0055,0.016,-0.1918,0.0336,-0.0346,-0.0629,-0.0125,-0.078,0.069,-0.0673,-0.0039,0.0735,0.1181,0.0123,0.0781,-0.1223,-0.0595,-0.0394,-0.1082,-0.0642,-0.0393,0.0518,0.0454,0.0397,-0.0816,-0.0548,0.0609,0.052,0.1139,0.1201,-0.137,-0.142,-0.0966,0.0007,-0.001,-0.0943,0.0347,-0.0005,0.0371,-0.0391,-0.0398,-0.0628,-0.0469,-0.0574,-0.0827,-0.0092,-0.0632,-0.0363,-0.0495,-0.0551,0.0228,0.032,-0.0706,-0.0901,-0.0524,-0.1095,-0.0483,-0.156,-0.0436,0.2011,-0.0611,-0.0838,-0.1444,-0.0535,-0.2022,-0.093,-0.0726,-0.0975,0.0974,-0.1171,-0.0105,-0.0315,-0.1523,-0.1323,-0.1699,-0.0749,0.0766,-0.1073,-0.0248,0.0016,0.1035,0.0486,0.0749,0.0284,0.0022,0.0155,-0.0325,0.0519,0.0275,0.0714,-0.1541,-0.1374,-0.1587,-0.1003,-0.0691,0.0801,0.1666,0.2233,0.0694,0.0412,0.0523,0.1438,0.0112,0.0539,-0.0369,0.0537,0.0394,-0.1459,-0.0601,-0.1224,-0.023,0.0245,-0.0781,-0.0913,-0.0656,-0.0289,0.0149,-0.2049,-0.1544,0.0093,-0.0622,-0.1231,0.0043,-0.0934,-0.0263,0.0323,-0.0855,0.0125,-0.139,-0.0389,0.0375,-0.073,-0.0562,0.0272,-0.1206,0.0441,0.0354,0.0134,-0.0856,-0.0657,0.0992,0.0212,0.0175,0.0665,0.0239,-0.0351,0.0498,0.0093,-0.0217,-0.1635,-0.03,-0.0322,-0.0338,-0.0076,-0.0202,-0.0961,-0.0434,-0.0207,-0.0764,0.0114,-0.0565,-0.049,0.0497,0.089,0.0626,0.096,0.0764,-0.1597,0.0011,-0.0921,-0.0821,0.0621,0.125,0.1383,-0.0311,0.3938,0.257,-0.1303,-0.1144,0.4519,0.1067,0.1061,0.1174,0.1757,0.1292,-0.0843,-0.0805,-0.0924,-0.1137,0.3678,0.2409,0.2351,0.0273,0.1077,0.2404,0.4176,0.4275,0.4054,-0.0129,0.0166,-0.0743,-0.0155,-0.0569,-0.0179,-0.0793,-0.0562,-0.0672,-0.0219,-0.0302,-0.0236,0.0951,-0.0566,-0.0249,-0.1519,-0.0063,0.0845,0.1176,-0.0671,-0.0,-0.1166,-0.0565,0.0029,-0.037,-0.0214,-0.0472,-0.0314,-0.0284,-0.0695,-0.1358,-0.1265,-0.0698,-0.0705,-0.0147,0.1464,0.0651,0.1059,-0.023,0.0756,0.3074,-0.1069,-0.1337,-0.1034,-0.0984,0.1034,0.0317,0.1219,0.0793,0.0786,-0.0093,-0.1519,-0.1493,-0.1188,-0.114,-0.0906,-0.2012,-0.184,0.0461,-0.0034,0.2111,-0.1118,-0.022,0.0808,0.0003,0.0948,0.1152,0.0375,-0.0683,-0.102,-0.0611,-0.0144,-0.1429,-0.0774,-0.1151,0.0448,0.0929,0.05,0.0296,0.1212,-0.0046,-0.0013,0.0409,0.0276,0.0851,0.1223,0.021,0.0406,0.0216,-0.0027,0.0067,-0.1008,-0.0981,-0.0125,-0.0,-0.0719,0.0185,-0.025,-0.0484,-0.0062,0.0567,0.0405,0.0444,0.0658,-0.0295,0.169,0.1244,-0.0265,-0.1305,-0.0511,-0.0992,-0.1071,0.0531,-0.0177,-0.0616,-0.076,0.1106,0.0035,-0.1368,-0.0942,-0.0653,0.0742,0.0316,0.0644,0.0848,0.1253,0.1691,0.3091,0.0819,0.0484,-0.0263,-0.0139,-0.0128,-0.126,-0.0826,-0.0821,-0.0182,-0.1113,-0.0891,0.0099,-0.0622,0.0307,-0.0271,-0.0996,-0.0853,-0.0599,-0.0562,-0.0729,-0.0218,-0.0583,-0.0687,-0.0128,-0.0425,-0.0898,-0.0721,0.1911,0.107,0.0318,-0.113,0.1703,0.1601,-0.1493,0.1762,-0.141,-0.0669,-0.0044,-0.0979,-0.0972,-0.0576,0.0236,0.002,0.0209,-0.0992,-0.0608,0.0456,0.0389,0.0559,-0.114,0.0016,-0.0002,0.0129,0.0394,-0.0954,-0.0465,-0.0216,-0.0607,-0.082,-0.0441,-0.0426,-0.0393,0.0069,0.023,-0.03,-0.1704,-0.0807,-0.1158,-0.1359,-0.0929,-0.0646,-0.0724,-0.0724,-0.0007,-0.0425,0.0431,-0.139,-0.0085,-0.1787,-0.1697,0.0711,0.0484,-0.1423,0.2087,-0.1684,0.0717,0.1139,0.0128,0.1262,0.081,-0.117,-0.1002,-0.0424,0.0023,-0.0317,-0.0009,-0.0451,-0.0373,0.0851,0.0578,0.0739,0.022,-0.0823,-0.076,-0.0625,-0.082,-0.0156,-0.0705,-0.0593,-0.0194,-0.015,-0.0418,0.0126,-0.0355,-0.0196,0.0094,0.0939,-0.025,0.1606,0.0619,-0.0604,-0.0287,-0.0985,-0.0271,-0.0134,0.0298,-0.0057,-0.0657,-0.0653,-0.0436,-0.0026,-0.0006,-0.0172,0.1361,0.0784,0.2995,0.1257,0.0216,0.003,-0.115,0.0134,0.1129,0.1188,-0.0712,0.0403,0.0435,-0.02,0.0238,-0.2509,-0.1417,-0.2099,-0.1627,-0.1436,-0.0957,-0.2204,0.1024,-0.0202,0.0895,0.1705,-0.039,0.0234,0.0182,-0.0432,-0.1001,-0.0341,-0.0051,0.067,-0.0259,-0.001,-0.1277,-0.0013,0.1168,0.0838,0.1211,0.0372,0.0583,-0.115,0.0406,-0.0543,-0.0056,-0.0361,0.0158,0.0073,-0.0255,-0.0238,-0.0863,-0.0524,0.0688,-0.0527,0.0824,-0.0615,0.0712,0.0111,0.076,0.0526,0.0235,-0.0662,-0.0686,-0.0313,-0.0019,0.0091,0.0902,-0.0275,-0.0558,0.0089,0.1335,0.0788,-0.0847,-0.0542,-0.1208,-0.0998,-0.0052,0.0109,0.0471,-0.0879,-0.0462,-0.0857,-0.0186,-0.0611,0.0161,-0.0026,-0.1686,0.0891,-0.033,-0.0687,-0.0818,0.0825,-0.0757,0.0319,0.0219,0.0189,-0.1335,0.0389,-0.0083,-0.0685,0.0403,0.0807,0.0088,0.0321,-0.1107,-0.0465,-0.1233,-0.1116,-0.125,-0.0378,-0.1056,-0.0792,-0.0693,0.0469,0.0396,0.0525,-0.0813,-0.0698,0.0972,0.2214,0.2805,0.1024,-0.0644,0.0232,-0.0331,-0.0432,0.0301,-0.0207,-0.0797,-0.0753,-0.0466,-0.0765,-0.1309,0.2983,0.0723,0.0322,0.2364,0.0783,0.1211,-0.0187,-0.0968,-0.0784,-0.0342,-0.1219,0.0115,0.036,0.0053,0.0269,-0.023,-0.0244,-0.0786,0.014,-0.0636,-0.0706,-0.0236,-0.0316,-0.0492,-0.0165,0.0347,0.0121,0.0349,-0.0411,0.0807,-0.1667,-0.0725,-0.0986,-0.1378,0.032,-0.0763,-0.0604,-0.1525,-0.0844,-0.1408,0.0662,-0.1311,-0.0151,-0.0527,-0.015,0.0928,0.0729,-0.0781,-0.0902,-0.0008,-0.0433,0.0733,0.1058,-0.054,-0.0188,0.0089,0.0588,0.0278,0.0497,0.0941,0.0015,-0.0572,0.0595,0.0128,0.0107,0.0757,0.0415,-0.0636,-0.0917,0.0027,0.178,0.0037,0.1978,0.2025,-0.1133,0.0267,0.0376,-0.095,-0.1012,-0.0475,0.0656,0.224,0.0303,0.0636,0.0575,-0.0098,0.1307,0.1716,0.0679,0.0641,-0.074,-0.0272,-0.0502,0.0353,-0.0353,0.0194,-0.0825,-0.0079,0.0539,-0.0184,0.0467,-0.0179,0.0449,0.015,-0.1484,0.1003,0.0856,0.0323,0.0233,0.0985,0.1504,0.0215,0.0847,0.0013,-0.0175,-0.0119,0.1171,0.1191,0.0078,-0.0093,0.1008,-0.0462,-0.1257,-0.2518,-0.2384,0.0189,0.0375,-0.0071,-0.0199,0.0264,0.1241,0.0137,0.0309,-0.0267,0.0826,-0.0379,0.0194,-0.0143,-0.0143,0.0345,-0.0982,-0.04,-0.1176,-0.0867,-0.0663,0.0058,-0.0031,-0.1488,-0.0705,0.0106,-0.0731,-0.0034,0.1009,0.009,-0.125,-0.0811,0.1386,-0.0706,0.0801,0.0341,0.0515,0.0009,0.0606,-0.201,0.0133,0.006,-0.0734,-0.0475,-0.0438,0.0308,-0.033,-0.087,-0.1347,-0.1144,-0.0556,-0.0487,0.0157,0.088,0.014,-0.0657,-0.0535,-0.1603,0.1697,0.2147,-0.0995,-0.0857,-0.0673,-0.0918,-0.1108,0.2377,0.049,-0.0615,-0.0049,0.0316,0.1186,-0.1966,-0.1915,-0.1012,-0.1619,-0.0465,-0.0952,0.0265,0.0484,0.0602,0.0723,-0.074,0.0171,0.3223,0.0912,0.194,0.3208,-0.174,-0.0705,-0.089,0.1788,0.0298,0.0479,0.0527,0.0566,0.1064,-0.1844,-0.1497,0.0051,0.2018,-0.0453,-0.1687,-0.1927,-0.0941,0.0069,0.1285,-0.0943,0.0084,-0.013,-0.0098,0.0271,0.0824,-0.0277,0.0181,0.0188,-0.0806,0.0068,-0.0262,0.0031,0.0009,-0.0853,0.0022,-0.0441,-0.005,0.0072,-0.0168,0.09,0.0584,-0.0068,0.0137,-0.0512,-0.0141,-0.1152,-0.1083,-0.0419,-0.1021,0.26,-0.0143,0.2046,0.0888,0.0408,0.0368,0.0348,0.0454,-0.0933,0.0691,0.0715,0.0424,0.0515,0.0238,0.0098,-0.0796,-0.0886,-0.1835,-0.0375,0.0604,0.1624,-0.1235,-0.039,-0.0283,0.0022,-0.0145,-0.0483,-0.0138,-0.0779,0.0344,-0.1859,0.025,-0.0867,0.1496,0.0355,-0.0044,0.0874,-0.0612,-0.0074,-0.0917,-0.0794,0.0146,0.0468,-0.0627,-0.0687,-0.0687,0.0351,0.0071,-0.0293,-0.0072,0.1329,0.0127,-0.0267,-0.1575,-0.0637,-0.1062,-0.1255,-0.0364,-0.0653,-0.052,-0.0599,-0.0612,-0.0803,-0.0129,0.0019,-0.0063,-0.0076,0.0175,0.0213,-0.0781,0.0277,-0.2608,-0.2292,-0.2139,-0.0641,-0.0366,-0.1155,-0.1036,0.0069,0.048,0.026,-0.1132,0.1486,0.151,0.0756,-0.0257,-0.0044,-0.058,-0.0598,0.0217,-0.0268,0.1057,0.1279,0.1885,0.0029,0.0752,0.0881,0.0496,-0.1393,-0.0006,0.0178,-0.0025,-0.1024,-0.0994,-0.089,-0.1018,-0.0749,-0.1695,-0.1628,0.0187,0.0145,-0.187,0.0045,-0.0022,0.0317,-0.0436,-0.061,-0.2476,-0.1941,-0.1077,-0.1874,0.1548,-0.0563,-0.004,0.0579,-0.0698,-0.1451,-0.2659,-0.1638,0.1837,0.1267,0.1343,0.0786,0.0369,-0.0465,-0.0104,0.0733,0.069,0.0494,0.0138,-0.0015,0.1589,0.0464,-0.1052,-0.1716,-0.0762,-0.0969,-0.1222,0.0507,-0.1439,0.0895,0.0564,0.0725,0.0344,0.0314,-0.1389,-0.0318,-0.1083,-0.0211,-0.1155,-0.1372,-0.0281,0.0821,-0.0624,-0.0545,-0.0174,-0.1643,-0.0674,-0.0949,-0.1083,-0.0676,-0.0593,0.0452,0.1094,-0.0061,-0.0566,0.0113,0.0227,-0.0008,-0.0631,-0.0372,-0.0764,-0.0071,0.1067,0.0257,-0.0249,0.1133,0.0116,0.0595,0.0562,-0.0062,0.0342,0.033,0.0459,-0.0325,0.045,0.0168,0.1421,0.1852,0.1705,0.08,0.0894,-0.0158,0.0321,-0.0567,0.0728,-0.0331,0.0507,-0.0118,-0.1181,-0.12,0.1538,0.0297,0.0024,-0.0336,0.0541,-0.0323,-0.0367,-0.0324,0.0727,-0.058,-0.0618,0.0371,0.0593,0.0592,-0.1233,-0.0508,-0.133,-0.014,-0.1325,-0.0107,0.018,0.0305,0.0122,-0.0143,-0.0776,-0.0918,-0.1052,0.0771,-0.0949,-0.0944,0.0597,0.0128,-0.028,0.0274,0.1782,0.0764,0.0973,0.1678,-0.0691,0.0061,0.193,0.0502,-0.0156,0.1797,-0.0092,0.0473,0.0304,0.1977,0.0351,-0.095,-0.142,-0.1099,0.1247,0.2443,0.0011,0.0968,0.0328,0.0108,0.024,0.028,0.0357,0.1222,0.0105,-0.0819,0.0885,-0.0972,-0.0775,0.0421,-0.0042,0.0298,0.0296,-0.0397,-0.0344,-0.1314,-0.0852,0.1201,0.2144,-0.0387,-0.0712,0.0907,0.0659,-0.0407,-0.0535,-0.1138,-0.1608,0.1165,0.105,-0.0431,-0.0445,-0.0807,-0.0514,-0.11,-0.0083,-0.0532,-0.1046,-0.0018,-0.0662,-0.0171,0.0085,-0.0926,-0.1209,-0.0413,-0.0445,0.0605,-0.0857,-0.04,0.0787,-0.0253,-0.0814,-0.163,-0.0416,-0.0974,-0.0194,-0.0964,-0.1203,0.0612,0.054,0.099,-0.057,-0.0714,-0.061,0.0376,-0.0493,-0.0126,-0.1561,-0.0643,-0.1169,0.0232,0.0156,0.0925,-0.0935,-0.1519,-0.1071,-0.1717,-0.1718,-0.0292,-0.0278,0.0584,-0.0019,-0.056,-0.0696,-0.0635,-0.0805,-0.1973,-0.094,-0.0374,0.0116,-0.0294,0.0775,-0.0147,0.0997,-0.0062,0.0324,-0.0519,0.0726,0.1579,0.1069,0.0477,0.002,-0.0527,-0.0025,-0.0736,-0.0043,-0.0494,-0.0379,0.0121,0.0004,-0.1061,-0.0559,-0.0183,-0.0141,-0.0394,-0.088,0.0003,0.2624,-0.0912,0.0932,0.0518,0.0512,0.0352,0.0525,0.0243,-0.0213,-0.1072,-0.0194,0.0441,0.0548,-0.0689,-0.0383,-0.071,-0.1018,-0.0629,-0.036,-0.0588,0.0842,0.0591,-0.1299,-0.1309,-0.0595,-0.113,-0.0599,-0.0643,0.1505,0.1402,-0.0314,0.0381,-0.09,-0.0207,-0.0767,-0.0805,-0.1871,-0.1435,0.0065,-0.0116,-0.076,0.029,-0.0431,-0.0545,0.1157,-0.0092,0.0353,-0.0024,0.0045,0.0072,-0.0537,-0.0042,0.127,-0.0894,0.0816,-0.0738,0.0411,-0.1164,0.3647,0.0357,0.0476,-0.1014,-0.0907,0.0654,0.1056,0.0085,0.1044,0.0863,0.0174,0.0087,0.0736,0.0933,0.0778,0.098,0.1595,0.1344,0.1803,0.2609,-0.0224,0.0847,0.1488,0.3827,0.1284,0.1374,0.2,0.1314,0.1026,0.1245,0.0779,0.1503,0.1648,0.186,0.2017,0.0515,0.1861,0.3724,0.1695,0.2257,0.1549,-0.0117,0.1233,-0.1585,-0.068,-0.087,-0.1483,-0.0405,-0.1608,-0.1631,-0.0484,-0.1244,-0.0856,-0.1717,-0.1499,-0.1308,-0.0291,0.0832,-0.07,0.1854,-0.0101,-0.061,0.0379,-0.0764,-0.0968,-0.093,-0.0416,-0.113,0.0734,-0.1537,-0.1608,0.0168,-0.0129,-0.0641,-0.0143,-0.0182,-0.1375,0.0517,0.0605,-0.0607,0.2531,0.3575,0.0395,0.1756,0.2208,-0.0689,0.1339,0.1369,-0.004,-0.0038,0.2204,0.0148,0.0377,-0.1194,0.026,0.1346,-0.0046,-0.0176,-0.0327,0.0062,-0.016,-0.0321,language processing
trm_4a3fd79d0b1b2,-0.0923,-0.0784,-0.1014,-0.0936,0.0168,-0.0234,-0.1029,-0.0787,-0.1063,-0.1075,-0.0079,0.0038,-0.102,-0.0733,-0.0868,-0.0465,-0.0135,-0.0547,-0.0773,-0.0248,-0.029,0.081,-0.048,0.0074,0.0302,0.0602,0.0528,-0.0938,-0.1493,-0.0753,-0.0888,-0.0834,-0.1298,-0.0302,-0.154,-0.0462,-0.054,-0.0663,-0.1268,0.0165,-0.089,-0.1068,-0.0628,0.0716,-0.0583,-0.0582,0.168,-0.083,0.0433,-0.0583,-0.0329,0.0511,0.0399,0.0189,-0.0185,-0.0491,-0.0984,-0.0352,-0.0195,-0.0201,0.0422,0.0745,-0.0932,0.0974,0.0421,0.0413,-0.1309,-0.1676,-0.1278,-0.0029,0.0189,0.0609,0.1512,-0.0778,-0.1408,0.0471,-0.1369,0.0874,0.0298,-0.0316,-0.0114,0.0506,-0.0485,-0.1428,0.0568,0.061,0.0032,0.0087,0.021,-0.1575,-0.0395,-0.0443,0.0052,0.1208,0.1286,0.1226,0.1023,-0.015,0.1745,0.1036,0.078,0.0678,0.089,0.0571,0.0731,-0.1211,-0.1113,0.0739,-0.0124,-0.0754,0.0212,-0.0992,0.0761,0.1346,0.0475,0.009,-0.0704,0.0506,-0.053,-0.0808,-0.0246,-0.1316,-0.0709,-0.0295,-0.065,-0.0964,-0.0299,0.0553,0.06,0.0143,-0.1287,-0.0722,-0.0512,-0.2704,0.0376,-0.1124,0.0013,-0.1247,-0.0002,-0.0662,-0.0849,-0.0974,0.0244,0.0284,0.0368,0.0818,-0.0692,0.0415,-0.0775,0.078,-0.0863,-0.0129,-0.1241,-0.116,0.135,0.049,0.0457,0.0378,0.0531,-0.0144,-0.0502,-0.0359,-0.1452,-0.1651,-0.0356,-0.0105,-0.0001,-0.1342,-0.1247,-0.0327,0.0096,-0.0287,0.0959,-0.252,-0.171,-0.1862,-0.1492,-0.1287,-0.094,-0.0253,-0.1354,0.0605,0.0098,-0.0021,-0.0448,-0.0188,-0.0705,-0.0939,-0.1258,0.0289,0.032,-0.0117,-0.0016,-0.1672,-0.1646,-0.2206,-0.1905,0.0225,-0.0172,-0.1705,-0.0747,0.1911,-0.0812,-0.0917,0.0762,-0.0838,-0.1571,0.0088,-0.0651,0.0103,-0.1885,-0.1026,-0.0294,0.0234,0.0419,0.0198,0.092,-0.1391,-0.1028,0.0805,0.0705,-0.083,-0.1026,-0.0256,0.0736,-0.0023,-0.0102,0.1122,-0.0241,0.1645,-0.0302,-0.1558,0.1329,-0.0792,-0.0731,0.043,-0.0531,0.0376,0.0316,-0.0719,0.0325,-0.165,-0.057,0.0185,-0.0627,-0.0827,-0.0782,-0.0779,-0.0609,-0.0554,0.029,-0.0148,0.0224,0.0189,0.0339,-0.1632,-0.0025,-0.0639,0.0538,0.2253,0.0708,0.2614,-0.0828,0.1207,0.1771,0.2647,0.0988,-0.0287,0.0207,-0.0209,-0.0577,-0.0047,-0.1496,-0.0097,-0.0599,0.0284,-0.0693,-0.1241,-0.1,0.0395,0.0566,-0.0706,-0.0438,-0.1162,-0.0812,-0.056,0.0272,0.0102,-0.1185,-0.1093,-0.1018,-0.143,-0.0137,-0.044,-0.0774,0.0483,0.0084,0.0801,-0.0141,0.1166,0.0895,-0.1187,-0.0914,-0.0489,-0.0647,-0.0443,-0.1124,0.004,-0.0598,-0.0319,-0.0071,-0.0448,-0.0933,0.0281,0.0692,-0.0801,0.1163,-0.0052,0.0457,-0.1022,-0.0479,0.0093,-0.1105,-0.1099,-0.1065,-0.0116,0.0063,-0.0485,-0.0749,-0.0476,0.0655,-0.0574,0.0106,0.0196,0.0467,0.1207,0.0479,0.0292,-0.0378,-0.1312,-0.1143,0.0752,0.0286,-0.03,0.0647,0.0273,-0.2364,-0.1639,-0.1462,-0.1168,-0.1044,-0.0305,-0.0551,-0.0562,-0.0736,-0.0222,-0.0313,-0.1032,-0.1171,-0.1071,-0.0137,-0.0278,-0.0102,-0.0102,-0.0163,0.0666,-0.0794,0.1962,0.0556,-0.1537,0.0522,0.0723,0.0429,0.066,-0.1082,-0.0222,-0.0714,0.0912,0.0895,0.1258,0.1525,0.0557,-0.0551,0.0616,-0.0177,-0.0085,-0.0742,-0.0565,0.0209,-0.0262,-0.0771,0.0199,0.0352,0.003,0.1463,0.0661,-0.0674,-0.1459,-0.0759,-0.0203,-0.0568,0.0213,0.0071,-0.0193,0.0874,0.0616,0.0213,-0.0054,-0.0914,-0.0297,0.0193,-0.1403,-0.0019,0.1391,-0.0743,-0.0053,0.1701,0.0022,-0.0987,-0.0374,0.0373,-0.1999,-0.1255,-0.2641,-0.245,-0.1192,-0.115,-0.0958,-0.1461,-0.0922,0.0105,0.0374,-0.0122,-0.0242,-0.0106,0.0557,-0.0258,0.0112,-0.1944,-0.1535,0.0352,0.0302,0.0756,0.0335,-0.0243,-0.0657,0.0137,0.0635,-0.0913,0.0137,0.0308,0.0644,-0.0881,-0.0439,0.0384,-0.1164,0.0269,-0.0343,-0.0204,0.0602,0.1067,-0.0352,-0.0467,0.1014,-0.1045,-0.0385,0.0529,0.3275,-0.1122,-0.0532,0.0138,0.0394,0.0846,-0.0274,-0.116,-0.0593,0.0256,0.07,-0.0282,-0.0323,0.0622,0.0351,0.0264,0.0259,0.1251,0.1266,-0.0078,0.0437,-0.0435,-0.0228,0.0614,0.1019,-0.0069,-0.039,0.1605,0.0315,-0.0639,0.0015,0.0743,-0.077,-0.0677,0.0305,0.0075,-0.0666,-0.1131,-0.1141,0.0208,-0.025,-0.0238,0.0999,-0.1151,0.0246,-0.01,0.0186,0.0927,0.0683,-0.1027,-0.0914,0.0951,-0.0929,-0.1098,-0.0189,0.0841,0.0884,0.1311,0.0219,0.1573,0.0558,0.0344,0.0424,-0.0583,-0.0318,-0.0724,-0.1574,-0.1082,-0.0058,-0.0779,-0.0379,0.0169,-0.0751,-0.0467,0.0487,0.011,-0.0451,-0.0727,-0.0372,0.0326,-0.0055,0.0141,0.0422,0.0682,-0.0069,-0.0128,-0.0386,-0.0201,-0.114,0.1041,-0.0063,0.0931,-0.0295,-0.0064,0.0612,-0.0236,0.0474,-0.0708,0.0517,0.1131,-0.0162,0.0086,-0.0542,-0.0513,0.0106,-0.0433,0.0423,-0.0152,-0.033,0.0356,0.0155,0.0777,0.0948,-0.0114,-0.0658,-0.0105,-0.0411,0.1448,0.0644,0.0131,0.0507,0.0548,-0.0321,-0.0458,0.0398,0.0866,0.0736,-0.006,0.0066,-0.1578,-0.0872,0.1295,-0.0025,-0.0046,0.061,0.032,0.0288,0.0707,0.0272,-0.0192,-0.1494,-0.1537,0.0834,-0.1239,-0.0316,0.0405,-0.0989,-0.2279,-0.0366,-0.0697,0.0408,0.0527,-0.1344,-0.058,-0.1311,0.0511,0.0227,0.0008,0.0385,-0.1117,-0.1735,-0.1052,0.0273,0.1009,0.0516,-0.0863,-0.0374,0.0192,0.0269,0.0754,-0.0296,-0.0388,-0.0993,-0.1132,0.0615,-0.0089,-0.0432,-0.0286,-0.0123,-0.1774,-0.1861,0.0921,-0.0812,0.0163,-0.0887,0.1721,-0.0039,-0.0661,-0.0065,0.0257,-0.0802,-0.0377,-0.0605,-0.1138,0.0326,0.1457,-0.0478,0.0001,0.121,-0.1369,-0.0442,-0.0342,0.0157,-0.0555,-0.0941,-0.048,-0.018,-0.0364,-0.0919,0.1435,-0.0457,0.0441,-0.0288,0.0439,0.0344,0.0841,0.0533,0.1422,-0.1204,-0.1002,-0.0009,-0.0052,-0.0054,0.1195,0.1506,0.1385,0.1099,0.2882,-0.0204,0.063,-0.0574,-0.1155,-0.0438,0.0552,0.0338,-0.0016,-0.0854,-0.0823,-0.0804,-0.0732,-0.0097,-0.0148,0.0423,0.0835,0.0386,-0.0078,0.07,0.0409,-0.0234,0.0031,0.0231,-0.0633,0.0554,0.0819,-0.0754,-0.1155,-0.1135,-0.097,0.0183,-0.0348,-0.0898,-0.0238,-0.0722,0.0266,-0.0335,-0.0339,0.1472,0.1209,0.0009,-0.137,0.1058,0.0999,0.1998,-0.1464,-0.0494,-0.0804,-0.0633,0.0284,-0.0733,0.099,0.0242,-0.0248,0.0124,-0.0248,0.0287,-0.1618,-0.2082,-0.1697,-0.1261,0.0621,0.1721,0.0627,-0.0893,-0.0051,0.0367,0.0671,0.1135,0.0587,0.0401,-0.075,-0.1043,-0.0106,0.0748,0.0779,0.1461,-0.021,-0.0469,0.0071,-0.0694,0.0982,-0.0663,-0.0829,0.0169,-0.1416,-0.1465,-0.0666,0.0118,0.0791,0.0082,-0.0346,-0.0319,-0.0132,0.1347,-0.0152,-0.1242,0.0597,0.0163,0.0229,0.0016,0.0831,-0.0592,0.1026,-0.1798,-0.1823,0.1083,0.0933,0.1722,-0.0174,-0.0441,0.0331,-0.0117,0.0313,0.2081,0.0422,0.0714,0.0587,0.1352,0.0245,0.0181,0.1256,0.1265,-0.1014,0.0021,0.0455,-0.144,-0.092,-0.0359,-0.0866,-0.0661,-0.2132,-0.0694,-0.1217,-0.0689,-0.1775,0.0164,0.0087,0.0081,-0.0299,0.0122,0.0229,0.0095,0.1219,0.0622,0.0857,0.1449,0.0215,0.0779,0.0439,-0.0293,0.1166,0.1177,-0.0918,0.1448,0.0594,-0.0276,-0.0511,-0.1038,-0.0464,0.0745,0.0133,-0.1462,-0.0956,-0.0806,0.0696,0.1821,0.0536,0.0129,-0.0129,-0.0033,-0.0289,-0.0785,0.1338,-0.0561,0.0763,-0.1516,0.0959,-0.0699,0.1394,0.081,0.0294,0.0784,-0.1633,-0.1479,-0.0704,0.2209,-0.047,-0.0916,-0.0819,0.0978,0.0177,-0.1603,-0.0195,-0.1339,0.0631,-0.0799,-0.0444,0.0191,-0.0118,0.1489,-0.1325,-0.1128,-0.0625,0.0391,-0.1267,0.0315,0.1453,0.0713,0.1132,0.3486,0.1077,-0.1161,-0.0549,-0.0966,-0.0502,-0.0632,-0.0584,-0.03,0.0788,0.0838,-0.0014,-0.1169,0.0938,0.1511,0.0684,-0.0107,-0.0312,0.0056,-0.1439,-0.0288,-0.0302,0.0111,0.087,-0.1067,-0.0534,0.0868,0.0148,-0.0746,-0.0044,0.0897,-0.0186,-0.0148,-0.0671,-0.113,-0.1101,-0.2591,-0.1484,-0.2815,-0.0379,-0.0511,-0.0897,-0.11,-0.1303,-0.1755,-0.1351,-0.2092,-0.1584,-0.1746,-0.0022,0.0312,0.0915,-0.0103,0.0276,0.0303,0.0987,0.0955,0.1432,0.1498,0.1252,-0.0274,-0.0256,0.016,-0.0017,0.1298,0.0633,0.1305,-0.0409,0.0797,-0.0543,0.0658,-0.0406,-0.0736,-0.0281,0.1248,-0.0135,0.1106,-0.1433,-0.0411,0.0228,0.0271,0.0416,-0.0317,0.0874,0.0415,0.076,0.1239,0.1,0.0227,0.0063,-0.0273,-0.0191,0.0391,0.0187,0.0002,-0.0266,-0.0776,-0.0429,0.0885,0.0804,-0.1057,-0.0748,-0.074,-0.1829,-0.0978,0.1512,0.0848,0.0865,0.0869,0.0401,-0.0309,-0.0114,0.0466,-0.0216,-0.0478,-0.0293,0.0222,-0.0885,-0.0747,0.0155,0.0869,-0.0598,-0.0161,-0.0694,0.0562,-0.1179,0.0528,0.097,0.1429,0.1198,0.0877,0.0468,0.0331,-0.0365,-0.0529,-0.0636,-0.0876,0.0155,0.002,0.105,-0.0109,-0.0228,-0.0021,-0.0163,-0.0629,-0.0004,-0.1237,-0.1761,-0.118,-0.1244,0.1474,0.0568,0.1225,-0.1013,0.1731,0.0934,-0.0091,-0.0094,0.0443,0.0399,-0.0167,0.0984,-0.0803,-0.0923,-0.0045,-0.041,-0.1047,-0.0036,-0.0925,-0.0508,-0.1217,-0.028,-0.0786,-0.0347,-0.0225,-0.0149,0.0239,-0.0063,0.0171,-0.0577,0.011,-0.0896,0.0668,-0.03,-0.0346,0.3138,0.2683,0.3038,0.2116,0.2273,0.1061,0.2834,0.191,-0.1661,0.0602,0.0939,0.025,0.0245,0.025,-0.1382,-0.056,-0.1161,-0.0082,0.0075,0.0134,-0.0183,0.0489,-0.1034,0.0041,0.0351,0.0061,0.0456,-0.0445,-0.0925,0.0297,0.0606,-0.0492,-0.0052,-0.0748,0.0262,0.0101,0.1249,0.0166,-0.0852,-0.1643,-0.1249,-0.0547,0.0799,0.0606,-0.0638,-0.0755,-0.2212,-0.1652,-0.1004,0.0923,-0.0779,0.2678,0.224,-0.051,-0.0089,-0.0071,0.0343,0.0743,0.0327,0.2081,0.0956,0.0366,0.0757,0.0351,-0.0497,-0.0584,0.0732,-0.065,0.0625,0.0108,-0.0598,-0.0111,-0.1221,-0.0617,-0.0296,-0.0823,-0.1434,-0.0313,0.1098,-0.0319,0.0023,0.0055,0.0686,0.036,0.018,-0.1428,-0.1681,-0.0412,-0.0249,-0.0077,-0.0647,0.0191,-0.0627,-0.022,0.1237,0.0145,0.0419,0.2339,-0.0002,-0.0275,-0.035,0.1042,-0.0307,0.197,-0.0927,0.1792,0.2563,0.0536,-0.1035,0.2393,0.219,-0.0388,-0.179,0.0393,-0.1424,-0.0399,-0.155,-0.0327,0.0603,0.005,-0.0215,0.0078,-0.0357,-0.019,-0.0863,-0.0188,-0.013,-0.0427,0.0195,0.1023,-0.0128,0.1963,0.0725,0.1935,0.1647,-0.0831,-0.0421,-0.0893,-0.0885,-0.0627,0.0095,-0.045,0.1381,-0.1216,-0.0762,0.0859,0.0758,-0.0137,0.0649,0.1179,0.0037,0.0042,0.1312,-0.0272,-0.0667,-0.0004,0.0465,-0.0084,0.0338,-0.026,-0.026,-0.1576,0.0875,0.0367,0.0555,-0.0063,0.0943,0.0096,0.1936,-0.2267,-0.2015,0.0428,-0.0508,-0.1993,-0.1903,-0.135,-0.0078,-0.0509,-0.0263,-0.0154,-0.0199,0.1347,0.0241,0.0622,-0.0824,0.066,0.0501,0.0045,-0.0148,-0.0799,-0.0644,-0.0191,-0.0559,-0.0089,0.0231,-0.0522,0.0723,-0.0072,0.0744,0.0251,0.0805,0.0552,0.0887,-0.1744,-0.0996,0.0272,-0.1485,0.0337,-0.1362,-0.2366,-0.0237,-0.1043,-0.1512,0.0054,-0.0612,-0.1508,-0.0429,-0.0753,0.0194,-0.1598,-0.0747,-0.0894,-0.2038,-0.0612,0.0694,-0.0506,0.204,0.0676,0.0978,0.11,0.0013,0.1163,-0.0654,-0.1286,-0.1246,0.0097,-0.0661,-0.0333,-0.0505,-0.0161,0.0623,0.0464,0.0156,-0.1033,-0.0767,-0.0269,-0.0039,-0.0404,-0.0382,-0.0212,0.0999,-0.0508,-0.0799,-0.0232,-0.0958,-0.1021,-0.0549,-0.0715,-0.0855,0.0611,0.065,-0.0224,0.024,0.0078,-0.1203,-0.0813,0.0175,-0.1575,0.0654,-0.0112,-0.0076,-0.1154,-0.0297,-0.0244,0.1093,-0.0159,0.0497,0.0315,-0.0499,0.0967,0.0166,0.0221,-0.0159,-0.1487,0.0343,-0.0009,0.091,0.1443,0.0343,-0.0096,-0.0756,0.0325,0.1441,-0.0464,0.0353,-0.1015,-0.0261,-0.0993,-0.0837,-0.0155,0.1214,-0.0401,-0.0339,-0.1346,-0.0205,-0.0006,0.0218,-0.0406,-0.1402,-0.0251,0.0132,-0.0665,0.0376,-0.0565,-0.0311,-0.0125,-0.0617,-0.0938,-0.0629,-0.0566,-0.0072,-0.0003,-0.0375,0.0466,-0.0486,-0.0276,0.0131,0.0841,0.0022,0.0352,-0.0376,0.024,-0.1006,-0.0107,-0.028,0.0283,0.0522,0.0104,0.0301,-0.0698,-0.0534,-0.0783,-0.0539,-0.1897,0.0195,-0.1507,-0.0026,-0.057,-0.064,-0.0265,-0.0757,-0.0788,0.0702,0.0178,-0.0311,0.1919,0.0349,0.068,0.0522,0.1116,-0.025,-0.0543,0.0127,0.2182,-0.0005,0.0053,-0.0645,-0.1227,-0.0703,-0.0724,0.0118,0.0296,-0.0579,0.0234,0.0485,-0.0152,-0.0092,-0.0237,0.0634,0.145,0.0834,-0.2917,-0.1624,-0.0843,-0.2239,-0.1943,0.0136,0.1483,0.038,0.0251,0.0125,-0.0047,-0.1522,-0.0251,-0.0283,-0.1097,-0.2103,-0.0257,-0.0065,-0.1052,-0.0401,0.1079,-0.0339,-0.0787,-0.0573,0.0114,0.0668,0.1446,-0.0402,0.0708,0.0254,-0.0159,-0.0848,-0.0764,0.0249,0.0244,-0.0071,0.1098,0.1163,0.0654,-0.0584,-0.0788,0.0446,0.3488,0.3503,-0.0713,-0.0627,0.043,-0.0812,-0.0346,-0.0233,-0.1643,0.0646,-0.0024,-0.0912,-0.0045,0.014,0.1676,-0.0407,0.1776,-0.0157,0.0241,0.0394,0.3016,-0.0861,-0.0555,0.2138,0.0257,0.0585,0.0366,0.0536,-0.0347,0.1627,0.1135,-0.0052,-0.0352,-0.0279,0.0286,0.1044,0.0911,0.0037,-0.0155,-0.0257,0.1065,-0.1028,0.0627,0.1389,-0.0596,0.0074,0.03,0.0176,-0.0977,0.0067,-0.0037,-0.0801,0.0069,-0.0842,0.0665,0.0715,0.0041,0.0054,0.0476,0.0122,0.02,0.1515,0.0791,0.122,0.0267,0.1016,0.0521,0.0483,0.274,-0.1501,-0.0484,0.0569,-0.1091,0.0368,0.071,0.062,-0.0558,-0.0003,-0.0123,0.0034,0.0609,0.0416,-0.0241,-0.0219,0.026,0.0282,0.0338,0.0685,0.2271,0.1746,-0.0668,-0.1374,-0.1189,-0.0038,0.0495,0.0006,0.0281,0.03,0.0332,-0.0115,0.0582,-0.0412,-0.2442,-0.0528,-0.0398,0.0863,0.0554,0.0721,0.0139,0.3452,0.2762,-0.0027,-0.0213,-0.0969,-0.0087,0.0459,0.1221,-0.0849,-0.1459,-0.174,0.0325,0.0432,0.0568,0.2073,-0.0315,-0.0129,0.0653,0.1445,0.0394,0.1967,-0.0079,-0.0013,-0.0512,0.0282,0.1052,0.2281,0.2191,-0.016,0.0378,0.0523,0.0487,-0.102,0.0898,-0.1978,-0.067,0.0234,-0.0309,0.0182,0.0846,-0.0068,-0.0457,-0.0537,-0.016,-0.0165,-0.0222,-0.0287,-0.0841,-0.0282,-0.0498,-0.0746,0.0842,0.1913,0.1876,0.1912,-0.1693,-0.0994,-0.1351,-0.048,0.0765,-0.0156,-0.141,-0.0952,-0.1236,-0.0154,0.0624,0.018,0.1341,0.0816,0.0256,0.0279,0.0133,0.065,0.0471,-0.0025,-0.1535,0.0143,-0.094,-0.0105,-0.0963,0.0068,0.0965,0.2092,0.1158,0.1003,0.0747,-0.1397,-0.2566,-0.146,-0.1869,-0.1194,0.0434,-0.0578,0.0585,-0.0955,-0.1411,-0.1321,-0.0811,0.001,0.0145,-0.0345,-0.0586,0.006,-0.0096,-0.1855,-0.0888,-0.0793,0.0479,0.0152,-0.0358,-0.1641,-0.054,-0.1096,-0.1364,-0.2619,0.0669,0.0241,-0.0589,-0.0592,-0.0374,-0.0228,-0.0526,-0.093,-0.0385,-0.0467,0.197,0.0694,0.1294,0.0367,0.1046,-0.0377,0.074,0.0885,0.1998,-0.0764,-0.0234,0.0577,0.1606,-0.1164,-0.1408,-0.1163,-0.0559,-0.0878,-0.1054,-0.0528,-0.0273,-0.0431,-0.0337,0.0062,0.0201,-0.2017,-0.0106,-0.0386,-0.0934,-0.122,-0.0908,-0.0165,-0.1271,0.0397,-0.0268,0.1995,-0.0451,-0.0525,-0.1166,-0.0713,-0.0948,-0.0828,-0.1719,-0.1066,0.0554,0.0391,0.0157,0.0033,-0.071,0.0125,0.1537,0.1914,0.1473,-0.1091,-0.1198,-0.0022,0.0469,0.0324,-0.08,0.0252,-0.0922,-0.0136,-0.0498,-0.0684,-0.1181,-0.0234,-0.1048,-0.0794,-0.0015,-0.0527,0.0055,0.0171,0.0395,0.0944,0.0438,-0.0968,-0.1506,-0.161,-0.1218,-0.0908,-0.2152,-0.1245,0.2152,-0.0762,-0.1165,0.0438,0.0064,-0.0585,0.0379,-0.0189,0.0125,0.0831,-0.0432,0.0678,0.002,-0.0688,-0.024,0.0182,0.0991,0.1792,-0.1675,0.0312,0.0271,0.2546,-0.0622,0.0027,0.0272,-0.0067,0.0337,-0.0189,0.0711,0.0083,-0.0251,-0.1535,-0.117,-0.1295,-0.0138,-0.0694,0.1101,0.1208,0.1351,0.0148,0.026,0.1162,0.2833,0.0985,0.0365,0.0317,0.0301,0.0114,-0.273,-0.1355,-0.1262,-0.1559,-0.1301,-0.1293,-0.1285,-0.0869,-0.0257,-0.0279,-0.1911,-0.0885,0.0806,0.0119,-0.1598,0.0459,0.0012,-0.0056,0.0252,-0.0539,-0.0197,-0.1462,-0.0869,-0.0008,-0.0965,-0.0349,0.0565,-0.1055,0.0178,0.0621,0.0728,0.0232,-0.1087,0.0353,-0.0196,-0.1984,-0.0569,-0.1111,-0.1015,0.1051,0.067,-0.0013,-0.1668,-0.0458,-0.004,0.0083,-0.0181,-0.0812,-0.1471,-0.0672,0.0231,-0.0565,0.0799,-0.0956,-0.0265,0.0244,0.0431,0.0291,0.0468,0.0266,-0.2194,0.0295,-0.0654,-0.142,0.1396,0.2143,0.1753,-0.0458,0.3249,0.173,-0.1645,-0.0653,0.2651,0.0985,0.0377,0.0816,0.0611,0.0304,-0.0869,-0.08,-0.0793,-0.0417,0.4141,0.3197,0.244,0.1175,0.2438,0.1422,0.2859,0.2648,0.2109,-0.0379,-0.0081,-0.0389,-0.018,-0.0617,0.0431,-0.1929,-0.0877,0.0643,0.0665,-0.0432,-0.0347,0.0809,-0.0118,0.0582,-0.0358,0.1274,0.1494,0.2208,-0.0296,-0.0971,-0.1197,0.0285,0.0593,-0.009,-0.0471,-0.0738,0.0079,-0.0394,-0.1451,-0.256,-0.2402,0.0263,-0.0431,-0.0041,0.1945,0.0532,0.2065,0.0626,0.1195,0.1672,0.0299,-0.1649,-0.1398,-0.0417,0.1006,-0.0386,0.1488,0.0655,0.1508,0.0386,-0.1458,-0.1455,-0.1216,-0.1042,0.0467,-0.2765,-0.1964,0.0607,-0.0399,0.103,-0.026,0.0314,0.1036,0.0114,0.0481,0.0683,0.0097,-0.1088,-0.1623,0.0699,0.0282,-0.0373,-0.0155,-0.0523,0.0463,0.2727,0.2163,0.1178,0.193,-0.0658,0.0664,0.0847,0.1287,0.1702,0.2652,0.1132,0.08,0.0127,0.222,0.229,0.01,0.0015,-0.0955,-0.0971,-0.0578,0.0024,0.0102,0.0094,-0.0224,0.0192,0.0295,0.0045,0.1244,-0.0846,0.035,0.0575,-0.0655,-0.1293,-0.0595,-0.1276,-0.1433,0.0991,-0.0505,-0.1,-0.0881,0.127,0.0347,-0.0838,-0.038,0.012,-0.1336,-0.0193,-0.0474,0.0454,0.0753,0.0272,0.2831,0.1892,0.1852,-0.0139,0.0762,0.0973,-0.1095,-0.1484,-0.0153,0.0577,0.0033,0.0447,-0.0451,-0.0945,-0.0727,-0.1264,-0.1933,-0.135,-0.087,0.0068,-0.0957,-0.0427,-0.0761,-0.0186,0.01,-0.0633,-0.0735,-0.0686,0.1214,0.0205,-0.047,-0.1197,0.0423,-0.0673,-0.0834,0.1056,-0.1947,-0.1056,0.1883,-0.1074,-0.1099,-0.0212,0.0436,-0.0222,0.0452,-0.0863,-0.0589,-0.0586,0.0034,-0.003,-0.1981,0.0579,-0.0062,0.1436,0.0325,-0.1949,-0.0729,0.0084,-0.0341,-0.0519,-0.04,-0.1004,0.0122,0.0054,-0.0308,0.0868,-0.2675,-0.1274,-0.0966,-0.2122,-0.1745,-0.1264,-0.1071,-0.1071,-0.047,-0.0364,0.0469,-0.1856,-0.0526,-0.0887,-0.0799,0.0387,-0.0259,-0.1763,0.1025,-0.1917,0.0825,-0.0059,0.2266,-0.0605,-0.0504,-0.1161,-0.0445,-0.0167,0.0719,-0.0366,0.1726,0.0186,0.0399,0.1353,0.1231,-0.017,0.0261,-0.0111,-0.0321,-0.0105,0.0613,-0.0407,-0.045,-0.0786,0.0042,0.0016,-0.0002,0.0598,-0.0346,-0.0019,0.0671,0.0809,-0.0564,0.0641,-0.0317,-0.0972,0.031,-0.121,0.0191,-0.0581,0.0268,-0.0828,0.0913,0.0932,-0.0087,0.1286,0.1379,0.0046,0.0948,0.0106,0.2215,0.0913,0.0147,0.1179,-0.1783,0.0429,0.0826,0.0493,0.0089,-0.0466,0.0317,-0.0217,0.05,-0.0837,-0.1118,-0.0748,-0.1205,0.001,-0.0214,-0.138,0.2889,-0.0277,0.0349,0.0078,0.0273,-0.0346,0.0351,-0.0004,-0.144,-0.0611,0.1059,0.0957,-0.0214,0.0247,-0.0892,-0.0008,0.0725,0.0906,0.1173,0.0433,0.0042,-0.0654,0.0483,-0.0771,-0.0344,0.021,-0.038,-0.014,-0.0627,-0.0943,-0.1093,-0.0164,0.0431,-0.1055,0.0753,-0.0345,0.0525,0.0539,0.07,0.0909,0.0894,-0.0427,-0.0308,-0.0613,-0.0317,0.0542,0.0571,-0.0519,-0.0407,-0.0015,0.009,-0.1093,-0.1116,-0.1091,-0.1141,-0.1048,-0.0376,-0.0691,-0.0281,-0.0749,-0.1028,-0.0907,-0.0458,-0.0868,-0.0166,0.0909,-0.1008,0.1117,-0.1112,-0.111,-0.0565,0.0411,-0.0725,-0.0513,0.1122,0.051,-0.1731,-0.0003,0.0227,-0.0013,0.0289,0.0251,0.0236,0.0862,-0.0832,-0.1692,-0.0445,-0.1412,-0.2335,0.0779,-0.0972,0.1011,0.0979,0.1,0.1081,0.1096,-0.1127,-0.1462,0.0128,0.1045,0.1679,0.0568,-0.0478,0.0479,0.0468,-0.0813,0.0663,-0.037,-0.1395,-0.0353,-0.0477,-0.0686,-0.1345,0.0904,0.0176,0.0592,0.0706,-0.0164,0.0012,-0.0039,0.021,-0.0161,0.0369,-0.0715,-0.0082,0.0811,0.0648,-0.0174,-0.0623,-0.0624,-0.124,-0.0596,0.0564,-0.1643,-0.0471,-0.0085,0.0185,-0.0368,0.0619,0.0229,0.0536,-0.0403,0.0813,-0.1509,-0.1111,-0.1173,-0.0797,-0.0453,-0.1436,-0.1351,-0.2651,-0.1383,-0.0628,0.1197,-0.0852,-0.0527,-0.0142,0.0273,0.1087,0.1166,-0.0586,-0.1201,-0.0791,0.0087,0.0274,0.0984,-0.0594,-0.0772,-0.0814,0.0665,0.0728,0.0774,0.1888,0.0072,0.0043,0.1192,-0.0482,0.0839,0.0639,0.046,-0.0603,-0.027,0.0287,0.0713,0.0322,0.0646,0.0869,-0.0007,0.0214,0.0188,-0.1467,-0.0735,-0.0309,0.0965,0.2065,0.0607,-0.0024,0.0145,0.0196,0.2801,0.1453,0.1232,0.2,-0.179,0.0025,-0.035,0.0821,-0.0704,0.0931,-0.0162,-0.0285,-0.0,0.0426,0.0616,-0.054,0.0526,0.0506,-0.1001,0.1595,0.1014,0.0392,0.0161,-0.004,0.0074,-0.0295,-0.0498,-0.0399,-0.0356,0.0773,0.14,0.1538,-0.132,0.0171,-0.0311,-0.0882,-0.0538,-0.1814,-0.1587,0.0408,0.0497,0.0808,-0.019,0.0475,0.0935,-0.0075,0.047,-0.0128,0.0452,-0.029,-0.0135,-0.0066,0.0764,0.0124,-0.1523,-0.0256,-0.133,-0.087,-0.0079,-0.0779,0.0193,-0.1217,-0.0808,-0.0063,-0.0222,0.0156,0.1086,0.0238,-0.0516,-0.0982,0.2056,-0.0287,0.0881,0.1475,0.122,-0.0061,0.0267,-0.1315,0.2435,0.2324,-0.1703,-0.0616,-0.0223,-0.038,-0.0645,-0.1068,-0.1726,-0.1581,-0.0654,-0.0033,-0.0373,0.027,-0.0064,-0.0166,-0.093,-0.1339,0.152,0.0859,-0.0943,-0.0582,-0.0627,-0.0892,-0.1787,0.0282,0.1445,-0.118,0.0457,0.1254,0.056,-0.1779,-0.1856,-0.1204,-0.1395,-0.0656,-0.0695,-0.0101,0.0674,0.0434,0.1252,0.0132,0.179,0.2202,0.1945,0.0701,0.1844,-0.2062,-0.1587,-0.1274,0.0179,-0.0068,-0.0219,-0.0573,0.0015,0.0389,-0.1431,-0.1552,-0.0282,0.1467,-0.1425,-0.0341,-0.0358,0.0224,0.091,0.0823,-0.007,-0.0694,-0.0197,-0.0858,-0.0241,0.1512,0.1519,0.0553,-0.0039,0.1017,0.1047,0.0718,0.0692,0.0051,-0.1149,0.0182,-0.0192,0.0199,-0.0096,0.042,0.1573,0.0353,0.0258,0.0375,0.0104,-0.0235,-0.134,-0.1235,-0.1195,-0.0953,0.3119,0.0439,0.1671,0.1394,0.0968,0.0135,0.0122,0.1336,-0.0355,0.2681,0.1456,0.0197,0.0689,0.0881,0.0297,-0.0407,-0.0357,-0.1088,0.0191,0.2471,0.0489,-0.0673,-0.0115,-0.0333,-0.0695,-0.005,-0.018,-0.0837,-0.0733,-0.0277,-0.1652,-0.0143,-0.0557,0.0586,0.079,0.0931,0.0362,-0.0037,-0.003,-0.0302,-0.0221,0.0461,0.1779,-0.0113,0.0605,-0.0747,0.0417,-0.016,-0.1037,-0.028,0.1223,0.0687,-0.0273,-0.1774,-0.0911,-0.0964,-0.0916,0.0037,0.0319,-0.0388,-0.0087,-0.0369,-0.091,-0.2249,-0.1405,-0.1355,-0.1373,-0.1009,-0.0948,-0.037,0.1045,-0.1619,-0.1818,-0.1477,-0.0514,-0.0123,-0.1256,-0.0189,0.0649,0.1806,0.0704,-0.0428,0.3513,0.267,0.2317,0.0164,0.1025,0.0063,-0.136,0.0036,-0.0417,0.0191,0.1011,0.1182,-0.0456,0.0161,0.0879,0.1189,-0.1189,-0.0863,-0.0274,-0.0452,-0.1324,-0.0916,-0.0618,-0.0818,0.0387,-0.0976,-0.1292,0.1617,-0.0443,-0.1394,0.0347,0.1251,0.1163,-0.062,-0.0836,-0.2179,-0.1643,-0.0402,-0.188,0.0143,-0.095,-0.0793,0.0615,-0.08,-0.0513,-0.1373,-0.0556,0.0473,0.0828,0.2026,0.116,0.1809,-0.0933,-0.08,0.1293,0.021,0.1147,0.0461,0.0483,0.2149,0.1381,-0.0952,-0.185,-0.0803,-0.0677,-0.1256,-0.0353,-0.0563,0.0149,0.032,-0.0,0.0813,0.0245,-0.172,-0.0076,-0.1324,-0.0382,-0.1265,-0.1862,0.0048,-0.0837,-0.0007,-0.0647,0.0025,-0.1373,-0.1014,-0.1927,-0.062,-0.1222,-0.0425,-0.0346,-0.0427,-0.0128,-0.0377,0.0544,0.0894,0.0541,-0.0728,-0.0683,-0.1199,-0.0371,0.0484,0.1245,-0.1096,0.1661,-0.0385,-0.0613,0.071,0.0217,-0.0927,0.038,0.0438,0.0411,0.0084,-0.0158,0.1248,0.2221,0.283,-0.0933,-0.0784,-0.0022,0.0645,-0.0157,0.1563,0.0182,0.2903,-0.119,0.0393,0.0146,0.0753,0.0027,0.0137,-0.0018,0.0241,-0.002,0.001,0.0727,0.0525,-0.0299,-0.0888,0.0851,0.1452,0.175,-0.1739,-0.1311,-0.1551,0.0188,-0.1577,-0.0887,0.0151,0.0005,0.0076,-0.0317,-0.1367,-0.1386,-0.0141,-0.0416,-0.0757,0.0264,0.2494,0.0505,-0.0336,0.1542,0.3023,0.1191,0.0505,0.1419,-0.0837,0.0369,0.1486,0.1644,-0.0728,0.1856,0.0992,0.0144,0.0498,0.2798,0.1087,-0.1551,-0.0705,-0.0774,-0.0887,0.0011,-0.0833,0.0163,-0.0877,-0.108,-0.039,-0.1194,-0.0433,0.0893,-0.0826,-0.1963,-0.1052,-0.1099,-0.0278,-0.0311,-0.0529,-0.0622,-0.0606,-0.0395,-0.0528,-0.1884,-0.1375,0.109,0.2001,-0.0123,-0.0095,0.0476,-0.0113,-0.0164,-0.0776,-0.0541,-0.1346,0.0394,0.0431,-0.1442,-0.1769,-0.0718,-0.0642,-0.035,-0.1099,0.0089,-0.0883,-0.017,-0.0407,-0.0847,-0.086,-0.1108,0.0053,-0.0198,-0.024,0.1294,-0.0563,0.0129,0.1163,0.0709,-0.1303,-0.0476,-0.109,-0.1232,-0.0779,-0.0467,-0.0347,0.0522,0.1019,0.1128,0.0092,-0.0294,0.0022,-0.0404,0.027,0.1343,-0.1702,-0.0967,-0.1482,0.029,0.0169,0.1053,-0.015,-0.1992,-0.1733,-0.0309,-0.0264,0.015,0.1398,0.0989,0.0201,-0.1007,-0.0908,-0.057,-0.1248,-0.2705,-0.1101,-0.0651,0.1093,0.0057,0.1473,-0.0365,0.0552,0.0378,-0.0115,0.0346,0.089,0.1264,-0.0021,-0.0476,0.0002,-0.0685,-0.0173,-0.0209,0.0004,-0.0404,-0.0034,-0.0066,-0.0229,-0.0766,-0.0429,-0.066,-0.053,-0.1325,-0.0113,0.021,0.0267,-0.0428,0.0422,0.0203,0.0649,-0.022,-0.024,-0.005,-0.0688,-0.2038,-0.0747,0.1533,0.1465,0.0127,-0.0569,-0.0982,-0.0644,-0.0412,-0.0257,-0.0231,0.0757,0.0563,-0.0969,-0.156,0.008,-0.1359,-0.0519,-0.0298,0.3917,0.1928,-0.2233,0.0764,-0.0548,0.0007,-0.045,-0.1613,-0.1438,-0.1388,0.0477,0.0163,-0.0757,-0.0429,-0.0941,-0.0143,0.1324,-0.0145,0.071,0.0284,-0.0214,0.0372,-0.1512,-0.0303,0.0355,-0.0833,0.052,-0.1238,0.0926,-0.164,0.2042,0.0655,0.0933,-0.187,-0.1538,0.06,0.1784,0.0311,0.1645,0.0079,0.1048,0.0797,0.0534,0.1205,0.0737,0.0497,0.0409,0.0745,0.01,0.0262,-0.0881,0.2003,0.2996,0.4564,0.2462,0.1627,0.3463,0.1717,0.2385,0.2541,0.1537,0.1946,0.1072,0.2318,0.2141,0.1899,0.177,0.1707,0.2746,0.2014,0.2538,0.1594,0.2257,-0.1896,-0.0621,-0.1192,-0.1612,-0.0894,-0.1958,-0.1917,-0.0648,0.0203,-0.0598,-0.227,-0.2037,-0.1403,-0.0269,-0.0093,-0.1382,0.0833,-0.0094,-0.0728,0.0364,-0.07,-0.087,-0.0574,-0.0591,-0.1433,0.0577,-0.1822,-0.1947,0.0965,-0.0149,-0.0962,0.0495,0.0577,-0.118,0.1255,0.1364,-0.1614,0.1279,0.1755,0.0532,0.0276,0.0771,-0.056,0.2501,0.253,0.0216,-0.0217,0.0511,-0.0143,0.0512,-0.0912,-0.0646,0.0817,0.028,-0.0461,0.0827,0.0522,0.0047,-0.0525,spatial attention
trm_4a3fd79d0ab7c,0.0885,0.1046,0.1216,0.0809,-0.0033,0.0232,0.1002,0.0388,0.0443,0.0576,-0.0062,-0.0083,0.1229,0.0907,0.0968,0.0333,0.0801,0.0836,0.0657,0.0167,0.0418,-0.039,0.0479,-0.0489,0.0251,-0.0229,-0.0197,0.1336,0.159,0.0756,0.1187,0.0755,0.1294,0.0743,0.1693,0.131,0.04,0.0496,0.1147,0.0001,0.112,0.1242,0.0719,-0.0847,0.0734,0.0942,-0.1991,0.0415,-0.0664,0.0931,0.0499,-0.0488,-0.0316,-0.098,0.0546,0.0575,0.1202,0.0197,-0.0536,0.0216,0.0045,-0.0635,0.137,-0.0949,-0.0437,-0.0816,0.1865,0.2066,0.0875,0.0449,-0.1114,-0.0239,-0.161,0.084,0.0948,-0.0215,0.1616,-0.0814,-0.0738,0.0949,0.0143,-0.1201,0.0636,0.0932,-0.0756,-0.0471,-0.0157,0.0237,-0.0013,0.315,0.1165,0.1102,0.0044,-0.195,-0.1806,-0.1291,-0.1521,-0.0213,-0.2169,-0.0883,-0.0635,-0.0495,-0.1111,-0.081,-0.1288,0.1221,0.1975,-0.165,0.0461,0.0459,-0.0495,0.0738,-0.13,-0.1993,-0.0435,-0.0106,0.0648,-0.0236,0.0041,0.0634,0.0745,0.1558,0.1032,0.0321,0.0681,0.1508,0.0526,-0.085,-0.1101,0.0278,0.1219,0.0686,0.0438,0.3183,-0.0066,0.1813,-0.008,0.135,0.057,0.0322,0.0835,0.1041,-0.0314,0.0323,0.0006,-0.1111,0.0652,-0.0682,0.0662,-0.0997,0.0634,0.0776,0.1681,0.1336,-0.1804,0.0188,-0.0964,-0.0373,-0.0481,0.0579,0.0663,0.0852,0.1877,0.2063,0.0344,0.0011,0.0079,0.224,0.2085,0.0141,0.0678,0.0909,-0.059,0.2805,0.1879,0.2456,0.1828,0.1447,0.1133,0.0644,0.2096,-0.0642,0.0738,-0.0384,0.1131,0.0661,0.1464,0.1433,0.0734,0.0483,0.033,0.0492,0.0538,0.16,0.1407,0.2226,0.1629,0.0707,0.0024,0.1124,0.0477,-0.2354,0.2017,0.1747,-0.1492,0.1748,0.2392,-0.0107,-0.0062,-0.0432,0.1805,0.0754,0.0626,-0.0013,-0.0734,-0.0244,-0.0834,0.1501,0.1436,-0.0569,-0.1303,0.1168,0.1766,0.0861,-0.0953,-0.0293,0.0524,-0.0749,0.0491,-0.3035,0.0985,0.184,-0.1924,0.1337,0.1266,-0.023,0.0653,-0.0781,-0.0467,0.1169,-0.0386,0.1936,0.0505,0.0271,0.0486,0.0885,0.0657,0.1234,0.094,0.0629,-0.0119,-0.0269,0.0405,-0.0692,-0.009,0.2059,-0.0067,0.0764,-0.1424,-0.2461,-0.0797,-0.3545,0.0767,-0.1589,-0.2472,-0.4317,-0.2152,-0.0243,-0.0074,0.04,0.0179,0.0632,0.1718,0.0196,0.1481,0.0439,0.2215,0.2654,0.2068,0.0456,0.0279,0.115,0.084,0.2849,0.206,0.101,-0.0413,-0.0485,0.1274,0.1725,0.0726,0.1055,0.0534,0.0396,0.1166,-0.0522,0.0085,-0.1124,0.0114,-0.1907,-0.0588,0.1284,0.1144,0.1247,-0.0024,-0.021,0.1361,0.0709,0.0758,0.002,-0.0168,0.0048,0.0399,-0.1596,-0.1204,0.0267,-0.2167,-0.0096,-0.1134,0.1131,-0.0033,-0.0321,0.1448,0.1856,0.0928,0.0467,-0.0248,0.0473,0.0706,0.112,-0.0599,0.0669,-0.0292,-0.0241,-0.0771,-0.1488,-0.048,-0.0466,0.0383,0.1208,0.104,-0.0295,-0.0238,0.018,-0.1036,-0.0543,0.256,0.1922,0.1629,0.1232,0.1377,-0.0842,0.0885,0.0504,0.0656,0.0774,0.0226,0.1592,0.1028,0.1188,-0.0083,0.0159,0.0376,0.0346,0.0549,-0.0725,0.1496,-0.3515,-0.0119,0.1335,-0.0187,-0.1038,0.0039,-0.1103,0.1219,0.0551,0.0779,-0.112,-0.1125,-0.1291,-0.1266,-0.0596,-0.0302,-0.1598,-0.044,-0.0995,0.1158,0.0402,-0.0926,0.0335,0.0415,0.0335,0.0365,0.0139,-0.1462,-0.0596,0.1019,0.1756,0.1109,0.0693,0.0551,-0.0041,0.0069,0.0299,-0.0545,-0.1242,-0.0642,-0.0609,0.1151,0.0429,0.0215,0.1771,0.0267,-0.2569,0.1516,0.0426,-0.2746,-0.1009,-0.0059,-0.0105,-0.0094,0.224,0.122,0.3221,0.2735,0.0968,0.2005,0.0843,0.1163,0.0779,0.0382,-0.0061,0.0602,0.0248,-0.0012,-0.0991,0.0078,0.0152,0.2679,0.1367,-0.0098,-0.0472,-0.0069,-0.0433,0.0669,0.1117,-0.0215,-0.12,0.0917,-0.0494,-0.1435,-0.1011,0.1081,0.0563,-0.0673,0.1526,0.0191,0.0272,-0.0172,-0.0246,-0.1,0.0503,0.091,-0.0504,0.1359,0.104,-0.065,-0.4401,0.1213,0.0738,-0.0288,-0.009,-0.1034,0.0801,0.1577,0.0209,0.002,-0.0526,0.0438,0.0059,-0.0751,-0.02,0.013,-0.0816,-0.1414,-0.1578,0.0198,-0.043,0.0471,0.0284,-0.0422,-0.096,0.0956,0.1611,-0.1147,-0.0216,0.2105,0.0291,-0.0528,0.0307,0.0173,-0.0628,0.039,0.1084,0.0844,0.1466,-0.0049,0.0368,0.0259,-0.1382,0.1635,-0.048,0.0759,-0.0256,-0.1314,-0.1112,0.0959,0.0776,-0.0892,0.0879,0.1008,0.091,-0.1306,-0.1883,-0.1889,-0.0525,-0.1761,-0.1095,-0.0062,-0.0874,0.1064,0.0639,0.1109,0.2335,0.1301,-0.0012,0.1517,0.0949,0.0417,0.1706,0.0389,-0.0243,-0.0198,0.0447,0.0907,0.0638,-0.0572,-0.0221,0.0037,0.0418,-0.0675,0.0234,0.0294,0.0521,0.0205,0.1629,-0.0978,-0.0693,-0.0509,0.0684,0.0599,-0.0411,0.1189,-0.0382,0.1092,0.0151,-0.1154,0.1024,0.0155,0.094,0.0932,0.01,0.1357,0.0153,0.0095,0.0405,-0.0218,-0.0181,-0.0723,-0.1053,0.0005,0.0724,-0.0037,0.0288,-0.1756,-0.0664,-0.1464,-0.087,-0.0796,0.0429,0.1456,-0.076,-0.1773,-0.1367,0.0177,0.008,0.2008,0.0547,-0.1435,0.062,-0.0095,-0.0517,-0.1042,-0.0295,-0.0893,-0.0111,0.0566,0.1441,0.1335,-0.1519,0.1986,0.0387,-0.1055,0.008,0.2475,0.0545,0.0568,-0.024,-0.0301,0.2205,0.0459,0.2153,-0.0413,-0.0395,0.084,-0.0436,0.0742,0.1712,0.0606,-0.0565,-0.094,-0.0823,0.0781,-0.0365,-0.1187,-0.0627,-0.1132,0.045,0.073,0.0554,0.0807,-0.0883,0.0197,0.0598,0.0827,0.0732,0.2649,0.1547,-0.1698,0.2292,-0.0879,0.1969,-0.2456,0.141,0.0332,0.1211,-0.04,0.0596,0.0544,0.0969,0.1728,-0.0171,-0.1812,0.0366,-0.0351,-0.1363,0.1044,0.1394,0.0634,-0.0354,0.0575,0.1011,0.0931,0.0692,0.0378,0.0686,-0.1637,0.0985,-0.0346,0.0523,-0.0847,-0.0847,-0.1073,-0.0238,-0.0994,0.1606,0.1018,-0.0652,-0.0711,-0.0079,-0.1412,-0.2667,-0.2008,-0.1374,-0.1021,0.0107,-0.0511,0.0709,0.062,-0.0379,-0.0604,-0.0458,0.0475,0.1463,0.0945,0.0718,0.1576,0.1223,0.1312,-0.0506,-0.1434,-0.1089,-0.0803,-0.0079,-0.0937,0.0178,0.0169,0.0306,0.1168,-0.0192,-0.0689,0.0915,0.306,0.2973,0.2337,-0.0154,0.0241,0.0852,-0.0325,0.0446,-0.0474,0.0534,0.0487,-0.1617,-0.1294,-0.0013,0.1263,-0.1224,-0.1853,-0.3135,0.1933,0.0238,0.0704,-0.0132,-0.0512,0.1299,-0.1285,-0.0326,0.024,0.0033,-0.0106,-0.0248,0.1735,0.2504,0.2112,0.1564,-0.0468,-0.2403,-0.0157,0.1562,0.0679,-0.0085,-0.0945,-0.0353,-0.0775,-0.0379,0.1315,0.0842,0.0585,-0.1357,-0.1127,-0.1407,0.1114,0.0077,-0.0068,0.0628,-0.0823,0.1049,0.1434,0.0029,0.1706,0.1515,0.0686,-0.0897,-0.1379,-0.0454,0.0245,0.0255,-0.051,-0.189,0.0241,0.1252,-0.0683,0.0192,0.003,-0.0158,-0.1373,0.0829,-0.183,0.161,0.174,-0.1656,-0.1401,-0.2052,0.026,0.0603,-0.0617,-0.0104,-0.0444,-0.2419,-0.0423,-0.0806,-0.0921,-0.161,-0.0405,-0.0182,-0.1659,-0.1808,0.1445,0.0033,-0.0401,0.1922,0.1643,-0.0051,0.1429,0.0499,0.203,0.0537,0.1704,0.1089,0.2318,-0.0439,-0.0078,-0.0601,0.0673,0.0358,-0.0757,-0.0516,-0.1247,-0.0554,-0.0853,-0.1894,0.0038,-0.0806,-0.0434,-0.0291,-0.1577,-0.1655,0.1418,-0.1365,-0.0486,0.0494,0.0652,0.1303,0.0532,-0.1671,-0.1218,0.3038,0.1839,0.041,-0.0669,-0.1711,-0.0707,-0.0457,-0.0034,0.0059,-0.044,0.0353,-0.1787,0.0229,-0.0777,0.2117,-0.0643,0.0239,-0.1515,-0.2465,-0.0667,-0.2425,0.251,0.2349,0.0535,-0.2615,0.0502,0.0698,0.0964,-0.0933,-0.0371,0.0968,0.0118,0.1505,-0.0525,0.066,-0.0042,-0.0944,0.0036,-0.0897,0.1697,0.0896,0.0258,-0.0431,0.1346,-0.0304,-0.1141,-0.112,-0.1539,-0.3142,-0.155,0.1004,0.0646,0.0548,0.0195,0.0923,0.0362,-0.0353,-0.1731,-0.0755,0.0084,0.1152,-0.1555,-0.2314,-0.0766,0.0343,0.0046,0.0591,0.1751,0.0931,0.0892,0.0143,-0.0565,0.1421,0.0624,-0.0664,-0.0055,0.1001,0.0524,-0.061,0.1072,0.0454,0.0758,0.1392,0.1353,0.3269,0.181,0.3363,0.0257,0.0863,0.1168,0.1935,0.1685,0.2373,0.1633,0.3013,0.1782,0.1831,0.0168,-0.0774,-0.1436,0.0402,-0.0928,-0.0237,-0.0254,-0.0857,-0.1659,-0.1549,-0.0971,0.0719,0.0143,-0.0553,0.0523,-0.0725,-0.11,-0.102,0.0262,-0.0416,0.0687,-0.1013,0.0926,0.0624,0.0105,-0.1133,0.0387,-0.114,0.2006,0.0317,0.0408,0.0949,0.0677,-0.0435,-0.1077,-0.0473,-0.1047,-0.1514,-0.0933,-0.121,-0.0877,0.0009,0.0253,-0.0763,0.0171,0.0232,0.0626,0.1219,0.0596,-0.1245,-0.1022,0.1325,0.1047,0.0774,0.2225,0.113,-0.1806,-0.0791,-0.1748,-0.0743,-0.0755,0.0785,0.0352,-0.0737,-0.0028,0.0777,0.0447,-0.0045,0.0734,0.1146,0.0338,-0.142,0.0975,0.028,0.1012,-0.0595,0.1477,-0.0327,-0.1005,-0.2135,-0.2127,-0.128,-0.0834,-0.1116,-0.0108,0.0057,0.0378,0.0775,0.0162,-0.0101,-0.0407,-0.0055,0.0259,-0.0773,-0.0128,0.0561,0.0276,0.1706,0.1946,0.1939,0.1352,-0.1898,-0.0308,-0.0737,0.1652,-0.2207,-0.1115,0.0372,0.0385,-0.0449,-0.0147,0.0188,-0.0747,0.0924,0.0878,0.0414,0.0225,0.1304,0.0472,0.1247,0.0474,0.111,0.0655,0.0788,0.0736,0.0094,0.0598,0.0522,-0.0214,-0.017,0.1075,-0.0363,0.1013,-0.0673,0.0599,0.091,-0.38,-0.2657,-0.3372,-0.235,-0.2711,-0.0682,-0.3109,-0.1714,0.1455,-0.1667,-0.1898,-0.1084,-0.0973,-0.1057,0.0993,0.0229,0.0986,0.0106,-0.0356,-0.0081,-0.0673,-0.0308,0.1399,0.0228,0.0022,0.0125,-0.0808,-0.002,0.1109,-0.0822,-0.0299,0.061,0.0073,0.0633,-0.0915,-0.0303,-0.2027,-0.0068,0.1647,0.1629,0.1041,0.043,-0.1591,-0.0926,0.0587,0.1193,0.2627,0.1669,0.0811,-0.1982,0.0578,-0.2672,-0.2403,0.0813,0.025,0.0687,-0.0338,-0.1115,-0.0363,-0.1965,-0.0876,-0.0893,-0.1027,-0.0946,0.0866,0.1523,-0.0276,0.1043,-0.0586,0.0111,0.1107,0.0413,0.1136,0.0693,-0.015,0.0593,0.1318,0.0231,-0.1288,0.0545,-0.0204,-0.0103,-0.1543,-0.0036,-0.0238,0.1499,0.1563,0.0902,0.1036,0.1067,0.1626,0.0368,0.0559,0.0031,-0.1813,-0.1162,-0.0706,-0.2868,0.0422,0.0257,0.0061,-0.1526,0.0236,-0.3016,0.1271,-0.2908,-0.4038,-0.1294,0.1719,-0.3779,-0.3215,-0.0043,0.209,0.0041,0.1522,0.0731,0.2358,0.0464,-0.1219,0.05,0.1003,-0.0073,0.0682,0.0617,0.097,0.1054,0.0596,0.0713,-0.045,-0.089,0.0253,-0.2769,-0.1828,-0.2179,-0.2278,0.0927,-0.0469,0.0043,0.0556,0.0024,0.0691,-0.0194,-0.1689,0.1498,0.0496,-0.1029,0.0141,-0.0402,-0.1031,-0.0531,-0.0137,0.0238,-0.0973,0.0004,0.0433,0.0309,-0.083,-0.0749,-0.0115,0.013,0.013,0.1757,-0.1474,-0.0458,-0.0852,0.0486,-0.0973,0.0481,-0.1908,0.2584,0.238,-0.0781,0.058,0.1995,0.2077,0.1968,0.0155,0.0922,0.0566,-0.0179,0.027,-0.1748,0.1177,0.0228,0.0985,-0.0915,0.0199,-0.0138,-0.0326,0.0846,0.0659,-0.0174,0.1048,0.0445,0.0404,0.1523,-0.0073,0.014,-0.0801,-0.0138,-0.0947,-0.0432,-0.1522,0.1765,0.095,-0.0458,0.1204,0.0404,0.1644,0.2384,0.0053,0.0733,0.1762,0.036,0.0502,0.1904,0.0054,0.0846,-0.0383,0.2839,0.1299,0.0918,0.1787,0.0461,-0.0853,0.07,-0.2694,-0.0826,-0.0894,-0.1011,0.0822,-0.0158,0.0903,0.2625,0.257,-0.0355,0.0949,0.0372,0.0575,0.0678,-0.0383,-0.0604,-0.0038,0.1545,0.0834,0.0034,0.0282,0.0374,0.0046,0.076,-0.0637,0.07,0.1463,0.0957,0.2021,0.0806,0.0704,0.121,0.1332,-0.0223,-0.0248,0.0165,-0.0687,-0.0053,0.1132,0.0766,-0.0288,0.1687,-0.0354,0.025,0.0241,0.1399,0.1675,-0.0129,-0.1456,0.0012,-0.0113,-0.0148,0.0498,-0.1907,-0.0221,-0.0049,0.0299,0.2144,-0.0976,0.0141,-0.0399,-0.1221,-0.1091,-0.0227,0.1145,0.0081,-0.1737,0.0774,-0.0009,0.1141,0.0295,0.1185,0.1018,0.0001,-0.1623,0.0414,0.0571,0.1393,0.0228,0.017,-0.0003,0.0753,0.1435,-0.0248,-0.0314,0.0674,-0.1018,0.0639,0.0374,0.0423,0.0094,0.0189,0.0135,0.0562,0.0363,0.0218,0.0275,-0.0907,0.0473,-0.0,0.006,-0.0473,0.0101,0.0298,0.1882,-0.0595,0.0981,0.0288,-0.0173,-0.066,-0.1104,-0.0879,-0.0816,0.0998,0.0658,0.0848,0.0463,0.2251,-0.0137,0.1814,0.0214,0.083,0.0737,0.0642,0.1505,0.1318,-0.1421,-0.0257,0.0006,-0.2582,-0.1465,-0.0717,-0.0722,-0.1412,0.0015,0.0464,-0.0529,-0.2212,-0.0519,-0.0418,-0.0343,0.0586,0.0158,0.0962,-0.0417,-0.0323,0.0045,-0.0156,-0.0744,0.0522,0.053,0.0564,-0.0498,-0.1233,-0.0792,0.2844,0.1235,0.073,0.2407,0.1925,-0.0613,-0.106,-0.0142,-0.0392,0.0702,-0.001,0.1645,-0.0071,0.0293,0.0787,0.2566,0.0854,0.0177,0.1472,0.0647,-0.1366,0.055,0.039,0.0694,-0.0252,-0.1309,-0.3092,0.0221,-0.0881,-0.0062,0.0085,0.1156,0.067,-0.0255,0.0022,0.0155,-0.133,-0.1229,-0.0498,0.0642,0.0998,-0.0645,-0.5063,-0.5063,0.1948,0.136,-0.0939,0.096,0.1163,0.0421,0.186,-0.0504,0.0473,0.0939,-0.0236,-0.0169,-0.2222,0.0114,-0.1967,-0.0482,-0.0355,-0.1502,-0.4662,0.0699,0.0627,-0.3046,-0.0107,-0.0947,-0.0302,-0.0262,0.0806,-0.2008,-0.1414,-0.0283,0.038,-0.0261,0.001,-0.1133,-0.0878,0.0347,0.0728,0.0617,-0.0753,0.0996,-0.0509,-0.1604,0.083,0.055,-0.0171,0.0111,0.1446,0.0116,-0.0616,0.0568,0.0607,0.1969,-0.024,-0.0746,0.0136,0.0379,-0.0286,-0.0152,-0.0115,-0.1329,-0.0899,-0.1161,-0.022,-0.2115,-0.107,-0.0457,-0.41,0.109,0.1027,-0.1672,0.2443,-0.0533,-0.04,-0.0763,0.0552,-0.0392,-0.0183,0.0436,-0.0407,-0.115,-0.0026,-0.017,-0.0274,-0.0765,-0.0569,-0.0856,-0.2776,-0.2964,0.0871,0.146,0.1072,0.0161,-0.0012,0.0059,0.0431,-0.0235,-0.0245,-0.03,-0.1016,0.0642,0.3046,0.0901,0.0096,-0.1569,0.0299,-0.0156,-0.0654,-0.2058,-0.1542,0.0833,0.0043,0.0676,-0.0244,-0.0531,-0.0789,0.2505,0.2602,0.3202,-0.0251,0.0167,-0.0386,-0.3192,0.1157,0.0662,-0.0021,-0.2345,-0.1443,-0.2396,0.0543,0.0078,0.0544,-0.0024,-0.1396,-0.2168,-0.2447,0.0027,-0.0766,-0.0846,-0.0717,0.1032,-0.1338,0.2319,-0.0033,0.0223,0.11,-0.0041,-0.0272,0.0217,0.0602,0.0276,-0.0426,-0.0402,-0.0214,0.1028,-0.0,0.0246,0.0303,0.0559,-0.112,-0.2472,-0.1848,-0.2884,0.2016,0.1165,0.1727,0.0697,-0.1391,-0.0335,0.1222,0.1095,0.147,0.0489,-0.1683,-0.0515,-0.2005,-0.1055,-0.0608,-0.0128,0.0211,-0.0248,-0.0326,0.011,0.2119,0.0017,0.0951,-0.0089,0.1165,-0.0311,-0.0881,-0.2938,-0.1931,-0.1043,-0.1063,0.133,0.2686,0.1618,0.2057,0.1659,-0.0561,0.0512,-0.0354,0.123,0.1848,0.1401,0.0837,0.063,0.0195,0.0414,0.0295,0.0105,0.0578,0.1708,0.138,0.0578,-0.1309,-0.0452,0.0042,0.3025,0.046,0.1372,0.121,0.4086,-0.0608,0.0615,0.1023,0.0467,0.0209,0.0105,0.031,0.1135,0.1108,0.1846,-0.2171,-0.0446,-0.2243,-0.0733,-0.0996,0.0441,-0.1154,-0.1404,-0.3141,0.1081,0.0393,0.0563,-0.1591,0.2545,0.317,0.2349,0.083,0.0248,0.1391,0.1134,0.0808,0.1129,0.0095,-0.051,-0.0612,0.2334,-0.0206,0.0037,0.0515,0.1052,0.0378,0.081,0.1586,-0.0986,0.011,-0.1682,0.0667,0.167,0.2559,0.1452,0.1557,0.0969,0.3073,0.2372,-0.0471,-0.0425,-0.0339,0.0072,0.0453,-0.0205,-0.1095,-0.204,-0.1441,0.2809,0.3082,0.0299,-0.0943,0.0452,0.0852,-0.0863,0.0981,-0.0053,0.045,0.0725,0.1201,0.0198,0.0847,0.017,-0.0706,0.0655,-0.0147,0.0259,-0.1155,-0.1167,-0.1243,0.0947,0.1735,0.2577,0.1556,0.1233,0.2472,0.1322,-0.2621,0.0184,0.0564,-0.0443,-0.0175,0.0965,-0.0566,-0.0003,-0.0192,-0.2021,0.0114,-0.094,-0.0377,0.0752,-0.0064,0.0102,-0.1205,-0.2472,0.2533,-0.0302,-0.05,-0.2991,0.1138,0.0567,-0.0306,0.0905,-0.0488,-0.0357,-0.0468,0.0338,0.0302,0.1219,0.217,0.2438,0.0498,0.0488,-0.022,-0.0928,-0.1418,0.0704,0.077,-0.0592,-0.2113,-0.0805,-0.0855,-0.065,-0.0462,-0.0532,0.3126,0.1741,0.1418,0.1752,0.0967,0.178,0.1594,0.1051,-0.0004,0.0917,0.193,0.1511,-0.0323,0.1048,0.3216,-0.0863,0.077,0.0232,-0.0649,0.1265,0.0121,0.1234,0.0934,0.005,0.1021,0.0113,-0.0619,0.1491,-0.0468,-0.1201,-0.119,0.0417,0.1384,-0.0761,0.0329,0.2029,0.0519,0.1321,0.1173,-0.1235,-0.0374,-0.0336,0.1247,0.1382,0.034,-0.0297,0.1223,0.1402,0.1406,0.0545,-0.0,0.0726,-0.0905,0.1319,0.047,-0.0603,-0.0098,0.0483,-0.0597,-0.0064,0.1638,-0.0506,-0.0151,0.089,-0.2588,-0.3591,-0.325,0.0768,-0.3982,-0.2139,0.1557,0.0806,-0.3573,-0.165,-0.0602,-0.1253,-0.103,-0.059,0.0376,0.03,0.0798,0.0957,-0.4782,-0.3862,-0.2714,-0.0619,-0.2188,-0.2091,-0.4108,-0.3992,-0.3325,-0.0062,0.0199,0.0343,-0.0108,0.0531,0.0206,0.1699,0.0959,0.009,0.0155,0.0928,0.0794,-0.1316,0.0012,-0.0048,0.0871,-0.0552,-0.2189,-0.3117,0.0646,0.0788,0.1395,0.008,0.0204,0.0005,0.0099,0.0903,0.0039,0.0721,0.1574,0.213,0.1889,-0.0328,0.0778,-0.0115,-0.2335,-0.073,-0.2412,-0.0878,-0.1362,-0.2417,0.0457,0.121,0.1314,0.0561,-0.1134,0.0815,-0.157,-0.0948,-0.1299,0.0008,0.1652,0.1607,0.1247,0.1082,-0.052,0.2544,0.1511,-0.0321,0.0347,-0.13,0.013,0.0496,-0.1266,-0.0549,0.0892,-0.0116,0.118,0.1902,0.2328,-0.0382,-0.0236,0.0696,-0.0809,0.0234,-0.0771,-0.4082,-0.3771,-0.1572,-0.2658,0.1222,-0.0716,-0.1167,-0.2314,-0.2529,-0.3584,-0.0655,-0.089,0.0126,-0.1925,-0.201,-0.0457,-0.0413,0.1149,0.0788,0.109,0.0154,0.0323,-0.0295,-0.061,0.0125,-0.0661,-0.0149,-0.1359,0.1457,-0.0762,-0.0415,0.1501,0.1628,0.0828,0.1101,0.1304,-0.1084,0.0181,0.1155,0.0327,-0.1954,0.0063,0.2622,0.0065,0.064,0.1767,0.0103,0.0317,0.0125,-0.1204,-0.0542,-0.3664,-0.232,-0.2947,-0.023,-0.0257,-0.1295,0.1025,0.1257,-0.0105,-0.0239,0.035,0.015,0.1098,0.0955,0.147,0.2219,0.2376,0.2293,0.1002,0.0892,0.1753,-0.0267,0.0439,-0.0324,0.0101,0.0645,0.0837,0.1289,-0.1306,-0.0004,0.0606,0.1211,-0.0538,0.0451,0.19,-0.0671,0.1509,0.0828,-0.2469,0.2111,0.2136,0.0426,-0.0382,-0.0259,-0.0396,0.0296,0.0391,0.009,-0.0034,-0.0349,0.2345,-0.0685,-0.0158,-0.1542,-0.0322,0.3039,0.063,-0.0285,0.0738,0.0265,0.0117,0.141,0.0325,0.0073,0.0156,-0.0816,0.3414,0.1586,0.1654,0.2629,0.1505,0.1121,0.1303,0.1303,0.0662,0.0573,-0.1015,0.2271,0.0688,0.1522,0.1524,0.0783,0.0859,0.3631,-0.1374,0.2194,-0.0537,0.0614,-0.3363,0.0844,0.0761,0.1541,0.0805,0.0073,-0.017,0.0507,-0.2489,-0.0132,-0.1011,-0.2488,-0.226,-0.0167,-0.0117,0.0128,0.0289,0.0165,0.0974,0.1299,0.0461,0.0795,-0.0017,-0.0396,-0.0538,-0.0409,0.026,0.0584,-0.0485,-0.0942,0.0494,-0.1078,0.0334,0.0385,-0.0218,0.0863,-0.0225,-0.0014,-0.1806,0.0801,-0.118,-0.0905,0.0169,-0.1971,-0.2206,0.0681,-0.1363,-0.0189,-0.2502,-0.0956,0.0178,-0.1071,0.1267,-0.0619,-0.133,-0.0789,0.0675,0.0216,-0.0467,0.0371,-0.0247,0.161,0.2554,0.1118,0.1264,0.0311,0.0758,0.1624,-0.241,-0.0324,-0.0478,-0.0464,-0.0148,0.025,-0.0405,0.0673,0.073,0.0391,-0.1021,-0.1696,-0.0379,-0.0749,0.1215,-0.0663,-0.1364,-0.0489,-0.1522,-0.0739,0.0068,0.0913,-0.0321,0.1111,0.0819,0.0859,0.0062,0.0714,0.0906,0.0705,0.0894,0.0184,-0.061,0.0923,-0.0488,0.0559,0.0085,-0.078,-0.1253,-0.1211,-0.0642,0.0277,0.0771,0.0679,0.0459,-0.0533,-0.0968,0.0783,0.0434,0.047,-0.0094,0.1373,0.1388,0.1057,0.1426,0.1348,0.0426,0.0126,-0.0619,0.1276,0.1482,0.1338,0.0686,0.0548,0.0126,-0.0481,0.0401,-0.197,0.1645,0.1326,0.0648,-0.0486,0.061,0.0866,-0.1068,-0.0378,0.194,-0.0687,0.0154,0.0608,-0.0702,-0.0689,-0.0296,-0.0942,0.0351,0.2104,0.0598,0.2076,0.2369,0.0042,0.0818,-0.0717,-0.0634,-0.1873,-0.179,-0.1638,0.1298,0.1643,0.0181,-0.1597,-0.176,-0.0209,0.0695,0.0103,-0.0425,0.1048,-0.0864,0.1477,0.1604,-0.0155,-0.015,0.0916,0.0885,-0.1295,-0.0513,-0.0194,-0.143,0.0162,-0.0096,0.0906,0.0502,0.0499,-0.0064,0.1004,0.0147,-0.1238,-0.0588,0.0486,0.0692,0.0556,0.0798,0.0259,0.0529,0.2815,0.0699,0.0799,0.0181,0.009,-0.0228,-0.0038,-0.0482,0.0938,-0.0708,0.1953,0.1243,0.148,0.135,0.0041,0.1787,0.1209,0.283,0.1194,0.0905,-0.1689,0.1304,-0.0079,0.058,-0.0683,-0.1377,-0.1431,0.103,0.1806,0.0607,0.0502,-0.0045,-0.1549,0.0598,0.0905,0.0878,-0.1011,-0.0744,-0.0469,-0.1335,0.0085,0.0416,-0.1064,0.0523,-0.0555,-0.0233,0.035,0.1012,0.0417,-0.0514,-0.1011,-0.0313,-0.0289,-0.0905,-0.0185,-0.0217,0.0303,0.1883,0.1441,0.0287,-0.1356,-0.2085,-0.0562,0.0558,-0.0159,-0.0049,-0.3264,-0.2104,-0.1552,-0.2185,0.1995,0.0137,0.0472,-0.0319,0.0902,-0.0807,-0.0406,0.0144,-0.029,-0.0589,-0.0532,0.0644,-0.0898,-0.0847,0.1583,-0.2281,-0.0711,-0.0317,-0.0307,-0.0453,-0.0476,-0.0026,0.071,-0.0529,-0.081,-0.1491,-0.246,-0.283,0.0981,-0.03,-0.0237,0.032,0.1879,0.3544,0.3292,0.0218,-0.0958,-0.0779,0.0861,-0.0638,-0.0583,0.0625,0.0944,0.1255,-0.0725,0.1248,0.0277,-0.0427,-0.0686,0.0465,0.0794,0.0092,0.1243,0.0236,0.0276,0.1683,-0.0251,0.1517,0.0147,0.0392,0.0683,-0.0295,-0.1547,-0.0224,0.0264,0.08,-0.2918,0.0923,-0.1717,-0.2247,-0.1899,0.0211,-0.0211,0.139,-0.2672,-0.2343,0.1929,0.0887,0.0426,0.0312,0.0969,0.1108,0.2502,0.2394,0.1079,-0.008,0.1109,-0.0424,0.035,0.0301,0.1444,0.1979,-0.0563,-0.0226,0.1583,0.1223,0.01,0.0906,0.2194,-0.1051,-0.1955,0.1335,-0.0838,-0.1196,-0.0845,0.1776,0.1909,0.1606,0.2409,0.1015,0.0449,-0.0088,-0.0938,-0.047,-0.1405,-0.0211,-0.2565,-0.3002,-0.2471,-0.1276,-0.2001,0.326,0.2732,0.1607,0.08,0.0435,0.0805,0.1497,0.0585,-0.0348,0.1223,0.1458,0.0654,-0.1546,0.1311,0.0934,0.0995,0.0449,-0.0718,-0.116,0.0815,0.1594,0.0705,0.1936,-0.0398,-0.15,-0.1521,-0.0423,-0.0056,-0.07,-0.1446,-0.0811,-0.1272,-0.0015,0.1011,-0.0219,0.0663,-0.0073,0.0041,-0.0499,-0.1838,-0.0977,-0.0783,-0.036,0.0719,-0.0091,0.185,0.1692,0.0947,0.1325,-0.4195,-0.0056,-0.2271,-0.1563,-0.1001,0.0317,0.029,-0.1941,0.0322,-0.3257,-0.2415,-0.0036,-0.1258,-0.0608,-0.0157,0.0853,0.0792,0.125,0.0015,-0.1702,-0.0718,0.1105,0.0718,0.0028,-0.0318,-0.0359,0.0171,0.1072,0.1095,0.0159,0.2132,0.0622,0.0579,-0.0512,-0.0844,-0.0991,-0.0844,0.0213,0.0787,0.0535,0.0607,-0.1199,-0.1541,0.085,-0.031,0.0468,-0.0445,0.0485,0.0586,-0.0305,-0.156,-0.0811,0.0406,0.1491,0.0852,0.1322,0.1003,-0.0676,-0.078,0.0792,0.0241,0.0753,0.1208,0.289,0.2074,0.183,0.178,0.12,0.1351,0.1047,-0.1716,0.2136,0.2048,0.1828,0.0567,0.1353,0.2917,0.0884,-0.0058,-0.1821,-0.0589,0.1884,-0.3853,-0.3488,-0.1998,-0.0015,-0.0567,0.066,0.2708,0.0362,0.1168,-0.0207,-0.1511,-0.2062,-0.0105,-0.0415,-0.0442,-0.121,0.2516,0.1297,0.0739,0.0843,0.2881,0.2111,0.1871,0.2003,-0.0696,0.1537,0.1317,-0.2221,0.1692,0.2367,-0.0073,-0.1645,-0.1414,0.0917,0.1144,0.4123,0.2731,0.1227,0.3458,-0.1206,0.1119,0.0915,-0.0931,0.2072,0.0558,0.1283,0.0395,-0.1015,-0.0765,-0.2402,-0.2179,-0.2358,-0.0172,-0.0413,-0.1942,-0.0448,-0.149,-0.1039,-0.0483,-0.1913,-0.1279,0.167,0.2443,0.13,-0.0373,0.0407,0.0358,0.09,-0.0359,-0.0103,-0.023,-0.1796,-0.1187,0.1981,0.0337,0.1367,0.0359,0.1717,0.2554,-0.0041,0.152,0.0003,0.1168,0.0208,0.1097,0.0851,0.1829,0.1237,0.1449,0.0545,0.0454,0.0391,0.0314,0.094,-0.033,-0.0971,-0.0377,0.0332,0.0629,0.1356,0.0313,-0.1184,-0.0653,0.0917,-0.2879,-0.0078,0.0569,-0.0715,-0.0522,0.0298,0.0159,0.0243,-0.0399,0.0252,0.0345,-0.1477,-0.2604,-0.4563,0.1038,0.1116,-0.0252,0.0377,-0.0061,-0.1973,0.1204,-0.363,0.2729,-0.0833,-0.0524,-0.0991,0.0053,0.0364,-0.0066,-0.0044,0.0717,0.0476,-0.0891,-0.0294,0.0663,0.119,-0.1215,-0.236,-0.2448,0.1955,0.1649,0.1482,0.0011,0.1805,0.1403,0.0166,-0.03,-0.0066,0.0378,0.1402,0.1498,0.0107,0.0184,0.1008,-0.0075,-0.3098,-0.0224,0.0954,-0.2149,-0.4595,-0.1622,-0.0813,-0.2322,0.0951,-0.0675,-0.2486,-0.2566,0.1123,-0.2889,-0.1271,-0.1307,-0.0822,-0.3858,-0.0843,0.1599,0.1697,0.0875,0.2508,0.0294,0.1293,0.0741,0.207,0.2448,0.0804,0.2319,0.1658,-0.1107,0.1002,0.2937,0.1971,0.2136,0.0488,0.1176,0.1577,0.1654,0.1516,0.0698,0.0428,0.1931,0.1385,-0.1525,-0.2443,0.0739,0.0426,-0.1131,-0.0336,0.0885,0.0986,0.0983,0.1295,-0.0433,-0.0914,0.2319,0.3072,0.1109,0.0316,0.1138,0.1967,0.016,0.0965,0.0679,0.1769,0.102,0.0772,0.1099,0.0011,0.0456,0.0751,-0.1824,0.1021,-0.0555,-0.2277,-0.0399,0.1726,0.0364,0.2373,0.1572,0.1017,0.116,0.1435,-0.0686,-0.0805,-0.0913,0.0167,0.0611,0.0236,0.0995,-0.0256,-0.1602,0.1669,0.0886,0.1687,-0.0273,-0.0561,-0.1323,0.0323,0.2645,0.2441,-0.0073,-0.0151,-0.0227,-0.0984,-0.1363,-0.0361,0.0931,0.1139,0.0506,0.1252,0.2821,0.1009,0.0914,-0.1753,-0.0363,-0.2634,0.029,-0.1596,-0.0133,-0.0449,-0.0078,-0.097,-0.1256,-0.0686,0.0269,0.0123,0.0636,-0.0966,-0.0276,-0.0405,0.0541,0.0522,0.0008,-0.0264,0.0751,0.0423,0.0573,0.0627,0.2073,0.0285,-0.0233,-0.0743,0.0606,-0.0222,-0.0013,-0.0347,0.0577,0.038,-0.04,0.018,0.2107,0.0807,-0.2153,-0.2136,0.0193,0.0377,0.0836,0.1418,0.051,0.0441,0.0903,-0.1385,-0.0653,0.1947,0.1644,-0.0168,0.1456,0.0579,0.0322,-0.3667,-0.2573,0.2824,-0.0847,0.1018,0.0103,0.0901,0.1284,0.1834,0.1909,-0.017,-0.0053,0.1087,-0.0189,0.0989,0.0418,-0.1451,-0.0102,-0.0539,-0.0186,0.0191,0.0055,0.1488,0.0269,-0.1104,0.1493,-0.123,0.2418,-0.0921,0.1043,-0.2842,-0.1414,-0.1465,0.2459,0.2094,-0.0099,-0.1904,-0.023,-0.2057,0.05,-0.0795,-0.1525,-0.0637,-0.1372,-0.0483,-0.0438,-0.0401,-0.0776,-0.0497,-0.0985,0.1094,-0.1858,-0.2997,-0.5077,-0.2452,-0.1397,-0.3473,-0.1906,-0.1921,-0.2854,-0.2022,-0.245,-0.1401,-0.2553,-0.2774,-0.1527,-0.1785,-0.2626,-0.3107,-0.2215,-0.3335,-0.1829,-0.3074,0.184,0.0674,0.1882,0.2747,0.195,0.2342,0.219,0.0796,-0.0187,0.0746,0.2815,0.2318,0.1647,0.0554,-0.0035,0.1726,-0.0851,0.052,0.0905,-0.0146,0.1433,0.0888,0.0112,0.0626,0.1483,-0.1186,0.1899,0.2013,-0.0495,0.0114,0.0396,-0.02,-0.0239,0.1641,-0.2403,-0.2176,0.1331,-0.1454,-0.2446,-0.0442,-0.0571,-0.0281,0.0934,-0.4148,-0.4175,0.0678,0.0203,-0.0589,0.058,0.0127,0.1371,0.0346,-0.0887,0.0329,0.0676,-0.0753,-0.0125,0.0136,0.0232,perception
trm_557b4a81a4a17,-0.0096,0.0555,-0.0121,0.0264,-0.0489,-0.0256,-0.0244,0.0097,0.008,-0.0025,-0.0619,-0.0707,0.0533,-0.0491,-0.031,0.0169,0.0174,-0.0501,-0.0073,-0.0659,-0.0331,-0.0405,0.006,-0.0118,-0.0377,-0.0568,-0.0515,0.0649,0.0736,0.0016,-0.0079,-0.0294,-0.0209,-0.0002,0.0221,0.0125,-0.0243,0.0252,0.0197,0.0361,0.0223,0.0346,0.006,-0.0448,0.014,0.0199,-0.1544,0.0183,0.0271,0.1403,0.0818,0.0322,0.0079,-0.0116,0.0009,0.0381,0.0741,-0.0599,-0.0274,-0.0465,-0.0561,-0.041,0.0162,-0.054,-0.0053,0.0595,0.0073,0.0159,0.0113,0.0038,-0.0218,-0.0011,-0.0526,-0.0198,0.03,0.0264,0.1015,-0.0705,-0.0892,0.0817,-0.0461,-0.0207,-0.0373,0.0252,-0.0013,0.0261,0.0691,0.0175,-0.0122,0.5192,0.0313,0.1249,0.0213,-0.0965,-0.0792,-0.1142,-0.0517,0.002,-0.0412,0.0255,-0.0262,-0.0125,0.0074,0.0021,-0.0575,0.0222,-0.0145,-0.0069,0.0796,0.0045,-0.0091,0.0231,-0.0046,-0.0104,-0.0155,0.0187,-0.0319,0.0617,-0.0452,0.0067,-0.0229,0.0221,-0.0484,-0.0103,0.0457,-0.0154,0.0104,-0.046,-0.0355,0.1279,-0.0351,-0.0018,-0.0174,0.0021,0.0582,-0.0131,0.0111,-0.0121,-0.0114,-0.0146,0.0157,0.0292,-0.077,0.0333,-0.0487,0.0168,0.057,-0.0403,0.0477,-0.0412,0.0262,-0.0289,0.0227,-0.0081,-0.0314,0.0353,-0.0308,-0.0324,-0.0351,0.0383,0.0039,0.0578,0.0037,0.0267,0.0033,0.0175,0.0137,-0.0194,-0.0318,0.019,0.0223,-0.0206,-0.0152,-0.0495,0.0179,-0.0044,-0.0176,-0.0364,-0.018,-0.0031,0.099,-0.0137,0.0237,0.0169,0.0747,0.0703,0.0511,-0.0031,-0.0412,-0.0067,-0.0145,0.0159,-0.0346,0.0557,0.045,0.0476,0.0323,-0.0984,-0.0278,0.093,0.0547,-0.0561,-0.0523,0.0506,-0.0342,0.2043,0.0054,0.0153,-0.0244,-0.0116,-0.0425,-0.0637,0.0497,-0.0308,-0.0212,-0.0142,-0.0646,-0.0226,0.1005,-0.073,-0.0512,-0.0374,0.008,0.0158,0.0016,-0.031,0.0513,0.0083,0.0824,-0.0474,0.0132,-0.0258,-0.0821,0.0244,0.0317,0.1669,-0.0341,-0.0552,0.0732,0.0323,-0.0117,0.0317,-0.0147,-0.0125,-0.0177,-0.0085,0.0028,0.0827,0.114,-0.0389,-0.011,-0.0005,0.0404,-0.0189,0.1439,0.008,0.0547,0.0112,-0.0819,-0.1353,0.006,-0.0904,-0.0352,-0.0576,-0.0664,-0.0742,-0.0075,-0.0553,-0.0946,-0.0674,0.0422,0.0208,-0.015,-0.0749,0.3081,0.2853,0.5688,0.5442,0.4345,0.354,0.2665,-0.0528,-0.0457,-0.0527,-0.0422,0.0119,-0.0063,0.0101,-0.01,0.0173,0.0303,-0.0668,-0.021,-0.0305,0.0262,-0.0055,-0.0347,0.0289,-0.0305,0.0349,0.0017,-0.0193,0.0742,0.0591,0.0509,0.0484,0.0232,0.0614,0.1085,-0.0037,0.1108,0.0094,-0.0241,-0.0313,-0.0179,0.0643,-0.0227,-0.0752,-0.0002,0.0044,-0.0324,-0.0614,-0.022,-0.0558,-0.0123,-0.0137,0.014,0.0368,-0.0182,0.0476,0.0516,-0.0111,-0.0821,-0.0639,-0.033,0.1002,0.0172,0.012,-0.0818,-0.0223,-0.0208,-0.0848,0.0136,0.0365,-0.0717,0.0126,0.0778,0.051,0.0547,0.0657,-0.0223,-0.1248,0.0785,0.0848,0.0116,0.0468,0.0249,0.0383,0.0762,0.0109,-0.0904,0.013,0.1764,0.0101,0.0439,-0.058,0.0573,-0.0106,-0.0103,0.0446,-0.05,-0.0459,0.028,-0.0043,0.0003,0.0358,0.0485,-0.0869,-0.1139,0.0658,-0.0823,0.0055,0.0101,-0.0121,-0.0368,0.0051,-0.018,-0.041,-0.021,-0.0025,0.1058,0.0468,-0.0239,-0.0536,-0.0229,0.0248,0.0608,0.0407,0.0889,0.0588,-0.0123,-0.0185,0.0275,0.0917,-0.0145,-0.0167,-0.0979,-0.0105,0.0254,-0.0068,-0.0524,-0.0537,-0.0306,-0.1168,-0.0297,0.0651,-0.1003,-0.0309,0.002,-0.0438,-0.0334,0.0418,-0.006,0.0384,0.029,0.018,0.0756,-0.0052,-0.0122,0.0098,-0.0586,0.0081,-0.0102,0.0544,0.0099,-0.0698,0.062,0.1155,0.0447,0.008,-0.0646,-0.051,-0.0217,-0.0627,-0.0016,0.02,0.0912,0.0884,-0.0674,-0.028,-0.0235,0.0097,0.0324,0.0883,0.0125,-0.0169,0.0829,-0.0008,0.0242,-0.0351,-0.0484,0.0137,0.0311,-0.075,-0.026,0.0848,-0.0643,-0.1629,0.0758,0.1718,0.0401,0.0194,-0.0348,0.0381,0.0879,0.0232,-0.037,0.0455,0.0357,-0.0362,0.061,0.076,0.0896,-0.0574,-0.0867,-0.0532,0.0419,-0.0264,-0.0513,0.0024,-0.0066,0.1098,0.019,0.0323,-0.0185,-0.0299,0.1491,-0.0381,0.0042,-0.0006,-0.0036,0.0256,0.0833,0.0192,0.0547,-0.0216,-0.0537,-0.04,-0.0144,-0.0532,0.0532,0.0557,-0.0662,0.0297,-0.0477,-0.0149,-0.0072,-0.0161,0.084,-0.0131,0.0701,0.1084,-0.0942,-0.047,-0.0517,-0.0642,0.0709,0.0412,0.0854,-0.0428,0.0072,0.0113,0.044,-0.0228,-0.0857,0.0404,-0.0376,-0.0103,-0.0194,-0.0021,-0.0429,-0.0645,0.1161,0.0619,-0.0151,0.0092,-0.0245,-0.0275,0.0163,-0.0822,-0.029,-0.0181,-0.0138,0.106,0.0282,-0.0041,-0.0143,-0.0207,-0.0469,0.0926,-0.0494,-0.0178,-0.0642,-0.0065,0.0693,0.071,0.0363,-0.0267,0.0002,-0.0033,0.0037,-0.1095,0.141,0.0381,0.0309,0.0388,-0.0005,0.0193,0.0583,-0.005,0.0753,-0.049,-0.0138,0.0021,0.0156,-0.0729,0.0275,0.0192,0.0609,0.0198,0.0639,-0.0161,-0.0606,0.0046,0.0684,0.0385,0.035,-0.0455,-0.0115,0.0873,0.0422,0.0231,-0.047,0.0483,-0.0442,0.0023,0.0106,0.0428,0.0446,-0.0419,0.0459,0.0641,-0.0735,0.0223,0.0104,-0.0973,-0.0467,-0.0008,0.0203,0.0216,0.023,0.0328,0.0191,-0.0071,0.0449,0.0024,0.0305,-0.0109,0.0323,0.021,-0.0052,-0.0025,-0.006,-0.0397,-0.0011,-0.0177,-0.0518,0.0678,-0.0064,0.0442,0.0305,-0.0426,0.0309,0.0069,-0.0221,-0.0047,-0.072,-0.0213,-0.0335,-0.0468,-0.0394,-0.0086,-0.0357,-0.0488,-0.0208,0.0465,-0.0002,0.014,-0.0599,-0.0303,-0.0287,0.0788,-0.0544,0.0126,-0.0178,0.0083,0.0577,0.018,0.0958,-0.0266,-0.0181,-0.0457,0.0042,0.0622,-0.011,-0.0002,0.0345,-0.0285,0.014,0.0037,-0.0468,-0.0492,-0.0755,0.0908,0.1029,0.068,0.0257,-0.005,-0.0021,0.0111,-0.0134,-0.0524,-0.0281,0.0039,-0.0516,-0.0253,-0.0143,0.0624,0.0235,-0.0387,-0.0313,0.0128,0.0297,-0.001,-0.0027,0.0055,-0.0271,-0.0032,0.0127,0.0386,-0.0631,-0.048,-0.0624,-0.0031,-0.1164,-0.0207,-0.0418,0.1476,-0.0382,-0.0338,0.0387,-0.0138,-0.0314,-0.0085,-0.056,-0.0016,-0.0113,-0.0377,-0.0253,0.0044,-0.0515,0.0104,0.0535,-0.0415,-0.0743,0.0028,0.0811,-0.0763,-0.0749,-0.0522,0.0112,-0.0275,0.0036,-0.0198,-0.0701,-0.0086,-0.0578,-0.0136,0.0189,-0.0098,0.0376,-0.0994,-0.0143,-0.0079,0.0013,0.0074,-0.0368,-0.1206,-0.0282,0.0544,-0.0226,0.0578,-0.0079,-0.008,0.0095,-0.0107,-0.0744,0.0045,0.0399,0.0117,0.0593,-0.0358,0.0892,0.0076,-0.0443,0.0284,-0.0526,0.0015,0.0021,0.0522,-0.0068,0.017,0.0063,-0.0247,-0.0576,0.0143,0.0231,0.008,-0.0046,-0.064,-0.0128,0.0332,-0.1056,0.0142,0.0453,-0.0117,-0.016,0.0201,-0.0288,0.0691,0.0715,-0.045,-0.0798,-0.1192,-0.0291,-0.0022,-0.0291,0.0588,-0.065,-0.0851,-0.0019,-0.0316,-0.0717,-0.0778,-0.0203,0.0641,0.0525,-0.027,0.0603,0.0047,0.0214,0.0091,-0.0374,0.0554,0.008,-0.1155,-0.0079,-0.0435,0.0201,-0.0319,-0.0533,-0.0338,-0.0393,-0.0825,-0.028,-0.001,-0.0189,0.0694,0.0078,-0.0744,0.0184,-0.0146,0.0297,0.0041,0.0152,0.0107,-0.0534,-0.0885,0.0177,-0.0679,-0.0424,0.0622,-0.0195,-0.0253,0.0152,-0.0634,-0.0092,-0.0264,-0.0709,-0.0214,0.026,0.0487,0.0788,0.0237,0.1043,0.0787,0.0072,0.0125,-0.0384,-0.0337,-0.0689,-0.051,0.0473,0.0196,-0.0355,-0.0453,-0.0344,-0.0498,-0.0419,-0.0724,-0.0539,-0.0859,-0.0096,-0.0271,0.0249,-0.0089,-0.0189,0.0055,-0.0017,0.0908,0.1004,0.0612,-0.0091,0.0087,-0.0121,-0.0701,-0.0434,-0.0135,0.0311,0.0581,-0.0108,0.0401,-0.1079,-0.0339,-0.0291,-0.2012,-0.0454,-0.035,0.0367,-0.0215,0.0042,0.0476,-0.0021,-0.0413,-0.0592,-0.0407,-0.0144,0.0378,-0.0967,-0.042,0.0763,0.0915,0.0198,-0.0536,0.0649,0.03,0.0318,0.0134,-0.0618,-0.0209,0.0809,-0.0756,-0.0188,0.0558,-0.0458,-0.0195,-0.0308,-0.0382,-0.0472,0.0104,0.0152,-0.005,-0.0504,-0.0406,-0.0507,-0.0505,0.0492,0.0215,-0.0646,0.0429,-0.0478,-0.0026,-0.0153,-0.0323,0.0194,-0.08,-0.0389,0.0395,-0.0559,0.0921,-0.0407,-0.0358,-0.1052,-0.1721,-0.0852,0.0644,0.1044,-0.0178,-0.0141,-0.0691,-0.0757,-0.0281,-0.0071,0.1203,-0.0038,-0.0689,0.0222,0.0228,0.0312,0.0125,0.1993,-0.0239,0.0194,-0.0356,-0.0437,-0.1206,-0.109,-0.0284,0.0178,0.0458,-0.026,-0.0981,-0.1086,-0.0059,-0.0295,0.0206,0.0341,-0.0295,-0.0137,0.014,0.0088,0.0818,-0.0089,-0.0515,-0.0426,0.0471,0.029,-0.0778,-0.0015,-0.0342,-0.0718,0.007,-0.0708,-0.0107,-0.0904,-0.043,-0.0266,-0.0018,0.0132,-0.0001,0.0809,-0.0867,0.0359,0.0867,0.0142,-0.0654,0.0092,-0.0226,0.0056,-0.0403,0.0091,0.0028,-0.0258,-0.0329,-0.0251,-0.0478,-0.0302,0.0296,-0.019,-0.0056,0.0419,0.019,0.0094,0.0184,0.0909,0.0898,0.0156,0.0119,0.0146,0.0148,0.0539,-0.0301,0.0555,-0.05,-0.0056,0.017,-0.012,-0.0337,-0.0002,-0.108,-0.0414,-0.0101,-0.0032,-0.0581,-0.0065,-0.0266,0.0204,0.0365,0.0372,-0.0091,0.0831,0.01,-0.04,0.0114,-0.0799,-0.0797,0.0134,0.0326,0.0893,-0.0197,-0.0167,0.0031,-0.0053,-0.0043,0.0725,-0.0274,-0.0351,-0.0599,0.053,0.0324,-0.3109,-0.2211,-0.0841,-0.0243,-0.0333,0.0085,-0.0821,-0.0917,0.0466,-0.2238,-0.2131,-0.1683,-0.1215,-0.2133,-0.0587,-0.0202,-0.0624,-0.0006,0.0222,-0.0234,0.0008,-0.0456,-0.006,0.0254,-0.0069,0.0243,-0.0044,0.005,0.0004,-0.1109,-0.0805,-0.0201,0.0301,0.0645,0.0392,0.0714,-0.0299,0.0206,-0.0376,-0.0472,-0.0756,-0.0502,-0.0388,0.0825,0.1003,-0.0033,0.0051,0.0005,0.0137,-0.2036,0.0638,-0.1205,-0.018,0.0286,0.0333,0.1037,0.0014,-0.0397,0.0257,-0.1171,0.0098,0.0045,-0.0224,-0.0132,-0.0301,-0.0629,0.0088,-0.0042,0.0641,0.006,0.0586,0.0113,0.0184,-0.0192,-0.0562,-0.0533,0.04,-0.0116,-0.0589,-0.0559,0.0127,0.0051,0.0092,0.075,0.0558,0.0455,0.0564,0.0218,0.0294,0.1041,0.1418,-0.0517,0.0306,-0.0306,0.0637,-0.0095,0.0871,-0.0163,0.0434,0.1221,-0.0144,-0.0208,0.065,-0.0278,0.0873,-0.0241,-0.0571,-0.0014,0.1124,-0.0391,-0.0117,-0.0453,0.0892,0.0048,-0.0149,0.021,-0.0533,-0.0696,0.0238,0.0482,0.0471,0.099,0.0611,0.0717,0.0917,0.026,0.0315,-0.0219,0.02,-0.0438,0.003,-0.2529,-0.2094,-0.1642,-0.1903,-0.0746,-0.0338,0.0188,0.0131,0.0011,0.0273,0.0491,-0.1001,-0.0191,-0.0235,-0.01,-0.0006,-0.0803,-0.0554,-0.0091,0.0694,-0.0435,0.0271,-0.0225,-0.0332,0.0623,-0.0011,0.004,-0.0271,0.0028,0.0028,0.0721,-0.1068,-0.0424,-0.0461,0.0172,-0.0652,-0.0149,-0.1112,0.0744,0.0613,0.0041,0.073,0.045,0.0471,0.0704,-0.0059,-0.0051,-0.066,-0.0119,0.0306,-0.0548,0.0726,0.1669,0.0446,0.0242,0.0002,0.0833,0.0215,0.067,-0.0237,0.0057,0.0676,0.0086,-0.0506,0.4078,0.1738,-0.0376,-0.0306,0.013,0.0209,0.0193,-0.0793,-0.0324,-0.0442,-0.0467,-0.033,-0.0019,0.0366,-0.0108,0.0114,-0.0479,0.0084,0.0112,-0.0038,0.0281,0.0161,0.0522,-0.0341,0.3377,0.3162,0.0217,0.062,-0.024,-0.0166,-0.055,-0.1801,0.1111,0.1163,0.1102,0.0811,0.0632,0.0315,0.5048,0.4994,-0.0293,0.0316,0.2296,-0.0537,0.0263,-0.0307,-0.0462,-0.0248,0.0017,-0.0329,0.0494,0.1054,0.1563,0.051,0.0318,-0.081,-0.0405,0.0424,-0.1024,-0.0713,-0.0471,0.0103,0.0182,0.0342,-0.0501,-0.0522,0.0136,-0.0755,-0.0008,-0.0494,-0.0362,0.0396,0.0074,-0.0363,0.0385,0.0242,0.1107,0.0404,0.0127,0.0087,-0.0243,-0.0053,0.0393,0.0265,-0.0859,0.0861,0.0217,0.0528,0.0218,0.0017,0.0566,-0.0458,0.0034,-0.2178,-0.0182,0.0169,-0.0132,-0.1103,-0.0252,-0.0085,-0.0273,-0.0578,-0.0336,-0.0049,-0.0012,-0.0555,0.0549,-0.0517,-0.0441,0.0207,-0.0452,0.0649,0.021,0.0699,-0.0159,-0.0125,0.0402,-0.06,0.0652,0.0008,0.1031,-0.0383,-0.0005,0.0,-0.0455,0.0152,-0.0292,0.0244,0.0936,-0.0598,0.0231,-0.0136,0.0843,0.0614,-0.0127,0.0403,0.0139,0.016,0.0132,-0.0312,-0.0801,-0.0643,-0.0638,-0.016,0.0806,0.0213,-0.0586,0.0219,-0.0321,0.0231,0.0378,0.01,-0.0563,0.0357,-0.0177,-0.0116,-0.0481,0.0963,0.1241,0.1097,-0.1292,0.0172,-0.0247,-0.0238,-0.0756,-0.009,0.0273,-0.072,-0.0134,-0.0012,-0.0188,-0.0011,0.0275,-0.0001,0.0051,-0.0236,-0.0132,0.0793,0.0961,0.0118,-0.0775,-0.0247,-0.0216,0.0205,-0.0124,-0.0718,0.1054,0.0263,0.0988,0.08,0.0704,-0.0659,0.0096,0.0934,-0.0192,0.1859,-0.0462,0.0566,-0.0296,0.0701,-0.0007,0.0879,-0.0697,-0.0403,-0.0469,0.0767,-0.0642,-0.0212,-0.0241,0.0033,0.0056,-0.0355,-0.0442,0.0065,-0.0281,0.0025,-0.0272,-0.0071,-0.0282,0.0146,0.0418,0.0702,-0.0243,-0.0349,0.0305,0.0179,0.0203,0.0437,-0.1021,-0.0902,0.0444,-0.0,-0.0319,0.0415,0.0754,0.003,0.0356,0.0698,-0.0367,-0.0044,-0.014,-0.0102,0.0036,0.0305,0.0734,-0.0126,-0.006,0.0142,-0.0629,0.0254,0.002,-0.0952,0.0433,0.0004,0.0558,-0.0343,-0.0054,-0.0961,-0.1088,0.0183,0.0236,-0.0719,-0.0541,-0.0701,-0.0374,-0.0734,-0.0377,-0.0193,-0.0109,-0.0385,-0.0727,-0.119,-0.0688,-0.025,-0.0859,0.0439,0.0369,0.0033,-0.0681,-0.0049,0.1905,0.1611,0.0962,0.0824,-0.0352,-0.0523,-0.0297,-0.0574,-0.0097,-0.1068,0.0566,-0.0472,-0.078,-0.2152,-0.0257,-0.0797,-0.2908,-0.0622,-0.0648,-0.085,0.0492,0.0999,0.1539,0.1238,0.0221,0.0614,-0.0117,0.0511,0.0107,-0.0158,-0.0515,0.0362,0.0962,0.0129,-0.0433,-0.0636,-0.0575,-0.0186,0.1034,0.0399,0.026,0.0299,0.1133,0.0218,-0.0604,-0.0281,-0.0323,0.0237,-0.0422,0.0252,0.0123,0.021,-0.0466,0.0252,-0.0191,-0.0169,-0.0745,-0.1234,-0.0675,0.2136,-0.0463,-0.0135,-0.0005,-0.0603,0.0243,0.4369,0.3452,0.5195,-0.0833,-0.0693,-0.0866,-0.0222,-0.0107,-0.0991,-0.0199,-0.0007,0.0072,-0.0549,-0.0505,0.0547,0.1624,0.0229,0.0361,-0.0279,-0.12,-0.0016,0.0136,-0.0325,0.0338,-0.0056,0.026,0.0848,-0.0122,-0.0054,0.0113,-0.0315,0.0988,0.0161,0.0008,0.0045,0.0352,0.0382,0.0271,0.0981,0.0284,-0.0433,-0.0542,0.0772,0.0321,-0.003,0.0198,0.0072,0.0145,-0.0073,0.0056,-0.0165,-0.0427,-0.0454,0.0227,0.0094,0.0349,-0.0178,0.0458,0.0038,-0.0558,0.0462,-0.0654,0.0295,0.0039,-0.0522,-0.0368,0.0851,0.1355,-0.001,0.0185,-0.0187,0.0177,-0.0747,-0.0771,-0.1278,-0.1213,-0.0749,-0.0457,0.03,0.0806,0.0789,0.0505,0.0064,-0.0538,-0.001,-0.0059,-0.0104,0.0151,0.0667,0.0124,0.1094,0.0127,0.04,-0.0345,-0.0186,0.0182,0.0065,0.0848,-0.0967,0.0107,0.0606,-0.0287,-0.143,-0.0635,-0.0556,-0.019,-0.0607,-0.0188,-0.1158,0.0313,0.0584,0.0023,0.0402,-0.006,0.0307,0.1423,-0.1114,-0.1199,-0.1294,-0.0398,-0.101,-0.0848,-0.0501,-0.0307,0.0203,-0.0437,-0.0575,-0.0562,-0.055,-0.0546,-0.016,-0.019,-0.0769,-0.0159,-0.0056,-0.0113,-0.0208,-0.0026,0.0811,0.0769,-0.0558,-0.0256,0.0191,-0.0294,0.0028,-0.0097,0.1029,0.0213,0.0992,-0.0005,0.1021,-0.0246,-0.1533,0.171,0.0612,0.0241,0.0223,0.0026,0.0599,-0.0356,-0.0367,0.024,-0.0514,-0.0773,0.0111,-0.0081,-0.0696,0.1101,0.0929,0.1782,-0.002,-0.0036,0.0761,0.0272,0.0104,0.0531,-0.0302,-0.0173,-0.0158,0.0027,0.037,0.0115,0.1155,0.0262,-0.0034,-0.0145,-0.0264,0.1209,0.0134,0.0149,-0.0679,-0.0783,0.0386,0.007,-0.0549,0.0587,0.0692,0.0428,0.0287,-0.1969,-0.0201,-0.0264,0.0472,0.0376,0.0419,0.0106,-0.0017,0.0076,0.0093,0.0366,0.0218,0.0072,0.0423,-0.006,0.0513,-0.0107,-0.1253,-0.0739,0.0387,-0.0235,-0.1977,0.1059,-0.1065,-0.0088,0.1102,0.0003,0.0392,0.1061,-0.0064,0.081,0.0507,0.4376,0.401,0.2703,-0.0329,-0.0243,-0.0305,0.0374,0.1138,0.0357,-0.0456,-0.1538,-0.0888,-0.0901,-0.0226,-0.0735,-0.0336,-0.0628,-0.0109,0.022,-0.0414,-0.0952,-0.0006,-0.1094,-0.0631,-0.0201,-0.0178,0.0617,0.0098,0.0255,-0.0019,-0.0178,-0.0218,-0.0046,-0.0128,-0.0606,0.0529,0.1213,0.0427,-0.0102,-0.0073,0.0466,-0.0239,-0.0157,0.0008,-0.0802,-0.0446,0.0324,0.0398,-0.0159,-0.0543,0.0206,-0.0657,-0.0763,-0.1056,0.02,-0.0633,-0.0189,-0.0168,0.0529,-0.0086,-0.047,-0.0458,0.3235,0.0527,0.0615,0.0472,0.017,0.0306,0.0158,0.0412,-0.0308,0.0255,0.0186,0.0342,0.0348,-0.0047,0.0272,0.0115,0.0222,0.0247,-0.064,-0.0449,-0.0253,0.0045,-0.2638,-0.1991,0.0439,0.0501,-0.2967,-0.0805,-0.016,-0.1128,-0.1367,-0.0656,0.0056,0.0039,0.0205,0.0627,-0.3252,-0.2568,-0.1837,-0.0553,-0.0941,-0.143,-0.2367,-0.2366,-0.2037,-0.0686,0.0253,0.0285,0.0548,0.023,0.1414,-0.0369,0.0267,-0.0536,-0.0343,-0.035,-0.0607,-0.0128,-0.0288,0.0179,0.1317,-0.045,-0.0423,-0.0183,0.1017,0.0878,0.1216,0.0397,-0.034,-0.0432,0.0719,0.0782,-0.0215,0.062,-0.0206,-0.0344,-0.0275,0.1368,0.136,-0.0134,-0.1778,-0.0953,0.0056,-0.0525,0.0118,-0.0303,-0.0715,0.0011,-0.0057,0.1212,-0.0224,0.0443,-0.0403,-0.0883,-0.0298,0.1045,0.0556,0.0558,0.0658,0.0467,0.0681,0.0276,0.0249,0.0334,0.0263,0.0134,0.0028,0.0081,0.0708,0.0384,-0.1931,-0.1295,-0.1428,0.0532,0.0517,-0.0367,-0.0763,0.0505,0.0499,0.05,0.0197,-0.0761,-0.0809,-0.0375,-0.029,-0.0184,0.0109,-0.0254,-0.004,-0.0637,-0.0336,-0.0578,-0.0579,-0.0198,-0.0101,-0.0662,0.0247,0.0237,0.1156,0.0878,-0.0583,-0.0038,-0.0605,0.0206,0.0282,0.0074,0.009,-0.0891,-0.0415,0.1601,-0.1207,0.0018,-0.0722,0.044,0.0172,0.0283,0.0057,0.0162,-0.0217,-0.0027,-0.0113,-0.0701,0.0234,-0.0121,0.0473,0.0459,-0.0869,0.0299,0.0792,-0.0019,0.0725,0.0658,-0.1094,-0.042,-0.0243,0.0113,0.002,0.0329,0.0296,0.0151,0.0468,-0.0441,0.0856,-0.0162,0.096,0.0323,-0.1299,-0.0512,-0.0523,-0.0615,0.0189,-0.1372,0.0303,-0.0781,0.0067,-0.0041,-0.0127,0.011,0.0939,0.2986,0.1757,-0.1297,-0.0168,-0.0145,-0.1476,-0.2018,0.4826,-0.1294,-0.0219,-0.0078,-0.0319,0.4875,0.4945,0.0443,-0.0727,-0.0329,-0.0619,0.0659,0.0765,-0.0369,0.0012,-0.0159,0.0537,-0.0156,-0.0929,-0.0477,-0.0406,0.0235,-0.0142,-0.0126,0.0025,-0.0058,-0.0184,-0.0098,-0.0085,0.0782,0.0492,0.0172,-0.0127,0.0285,0.0644,-0.0364,-0.0375,0.0072,0.0103,0.0103,0.0169,0.0021,0.0452,0.0193,0.01,0.0495,0.0347,0.0543,0.0784,-0.0118,0.0284,0.0934,-0.0572,0.0854,-0.0736,0.2382,0.1175,-0.0041,0.0481,-0.0381,-0.0581,0.0412,-0.0352,0.0006,0.0343,-0.0164,0.0015,-0.006,-0.0071,0.0838,0.0804,0.0249,-0.0359,-0.0729,0.014,0.0014,0.0134,-0.0207,-0.0367,0.0638,-0.0072,0.0452,0.0102,-0.0414,-0.0129,-0.0549,-0.0724,-0.1168,-0.0248,-0.0899,-0.0471,-0.0302,-0.0717,-0.0003,0.0431,0.062,0.0811,-0.0427,-0.0165,-0.0038,0.0507,-0.0418,-0.0342,-0.0217,0.0255,-0.0572,0.0707,-0.0059,0.0145,-0.056,0.0027,-0.0203,-0.0348,0.0407,0.0004,0.1167,0.4688,0.0499,0.0538,-0.004,0.1165,0.0453,-0.189,0.0039,-0.0116,-0.0332,-0.016,0.0231,0.0131,-0.0078,0.0314,0.0134,-0.0311,-0.0261,0.0946,-0.0175,0.0104,0.035,-0.0176,0.0442,-0.0424,-0.0279,-0.0063,0.1059,0.0966,0.062,0.0711,0.2673,0.0292,0.1062,-0.026,0.0012,0.025,0.0162,0.0233,0.0654,-0.0547,0.0704,0.0056,-0.0367,-0.0557,0.0108,-0.0083,-0.0276,0.0664,0.0037,0.0014,0.003,-0.0768,0.0156,0.0202,-0.0203,0.1158,0.1116,-0.0704,-0.0424,-0.0162,0.0357,-0.0158,-0.0255,-0.0366,-0.0116,-0.0495,-0.0287,0.0239,0.0136,0.1699,0.039,0.0551,-0.1075,0.0443,-0.013,0.0124,0.0233,0.01,-0.01,-0.033,0.0404,0.1124,0.0031,-0.0267,0.0287,0.0078,-0.0249,0.0219,-0.0564,0.0157,-0.0098,0.0456,0.023,-0.0165,0.0372,0.0103,-0.0638,-0.0112,-0.0972,-0.1035,-0.0607,0.017,-0.0225,0.0118,-0.0268,-0.0001,-0.0214,0.0433,-0.0205,-0.0441,0.0038,-0.0978,0.0588,-0.0171,-0.0099,0.018,-0.0141,0.0188,-0.1654,-0.1244,-0.0466,-0.1218,-0.0441,0.0219,-0.0611,0.076,-0.0135,0.0388,0.0135,0.0209,0.0419,0.0125,0.0513,-0.0283,-0.0633,-0.0175,-0.0638,-0.0214,-0.0561,0.0344,-0.0105,-0.0373,-0.0133,0.045,-0.0031,0.0201,-0.02,-0.0178,0.0258,0.0339,-0.0055,0.0257,0.1014,-0.0212,-0.0297,-0.0106,0.009,0.0545,0.043,0.0336,-0.0643,0.0934,-0.0583,-0.0657,-0.0461,-0.033,0.0075,0.053,-0.0295,-0.0037,-0.0936,0.0548,-0.0132,0.0201,0.0025,-0.0169,0.0297,0.0009,0.0058,0.0851,-0.0154,-0.0078,-0.0595,-0.1301,-0.1118,0.0155,0.0488,-0.046,-0.0765,0.0099,0.0357,0.0028,0.0526,0.0147,-0.0232,-0.0024,0.0278,-0.0421,0.0051,-0.0549,-0.0618,-0.0393,-0.043,0.0488,-0.0513,-0.0807,-0.0204,-0.0565,-0.0124,-0.0344,0.0606,-0.1277,0.0003,-0.0171,0.0384,0.0291,0.0425,-0.0263,0.0332,-0.0072,-0.1311,-0.0057,0.0402,-0.0063,0.0061,0.0305,-0.0716,0.0297,0.0107,-0.0167,0.0262,-0.001,0.0045,-0.0108,-0.0549,-0.0435,0.0272,0.0521,-0.0904,0.0275,-0.0391,0.0025,-0.0022,-0.0229,0.0463,0.0208,0.0228,-0.0524,-0.0907,-0.027,-0.105,-0.0684,-0.0438,0.0473,0.0553,-0.0416,-0.0119,0.0506,-0.0055,-0.0306,0.0239,-0.0018,0.0942,0.001,-0.0596,-0.025,-0.0153,-0.059,0.0375,-0.0015,-0.068,0.0337,-0.0162,-0.013,-0.1035,0.0075,-0.0543,-0.0128,-0.0059,-0.0361,-0.0982,0.0487,-0.0588,-0.0249,0.0496,-0.0893,-0.0326,-0.0609,-0.0688,-0.0015,0.1996,-0.0042,0.019,-0.0437,-0.0361,-0.0141,-0.0149,0.0842,0.0589,0.0308,-0.1818,-0.2083,0.0277,0.0618,0.0381,0.0095,0.0001,-0.1157,-0.0539,0.0654,-0.0095,-0.0869,0.0278,0.058,0.0483,0.068,0.0097,0.0096,0.0121,-0.0702,-0.0068,0.0251,-0.0717,0.0075,-0.0063,-0.1178,0.011,-0.0485,-0.1682,-0.0616,-0.0602,-0.0233,0.0277,0.0239,0.0145,-0.0167,0.0355,0.0215,0.0776,0.0312,0.007,-0.0261,0.0395,0.0383,-0.0029,0.1661,0.0124,0.0605,0.0438,0.1646,0.1392,0.2115,-0.0044,-0.0121,-0.0226,-0.073,0.0635,0.0498,0.1567,0.0194,0.0762,0.0859,-0.0327,-0.0125,0.0517,0.033,-0.0161,-0.0355,-0.0174,0.0211,-0.0184,-0.029,0.023,-0.0068,0.045,0.0246,-0.0013,-0.0175,-0.2044,0.0141,-0.1509,-0.0567,0.0128,0.0101,-0.0175,0.0817,0.1728,-0.0381,-0.0126,0.077,0.0475,-0.0319,0.0547,-0.0002,0.0233,0.0741,0.0292,-0.1169,-0.0087,0.1251,0.0573,0.0476,0.0291,-0.046,0.0563,0.1103,0.0535,0.0335,0.0954,0.1946,-0.0155,-0.0117,-0.0456,0.01,-0.0261,-0.0422,-0.0134,0.1293,0.0125,0.0009,0.0276,0.0994,0.0087,0.1172,0.011,-0.0433,0.0006,0.0214,-0.1139,0.0092,0.0924,0.0363,-0.0143,0.0138,0.0514,0.0062,0.0316,0.0186,-0.0037,-0.0496,-0.0432,-0.0893,-0.0407,-0.0058,0.016,-0.0013,-0.0587,0.0262,-0.0552,0.0582,0.0314,0.0467,-0.0364,0.453,0.5477,0.0858,0.1081,-0.0664,0.0817,0.2342,-0.1025,-0.0875,-0.0221,0.0088,0.0399,-0.0371,0.3107,0.1343,0.2247,-0.0207,0.027,-0.0876,-0.0032,-0.0224,0.0034,0.0513,0.3841,0.0017,-0.0273,-0.0239,0.485,0.394,0.2733,0.3817,-0.0533,0.0408,0.0308,-0.0413,0.3403,-0.0325,-0.0338,0.0009,0.0758,0.0547,-0.0011,0.0167,-0.0191,-0.0078,-0.0019,-0.092,0.0647,0.0004,-0.0108,0.4475,0.071,0.1168,0.0522,0.0094,0.0191,0.0352,-0.0078,-0.0353,0.0851,0.0323,-0.0009,0.081,-0.0533,-0.0532,-0.0094,0.0406,0.0974,0.017,0.023,-0.0279,0.006,-0.0025,-0.0066,0.0544,0.0047,0.0412,-0.0839,-0.0188,-0.017,0.0722,-0.0113,0.0048,0.0845,0.1201,0.0131,0.0409,0.2634,-0.0423,-0.0517,0.0445,0.085,0.0743,0.0121,0.1086,-0.0804,0.0112,-0.0242,-0.0934,-0.0071,0.0054,-0.1061,-0.0176,-0.0019,-0.0214,-0.025,0.046,-0.0322,-0.06,0.0886,0.0027,0.0594,-0.0219,-0.0058,-0.0545,0.1272,-0.0779,0.0132,-0.0551,0.0054,-0.0016,-0.0536,-0.0054,0.1139,-0.0622,0.101,0.2001,-0.0236,0.3784,-0.0485,-0.0476,0.1577,-0.0564,0.4479,0.0538,0.0608,-0.0094,0.0222,0.0614,-0.0002,0.0387,0.1888,0.1577,-0.0264,-0.0144,0.0529,-0.0003,-0.0693,-0.0557,-0.0403,0.0212,0.0106,-0.0094,0.0495,0.0104,0.1831,-0.0115,0.0119,-0.0123,0.0006,0.053,0.0431,-0.0088,-0.0391,-0.0352,0.0763,-0.011,0.0742,0.0006,-0.0252,-0.1051,-0.0224,0.0028,-0.0895,0.0169,-0.0188,-0.0776,-0.0416,0.0077,-0.0328,-0.052,-0.0504,-0.0064,-0.0427,-0.0327,0.0168,0.0707,0.0975,0.2364,0.086,0.0793,0.0977,0.2271,0.3361,0.115,0.0313,0.043,-0.0886,0.0356,0.0231,0.2694,0.4945,0.062,0.0201,0.0364,-0.0081,-0.0299,-0.0376,-0.0069,0.0691,0.068,-0.0144,-0.0691,-0.0011,-0.0025,-0.0481,-0.0124,0.0187,0.0342,0.0557,0.0529,-0.1016,-0.0489,-0.0428,-0.0372,0.0241,-0.0248,0.0304,-0.0127,0.0096,-0.0193,-0.061,-0.0053,-0.0397,-0.0749,0.0164,0.0034,0.0141,0.0545,-0.0473,0.0383,-0.0181,-0.0469,0.1345,0.1068,0.0964,-0.0393,0.009,-0.0086,0.2991,0.4037,-0.0297,-0.0066,-0.0945,-0.0298,0.0047,-0.0346,-0.0312,0.0032,-0.035,0.0772,0.0298,0.0739,-0.0401,-0.0082,-0.0329,0.0868,-0.0328,-0.0651,0.0274,0.0304,-0.0475,0.0536,-0.0672,0.022,-0.0064,-0.0475,0.0095,0.0212,-0.0133,-0.0041,0.0101,0.0144,-0.0475,-0.0571,0.0238,-0.0268,0.0201,-0.0295,-0.0399,-0.0396,-0.0507,-0.0519,-0.0102,0.0296,0.0018,0.019,-0.0103,-0.0317,-0.0427,-0.0269,-0.0202,0.0051,0.0384,0.0328,-0.0177,-0.0221,-0.0403,-0.0177,0.1033,-0.067,0.0249,0.1153,-0.0214,-0.0315,-0.0064,-0.0364,0.0292,-0.0224,0.0482,0.0403,-0.0382,-0.0145,0.0183,0.0334,0.0505,0.0845,0.0299,-0.0052,0.0701,-0.0598,0.0166,-0.0025,0.0504,0.0005,-0.0223,0.0053,0.0548,-0.2407,-0.1627,-0.0307,-0.0383,0.0301,-0.0081,0.0419,-0.0255,0.0249,0.1316,-0.0151,-0.0208,0.0173,-0.0027,0.0599,0.0741,-0.001,0.0293,-0.0011,0.0109,0.0046,0.0957,0.0369,0.0077,-0.1126,0.002,-0.0509,-0.0049,0.019,0.0087,-0.2262,-0.043,-0.0545,-0.0107,-0.0113,0.03,0.1095,0.054,0.0379,0.0518,0.0184,0.0195,-0.1125,-0.0164,-0.0527,-0.0795,-0.0851,-0.0712,-0.237,-0.2388,0.0258,-0.0748,-0.1223,-0.2632,-0.0944,0.158,-0.2349,-0.1559,-0.0884,-0.1981,-0.0702,-0.1606,-0.1581,-0.1308,-0.0904,0.0306,-0.1525,-0.089,-0.1311,-0.0626,-0.081,-0.078,-0.1199,0.0295,-0.0028,-0.0413,0.3664,0.4038,0.0565,0.0494,-0.0086,0.0846,0.0643,0.0491,0.0406,0.0655,0.003,-0.0183,-0.0348,-0.0619,-0.0068,0.0224,0.0058,0.0087,0.0195,-0.0023,-0.0357,0.0395,-0.0625,0.081,0.0698,-0.0502,0.0291,0.0696,-0.0434,-0.0441,0.0423,-0.0268,-0.0364,-0.0427,0.031,-0.0908,-0.0151,0.0053,0.0808,0.0998,0.0027,0.0065,0.0051,-0.0223,-0.0022,-0.0161,0.0138,0.0297,0.0078,-0.0601,-0.0751,-0.0566,-0.0122,-0.0258,-0.0195,0.037,reward anticipation
trm_557b4b652cbec,0.1259,0.1093,0.1309,0.12,0.0048,0.0468,0.0938,0.1286,0.0586,0.1058,-0.0203,-0.0256,0.1294,0.0459,0.1193,0.0858,0.0759,0.0277,0.0918,-0.0746,0.0354,-0.0398,0.0449,-0.0812,0.0232,-0.0016,0.0017,0.0654,0.1111,0.0639,0.0776,0.009,0.0864,0.1302,0.0521,0.08,0.1216,0.095,0.133,0.0225,0.0901,0.1215,0.0684,-0.0904,0.0716,0.0272,-0.167,0.1016,-0.0067,0.0937,0.062,0.0377,-0.0227,0.0098,-0.0146,0.0569,0.1302,0.0275,-0.0096,0.032,0.0021,0.0009,0.086,-0.05,-0.0341,0.0668,0.1314,0.1354,0.0813,-0.0037,-0.0351,0.0072,-0.1588,0.0243,0.187,-0.1244,0.1319,-0.0261,-0.0464,0.0518,-0.0444,-0.0875,0.0306,0.0756,-0.0468,-0.0369,0.0296,0.0216,-0.0554,0.2074,0.0707,0.1118,-0.0186,0.0108,-0.0384,-0.0437,-0.0384,0.0472,-0.0309,0.0875,-0.0682,-0.0215,-0.0234,0.1331,-0.0057,0.1189,0.0503,-0.1625,0.0631,0.0275,-0.0158,0.0593,-0.1012,-0.0639,-0.054,-0.0768,0.0533,0.0461,0.0136,0.0702,0.0161,0.1029,0.0167,-0.0246,0.058,0.0215,-0.0004,-0.0175,-0.054,-0.0032,-0.0527,0.0664,0.0303,0.1581,-0.053,0.0921,0.0463,0.0499,-0.002,0.0563,0.0753,0.1031,-0.0894,-0.0402,0.0009,-0.0206,0.1419,-0.0425,0.0851,-0.102,0.05,0.0171,0.0845,0.049,-0.1578,0.0586,-0.0555,0.0149,-0.0572,0.0083,0.0337,0.0186,0.0985,0.1715,0.0197,-0.0198,-0.0036,0.0373,0.0301,-0.0675,0.0333,0.0345,-0.0236,0.0202,0.0801,0.0605,0.0469,0.0126,-0.007,0.0607,0.0817,-0.0697,0.041,0.0213,0.0917,0.0321,0.0816,-0.0608,-0.0687,-0.0178,-0.0229,0.0465,0.0091,0.0529,0.037,0.2533,0.2219,-0.0475,-0.0721,0.2869,0.1589,-0.0474,0.021,0.1026,-0.0274,0.0551,-0.0863,0.0587,0.1059,0.0079,0.0696,0.0072,-0.0249,-0.0122,-0.0867,-0.0618,-0.099,0.1563,0.304,-0.0036,-0.0832,0.0702,0.0773,0.0522,-0.0346,-0.0376,0.0467,-0.0996,-0.0317,-0.1866,0.1695,0.1076,-0.1154,0.1587,0.1612,0.0274,-0.0295,-0.1159,-0.0025,0.041,0.0715,0.1459,0.1097,0.0331,0.0624,0.0532,-0.0275,0.0877,0.102,-0.0375,-0.0665,-0.002,-0.0505,-0.0702,0.0116,0.047,0.0391,0.1154,-0.1278,-0.2295,-0.0534,-0.1486,0.0797,-0.0684,-0.1093,-0.2124,-0.075,0.0017,-0.0835,-0.0519,0.0723,0.1019,0.0198,-0.0493,0.1117,-0.055,0.1668,0.1465,0.1878,0.0319,-0.0275,-0.0386,-0.0415,-0.0182,-0.0406,0.0992,-0.0668,-0.1085,0.2039,0.082,0.0553,0.0858,0.049,-0.0033,0.1009,0.0297,-0.0746,-0.0673,0.0272,-0.0745,-0.065,0.0204,0.1302,0.0013,0.2029,0.2008,0.1146,0.0468,0.0986,-0.0448,0.0235,0.0065,0.1398,-0.0962,-0.0464,0.07,-0.1131,-0.0018,-0.0723,0.0816,-0.0173,-0.0458,0.0383,0.0253,0.0949,0.0496,-0.0302,0.0194,0.1047,0.1076,-0.0219,0.0904,-0.0515,-0.0345,-0.0863,-0.0129,-0.085,-0.0731,-0.0947,0.0134,0.013,-0.0537,0.1091,0.1052,-0.0667,-0.004,0.2349,0.1877,0.1678,0.0938,0.14,0.0051,0.1754,0.0872,0.0663,0.1444,0.0639,0.0509,0.1767,0.0921,0.0025,0.0115,0.0479,0.0735,0.0689,-0.0052,0.1613,-0.1144,-0.0758,0.1016,-0.0599,-0.0649,0.0162,-0.053,0.0482,0.0506,0.0206,-0.0813,-0.2483,-0.1058,-0.2529,0.114,0.0773,-0.0022,-0.0355,-0.0473,0.0276,0.0254,-0.0242,0.0537,0.1144,0.0223,0.2023,0.0007,0.0439,0.1772,0.2332,0.1619,0.1324,0.0277,0.0209,-0.0452,-0.0013,0.0042,-0.0245,-0.057,-0.0963,-0.0088,0.076,0.0484,0.0856,0.0722,-0.001,-0.244,0.0178,-0.062,-0.248,-0.0221,0.0335,0.0434,0.0182,0.2674,0.2083,0.3163,0.2802,0.1835,0.1536,0.1512,0.1275,0.2267,-0.0073,-0.0528,-0.0071,0.0475,-0.0833,-0.0986,0.0623,-0.0043,0.2336,0.1441,-0.0647,-0.0066,0.0691,-0.0666,0.0071,0.0852,-0.0267,-0.0221,-0.0313,-0.0094,0.0039,-0.037,0.0891,0.0607,0.0443,0.0172,-0.0632,0.0565,-0.0011,-0.0005,-0.0314,0.0947,0.0052,-0.1049,0.0261,0.0824,-0.0153,-0.3159,0.0898,0.0744,0.0408,0.0063,0.0473,-0.0263,-0.0318,0.0478,0.0485,0.0363,0.0093,0.0655,0.0574,0.08,0.0759,-0.0083,-0.0707,-0.1031,0.0253,0.0743,0.0049,0.0777,-0.0844,-0.0308,0.0505,0.0699,-0.0896,-0.1025,-0.0359,0.0863,-0.0705,0.0584,0.0424,-0.0713,0.053,0.1103,0.1054,0.065,-0.1123,-0.1337,0.0313,-0.048,0.1424,0.0535,-0.0469,0.0006,-0.0731,-0.0404,0.1092,0.1234,0.0316,0.1062,0.0544,0.0749,-0.1167,-0.0055,-0.1369,-0.0853,-0.0953,-0.0552,-0.0125,-0.0183,0.0948,0.0526,0.1229,0.1542,-0.0252,-0.0074,0.0867,0.1176,0.0214,0.0504,-0.0128,-0.0363,0.0114,0.0534,0.0542,0.0388,-0.012,-0.0584,-0.0294,0.0102,-0.0204,-0.0296,0.0218,0.1577,0.0386,0.0404,-0.0767,-0.0323,-0.1116,0.0661,-0.0274,-0.0674,-0.0189,0.002,-0.0022,-0.043,-0.1193,-0.1493,-0.0246,-0.0214,0.0173,-0.0985,0.1252,0.0004,0.2158,0.2455,-0.008,0.0145,-0.0725,-0.0769,-0.0147,0.0857,-0.0026,0.0454,-0.0264,-0.0422,0.1356,-0.0558,0.0094,-0.0083,0.0523,0.0566,-0.0278,-0.0798,0.1404,0.1143,0.1415,0.004,-0.0826,0.0098,-0.0792,-0.0699,-0.0368,-0.0426,0.0015,0.184,-0.0353,0.104,0.1016,-0.0654,0.1349,0.0734,-0.0807,0.0204,0.1993,0.0111,0.0498,-0.0587,-0.0512,0.1256,0.0984,0.1662,-0.0157,-0.0439,0.0428,0.023,0.1532,0.06,0.1748,0.0058,0.0038,0.0964,0.0098,0.0313,0.043,0.1067,-0.0242,0.1171,0.0241,0.0974,0.1547,0.0019,0.0738,0.1833,0.0681,0.0166,0.0467,0.0401,-0.0132,0.0499,-0.0031,0.0492,-0.0604,-0.001,-0.0101,0.1094,0.1464,0.1485,0.047,0.0894,0.0362,0.1575,-0.1268,0.1523,0.0748,-0.0439,0.2474,0.0369,0.2126,0.0929,0.1096,0.0207,0.0743,0.0814,0.056,0.0716,-0.0651,0.0323,-0.0773,0.0217,-0.0418,-0.0095,-0.1044,-0.009,-0.0683,0.0868,0.0974,-0.0814,-0.0006,0.0669,0.0003,-0.1117,-0.0565,-0.1082,-0.0643,-0.1102,-0.0499,0.0229,0.0806,0.046,0.001,-0.0231,-0.012,0.0133,0.0059,0.0653,0.0959,0.0844,0.1063,-0.0629,-0.1259,-0.0884,-0.0028,-0.1044,-0.1126,-0.0593,0.0186,-0.0754,0.0403,-0.0311,-0.0811,0.0399,0.1168,0.1339,0.0361,-0.0035,0.0161,0.0766,-0.0668,0.1482,-0.0782,0.0075,0.1119,-0.0139,-0.0348,0.0139,0.2238,-0.0953,-0.0716,-0.1765,0.0,-0.0217,0.1162,0.0143,-0.087,0.0343,-0.1337,-0.0417,-0.0086,-0.0316,0.0125,-0.0427,0.0648,0.0645,0.0593,0.0462,-0.0651,-0.2494,-0.0546,0.184,-0.0571,0.095,-0.0399,-0.0626,0.0049,0.0205,-0.0184,0.0705,0.1078,-0.0728,-0.0396,-0.0971,0.0897,0.0621,0.0121,0.0603,-0.0575,0.0156,0.0564,-0.0373,0.0382,0.0501,0.0226,-0.0478,-0.1066,-0.0352,0.0017,0.0388,0.0426,-0.131,0.0809,0.061,-0.0885,0.0009,-0.0148,0.046,-0.0766,-0.0071,-0.0848,0.0507,0.0649,-0.0811,-0.1897,-0.1824,-0.0267,-0.0286,-0.0642,0.0345,0.007,-0.0892,0.042,0.0411,-0.0991,-0.1201,-0.0492,-0.0046,-0.1002,-0.1424,0.1603,-0.0226,-0.1107,0.1079,0.038,0.0673,0.0818,-0.0838,0.1052,0.0435,0.0647,0.0386,0.0758,-0.0722,0.0116,-0.1229,0.0472,0.0665,-0.014,0.0407,-0.0433,-0.0891,-0.0671,-0.1402,-0.0401,-0.0692,0.0235,-0.014,-0.0647,-0.0818,0.0483,-0.0507,-0.0466,0.0289,0.0037,0.0532,0.0112,-0.0703,0.0422,0.1104,0.0426,0.0859,-0.0929,-0.148,-0.0521,-0.0576,0.0146,0.1271,0.0682,0.0467,0.0669,0.0855,-0.0365,0.0646,0.133,0.059,-0.0474,-0.0111,-0.054,0.001,0.0678,0.0268,0.0495,-0.1414,0.0654,0.0793,0.0642,-0.0607,0.0097,0.1104,0.0076,0.0508,-0.0329,0.0819,-0.0656,-0.036,-0.0518,-0.0598,0.1229,0.027,0.0011,-0.0743,0.0655,0.014,-0.1594,-0.0522,-0.0636,-0.3469,-0.0821,0.0173,0.0466,0.0371,0.0257,0.0426,-0.0261,-0.0599,-0.1119,0.002,-0.0224,0.1098,-0.0888,-0.1374,0.0426,0.0536,0.0505,0.0107,0.3463,0.1078,0.0779,0.0369,-0.0521,0.0792,0.0807,-0.1064,-0.0127,0.1172,0.0275,-0.0974,0.0093,-0.0259,0.042,0.0906,0.0951,0.0508,0.0514,0.0404,-0.0609,-0.0219,0.0003,0.0692,-0.0351,0.0442,-0.0616,0.0474,0.0847,0.0642,-0.0139,-0.0864,-0.0626,0.0257,-0.0387,0.0768,-0.0912,-0.0289,-0.1935,-0.2195,-0.1418,0.0188,0.0493,0.0422,0.0203,-0.1439,-0.0879,-0.0926,0.0582,-0.1293,-0.0434,-0.1289,-0.0009,0.0266,0.1024,-0.0784,0.0413,-0.084,0.0859,-0.0228,0.0158,-0.126,-0.1203,0.0198,-0.0373,0.0187,-0.0893,-0.1704,-0.1351,0.057,0.0135,0.0191,0.0604,0.0163,0.0018,0.0426,0.058,0.1101,0.0103,-0.1102,-0.1028,0.1235,0.1007,-0.0029,0.1016,-0.001,-0.1013,-0.0056,-0.0359,-0.1145,-0.1098,0.0121,-0.0618,-0.0707,0.0046,0.0072,-0.0023,-0.061,0.0546,0.1837,0.0144,-0.0574,0.0823,0.0066,0.0589,-0.0684,0.1396,0.0431,0.0724,0.09,-0.0169,-0.0621,-0.0221,0.0445,-0.0065,-0.0305,-0.0104,0.0138,0.0057,0.025,0.0208,0.0672,0.0654,0.0213,0.0337,0.0326,0.1255,0.0443,0.1436,0.0345,0.0698,-0.1131,0.0002,-0.028,0.0942,-0.1502,-0.1142,0.0102,-0.0313,-0.0705,-0.1351,0.0039,-0.0336,0.0586,0.0414,-0.0159,0.0603,0.0238,-0.0352,0.0381,-0.0629,-0.1192,0.0379,0.0089,0.0334,-0.053,0.1973,-0.0004,0.0119,0.0111,0.0988,0.0607,0.0065,-0.0804,0.0348,-0.0037,-0.3802,-0.2374,-0.1366,-0.0288,-0.0505,-0.0135,-0.1113,-0.1504,0.0397,-0.4013,-0.3577,-0.282,-0.209,-0.363,-0.1254,-0.0962,-0.1042,-0.0836,-0.1089,-0.0473,0.0082,-0.0342,0.0651,0.0074,-0.0184,-0.0808,-0.0261,-0.0106,0.0196,-0.1952,-0.1567,0.0014,-0.0051,0.0227,-0.0638,0.0124,-0.093,0.0076,0.0937,0.0115,-0.073,-0.0769,-0.1673,-0.1475,0.1892,0.103,0.1292,0.0688,0.0793,-0.3566,0.0935,-0.1015,-0.0771,-0.0093,-0.018,0.1428,0.1557,0.0893,0.1201,-0.1525,-0.0756,0.0208,-0.0276,-0.016,0.0901,0.0826,-0.0121,0.0014,0.0587,-0.0251,0.0909,0.0949,0.0553,0.0461,0.0465,0.0081,0.373,0.1664,-0.1971,-0.0322,-0.0084,-0.0161,-0.1433,-0.0005,0.0274,0.0475,0.0518,-0.0215,0.0794,0.1757,0.1334,-0.0003,0.0365,-0.0219,-0.0374,0.0016,0.0286,-0.0627,0.0483,-0.0131,-0.0291,-0.1069,0.1251,-0.0575,0.0274,-0.0966,-0.1457,-0.0019,0.0019,-0.1161,-0.1047,-0.0133,0.0539,0.0034,0.0986,0.0336,0.16,-0.0012,0.0875,0.0868,0.0932,0.0208,0.0902,0.0219,0.0917,0.0617,0.0603,0.013,0.0969,-0.0304,0.0588,-0.4624,-0.3469,-0.2912,-0.4005,0.0474,0.0441,0.0549,0.0282,0.0613,0.0161,0.2017,-0.1566,0.0121,-0.0241,-0.0801,0.0382,-0.0312,-0.0698,-0.0749,0.0506,0.0083,0.0359,-0.0154,-0.0189,-0.0063,-0.1025,0.0137,-0.0309,0.0909,0.0909,0.0531,-0.0686,0.0181,-0.0323,0.0836,-0.1179,0.0439,-0.0702,0.1731,0.1319,-0.12,0.0427,0.145,0.1315,0.1682,0.0956,0.1397,-0.0186,-0.0081,0.0521,0.0091,-0.023,-0.1439,0.0846,-0.1209,0.0577,-0.033,-0.0136,0.088,-0.0122,0.0185,-0.0122,-0.0246,-0.0359,0.0901,-0.0326,-0.0797,0.1348,0.0953,0.0619,-0.0034,-0.0109,-0.0244,-0.0184,-0.0212,0.0288,0.0363,0.0963,0.3011,0.0469,0.0115,0.1089,0.1192,0.0866,0.1094,0.0388,0.2129,-0.0133,0.1618,0.0295,0.1044,0.3201,0.0076,0.009,0.0269,-0.2438,-0.01,0.0825,0.0064,0.0885,0.0222,0.048,0.152,0.1467,-0.0413,0.0344,-0.023,-0.0263,0.0296,-0.055,-0.0501,-0.0487,0.0094,-0.0034,0.0381,-0.0313,0.0976,0.0853,-0.0514,-0.0363,0.0101,0.0599,-0.084,-0.0235,0.0521,0.0371,0.0728,0.0822,-0.0355,-0.0334,0.0111,0.0566,0.0532,0.0842,0.0719,0.0069,0.1215,-0.0093,-0.0197,0.1232,0.2346,0.0571,-0.0699,-0.0524,-0.0986,0.021,-0.0457,-0.0176,-0.2668,-0.0462,0.0497,0.0775,0.0785,-0.0781,0.0406,-0.0864,0.1378,-0.2073,-0.0109,0.1944,0.0999,-0.0367,0.0674,-0.0216,0.0144,-0.0286,0.0321,-0.0334,-0.0747,-0.0394,0.0292,0.0222,0.0056,-0.0423,-0.0972,0.002,-0.0524,0.1522,-0.0012,0.0017,0.14,-0.0566,0.0304,0.0776,-0.0042,0.0178,0.0446,0.0506,-0.0062,0.0385,0.0153,-0.0033,-0.046,0.0418,0.0106,0.0184,0.0304,0.055,-0.0218,0.0818,-0.0198,0.1981,0.1432,-0.0254,-0.0871,-0.0991,-0.0132,-0.0473,0.0928,-0.0089,0.0337,0.0756,0.0733,0.0214,0.2438,0.052,0.0452,0.0865,0.0096,0.0321,-0.021,-0.0729,-0.0561,0.0149,-0.353,0.0883,-0.0917,0.0362,-0.2589,0.0106,0.0275,-0.1146,-0.2045,0.038,0.0209,0.1118,0.1835,0.079,0.0155,-0.0765,0.0631,0.1762,0.0318,-0.0584,0.0773,0.0347,0.0064,0.052,-0.0589,-0.1065,0.3807,0.222,0.1279,0.3664,0.321,-0.1332,-0.0426,-0.012,-0.0335,-0.0027,-0.0471,0.1047,-0.0115,0.0385,0.1241,0.3033,-0.0282,-0.0323,-0.0165,0.1292,-0.1323,-0.0076,-0.0156,-0.0468,-0.0213,-0.0913,-0.087,0.0046,-0.1202,0.0431,0.0204,0.1343,-0.017,-0.0167,0.005,-0.0328,-0.1094,0.0061,0.0183,0.0287,0.0978,0.0138,-0.2326,-0.2316,0.0777,0.1002,0.0395,0.059,0.0708,-0.0115,0.1475,-0.0359,-0.0033,0.0059,0.0616,0.0121,-0.0338,-0.0026,-0.0163,-0.0949,0.046,0.0308,-0.2254,0.2782,0.0104,-0.2025,-0.0049,-0.0252,-0.0867,-0.0794,0.0334,-0.206,-0.1597,0.1273,0.1113,-0.102,-0.0817,-0.2174,-0.1401,-0.102,-0.0349,-0.0171,-0.0751,0.0659,-0.0198,-0.2052,-0.0753,-0.1062,-0.0074,0.0329,0.1335,-0.0082,-0.0528,0.0681,-0.0861,0.0111,-0.1183,-0.1247,0.0239,-0.0137,-0.019,-0.0806,-0.0332,-0.1411,-0.0304,-0.0922,-0.136,-0.1753,-0.0012,-0.0391,-0.437,0.037,0.0237,-0.029,0.0005,0.0123,-0.0274,-0.0123,0.0515,-0.0058,-0.0167,0.0162,-0.0195,-0.002,-0.0296,0.0372,-0.0065,-0.0456,-0.0851,-0.0629,-0.2304,-0.2189,0.1037,0.1564,0.0459,-0.0229,-0.0858,-0.0636,-0.1288,-0.0508,-0.0925,0.0288,-0.007,0.2666,0.1564,0.0498,-0.0165,-0.1033,0.0396,0.0073,-0.0242,-0.2161,-0.1486,-0.0507,-0.0242,0.0093,-0.0192,-0.0453,-0.085,0.1256,0.118,0.1727,-0.0506,-0.0149,-0.0462,-0.1083,-0.0348,-0.0647,-0.1428,0.0689,0.0053,0.0045,-0.0328,0.0297,0.0378,0.035,-0.0304,-0.0706,-0.1688,0.053,-0.0859,-0.1463,0.0343,0.0508,0.0075,0.1235,0.0322,0.0127,0.0817,0.0287,-0.0832,0.1582,0.1895,0.0125,0.1513,0.1469,0.0886,0.1014,0.0562,0.0496,0.0525,0.1201,0.0005,-0.1086,0.0035,-0.067,0.089,0.0567,0.0523,0.0494,-0.0816,0.0156,0.0779,-0.0063,0.1312,-0.0285,-0.1535,-0.086,-0.0399,-0.0889,-0.0259,0.0543,0.0848,-0.0334,0.0518,0.0675,0.2152,0.07,0.0275,0.0317,0.0063,-0.0503,-0.0375,-0.3049,-0.2836,-0.1503,-0.076,0.1841,0.1455,0.0517,0.1467,0.0708,-0.0475,0.0583,0.0485,-0.0192,0.0772,0.1409,0.0641,-0.1067,-0.0764,0.0851,0.0642,0.0057,0.0466,0.1368,0.1108,0.0238,-0.0359,-0.0019,0.0273,0.0426,0.0671,0.0641,0.0451,0.0962,-0.0023,-0.1194,0.1337,0.0804,0.0819,0.0538,0.021,0.081,0.0813,-0.0853,-0.2171,-0.1688,-0.0451,-0.1294,-0.0934,-0.0488,-0.0636,-0.0347,-0.066,0.1119,0.0201,-0.0166,-0.0391,0.0263,0.0171,-0.0089,0.1189,0.0252,0.0469,-0.0102,0.0727,0.0302,0.0498,-0.036,-0.0362,0.1065,-0.0487,0.0146,0.0798,0.1447,0.0952,-0.0383,0.1893,0.0005,-0.0276,-0.183,0.0287,-0.0972,0.1207,0.0687,0.0108,0.1286,0.032,-0.0051,-0.0092,0.0032,-0.0233,0.0444,0.064,-0.022,-0.0408,-0.1127,-0.0605,0.1417,0.1355,0.1092,0.0055,0.005,0.1501,-0.0181,0.0793,-0.0825,0.0776,0.053,0.0575,0.0521,0.0933,0.0504,-0.0326,0.0739,0.0687,0.059,0.0604,-0.0218,-0.0432,0.1111,0.0233,0.0495,0.1114,0.0202,0.0941,0.0053,-0.255,0.0321,0.0639,0.2433,0.1347,0.258,0.2253,0.1952,0.173,-0.0396,0.1155,0.0556,0.0528,0.3145,0.145,0.2475,0.1416,-0.0964,0.0494,0.0848,0.0031,-0.236,-0.0361,-0.0835,-0.0281,-0.023,-0.0052,0.0835,0.012,-0.015,-0.0513,0.3127,0.177,0.1927,0.132,0.0341,-0.1284,-0.134,-0.2024,-0.0864,-0.0748,-0.1166,-0.146,-0.0486,-0.0894,-0.0352,-0.0593,-0.0549,0.0843,0.0395,0.0879,0.0076,-0.0564,0.0226,0.0402,0.0356,-0.0445,-0.0032,0.3019,0.2523,0.0912,0.1127,0.1113,0.0319,0.1565,0.0886,-0.0303,0.0708,0.0434,0.1346,0.0225,-0.053,0.0478,0.0065,-0.0433,0.1536,-0.0348,-0.0198,-0.0561,0.0528,0.0584,-0.1308,-0.0673,-0.0443,-0.1121,-0.0131,-0.0159,-0.088,-0.024,-0.0346,0.328,0.0865,0.0412,0.0428,0.0346,0.0477,0.0866,0.0321,0.0149,0.0621,-0.0915,0.0785,0.0533,-0.0492,-0.0675,-0.031,-0.0604,-0.0215,0.3602,0.0665,0.1062,0.0753,-0.123,-0.1488,-0.1568,0.0643,-0.3877,-0.2814,0.1863,0.0574,-0.4127,-0.0158,-0.0736,-0.1094,-0.1894,-0.0519,0.0561,0.0545,0.012,0.0955,-0.513,-0.3917,-0.3218,-0.1084,-0.1847,-0.2516,-0.4157,-0.4198,-0.3614,-0.0768,0.0336,0.0639,0.0364,0.0665,0.0686,0.0395,0.0314,-0.0014,-0.0432,0.0415,0.0463,-0.1368,0.0376,0.0431,0.0906,-0.0532,-0.0828,-0.1387,0.1918,0.1258,0.2799,0.001,0.0183,0.0382,0.0237,0.0605,-0.0193,0.0692,0.0652,0.0972,0.0912,0.0859,0.1569,0.046,-0.2087,-0.0683,-0.0904,-0.0407,-0.1421,-0.2561,0.0329,0.1013,0.0896,0.1749,-0.0847,-0.0156,-0.1349,-0.0282,-0.037,0.1113,0.1598,0.17,0.0984,0.0907,0.111,0.4283,0.363,-0.0211,-0.0102,-0.1786,0.0909,-0.036,-0.0725,0.0082,-0.1036,-0.0892,-0.0596,0.0859,0.1416,0.0242,-0.0073,0.0565,0.0554,0.1065,-0.0575,-0.0684,-0.066,-0.0499,-0.1147,-0.003,0.059,-0.083,0.0224,-0.0081,-0.1322,-0.0973,-0.0274,0.0047,-0.0327,-0.1198,0.0614,0.0635,0.1383,0.1258,0.0272,0.0055,-0.0256,0.0809,0.039,-0.0277,-0.039,-0.037,-0.0302,0.105,-0.1474,-0.1342,-0.0192,0.1109,0.0614,0.1079,0.0798,-0.0678,0.066,0.0333,0.0309,-0.054,0.0873,0.1036,0.0583,0.0639,-0.0593,-0.0151,0.0325,-0.0805,-0.1114,-0.1023,-0.3192,-0.0254,-0.0558,0.0579,0.0665,0.0093,0.121,0.1427,0.1051,-0.0298,0.1073,0.1143,0.0573,0.0822,-0.035,0.0123,0.0664,0.0421,0.0369,0.0475,0.0798,-0.014,0.1097,0.1058,0.0505,0.0853,0.1372,0.0996,-0.1064,-0.0926,0.0566,0.125,-0.196,-0.1651,0.1628,-0.1288,0.1576,0.1109,0.0466,0.1569,0.1587,0.0422,-0.0247,0.0052,-0.0043,0.1096,0.0521,-0.0197,-0.0062,-0.0655,0.1038,-0.0365,-0.0316,-0.0408,-0.0677,0.0509,0.0117,-0.0027,0.0014,0.0367,0.0209,0.027,-0.0141,0.0097,0.0233,-0.0177,0.1271,0.0601,0.1269,0.0809,0.0816,0.0793,0.0851,0.0851,-0.0077,0.0565,0.0311,0.1412,0.0312,0.1484,0.1108,-0.0352,-0.0524,0.1255,-0.1074,0.2843,-0.0586,-0.0868,-0.0676,-0.0354,-0.045,0.0465,0.0774,0.0014,-0.0433,-0.0029,-0.0605,0.055,0.1135,0.0016,-0.0328,0.0154,-0.0241,0.1733,0.1363,0.0031,0.0338,0.0085,0.0352,0.0637,0.0154,0.0067,0.0208,-0.0046,0.0144,0.0125,0.0345,-0.1249,-0.0087,-0.1028,-0.0504,0.0099,0.0011,0.04,0.0065,0.0749,-0.0023,0.0145,0.1601,0.1538,0.1154,0.0447,-0.0168,0.056,-0.1582,-0.0473,-0.3165,-0.1331,0.0167,-0.0154,0.1865,0.0019,-0.0822,-0.0747,0.1124,-0.0292,-0.0408,-0.0174,-0.0191,0.306,0.1469,0.2799,0.2639,0.1785,0.1557,0.2822,-0.2219,0.0466,-0.1156,-0.1698,0.0551,-0.0168,-0.0668,0.0366,0.0465,0.0383,-0.038,-0.1183,-0.0193,-0.044,0.0676,0.0303,-0.1415,-0.1341,-0.1051,-0.0532,0.003,0.0913,0.0347,0.1355,0.0041,0.0986,0.0153,0.0278,0.0377,0.0225,0.0967,0.0679,-0.0248,0.0849,0.0058,0.0826,-0.0975,-0.0377,-0.0816,-0.0584,-0.0081,0.0247,0.0962,0.1038,0.056,0.0079,-0.0337,0.025,0.0268,-0.0279,-0.05,0.007,0.0157,0.02,0.1308,0.0833,0.0088,0.034,-0.0107,0.0331,0.0457,0.0505,0.0725,0.0599,0.0216,-0.0214,0.2432,-0.1333,0.0388,0.0454,0.051,-0.0706,0.0943,-0.0589,-0.0346,0.0399,0.182,-0.0706,0.0151,0.078,-0.0038,-0.0765,0.0644,-0.058,0.1077,0.0765,0.1362,0.1297,0.1838,0.0691,0.0532,0.0344,0.0402,-0.0632,-0.0633,-0.0728,0.1312,0.0718,-0.1329,-0.1994,-0.2868,-0.0642,0.1052,-0.0784,0.0235,0.0556,-0.1019,0.0184,0.0257,0.04,0.0685,0.0635,0.0875,-0.3118,-0.1179,-0.074,-0.2335,-0.0678,-0.1116,-0.0545,0.0689,0.1261,0.0707,0.1115,0.0139,-0.0096,0.0155,0.0209,0.0708,0.0277,0.0469,-0.0221,-0.019,0.0681,0.0123,0.0097,0.0242,-0.0515,-0.0132,-0.0187,-0.0444,0.017,-0.0672,0.1374,0.0804,0.0694,0.0847,0.0393,0.0913,0.0619,0.1548,0.0874,0.2077,0.0347,0.083,-0.0135,0.0924,-0.0312,-0.1217,-0.1351,0.0664,0.0823,-0.0072,0.015,-0.0841,-0.1172,0.1036,0.0094,0.053,-0.0318,-0.034,-0.0358,-0.1082,-0.0117,0.038,-0.0569,-0.0022,-0.0742,-0.1251,-0.0907,0.0577,0.1037,-0.0425,-0.0762,0.0233,-0.1312,-0.133,0.1102,-0.0341,-0.0248,0.0839,0.1131,-0.004,-0.0497,-0.1935,-0.0658,-0.0706,-0.0594,0.0219,-0.1587,-0.1503,-0.107,-0.1134,0.0291,-0.0151,0.0661,-0.0311,-0.0055,-0.0095,0.145,0.1161,-0.048,0.0184,-0.0625,0.028,-0.0585,-0.007,0.1249,-0.0739,-0.088,0.0198,-0.0715,-0.0396,-0.103,-0.0334,0.0243,0.0201,0.0885,0.047,-0.1444,-0.1484,0.0399,0.0149,-0.0993,0.0504,0.1522,0.232,0.2055,-0.0108,-0.0294,0.0614,0.0353,-0.0352,-0.1687,-0.0544,-0.0535,-0.014,-0.069,0.0429,0.0505,-0.0278,-0.0294,-0.004,0.0642,0.0216,0.0853,0.0437,0.1426,-0.0371,-0.0022,0.0815,0.05,0.0088,0.0657,-0.0403,-0.0938,-0.0087,0.1779,0.0709,-0.1713,0.0361,-0.0433,-0.0809,-0.0444,0.0148,-0.0628,0.2801,-0.0595,-0.0592,0.0248,0.0397,0.058,-0.0365,-0.0368,0.1066,0.2137,0.1324,0.0641,-0.009,-0.0994,-0.0429,-0.0215,0.0762,0.1119,0.1536,-0.1758,-0.1751,0.0234,0.0213,0.0831,0.0751,0.1257,-0.2552,-0.1211,0.0678,0.0033,-0.1264,-0.0826,0.3735,0.3864,0.0868,0.1877,0.0644,0.0897,0.0298,0.002,-0.0223,-0.1093,0.0426,-0.0659,-0.3896,-0.1408,-0.1352,-0.3139,0.1424,0.0645,0.0547,-0.1694,-0.0318,-0.0422,-0.0286,-0.0822,-0.076,0.3142,0.2719,0.0083,-0.2509,0.0529,0.2604,0.2011,0.1772,-0.0452,-0.1318,0.171,-0.0311,-0.0121,-0.0116,0.0102,-0.0456,-0.0226,-0.0555,-0.0337,0.1073,0.0227,0.1101,0.002,-0.0062,0.0394,0.0239,0.0938,0.0429,0.0237,0.0106,-0.0904,-0.0929,0.0207,-0.0036,0.0242,-0.0198,0.1267,0.1101,0.0433,0.1202,-0.3525,-0.0284,-0.2397,-0.0608,-0.0004,0.0162,0.0038,-0.1091,0.1067,-0.1336,-0.0787,-0.0499,-0.0357,-0.0277,-0.0178,0.0951,0.0412,0.2782,0.0888,-0.1654,-0.1217,0.1738,0.0378,0.0302,0.0344,0.0215,0.0137,0.0672,0.0791,0.0319,0.3664,-0.0148,0.0113,-0.103,-0.0725,0.0048,-0.0226,-0.018,-0.0181,0.1479,0.0734,-0.0142,-0.0708,0.0771,0.0517,0.1098,-0.0106,0.0097,0.0061,0.0732,-0.1482,-0.0206,0.0876,0.2533,0.1054,0.0779,0.1075,0.0166,0.2167,0.032,-0.0054,0.0623,0.0619,-0.0355,-0.0175,-0.0134,0.0227,-0.0063,-0.048,0.0697,-0.0933,0.3797,0.3267,0.3427,0.017,0.1097,0.1547,0.0749,-0.0444,-0.1586,-0.0351,0.1763,-0.1791,-0.1818,-0.0874,0.0596,-0.0172,0.0074,0.0643,-0.0019,0.021,-0.1093,-0.1255,-0.2096,-0.0248,-0.0631,-0.0704,-0.0302,0.1436,-0.0077,-0.0183,-0.0031,0.1283,0.1098,0.1184,0.0934,0.041,0.1682,0.2386,-0.0247,-0.0033,0.1213,-0.0564,-0.0853,-0.0464,0.0353,0.105,0.2367,0.1814,0.0834,0.1877,-0.0995,0.0219,-0.0131,-0.0809,0.0946,0.2284,0.3419,0.0873,-0.174,-0.0676,-0.0899,-0.0946,-0.0723,0.0746,0.0627,-0.0427,-0.0935,-0.1067,-0.0276,-0.0301,-0.1574,-0.0662,0.1587,0.1541,0.0408,0.0953,0.0967,-0.0478,0.1842,-0.0481,-0.0717,-0.0556,-0.0486,-0.037,0.0864,0.0103,0.0649,-0.0351,0.0968,0.2099,0.0192,-0.0491,0.0554,-0.0188,0.0772,0.2215,0.1148,0.1241,0.1313,0.0696,0.1019,-0.0235,-0.0852,0.0222,0.0609,-0.061,-0.035,0.0278,0.0268,0.0088,0.1042,0.0768,-0.1296,-0.0189,0.08,-0.1153,-0.0363,-0.0611,-0.1067,-0.0034,-0.0112,-0.09,-0.0449,0.0155,0.0225,-0.0389,-0.1598,-0.1873,-0.2222,0.0168,-0.0542,0.0194,0.0192,0.073,-0.0525,0.1249,-0.0866,0.0683,0.2471,0.2553,-0.1058,-0.006,0.0203,0.0182,-0.0157,0.1808,0.1773,-0.0165,-0.0521,0.0024,0.0571,-0.0165,-0.0862,-0.0684,0.1128,0.0898,0.0775,0.0081,0.1248,0.0197,-0.0527,-0.0333,0.0132,0.0189,0.0558,0.0593,0.1769,-0.0623,0.072,0.17,-0.1304,0.0262,0.0406,-0.0832,-0.1826,-0.0074,-0.0427,-0.1162,0.0855,-0.014,-0.1596,-0.059,0.067,-0.1655,-0.054,-0.0317,-0.0709,-0.1195,-0.0289,0.1081,0.1001,0.0994,-0.0825,-0.2011,0.0224,-0.0876,0.0546,0.0138,0.0553,-0.0385,-0.0782,-0.185,-0.0115,0.0334,-0.0481,0.1587,0.0894,0.0045,0.0414,0.0273,0.0149,0.0625,-0.0076,0.0676,0.0294,-0.1452,-0.2407,0.0314,0.0733,-0.1138,-0.0671,0.0573,0.0364,0.1411,0.2455,-0.1185,-0.0956,0.0014,0.0086,0.061,-0.0003,0.036,-0.0195,0.0656,0.0719,0.0037,0.0455,0.033,-0.0243,0.1649,0.1108,0.0961,0.08,-0.0542,0.1242,0.0327,-0.1065,0.1064,0.0691,0.1059,-0.0051,0.0941,0.043,0.1589,0.1476,-0.0944,-0.066,-0.1351,0.0715,0.0943,0.1117,-0.0204,-0.0143,-0.0058,0.1584,0.0293,0.0774,-0.0409,-0.0332,-0.0524,0.1573,0.1051,0.0629,0.0912,0.0929,-0.0192,0.0221,-0.128,-0.0109,0.0238,0.0175,0.0784,0.0648,0.1726,0.093,0.0704,0.0271,0.0351,-0.0615,0.0552,-0.0536,-0.0131,-0.0185,-0.0091,-0.0799,-0.1356,-0.1019,-0.0144,-0.0196,0.1017,-0.005,0.0135,-0.0302,0.0557,0.0308,-0.0329,-0.0303,0.0684,0.0666,0.034,0.0013,0.0336,0.0467,0.0481,-0.1752,0.1079,-0.0992,-0.0206,-0.0493,-0.0304,-0.0583,-0.043,0.0055,0.1592,0.0028,-0.0854,-0.0736,0.1255,0.0392,0.1261,0.0868,-0.0085,0.0221,0.0416,-0.0187,-0.0318,0.125,0.0818,0.0817,0.0608,0.0604,0.04,-0.3549,-0.1946,0.0356,-0.073,0.0132,-0.0003,0.096,0.0108,0.0981,0.1843,-0.0362,0.0034,0.1361,-0.0302,0.0343,0.0505,-0.1493,0.0068,-0.038,0.0095,-0.0168,-0.0322,0.0284,-0.0093,-0.1323,0.0863,-0.1148,0.0672,0.0731,0.076,-0.3708,-0.0438,-0.066,0.0336,0.0304,-0.0549,-0.0989,0.02,-0.0348,-0.0461,0.0869,-0.0216,-0.0944,0.0456,-0.0398,-0.0906,-0.1606,-0.1666,-0.2464,-0.2561,0.0624,-0.0874,-0.2822,-0.459,-0.1922,-0.1401,-0.3491,-0.2174,-0.2128,-0.2444,-0.0958,-0.2038,-0.1596,-0.1752,-0.2927,-0.0826,-0.198,-0.3107,-0.1886,-0.272,-0.1935,-0.0184,-0.1699,0.1097,0.0821,0.0351,0.1992,0.0217,0.1423,0.1317,0.0726,0.246,0.2116,0.1058,0.0864,0.1282,0.0597,-0.0642,0.0281,-0.1086,-0.0062,0.0787,0.0016,0.1116,0.0644,0.06,0.0161,0.0741,-0.0615,0.0659,0.0853,0.0061,0.0116,0.0704,-0.0349,-0.0298,0.0915,-0.0554,-0.064,0.0908,-0.2509,-0.322,-0.1151,-0.1194,-0.1918,0.0808,-0.1216,-0.1212,-0.071,-0.0269,-0.1591,-0.0618,-0.0616,0.0808,0.0201,-0.1011,0.0248,0.0453,0.0239,-0.0412,-0.0039,0.127,visual pattern recognition
trm_557b4b47d994a,-0.1384,-0.1135,-0.1887,-0.1278,-0.0206,-0.0459,-0.1231,-0.0954,-0.0601,-0.1228,-0.0554,-0.0602,-0.1275,-0.0724,-0.131,-0.0657,-0.1103,-0.1197,-0.0901,-0.0283,-0.0856,-0.0062,-0.022,0.0454,-0.0264,-0.0098,-0.0133,-0.1246,-0.1519,-0.1077,-0.085,-0.1189,-0.1481,-0.1425,-0.1307,-0.1041,-0.1169,-0.0788,-0.1105,-0.051,-0.1071,-0.0633,-0.0515,0.0728,-0.0864,-0.0384,0.115,-0.0981,0.0322,-0.1254,-0.0283,0.0255,0.088,0.0424,0.0225,-0.1037,-0.1056,-0.0479,0.007,-0.0416,-0.0022,0.02,-0.1229,0.0826,0.0281,0.0348,-0.223,-0.2747,-0.1025,-0.0167,0.0797,-0.0135,0.169,-0.1048,-0.0662,0.1047,-0.1234,0.0025,0.055,-0.0369,-0.0101,0.0938,-0.0243,-0.1422,0.0765,0.0917,0.0018,-0.003,-0.045,-0.1509,-0.1002,-0.0803,-0.033,0.1079,0.1022,0.1062,0.161,0.0007,0.206,0.0617,0.1136,0.0137,0.0489,-0.0135,0.08,-0.1852,-0.1251,0.1638,0.0063,-0.0182,0.0041,-0.127,0.1574,0.1687,0.025,0.0338,-0.0884,0.0344,-0.0473,-0.1023,-0.0766,-0.1358,-0.1178,-0.0409,-0.0848,-0.1153,-0.0122,0.053,0.0623,0.0617,-0.0148,-0.0759,-0.0514,-0.2265,0.0266,-0.1724,-0.0679,-0.1115,0.0226,-0.0513,-0.1469,-0.1179,0.006,0.0256,0.0089,0.0764,-0.1822,0.0148,-0.1063,0.0385,-0.1009,-0.1141,-0.159,-0.1497,0.2218,-0.0629,0.0506,0.0178,-0.0302,-0.0984,-0.0745,-0.0737,-0.2282,-0.2287,-0.0395,0.0335,-0.0274,-0.1138,-0.1043,0.0487,-0.0958,-0.1492,0.0139,-0.1841,-0.1059,-0.139,-0.1198,-0.1316,-0.0844,-0.044,-0.11,0.0336,-0.0602,0.0049,-0.1268,-0.0731,-0.1118,-0.0622,-0.0624,0.0254,0.0379,-0.1026,-0.0205,-0.197,-0.1812,-0.1648,-0.1558,0.0027,0.0164,-0.0613,-0.0543,0.1545,-0.0971,-0.0951,0.0852,-0.0803,-0.076,-0.0598,-0.0772,-0.0247,-0.1605,-0.0872,0.0046,-0.0048,0.0754,0.0704,0.1159,-0.1379,-0.2008,0.0383,0.0767,-0.1018,-0.1197,-0.0366,0.0312,0.0265,-0.0178,0.167,-0.0129,0.2541,-0.124,-0.1378,0.1621,-0.1297,-0.1226,0.06,-0.0298,0.0757,0.0476,-0.0744,0.019,-0.1783,-0.0674,-0.0259,-0.0762,-0.0577,-0.0644,-0.117,-0.0179,-0.0829,0.0385,0.0218,0.02,0.046,0.0157,-0.156,0.0155,-0.0642,0.1482,0.268,0.0923,0.3146,-0.1012,0.1815,0.2076,0.3536,0.1731,0.0043,0.0343,0.0122,-0.0347,-0.026,-0.1059,0.0234,-0.0307,0.0565,-0.071,-0.1055,-0.0863,0.0232,0.0527,-0.0379,-0.0291,-0.1199,-0.0862,-0.1066,0.0527,0.0664,-0.1405,-0.0905,-0.1165,-0.098,-0.0332,-0.0488,-0.1174,-0.0347,-0.0248,0.1337,-0.0354,0.1674,0.0928,-0.1653,-0.1185,-0.1189,-0.1253,-0.1136,-0.1419,-0.0596,-0.0285,-0.0063,-0.0132,-0.0232,-0.1243,0.1108,0.048,-0.0203,0.1256,0.0524,0.1074,-0.1586,-0.0063,0.0129,-0.0669,-0.0979,-0.0908,-0.0657,0.0298,-0.006,-0.0972,-0.1195,0.0388,-0.1498,-0.0463,0.0244,0.0092,0.0526,0.1161,0.0071,-0.0218,-0.1204,-0.0963,0.0072,-0.0339,-0.0847,0.0774,0.0116,-0.2874,-0.2084,-0.2054,-0.1181,-0.0988,0.0014,-0.1249,-0.0816,-0.0766,-0.1041,-0.0764,-0.137,-0.1765,-0.1089,0.0043,-0.0366,0.0041,-0.0244,-0.0357,0.0581,-0.1436,0.2833,0.0623,-0.1849,0.0777,0.1328,-0.005,0.0804,-0.1563,-0.0589,-0.0767,0.1173,0.1862,0.2044,0.2126,-0.0461,-0.0896,0.0259,-0.014,0.053,-0.0774,-0.0547,0.0467,-0.0623,-0.0747,0.0179,-0.0963,-0.0191,-0.0935,-0.1564,-0.1744,-0.1904,-0.1189,-0.0489,-0.0787,0.0333,0.0443,-0.0345,0.0909,0.0934,0.1105,0.0211,-0.1185,-0.0567,-0.015,-0.1518,-0.0007,0.3023,-0.1238,0.0015,0.2781,0.0309,-0.0496,0.0111,0.0161,-0.2757,-0.1809,-0.2639,-0.2312,-0.0994,-0.1493,-0.1305,-0.1661,-0.1369,-0.0024,0.0751,-0.0065,-0.0639,0.0231,0.0672,0.0322,0.0528,-0.2761,-0.1457,0.0057,0.0559,-0.0559,0.0843,-0.0655,-0.1057,0.05,0.1156,-0.0665,0.0463,0.0975,0.0949,-0.0873,-0.0414,-0.0092,-0.0714,0.0415,-0.0528,0.0292,-0.0015,0.0689,-0.0261,-0.0386,0.1059,-0.0905,-0.0769,0.0452,0.3526,-0.0957,-0.0431,0.0156,0.0298,0.1016,-0.0023,-0.0813,-0.0053,0.0326,0.0173,-0.0606,-0.0586,0.0399,0.0091,0.0225,0.0712,0.1494,0.1563,-0.0234,-0.0431,-0.0705,-0.0394,0.0768,0.1113,-0.032,-0.0661,0.125,0.0875,-0.0286,-0.0589,0.0725,-0.1137,-0.1016,0.0413,-0.0631,-0.1234,-0.1299,-0.0988,0.096,0.1262,-0.0095,0.0769,-0.1975,0.0081,-0.0044,0.0359,0.0468,0.073,-0.1665,-0.1751,0.0882,-0.107,-0.0635,-0.0912,0.0601,0.1495,0.2016,0.0229,0.1756,0.161,0.0451,0.0846,-0.0694,-0.052,-0.1298,-0.2014,-0.0871,0.0666,-0.1218,-0.0496,-0.0316,-0.1427,-0.0081,0.0532,-0.015,-0.0075,-0.0862,-0.0431,0.0335,0.0787,0.0011,-0.0247,0.0479,-0.0006,0.0374,-0.029,-0.0287,-0.1199,0.0448,0.0238,0.0388,-0.023,-0.039,0.0073,-0.0479,0.0057,-0.0193,0.0766,0.0838,0.014,0.0236,-0.0119,-0.0566,0.0501,-0.148,-0.0252,-0.0937,-0.0874,0.0288,0.0741,0.0966,0.0997,0.0253,-0.1173,0.0023,-0.0593,0.0918,0.0897,-0.0172,0.0437,0.0499,-0.056,-0.1087,0.0581,0.1498,0.1379,-0.0359,-0.0976,-0.2406,-0.0179,0.184,-0.0438,0.0602,0.0348,0.0749,0.0465,0.0421,-0.0642,0.0286,-0.1904,-0.1849,0.1378,-0.2439,-0.0734,0.1114,-0.0556,-0.2582,-0.0408,-0.0616,0.095,0.0484,-0.2088,-0.1083,-0.2028,0.0264,0.0351,-0.0283,0.0061,-0.0696,-0.1326,-0.0748,0.0509,0.0245,-0.0769,-0.0287,0.0186,0.0515,0.0125,0.0372,-0.0165,-0.0727,-0.0227,-0.0578,0.0517,0.0123,-0.1172,-0.0495,-0.0075,-0.1544,-0.1636,0.0674,-0.1576,0.0387,-0.0983,0.1643,-0.0576,-0.034,-0.0377,-0.0553,-0.1178,-0.0323,-0.0479,-0.1304,-0.0847,0.0823,-0.1141,0.0184,0.1242,-0.1714,-0.1328,-0.0504,-0.1348,-0.0906,-0.0877,-0.0602,0.0216,-0.0414,-0.0905,0.1278,-0.0914,-0.0032,-0.0425,0.0474,0.0404,0.0908,0.0475,0.1328,-0.1383,-0.0973,0.0639,0.0291,0.0069,-0.0745,0.177,0.1342,0.1185,0.0969,0.0071,0.0664,-0.0422,-0.102,0.0224,0.0125,-0.0088,-0.0782,-0.1127,-0.1017,-0.1029,-0.0804,-0.0257,-0.047,0.0649,0.1398,0.0735,-0.0186,0.0834,0.0596,0.0752,-0.0138,0.037,-0.1037,0.0292,0.054,-0.1066,-0.1829,-0.1933,-0.0994,-0.0203,-0.023,-0.0977,0.0679,-0.0323,0.0327,-0.0009,-0.0853,0.0499,0.0898,0.0314,-0.1773,0.1385,0.1588,0.2985,-0.1145,-0.0379,-0.0961,-0.0003,0.0361,-0.1815,0.1364,0.077,-0.0337,0.0314,0.037,-0.001,-0.1767,-0.2473,-0.2187,-0.1671,0.0562,0.2063,0.0124,-0.1358,-0.0282,-0.0159,0.0647,0.0803,0.0374,-0.013,-0.0356,-0.0821,-0.056,0.1234,0.1245,0.1673,-0.0512,-0.0508,0.0204,-0.0884,0.0269,-0.0791,-0.1313,-0.0123,-0.162,-0.136,-0.0912,0.0893,0.1029,0.0502,-0.0133,-0.1066,0.0228,0.1639,-0.0565,-0.0579,0.0614,0.031,0.0354,0.018,0.1217,-0.0202,0.2131,-0.1955,-0.1933,0.1136,0.1525,0.15,0.0248,-0.0215,0.0608,0.0077,0.0499,0.128,-0.0436,0.0922,0.0401,0.1303,0.0591,-0.0179,0.1639,0.16,-0.0987,0.0266,0.0917,-0.1859,-0.1057,-0.0701,-0.1467,-0.0275,-0.2613,-0.0741,-0.1649,-0.1065,-0.1957,0.0599,0.0,0.0974,-0.0906,-0.1271,0.05,0.042,0.1385,0.096,0.126,0.1613,0.0272,0.074,0.0329,0.0651,0.1578,0.1916,-0.0725,0.155,0.0832,-0.0375,-0.0619,-0.0841,-0.0414,0.0846,0.072,-0.1902,-0.1145,-0.0108,0.091,0.2253,0.1188,0.0617,0.0514,-0.029,-0.0712,-0.1126,0.0674,-0.0542,0.0884,-0.115,-0.039,-0.075,0.1221,0.1177,0.0732,0.1158,-0.1452,-0.1228,-0.1009,0.209,-0.0928,-0.118,-0.0948,0.0627,-0.0234,-0.1902,-0.0281,-0.1429,0.082,-0.1016,0.0191,0.0283,0.0529,0.1347,-0.1816,-0.1195,-0.05,0.0457,-0.1512,0.0072,0.1005,0.0182,0.0952,0.2899,0.1046,-0.1164,-0.1244,-0.0513,-0.0745,-0.127,-0.035,0.0267,0.1046,0.0358,0.0173,-0.1268,0.1247,0.1974,0.0508,-0.0113,-0.0064,0.0191,-0.2088,-0.0964,-0.0867,-0.0528,0.0716,-0.1344,-0.0693,0.1339,-0.0109,-0.0864,-0.0625,0.0895,-0.0354,-0.0453,-0.0548,-0.176,-0.1686,-0.2017,-0.1347,-0.2036,-0.0072,-0.0018,-0.0428,-0.1077,-0.0713,-0.1469,-0.0785,-0.206,-0.0851,-0.0744,0.0034,0.1094,0.1154,-0.0165,0.0635,-0.0367,0.0377,0.0656,0.1862,0.2186,0.1517,-0.0625,-0.0056,-0.0222,0.0433,0.1741,0.1433,0.1246,0.01,0.1436,0.0235,0.1316,-0.0346,-0.0226,-0.0317,0.1258,-0.0209,0.1002,-0.1668,-0.0648,-0.0445,0.0342,0.0363,0.0182,0.0777,-0.0159,0.1248,0.1693,0.1196,0.0326,0.0208,-0.0079,-0.0269,-0.0101,-0.0269,-0.0611,-0.0806,-0.103,-0.0317,0.0516,0.0407,-0.1124,-0.0945,-0.0258,-0.1567,-0.0982,0.2406,0.0811,0.1641,0.0742,0.0973,-0.0387,0.0199,0.091,-0.0046,-0.0453,0.0049,0.0162,-0.0837,-0.1429,-0.0465,0.0976,-0.089,0.0106,-0.0492,0.0504,-0.1657,-0.0129,0.0082,0.0652,0.102,0.0968,0.0875,0.0365,0.0194,0.007,-0.0049,-0.0587,-0.0068,-0.0327,0.0201,-0.0126,-0.0613,0.0222,-0.0211,-0.0373,-0.1254,-0.0706,-0.1626,-0.1089,-0.085,0.1779,-0.0065,0.0266,-0.1491,0.1714,0.0983,-0.0346,-0.0362,-0.004,0.0963,-0.0166,0.0533,-0.1426,-0.1011,0.0164,-0.0032,-0.1033,-0.0189,-0.0839,0.0023,-0.0243,-0.098,-0.0477,-0.0668,0.0344,-0.09,0.0144,0.0321,0.1176,-0.0925,-0.0072,-0.0853,0.0618,-0.0332,-0.0395,0.3237,0.2486,0.1837,0.1247,0.1437,0.0087,0.1601,0.0819,-0.1842,0.2384,0.2169,0.1592,0.1176,0.1657,-0.0477,0.0184,-0.051,0.0102,0.0603,0.0309,0.0881,0.0265,-0.0982,0.0796,0.0661,0.0373,0.0732,-0.0017,-0.0162,0.1505,0.1283,-0.09,-0.0216,-0.102,0.0529,-0.0144,0.1617,-0.0239,-0.138,-0.1439,-0.0468,-0.0161,0.153,0.1671,-0.0833,-0.0884,-0.1782,-0.157,-0.113,0.2254,-0.1421,0.1172,0.149,-0.042,0.0561,-0.0313,-0.0801,-0.0417,-0.0591,0.1412,0.0486,-0.0042,0.0867,0.0651,-0.1385,-0.1453,0.0626,-0.1101,-0.002,0.0151,-0.0508,-0.0502,-0.1324,-0.0379,-0.08,-0.0691,-0.1733,-0.1112,0.2164,-0.0493,0.023,0.0057,0.2021,0.022,0.0246,-0.203,-0.194,0.0023,-0.0998,-0.115,-0.1334,-0.0911,-0.0317,-0.0384,0.2054,0.1208,0.1162,0.1722,0.0159,0.063,0.0088,0.134,0.0137,0.1729,-0.0451,0.201,0.3039,0.0354,-0.0664,0.259,0.2095,-0.0395,-0.1028,0.013,-0.156,-0.0959,-0.2,-0.0227,0.0544,-0.0474,-0.0267,0.0336,-0.0198,0.0021,-0.1018,-0.0523,-0.0275,-0.0208,-0.0326,0.0809,-0.0126,0.3484,0.209,0.2386,0.323,-0.1009,-0.0539,-0.075,-0.0979,-0.0677,-0.0568,-0.1144,0.1298,-0.1163,-0.1124,0.1552,0.0274,-0.0111,0.1397,0.0336,-0.0091,-0.0362,0.0493,-0.0811,-0.1046,0.005,0.1271,0.0354,0.002,-0.1119,-0.1119,-0.193,0.1068,0.0438,0.0374,-0.1111,0.0627,-0.0393,0.1601,-0.3183,-0.2892,0.1886,-0.0415,-0.2587,-0.2577,-0.2139,-0.0962,-0.0841,-0.0437,-0.0131,-0.0183,0.0694,0.0145,0.1389,-0.0265,0.1401,-0.0923,0.084,0.0748,-0.0421,-0.0133,-0.0145,-0.0126,0.0244,-0.0273,-0.0091,0.0402,0.0272,-0.0332,-0.0619,-0.0149,0.0038,0.0403,-0.1325,-0.0999,0.0214,-0.1114,-0.0542,-0.1557,-0.3314,0.0183,-0.0716,-0.2073,-0.0721,-0.1232,-0.1579,-0.0218,-0.1398,-0.0108,-0.1466,-0.0219,-0.1248,-0.1686,-0.0319,0.0612,-0.0626,0.2533,0.0828,-0.0267,0.1002,-0.0553,0.0382,-0.0566,-0.1348,-0.1369,0.0356,-0.0785,0.0178,-0.0936,-0.0012,0.0833,0.0409,0.0527,-0.1966,-0.108,0.0129,0.0336,-0.0241,-0.0212,-0.0255,0.0473,-0.0707,-0.0605,-0.0334,-0.1108,-0.1398,-0.0336,-0.1682,-0.1757,0.0034,0.0009,-0.0364,-0.0382,0.0162,-0.1198,-0.0891,0.0541,-0.188,0.0098,-0.0078,-0.046,-0.1719,-0.069,0.0468,0.1272,0.0855,0.0489,-0.021,-0.0053,0.2143,0.0889,-0.0717,-0.0588,-0.1884,0.081,-0.0208,0.0313,0.0109,0.0607,-0.0014,-0.1203,-0.0651,0.0753,-0.083,0.0114,-0.1111,-0.0098,-0.0674,-0.0355,0.0378,0.0761,-0.0097,-0.066,-0.0656,-0.002,-0.0228,-0.0023,-0.02,-0.1728,-0.0089,0.0291,-0.1025,0.0511,-0.1057,-0.0734,-0.0366,-0.0821,-0.0979,-0.1077,-0.0033,-0.0771,-0.0001,-0.003,0.1421,-0.0413,0.0136,-0.0366,0.0132,-0.0186,0.0376,-0.0912,0.0762,-0.1817,-0.1024,0.0198,0.0819,0.1032,0.0224,0.0678,-0.0664,-0.0398,-0.0707,-0.0633,-0.2094,-0.0239,-0.2243,-0.0722,-0.0598,-0.0467,-0.0222,-0.0653,-0.033,0.1939,0.1517,0.0069,0.2277,0.0831,0.0999,0.0119,0.2092,0.0194,-0.0369,0.0238,0.306,0.0066,0.0499,-0.0466,-0.103,-0.0536,-0.0736,0.0467,-0.0705,-0.1102,0.0298,0.088,-0.0566,-0.1228,-0.0049,0.0377,0.1091,0.0762,-0.2092,-0.0769,0.0041,-0.2245,-0.1833,0.0797,0.1266,0.0102,0.0428,0.0336,0.0754,-0.2183,-0.0473,-0.041,-0.071,-0.2131,-0.0445,-0.0348,-0.0628,-0.062,0.1419,-0.0248,-0.0227,-0.0186,-0.0022,0.1272,0.2269,-0.0658,0.0892,-0.0484,-0.0179,-0.1074,-0.0457,0.0508,-0.02,-0.0054,0.146,0.0256,-0.0173,-0.0718,-0.1299,0.0847,0.4053,0.4004,-0.1292,-0.0932,0.0197,-0.0815,-0.1177,-0.0343,-0.1781,0.0364,-0.0232,-0.0542,-0.0405,0.0521,0.1437,0.0047,0.0997,0.0929,-0.0229,0.0975,0.3741,-0.1668,-0.0638,0.3369,0.0271,0.015,0.1039,0.097,-0.0695,0.2124,0.1857,-0.1023,-0.0531,0.0701,0.0586,0.2165,0.1385,0.0881,0.0364,-0.0063,0.1286,-0.1254,0.0169,0.2136,-0.0132,0.0641,-0.024,-0.0247,-0.14,-0.0483,0.0459,-0.0971,0.087,-0.0525,0.1014,0.1805,0.0231,0.0521,0.0532,0.0592,-0.0079,0.1263,0.0668,0.0917,0.0418,0.1874,0.0698,0.0892,0.3868,-0.1282,-0.0194,0.0995,-0.0578,0.0224,0.0822,0.1132,-0.0532,-0.0209,0.0031,-0.034,0.0341,-0.0194,-0.0204,0.0033,-0.003,0.0412,0.0383,0.0907,0.2665,0.2713,-0.1206,-0.1857,-0.0619,-0.0134,0.1485,0.0889,0.01,-0.0266,0.0544,0.0347,0.015,-0.1605,-0.2461,-0.1071,0.0026,0.1439,-0.042,0.0306,0.0673,0.164,0.119,0.0778,-0.0076,-0.0701,-0.0064,0.0216,0.0889,-0.0778,-0.0845,-0.1374,0.0575,-0.0334,-0.0134,0.2533,-0.061,-0.0287,0.0608,0.067,0.0899,0.0199,-0.085,0.0043,-0.0219,-0.0177,0.0836,0.1821,0.1919,-0.0792,0.0482,0.0879,0.0406,-0.1588,0.0149,-0.2396,-0.0379,-0.0324,-0.1098,-0.0272,0.0907,-0.0863,-0.1192,-0.0505,-0.0791,-0.0699,-0.0541,-0.0991,0.0115,-0.0109,-0.0266,-0.1014,0.045,0.1897,0.0607,0.1947,-0.2052,-0.1371,-0.1737,-0.0349,0.0949,-0.0412,-0.1205,-0.0811,-0.1472,-0.0714,0.1848,0.0723,0.1894,0.1079,0.0515,0.0097,-0.0398,0.0009,-0.0807,-0.0593,-0.1918,-0.0598,-0.1312,-0.0858,-0.0634,-0.0348,0.0857,0.3327,0.2697,0.137,0.0866,-0.1043,-0.34,-0.1739,-0.2762,-0.1791,0.0338,-0.0629,0.0106,-0.064,-0.1769,-0.1857,-0.0621,0.0973,0.0383,-0.051,-0.058,-0.0795,-0.0996,-0.2064,-0.1183,-0.0584,0.0928,-0.03,-0.035,-0.1636,0.0385,-0.0747,-0.1779,-0.2387,0.0723,0.0047,-0.0817,-0.0442,-0.0686,-0.0344,-0.0297,-0.1589,-0.0997,-0.0417,0.2561,0.1416,0.1637,0.0948,0.1065,0.0616,0.0961,0.1045,0.2301,-0.1059,-0.0682,0.0257,0.1163,-0.1154,-0.1369,-0.0992,-0.0814,-0.0595,-0.126,-0.1186,-0.1198,-0.0861,-0.0297,0.0177,0.006,-0.2981,0.026,-0.0251,-0.116,-0.0781,-0.1304,0.0457,-0.1265,0.0599,0.0529,0.1803,0.0044,-0.0085,-0.1566,-0.0806,-0.0603,-0.1032,-0.1312,-0.0856,0.0391,0.0133,0.0054,-0.0139,-0.1217,0.0832,0.1142,0.2011,0.19,-0.1815,-0.2087,-0.0651,0.0604,0.0045,-0.1099,0.09,-0.0426,0.058,-0.0243,-0.1127,-0.1211,0.0026,-0.0818,-0.1223,-0.0149,-0.0726,0.0142,-0.0224,0.0874,0.0805,0.0726,-0.1412,-0.1625,-0.141,-0.1644,-0.1271,-0.2887,-0.1598,0.2443,-0.0754,-0.1179,-0.087,-0.0821,-0.1543,-0.065,-0.1028,-0.1202,0.1477,-0.1078,0.037,-0.0369,-0.1364,-0.0745,-0.1313,-0.0325,0.1137,-0.147,-0.122,-0.0028,0.2463,0.0141,-0.0124,0.0026,-0.0155,0.0129,-0.0097,0.1064,-0.0094,-0.0079,-0.2063,-0.1368,-0.1502,-0.034,-0.1241,0.0525,0.1423,0.2311,0.0553,0.0306,0.0828,0.1726,0.0556,0.0662,0.0471,0.0314,0.0451,-0.2512,-0.1194,-0.1378,-0.1219,-0.0164,-0.1178,-0.1362,-0.1087,0.0101,-0.0439,-0.2392,-0.1422,0.0936,-0.0645,-0.2079,0.0658,-0.0322,0.0181,0.0485,-0.1078,0.0217,-0.1359,-0.0753,0.0063,-0.1325,-0.0608,0.0516,-0.1723,0.0128,0.0029,0.0525,-0.0212,-0.1083,0.0581,-0.0289,-0.0985,-0.0117,-0.0638,-0.0455,0.1152,0.0353,-0.0312,-0.1791,-0.0919,-0.0105,0.0095,-0.0451,-0.0788,-0.1254,-0.058,-0.1024,-0.1069,0.0823,-0.0809,-0.0838,0.0492,0.0508,0.0353,0.0992,0.084,-0.2007,-0.1261,-0.1489,-0.1393,0.1849,0.2407,0.2644,-0.052,0.4163,0.2191,-0.1654,-0.127,0.4088,0.0701,0.0251,0.0729,0.1136,0.0579,-0.1162,-0.1115,-0.0745,-0.1317,0.4172,0.3334,0.2447,0.0141,0.1746,0.1774,0.3992,0.3895,0.3392,0.0187,0.0003,-0.0639,-0.0375,-0.0587,0.0251,-0.1673,-0.0955,-0.046,0.0438,-0.0518,-0.0476,0.1326,-0.0039,0.0175,-0.1523,0.0464,0.162,0.2147,-0.0254,-0.0196,-0.093,-0.0416,0.0118,-0.0265,-0.0229,-0.1137,-0.0144,-0.0763,-0.1446,-0.2337,-0.2139,0.0043,-0.0615,0.0121,0.177,0.0614,0.1992,0.0427,0.1009,0.2761,-0.0702,-0.1506,-0.169,-0.0944,0.1145,0.01,0.1778,0.0955,0.152,-0.0086,-0.2046,-0.2054,-0.1212,-0.1099,-0.0235,-0.2438,-0.1596,0.0763,-0.0011,0.2283,-0.1119,-0.0158,0.1191,0.0516,-0.0046,0.0524,-0.0506,-0.1275,-0.1695,0.0071,-0.0186,-0.1186,-0.0381,-0.1045,0.1023,0.2948,0.2657,0.0888,0.201,-0.0212,0.0507,0.084,0.1438,0.1651,0.2767,0.0443,0.0657,-0.0112,0.1108,0.1239,-0.0681,-0.0662,-0.0276,-0.0196,-0.0459,0.0352,-0.054,-0.0423,-0.0732,0.0633,0.0353,0.0074,0.0504,-0.0549,0.0967,0.1035,-0.0866,-0.174,-0.1786,-0.1461,-0.1951,0.0852,-0.086,-0.1079,-0.0627,0.1711,0.0025,-0.1719,-0.0844,-0.0199,-0.0476,0.0035,-0.008,0.0439,0.1513,0.1108,0.3601,0.1632,0.1708,0.0394,-0.0318,0.0761,-0.1304,-0.161,-0.0511,-0.0064,-0.0365,-0.0573,-0.0088,-0.0969,-0.0414,-0.1317,-0.1819,-0.1556,-0.049,-0.0532,-0.1864,0.027,-0.0917,-0.0073,-0.0059,-0.0357,-0.061,-0.0639,0.1877,0.0175,-0.0305,-0.1363,0.1346,0.0766,-0.0917,0.1091,-0.1963,-0.1152,0.0995,-0.0777,-0.0793,-0.0496,0.0218,0.015,0.0192,-0.0517,-0.0665,0.0032,0.0029,0.0262,-0.167,0.043,-0.0191,0.1017,-0.0009,-0.1915,-0.1059,-0.0321,-0.0652,-0.0666,-0.043,-0.1338,-0.019,0.0181,0.0147,0.047,-0.2734,-0.1289,-0.1391,-0.1841,-0.1645,-0.1393,-0.1662,-0.1662,-0.0542,-0.0362,0.0958,-0.2072,-0.0302,-0.1148,-0.1157,0.064,0.008,-0.2182,0.1481,-0.1657,0.1107,0.0256,0.2325,0.0474,-0.0022,-0.1485,-0.0388,-0.0181,0.0449,-0.0002,0.1743,-0.0257,0.0392,0.1555,0.159,0.0022,0.0232,-0.0425,-0.0839,-0.0314,-0.0346,-0.0363,-0.0645,-0.101,-0.0367,-0.0447,-0.0468,0.0296,-0.0722,-0.0167,0.0491,0.1435,-0.0134,0.1414,0.0313,-0.0282,0.0314,-0.0783,-0.0264,-0.0316,0.1129,-0.1032,-0.0087,-0.0106,-0.0522,0.0894,0.1354,-0.0362,0.1399,0.0531,0.3459,0.0849,0.0374,0.097,-0.1383,0.0681,0.129,0.0831,-0.0641,-0.0182,0.0563,0.0163,0.0165,-0.1877,-0.1147,-0.1588,-0.1189,-0.1102,-0.0486,-0.1742,0.2191,-0.0007,0.0623,0.1237,-0.0409,0.0263,-0.0087,-0.0571,-0.1187,-0.024,0.044,0.1462,0.0205,0.0625,-0.1188,0.0237,0.1353,0.1187,0.2095,0.049,0.0272,-0.0733,0.0197,-0.0578,-0.0029,-0.0235,-0.0075,-0.0215,-0.0738,-0.0858,-0.1096,-0.0211,0.0052,-0.0862,0.0447,-0.0344,0.0786,0.0461,0.082,0.1038,0.0478,-0.071,-0.0602,-0.0729,-0.0462,0.0065,0.0295,-0.0171,-0.0445,-0.0298,0.0726,-0.0551,-0.1408,-0.0975,-0.2,-0.1278,0.0142,-0.0507,-0.0112,-0.0958,-0.0636,-0.1319,-0.0269,-0.1015,0.0226,0.0421,-0.1727,0.1406,-0.0882,-0.1302,-0.0878,0.0445,-0.0773,-0.0419,0.0936,0.054,-0.1918,0.0728,-0.0065,-0.0415,0.085,0.0613,0.0127,0.0879,-0.1106,-0.0878,-0.0684,-0.1651,-0.1915,-0.1207,-0.1216,-0.0319,-0.0094,0.1383,0.1176,0.125,-0.1641,-0.172,0.0704,0.2011,0.2613,0.0517,-0.0459,-0.0031,-0.0275,-0.0738,0.1003,-0.0179,-0.1148,-0.0889,-0.0346,-0.0997,-0.1926,0.2824,0.1187,0.0828,0.1699,0.0937,0.0765,0.0037,-0.1036,-0.0708,-0.0378,-0.1173,0.0405,0.1198,0.0609,0.0111,-0.0654,-0.0349,-0.1051,-0.0212,-0.0244,-0.135,-0.0136,-0.0204,-0.0036,0.0107,0.0165,0.035,0.068,-0.0439,0.1059,-0.2122,-0.1459,-0.1859,-0.1798,-0.0258,-0.1619,-0.1108,-0.2566,-0.0926,-0.1283,0.0624,-0.1739,-0.0483,-0.0496,0.0739,0.1626,0.1205,-0.1014,-0.1349,-0.0167,-0.0183,0.086,0.1145,-0.0538,-0.0129,-0.0206,0.1049,0.0663,0.0896,0.1816,-0.0214,-0.0398,0.0741,-0.0584,0.0673,0.0728,0.0564,-0.0833,-0.0503,-0.0067,0.1185,0.0032,0.1596,0.1571,-0.08,0.01,-0.0554,-0.1701,-0.1282,-0.0599,0.1117,0.2473,0.0667,0.0167,0.0139,0.0395,0.2684,0.1886,0.1345,0.1452,-0.1534,-0.0518,-0.0385,0.0304,-0.1086,0.0377,-0.0671,-0.0252,0.0338,0.0426,0.0736,-0.0911,0.0671,0.0306,-0.1593,0.2208,0.1273,0.0484,0.0517,0.0694,0.1442,0.0085,-0.012,0.0082,0.0313,0.0836,0.2072,0.2099,-0.0741,0.0068,0.0877,-0.0615,-0.17,-0.3139,-0.2972,-0.0065,0.0758,0.0379,-0.0566,0.0477,0.1974,0.0282,0.0006,-0.0508,0.088,-0.0683,0.0093,0.0293,0.0714,-0.014,-0.1672,-0.0656,-0.142,-0.1034,-0.0806,-0.0861,-0.0174,-0.1823,-0.0638,-0.0141,-0.1084,0.0064,0.0762,0.0659,-0.1297,-0.085,0.2331,-0.0822,0.1284,0.137,0.1365,-0.0029,0.0809,-0.1385,0.1141,0.1016,-0.1545,-0.0692,-0.0035,0.0215,-0.1307,-0.1446,-0.1131,-0.1628,-0.0988,-0.026,-0.0612,0.0765,0.0181,-0.0983,-0.1316,-0.2518,0.1237,0.1242,-0.1217,-0.0569,-0.0577,-0.1526,-0.1975,0.1349,0.144,-0.0948,0.0509,0.1318,0.1015,-0.1824,-0.1722,-0.1383,-0.173,-0.0797,-0.0891,-0.0021,0.0458,0.0852,0.0996,-0.049,0.1664,0.3243,0.2433,0.1751,0.3025,-0.2428,-0.1326,-0.164,0.1172,0.0504,0.0179,-0.0287,0.0754,0.0968,-0.1821,-0.1619,-0.03,0.192,-0.1231,-0.1429,-0.124,-0.0267,0.0775,0.1418,-0.0465,-0.012,0.0227,-0.0181,0.0575,0.1219,0.1003,0.0646,-0.0004,-0.0559,0.0378,0.0102,0.0301,-0.0017,-0.1411,-0.0201,-0.0443,0.0137,-0.0158,-0.0348,0.2045,0.1353,0.0538,0.0175,-0.0428,-0.0384,-0.2258,-0.1815,-0.091,-0.152,0.3651,0.0077,0.2337,0.1733,0.0802,-0.0711,-0.0674,0.1787,-0.013,0.2377,0.1626,0.0661,0.1186,0.0172,0.0496,-0.0882,-0.1082,-0.1345,0.0095,0.1806,0.1432,-0.1333,-0.0124,-0.0048,0.0363,-0.0031,-0.0115,-0.0215,-0.1158,-0.0478,-0.1859,0.0279,-0.0523,0.1758,0.11,0.0437,0.0596,-0.0464,-0.0546,-0.078,-0.0659,0.1002,0.1233,-0.0305,0.0025,-0.087,0.001,0.0033,-0.0212,-0.0509,0.1162,0.0758,-0.0432,-0.189,-0.1037,-0.1581,-0.1227,0.0445,-0.0101,-0.0965,-0.0439,-0.0841,-0.1343,-0.1601,-0.1005,-0.0936,-0.0972,-0.0595,-0.0339,-0.1092,0.1099,-0.2057,-0.2116,-0.1434,-0.0469,0.016,-0.0985,-0.1001,0.021,0.0772,0.0835,-0.0687,0.2907,0.253,0.1616,0.0125,0.0169,-0.0309,-0.0646,0.0514,-0.0127,0.0493,0.168,0.2045,-0.0115,0.0441,0.0633,0.0688,-0.1022,-0.0874,-0.0674,-0.046,-0.1119,-0.0937,-0.0731,-0.091,-0.0344,-0.148,-0.189,0.1315,0.0186,-0.2241,0.0467,0.0961,0.1482,-0.0694,-0.078,-0.3234,-0.2821,-0.1371,-0.2184,0.1187,-0.1013,-0.0365,0.0567,-0.0407,-0.085,-0.2024,-0.0503,0.1837,0.1696,0.2665,0.1589,0.1555,0.0108,0.0284,0.1025,0.0801,0.1166,0.0538,0.0367,0.2202,0.1659,-0.1292,-0.2659,-0.1295,-0.114,-0.167,0.0374,-0.153,0.098,0.0596,0.0766,0.1195,0.069,-0.2647,-0.0485,-0.2016,-0.0721,-0.1793,-0.2309,-0.0544,0.0166,0.026,-0.045,-0.0377,-0.2043,-0.0814,-0.1884,-0.1163,-0.1313,-0.0562,0.0108,0.019,-0.0095,-0.0399,0.0747,0.0543,0.0436,-0.1052,-0.0886,-0.1046,-0.0241,0.1241,0.0475,-0.0833,0.208,0.0396,0.0381,0.0818,0.0251,-0.0332,-0.0479,0.0512,0.0447,0.0407,-0.0582,0.2078,0.308,0.3726,-0.0436,0.0266,-0.0036,0.0673,-0.0279,0.1215,-0.0286,0.2431,-0.0671,-0.0487,-0.0615,0.083,0.0507,-0.0025,0.019,0.0482,-0.0156,-0.0046,0.024,0.0405,-0.0429,-0.1511,0.0736,0.1496,0.1856,-0.2198,-0.1597,-0.2016,-0.037,-0.1939,-0.0198,-0.0072,0.0855,0.0038,-0.0617,-0.1771,-0.1869,0.0039,0.0414,-0.0863,-0.0749,0.2644,0.0705,-0.0668,0.1501,0.3582,0.134,0.1248,0.25,-0.0794,0.0456,0.2571,0.1461,-0.0568,0.2438,0.097,0.1292,0.0633,0.321,0.0394,-0.1526,-0.1537,-0.1185,-0.0041,0.1367,-0.0482,0.0627,-0.0668,-0.0428,-0.0009,-0.0986,-0.0203,0.1149,-0.019,-0.1784,-0.0165,-0.0793,-0.0149,0.0119,-0.0282,-0.0287,-0.0361,-0.0762,-0.0507,-0.208,-0.1391,0.1497,0.2695,-0.0149,-0.0655,0.0826,0.0337,-0.0409,-0.1102,-0.1437,-0.2103,0.1003,0.0807,-0.0808,-0.1367,-0.1216,-0.0902,-0.1479,-0.0735,-0.0266,-0.1174,-0.0425,-0.0804,-0.0879,-0.0493,-0.1405,-0.0358,-0.0172,0.0287,0.122,-0.0891,-0.0005,0.1718,-0.0515,-0.1588,-0.0612,-0.0837,-0.1908,-0.1076,-0.0517,-0.0824,0.0957,0.0814,0.1016,-0.0821,-0.1599,0.0092,-0.0139,0.0039,0.0756,-0.2153,-0.0953,-0.1718,0.0309,0.0348,0.0852,-0.0794,-0.212,-0.1692,-0.0735,-0.0565,-0.0329,0.0463,0.109,-0.0078,-0.1269,-0.1333,-0.101,-0.1372,-0.2795,-0.121,-0.0518,0.1045,0.0119,0.1904,-0.024,0.1099,0.028,0.0389,0.003,0.1311,0.212,0.085,0.0295,0.0014,-0.0779,0.0469,-0.0187,0.0294,-0.0351,-0.0257,-0.0091,0.0081,-0.103,-0.0574,-0.0371,-0.0665,-0.1633,-0.0347,0.0028,0.1402,-0.1372,0.0878,0.0385,0.0158,0.0027,-0.0331,0.0362,-0.0479,-0.1717,-0.0053,0.1522,0.0937,-0.0824,-0.0742,-0.073,-0.1081,-0.1045,-0.0288,-0.1132,0.092,0.0576,-0.1715,-0.1936,-0.0108,-0.1259,-0.0861,-0.0513,0.3023,0.1981,-0.1503,0.0584,-0.1103,-0.0261,-0.0915,-0.1279,-0.2164,-0.1647,0.0236,-0.0369,-0.094,0.0163,-0.1196,-0.0704,0.1634,0.0082,-0.0109,0.0265,0.0097,0.0457,-0.182,-0.0274,0.0719,-0.1246,0.1163,-0.1328,0.0402,-0.1723,0.3328,0.1249,0.1533,-0.208,-0.1784,0.0491,0.1567,0.0151,0.1017,0.0488,-0.1037,0.0746,0.0977,-0.0864,0.0185,0.0397,0.0761,0.1518,0.1235,0.1407,-0.0255,0.1129,0.2587,0.4907,0.221,0.1736,0.3097,0.1812,0.193,0.2147,0.1845,0.1874,0.1745,0.2297,0.2426,0.1373,0.2148,0.3314,0.2425,0.2257,0.2534,0.0666,0.2242,-0.2192,-0.0324,-0.1398,-0.14,-0.0292,-0.3265,-0.2385,-0.155,-0.0621,-0.1332,-0.3217,-0.2758,-0.1885,-0.0541,0.0662,-0.1473,0.1174,-0.0118,-0.0692,0.0757,-0.0652,-0.1182,-0.1082,-0.0962,-0.1874,0.082,-0.2498,-0.2493,0.0437,-0.0224,-0.0527,-0.0021,-0.0064,-0.1706,0.1442,0.1492,-0.1448,0.2686,0.2979,0.1046,0.157,0.1942,-0.0451,0.2896,0.2919,-0.0439,-0.0416,0.1403,-0.0213,0.0342,-0.1439,-0.0523,0.1159,-0.0556,-0.0995,-0.0083,0.0551,0.0134,-0.0649,visual number recognition
trm_558c736199abd,-0.1731,-0.0901,-0.1993,-0.1782,-0.065,-0.012,-0.1509,-0.0718,-0.0236,-0.1207,-0.0639,-0.0471,-0.1519,-0.0975,-0.1128,-0.0369,-0.0727,-0.1697,-0.0696,-0.062,-0.1311,-0.0166,-0.0087,0.0259,-0.0162,0.0125,0.013,-0.1873,-0.1747,-0.1037,-0.1379,-0.1343,-0.0824,-0.0815,-0.1646,-0.165,-0.0379,-0.1021,-0.1376,-0.107,-0.1306,-0.1462,-0.0492,0.0367,-0.0899,-0.1019,0.2457,-0.0959,0.035,-0.1446,-0.0299,0.0371,0.0541,-0.0305,-0.0783,-0.0603,-0.1387,-0.0415,-0.0129,-0.0761,-0.0024,0.0362,-0.1979,0.0257,0.0616,0.0911,-0.2848,-0.3306,-0.1824,0.0058,0.117,0.0308,0.1541,-0.1306,-0.164,-0.0007,-0.1306,0.0437,0.0676,-0.0078,0.0168,0.0278,-0.0276,-0.181,0.0021,0.1125,0.0602,-0.0014,-0.0081,-0.0899,-0.0721,-0.0601,0.0042,0.4755,0.4456,0.449,0.2043,0.1269,0.2405,0.1733,0.1033,-0.0029,0.092,0.1168,0.2085,-0.1824,-0.221,0.1639,-0.0433,-0.0407,-0.0264,-0.1735,0.0778,0.2032,-0.0097,0.0473,-0.133,0.1439,-0.1171,-0.122,-0.156,-0.1854,-0.2065,-0.0658,-0.136,-0.176,-0.1548,0.0601,0.05,0.0318,-0.111,-0.0668,-0.017,-0.2122,-0.0521,-0.2848,-0.0054,-0.1372,-0.0741,-0.0159,-0.1261,-0.1372,0.1047,-0.1111,-0.1024,0.1087,-0.0972,-0.0139,-0.0335,0.048,-0.1149,-0.1276,-0.1255,-0.2096,0.1211,-0.0101,0.1094,0.029,-0.0003,-0.0935,-0.0605,-0.1108,-0.257,-0.2356,-0.0178,-0.0128,-0.0516,-0.2501,-0.242,0.001,-0.0781,-0.1663,0.0247,-0.2479,-0.1817,-0.199,-0.1392,-0.1674,-0.0962,-0.0246,-0.1697,0.0625,-0.1363,-0.0137,-0.1348,-0.1002,-0.0956,-0.0956,-0.0323,-0.0184,-0.0104,-0.1413,-0.0618,-0.3198,-0.289,-0.2463,-0.2946,-0.0765,0.0149,-0.0502,-0.0335,0.4021,-0.1797,-0.1577,-0.0186,0.0165,-0.1259,-0.106,-0.1076,-0.0524,-0.2608,-0.0895,0.0407,-0.0526,0.0813,0.0011,0.0965,-0.1869,-0.0394,-0.0415,0.1448,-0.1022,-0.1883,-0.0895,0.1019,0.0324,-0.0699,0.1589,-0.0349,0.1508,0.1101,-0.1161,0.1979,-0.109,-0.1005,0.0599,-0.0402,0.0098,0.0614,0.0085,0.0657,-0.1871,-0.0107,-0.03,-0.1338,-0.129,-0.0772,-0.2058,-0.0282,-0.2133,-0.0582,0.0562,-0.0426,0.0581,0.0206,-0.2124,0.0212,-0.0301,0.1563,0.2602,0.1437,0.3637,-0.1272,0.1489,0.1931,0.3662,0.1614,-0.0467,0.0179,0.0185,0.0132,-0.054,-0.043,0.0002,0.047,0.0818,-0.0194,-0.0947,-0.0504,0.0211,0.0445,-0.0539,-0.0603,-0.2539,-0.1887,-0.0671,0.0942,0.0677,-0.1106,-0.1156,-0.119,-0.1251,-0.028,-0.0721,-0.0872,0.0955,-0.0485,0.071,-0.0557,0.121,0.0546,-0.268,-0.0669,-0.122,-0.0509,-0.0344,-0.1758,-0.054,0.0785,-0.0441,0.0151,-0.0239,-0.0949,0.0139,0.0351,-0.0555,0.104,-0.0049,0.025,-0.1873,-0.0035,-0.0151,-0.0108,-0.0702,-0.0542,-0.0938,0.0411,0.0068,-0.0623,-0.1031,-0.0134,-0.0988,-0.0195,0.0375,-0.0127,0.1828,0.0146,-0.049,0.0463,-0.1839,-0.1688,-0.0603,-0.0184,-0.0394,0.0619,0.0231,-0.2397,-0.1687,-0.1615,-0.0722,-0.0119,0.3015,-0.0267,0.0167,-0.0557,-0.033,-0.0553,-0.1139,-0.1576,-0.0611,-0.0245,-0.0188,-0.0123,0.0099,0.0179,0.0836,-0.1585,0.2072,0.0544,-0.2219,0.0085,0.0952,-0.0312,0.1141,-0.1453,0.03,-0.0426,0.0592,0.1101,0.0587,0.0731,0.0547,-0.1506,-0.0052,0.1042,0.119,-0.0457,-0.0532,0.0654,-0.034,0.0138,-0.0302,0.0088,-0.0153,0.0296,-0.0013,-0.0401,-0.1588,-0.088,-0.0769,-0.1027,-0.0271,0.0264,-0.112,0.0753,0.0593,0.0774,0.0468,-0.1371,-0.0599,-0.045,-0.1781,-0.0894,0.2178,-0.1551,-0.129,0.1695,-0.095,-0.1677,-0.059,-0.0064,-0.2472,-0.1564,-0.3931,-0.3479,-0.1209,-0.2247,-0.0199,-0.2103,-0.0819,0.0103,0.0222,0.0341,-0.0152,-0.0833,0.0222,0.0854,0.0363,-0.2674,-0.1448,0.2846,0.1456,0.0167,0.0987,-0.1068,-0.1197,0.1257,0.2297,-0.0825,-0.0901,-0.0888,0.0354,-0.1075,-0.1004,0.0223,-0.2065,0.0413,-0.0693,-0.0056,-0.0489,-0.0049,-0.0387,-0.0562,0.1118,-0.1235,-0.1299,0.0985,0.287,-0.0427,-0.0661,0.0845,0.0578,0.1254,-0.0318,0.0471,-0.0839,0.0479,0.0922,-0.0013,-0.0369,0.2366,0.0338,0.0303,0.0769,-0.0068,0.0937,0.0029,0.0826,-0.1504,-0.0544,0.192,0.1451,-0.0842,-0.1502,0.0876,0.0625,-0.0506,-0.0821,0.0405,-0.1334,-0.1071,-0.0272,0.0118,-0.1471,-0.1299,-0.0959,0.0079,0.0358,-0.0317,0.2042,-0.1775,0.0951,-0.0522,0.0199,0.0742,0.0773,-0.1665,-0.1651,0.1837,-0.0911,-0.0945,-0.0725,0.1106,0.0163,0.1012,0.0311,0.1372,0.1767,0.0529,0.1103,-0.0559,-0.038,-0.0784,-0.2274,-0.112,0.0649,-0.1407,-0.0625,-0.0511,-0.1322,-0.0706,0.0051,0.0866,-0.0609,-0.0712,0.0427,-0.0416,-0.011,0.0122,-0.0431,0.1088,-0.0797,-0.005,0.0539,0.0545,-0.1371,0.0063,0.079,0.014,0.0124,-0.0413,0.0063,-0.0493,0.1155,-0.0267,0.1248,0.0617,-0.0589,-0.0076,-0.0822,-0.0325,-0.0267,-0.0659,0.0491,0.1318,0.0694,0.0649,0.0711,0.1001,0.0816,-0.012,-0.1394,-0.0516,-0.0225,0.0548,0.052,0.0657,0.0665,0.1509,-0.0695,-0.1405,0.0204,0.0559,0.0808,0.015,-0.0812,-0.2925,-0.0897,0.1614,-0.0946,0.1097,0.0278,0.0446,0.1649,0.1443,0.1157,-0.0025,-0.2351,-0.2219,-0.0306,-0.2299,-0.0563,0.058,-0.0513,-0.2993,-0.1165,-0.0755,-0.0199,0.0237,-0.2575,-0.0481,-0.2475,0.105,-0.0209,-0.0079,0.1132,-0.1291,-0.1815,-0.0448,0.0143,0.0549,0.0804,-0.052,-0.0613,-0.0492,0.0653,0.0294,-0.0023,-0.14,0.0272,-0.0826,0.1221,0.0117,0.0566,-0.1172,-0.0562,-0.2328,-0.2053,0.1313,-0.2444,-0.0332,-0.107,0.281,-0.1033,-0.0021,0.0503,0.1214,-0.0857,-0.0902,-0.0737,-0.2073,0.1852,0.1941,0.0396,0.1616,0.156,-0.0707,-0.1304,0.0607,-0.0802,-0.0551,-0.0956,-0.0886,0.0403,-0.0613,-0.0963,0.244,-0.1331,0.034,-0.0924,0.0399,0.1213,0.1278,-0.0159,0.099,-0.1642,-0.1445,0.1018,0.0465,0.0658,0.0001,0.1433,0.1518,0.1415,-0.0393,-0.1053,0.0385,-0.0777,-0.0676,-0.0743,0.0814,0.0215,-0.1099,-0.1112,-0.0794,-0.0876,-0.1309,-0.117,-0.0755,-0.0073,0.074,-0.0997,-0.1321,-0.014,-0.0802,-0.0806,-0.1117,0.0098,-0.1151,0.0207,0.0924,-0.0723,-0.2772,-0.275,-0.185,-0.0636,-0.0539,-0.1328,0.0011,-0.0173,0.0788,-0.0344,-0.0018,0.011,0.0856,0.0199,-0.0925,0.0979,0.1141,0.1754,-0.2005,0.003,-0.0937,0.0383,0.0,-0.2032,0.0783,0.0903,-0.0104,0.055,0.0243,0.1753,-0.2169,-0.326,-0.272,-0.2085,0.0683,0.2211,-0.0516,-0.0498,0.0028,-0.017,0.0825,0.062,0.0269,0.0489,-0.147,-0.0855,-0.0054,0.1182,0.1599,0.1629,-0.0444,-0.0426,0.0171,-0.1082,0.0462,-0.1264,-0.1107,-0.0679,-0.2074,-0.2087,-0.1213,0.0878,0.0492,0.0143,-0.0147,-0.066,0.0746,0.0949,0.0242,-0.1222,0.027,0.0235,0.0611,-0.0087,0.0625,-0.0759,0.128,-0.2972,-0.2902,0.0667,0.11,0.2206,-0.0317,-0.053,0.1312,0.0535,0.1855,0.3517,0.1435,0.177,0.0599,0.1205,0.1165,0.0318,0.1909,0.1387,-0.0815,0.0688,0.0447,-0.27,-0.2166,0.014,-0.1499,-0.0161,-0.3271,-0.111,-0.2133,-0.1597,-0.2637,0.0794,0.0061,0.0773,-0.118,-0.1046,-0.0129,0.0536,0.0982,0.045,0.0918,0.1072,0.0319,0.0485,0.0217,0.0061,0.0989,0.0924,-0.112,0.1229,0.0509,0.0445,-0.1059,-0.163,-0.041,0.0732,-0.0525,-0.2491,-0.1578,0.0191,0.0601,0.0878,0.0525,-0.0496,0.1198,0.1668,-0.1326,-0.1601,0.1968,-0.1702,0.0655,-0.1195,0.2775,-0.1133,0.2012,0.0188,-0.0179,0.0218,-0.152,-0.1249,-0.1228,0.305,-0.113,-0.1719,-0.0987,0.1067,0.0215,-0.2203,-0.0862,-0.2389,0.0142,-0.0317,0.1727,0.1313,0.0545,0.0775,-0.2384,-0.0878,-0.0694,-0.002,-0.1626,-0.016,0.0269,-0.0152,0.092,0.2227,0.1125,-0.1814,-0.1427,-0.1124,-0.0475,-0.1177,-0.1008,0.0787,0.1869,0.0357,-0.0643,-0.0837,0.1582,0.139,0.0656,-0.0155,-0.0852,-0.1056,-0.1117,-0.0915,-0.0932,0.052,0.0638,-0.1495,-0.0624,0.1025,0.0708,-0.0953,-0.0621,0.0547,-0.0155,-0.0087,-0.0102,-0.1969,-0.1901,-0.2378,-0.1358,-0.2598,-0.0753,-0.094,-0.0946,-0.1621,-0.1534,-0.2036,-0.119,-0.1918,0.0079,0.0644,-0.0296,0.0869,0.0802,-0.049,0.1003,0.0014,0.0322,0.0827,0.0557,0.0302,-0.0396,-0.0642,0.0486,0.0666,-0.056,0.0886,0.0586,0.1164,0.0036,0.0122,-0.0469,0.0766,-0.0266,-0.0975,-0.0015,0.1715,0.0122,0.0894,-0.2139,-0.1255,-0.082,-0.1995,-0.1695,-0.005,0.1094,0.0428,0.1583,0.0785,0.0584,-0.024,-0.0164,0.0102,0.01,0.0549,-0.0036,-0.0446,-0.061,-0.0669,-0.0986,0.0769,0.051,-0.0716,-0.1196,-0.0888,-0.2083,-0.1033,0.1273,0.0867,0.1025,-0.0204,0.0202,-0.0485,0.0572,0.0811,-0.0344,-0.064,-0.0352,-0.0358,-0.0314,0.0112,0.0544,0.0586,-0.1476,0.0051,-0.1725,0.0369,-0.1578,0.0103,0.1645,0.3238,0.0166,0.0318,-0.0174,0.0266,0.0003,-0.0818,-0.0888,-0.1318,0.002,-0.0219,0.0228,-0.0007,-0.0686,0.0147,-0.0129,-0.0451,-0.0575,-0.0447,-0.1144,-0.1113,-0.1168,0.1554,0.0021,0.1194,-0.161,0.2771,0.1751,-0.0576,-0.0205,-0.0439,0.0316,-0.0581,0.0871,-0.0767,-0.0831,-0.018,-0.0388,-0.1323,-0.1164,-0.0055,-0.0262,-0.0089,-0.1001,-0.0024,-0.0628,0.0321,0.0197,-0.0126,0.0752,0.0418,-0.0682,0.0655,-0.164,0.0165,-0.0136,-0.0981,0.3705,0.2138,0.434,0.3015,0.345,0.1012,0.4136,0.1819,-0.2965,0.1504,0.15,0.0654,0.0675,0.055,-0.0438,0.0252,-0.0034,-0.0461,0.082,0.0037,0.0576,0.0668,-0.1144,0.1318,0.1512,-0.0478,0.0466,-0.0235,-0.1005,0.119,0.0346,-0.1425,0.0251,-0.1701,0.047,0.0099,0.1725,-0.033,-0.1548,-0.1596,-0.0842,-0.0536,0.1414,0.136,0.0339,-0.0239,-0.0807,-0.1791,-0.1077,0.155,-0.1363,0.2408,0.3484,-0.08,0.0228,0.0632,0.1663,0.216,0.0734,0.2184,0.0351,-0.012,0.0688,0.0334,-0.0135,-0.1917,-0.0608,-0.108,0.1656,0.0195,-0.0754,-0.0573,-0.1344,-0.0628,-0.0473,-0.1654,-0.0108,0.0321,0.1879,-0.1058,0.057,-0.0519,0.1447,0.08,0.0251,-0.3205,-0.3136,-0.1009,-0.1437,-0.0639,-0.1292,-0.1199,-0.0636,-0.0513,0.1676,0.0531,0.0877,0.3637,-0.0176,0.0673,-0.1301,0.0137,0.0046,0.1933,-0.0982,0.2001,0.3789,-0.0374,-0.1136,0.2724,0.2631,-0.0531,-0.1343,0.0014,-0.2304,-0.122,-0.2624,-0.0504,0.1549,-0.0569,-0.0511,0.0878,0.0282,-0.0587,-0.161,0.0036,-0.0154,-0.0685,-0.0363,0.0882,0.0135,0.1857,0.1496,0.1195,0.1662,-0.1522,-0.0572,-0.1255,-0.1565,-0.0892,-0.071,-0.0354,0.2888,-0.1758,-0.1345,0.0475,0.0249,-0.0353,0.0363,-0.0063,0.0122,-0.0144,0.0931,-0.1263,-0.1606,-0.0869,0.3005,0.0662,-0.0461,-0.0649,-0.0649,-0.1914,0.1723,0.0953,0.1106,-0.0433,-0.0194,-0.0537,0.3918,-0.3059,-0.2915,0.0282,-0.035,-0.2513,-0.2513,-0.2097,0.0024,-0.0547,-0.1173,-0.0346,0.0154,0.2719,-0.0538,0.0739,-0.0295,0.0718,-0.017,0.1088,0.0612,-0.0476,-0.0665,0.0048,-0.0649,-0.0458,-0.0289,0.0175,0.1001,0.0397,0.27,0.1551,0.1703,0.0336,0.3393,-0.142,-0.1168,-0.0056,-0.1847,-0.0075,-0.221,-0.2919,-0.0319,-0.1299,-0.2518,0.0816,-0.0416,-0.1933,0.0005,-0.0529,-0.0686,-0.1467,-0.0049,-0.1148,-0.1226,-0.0678,0.0756,-0.0975,0.2074,0.1745,0.1595,0.1805,0.0084,0.0197,-0.0249,-0.1145,-0.1117,-0.0135,-0.106,0.057,-0.1624,-0.0438,0.0425,0.0301,-0.0138,-0.1963,-0.1169,-0.0299,0.0374,0.0661,-0.0272,-0.1099,0.0046,-0.0398,-0.1018,-0.2005,-0.2816,-0.1998,-0.066,-0.1801,-0.1687,-0.0004,0.0028,0.1735,0.0733,0.0373,-0.1305,-0.1302,0.045,-0.1818,-0.0345,0.0189,-0.012,-0.0227,-0.168,0.0219,0.1561,0.0214,0.0328,0.0079,-0.0731,0.1555,0.0994,0.0031,-0.0172,-0.2596,0.1906,-0.0043,0.0256,0.2128,0.0253,0.0356,-0.0171,0.0697,0.3145,-0.1097,0.0333,-0.1432,-0.0565,-0.1788,-0.152,-0.0776,0.0876,-0.0006,-0.0962,-0.1439,-0.0417,-0.0486,0.0241,-0.1132,-0.1611,-0.0329,0.0319,-0.0725,0.0424,-0.1208,-0.0466,-0.0561,-0.1299,-0.1569,-0.1433,-0.0532,-0.0591,-0.0389,0.0438,0.1466,-0.0492,-0.0359,-0.0818,-0.0108,0.0412,0.0004,-0.166,0.1113,-0.0394,0.0757,0.0036,0.0697,0.0558,0.1062,0.1036,-0.0898,-0.0073,-0.0839,-0.0515,-0.2302,-0.0023,-0.0957,-0.0046,-0.0173,-0.0413,0.0164,-0.0286,-0.0557,0.2191,0.1346,-0.0405,0.2078,0.2069,-0.0422,0.0554,0.1343,-0.0187,-0.0424,0.0028,0.2476,0.0014,-0.0036,-0.0536,-0.0611,-0.0267,-0.1113,0.0435,0.0072,-0.0232,0.1691,0.1685,-0.0983,-0.087,0.0246,0.0769,0.101,0.0743,-0.2066,-0.1113,0.0137,-0.17,-0.1438,0.0555,0.1424,0.0498,0.0569,0.1219,0.0705,-0.2379,-0.0563,0.0565,-0.0747,-0.1882,-0.0004,0.0385,0.1044,0.0178,0.1981,0.0025,0.0042,0.0288,0.0626,0.2165,0.1688,-0.0809,0.0298,0.0622,0.016,-0.0835,-0.0,0.0843,-0.0119,0.0034,0.1795,0.0067,0.0349,-0.1003,-0.1302,0.0539,0.5512,0.5337,-0.1374,-0.1094,0.0544,-0.0852,-0.0775,-0.1059,-0.1459,-0.0029,-0.0661,-0.1111,-0.0255,-0.0044,0.2485,-0.075,0.1288,0.1071,-0.0002,0.1467,0.4207,0.0385,-0.1126,0.2564,0.1224,0.1014,0.0505,0.0317,-0.084,0.0549,-0.0338,-0.0298,0.0403,0.0729,0.0609,0.0757,0.081,-0.0429,0.147,0.0874,0.195,-0.1505,0.0207,0.0863,-0.0514,0.0016,0.0213,0.0157,-0.14,0.001,0.0915,-0.047,0.0416,-0.0409,0.0339,0.0702,0.0215,-0.0378,0.1,-0.0106,0.0129,0.0676,0.0963,0.0619,-0.0451,0.1421,0.0514,0.0331,0.3795,-0.1785,-0.1096,0.0119,-0.1399,0.0863,0.0876,0.1593,-0.0609,0.0057,0.0024,-0.104,0.0036,-0.0849,-0.1484,0.0692,0.0696,0.0737,0.0271,0.1497,0.1607,0.1681,-0.0826,-0.1035,-0.1117,-0.0393,0.0175,0.0159,-0.0435,0.0579,0.096,-0.0366,0.003,0.1152,-0.2881,-0.1634,-0.0252,0.1191,-0.0794,0.0416,0.0114,0.0494,0.0288,0.061,-0.0113,-0.1402,0.0263,0.0277,0.0019,-0.0682,-0.0953,-0.0996,0.0314,-0.0,0.0133,0.1682,-0.1587,-0.1716,-0.0671,0.2581,0.1243,0.1387,-0.0868,0.0872,0.107,0.0193,0.1814,0.3044,0.2298,-0.0501,-0.0029,-0.0231,0.0456,-0.2054,0.0187,-0.2879,-0.1178,-0.1402,-0.1382,-0.0415,0.0736,-0.111,0.0715,-0.0642,0.0559,0.0465,0.1348,-0.0176,-0.0309,-0.0508,-0.0531,-0.0334,0.0467,0.1994,0.1232,0.1304,-0.2569,-0.1776,-0.2211,-0.1289,0.0204,-0.1334,-0.1015,-0.0612,-0.1248,-0.0632,0.141,0.0206,0.1484,0.0665,0.0806,0.1279,0.067,0.0028,0.0455,0.0209,-0.124,-0.0295,-0.2005,-0.1049,-0.0924,-0.0378,0.043,0.2424,0.1309,0.0514,0.093,-0.0371,-0.3875,-0.1688,-0.2456,-0.1906,-0.0177,-0.0549,0.0086,-0.182,-0.2298,-0.2077,-0.0986,0.0328,0.0909,0.0344,-0.0722,-0.0457,-0.0562,-0.2233,-0.0237,-0.0448,0.0401,-0.0142,-0.0523,-0.318,-0.1032,-0.1595,-0.1814,-0.3059,0.1639,-0.1667,-0.0711,-0.0903,-0.1076,-0.0577,-0.0522,-0.1519,0.0102,-0.2213,-0.0505,-0.0184,0.1583,-0.0083,-0.0466,-0.1486,-0.0532,-0.0094,0.167,-0.1293,-0.085,0.0497,0.1277,-0.1052,-0.1016,-0.0137,-0.0635,-0.1331,-0.2057,-0.2196,-0.1436,-0.1541,-0.0557,-0.0552,-0.0196,-0.3302,-0.0307,-0.0194,-0.1432,-0.0968,-0.1783,-0.0327,-0.1049,-0.0041,0.0483,0.1268,-0.0197,-0.0323,-0.1644,-0.1877,-0.1823,-0.037,-0.1179,-0.0316,0.0468,0.3195,0.2946,-0.0618,-0.1271,0.0189,0.1223,0.1684,0.2371,-0.2539,-0.274,-0.0572,0.0956,-0.044,-0.0428,0.0508,-0.0625,0.0872,-0.0646,-0.0929,-0.1393,0.0295,-0.1181,-0.214,-0.108,-0.1497,0.0171,-0.0144,0.0546,0.2559,0.1834,-0.1474,-0.2636,-0.1038,-0.1702,-0.0923,-0.2694,-0.1593,0.49,-0.1533,-0.1193,0.1915,0.0848,0.053,0.1982,0.074,0.0797,0.147,0.02,0.0944,0.0243,0.0542,0.0964,0.1555,0.3401,0.4577,-0.2401,-0.0289,0.0426,0.3876,0.0077,-0.1778,0.0352,-0.0361,-0.0154,0.029,0.247,0.0041,0.0097,-0.0415,-0.0902,-0.1046,0.0471,-0.0871,-0.073,0.0998,0.1485,0.01,0.0614,0.0139,0.122,0.1843,0.0385,0.0047,-0.0218,0.0141,-0.3738,-0.1322,-0.1781,-0.1655,-0.0669,-0.1769,-0.2208,-0.1385,-0.0786,-0.1547,-0.1431,-0.0686,0.1514,-0.0789,-0.273,0.1561,-0.0505,0.0277,0.0158,-0.1199,0.075,-0.1586,-0.1298,-0.0973,-0.0958,-0.0814,0.0473,-0.1273,0.2827,0.0383,0.1549,0.0529,-0.1228,-0.0125,-0.0408,-0.1259,-0.0854,-0.0665,-0.1133,0.0151,0.0075,-0.1087,-0.089,-0.0558,0.0125,0.0571,-0.0658,-0.0583,-0.1658,-0.1051,-0.0831,-0.0867,0.0817,-0.1111,-0.0705,0.0069,0.0017,-0.1041,0.01,0.0136,-0.1255,-0.0431,-0.1679,-0.1767,0.1307,0.1966,0.2123,-0.0893,0.4939,0.2452,-0.1779,-0.1515,0.3907,0.4788,0.0254,0.3132,0.2438,0.3266,-0.1291,-0.1205,-0.1422,-0.1079,0.3793,0.2967,0.2169,0.0029,0.1415,0.1419,0.3695,0.3744,0.35,-0.0158,-0.0284,-0.0447,0.0658,0.0301,-0.0025,-0.2327,-0.1179,-0.0622,-0.1168,-0.1672,-0.1257,0.0364,-0.0004,0.0606,-0.0017,0.0572,0.1636,0.1884,0.0372,0.043,-0.0071,-0.0626,-0.0312,0.0332,-0.0466,-0.1403,-0.0691,-0.031,-0.2093,-0.2951,-0.2731,0.0606,0.0781,0.1039,0.2052,0.09,0.2695,0.0944,0.0568,0.1447,-0.0742,-0.1995,-0.2533,0.0266,0.1167,-0.0639,0.1057,0.1382,0.1563,0.1363,-0.172,-0.1585,-0.075,-0.0607,0.1112,-0.1585,-0.0691,-0.0101,-0.0915,0.0224,-0.0649,-0.0602,0.0615,0.0525,-0.1694,-0.0636,-0.1706,-0.1773,-0.2079,0.0432,-0.0883,-0.0404,-0.0076,-0.027,0.0744,0.4657,0.3857,0.1302,0.2754,0.0251,0.1632,0.0894,0.2988,0.2396,0.2723,0.0621,0.0939,0.0716,0.2752,0.2357,-0.0002,-0.0084,0.0221,0.043,-0.0471,0.0417,0.017,0.0194,0.0004,0.1027,-0.0163,0.0393,0.2504,0.0657,0.1531,0.1948,-0.1647,-0.1793,-0.1823,-0.1305,-0.2241,0.1356,-0.0516,-0.0987,-0.0212,0.1217,0.0038,-0.2676,-0.0236,0.0243,-0.0679,0.0033,0.0552,0.1712,0.1572,0.2696,0.358,0.1983,0.1027,0.0248,-0.0509,0.171,-0.1128,-0.1553,-0.0547,0.0056,-0.0151,0.0347,0.005,-0.0948,0.0071,-0.1604,-0.2335,-0.231,-0.0473,0.0474,-0.1992,-0.0805,-0.1211,-0.0034,-0.0762,-0.0229,0.0506,-0.0476,0.0912,0.032,0.0976,-0.1666,0.0399,-0.0466,-0.0216,0.0808,-0.2331,-0.1239,0.2799,0.0112,0.011,0.0111,0.0246,-0.0047,0.0375,-0.0284,-0.0203,-0.0196,-0.0084,0.0207,-0.2048,0.0992,0.0611,0.2019,-0.0287,-0.2128,-0.1396,0.0003,-0.1342,-0.0793,-0.066,-0.1354,-0.0262,0.1416,0.0842,0.1967,-0.3489,-0.1325,-0.1418,-0.2871,-0.2267,-0.1716,-0.1915,-0.1915,-0.0349,0.0186,0.0748,-0.2094,-0.0627,0.0077,-0.0302,0.1122,-0.0543,-0.3637,0.1975,-0.1041,-0.0036,0.0237,0.3757,0.2268,0.0488,-0.2194,-0.0938,-0.0173,0.0225,-0.0092,0.2805,0.0434,0.1221,0.1924,0.1462,-0.0044,0.0091,0.1468,0.0417,-0.0353,-0.0146,-0.0466,-0.0435,-0.1214,-0.0437,0.0112,-0.0638,0.1167,-0.095,-0.0579,0.074,0.0788,-0.0956,0.0872,0.0801,-0.1951,-0.0279,-0.2351,-0.0663,-0.024,0.0808,-0.1133,0.3559,0.3226,0.1904,0.2129,0.2308,0.0453,0.058,0.0118,0.2973,0.1171,0.0337,0.1083,-0.1268,0.1184,0.0446,0.1241,-0.0046,-0.0212,-0.0085,-0.0519,0.0392,0.0213,-0.0891,0.0467,-0.0125,0.0466,-0.0182,0.064,0.1593,0.1048,0.0085,0.0067,-0.0615,0.0469,-0.0695,-0.1167,-0.1313,-0.0663,0.0807,0.0598,-0.0666,-0.0446,-0.0812,-0.0262,0.1297,0.0955,0.0359,0.0163,-0.0015,-0.0267,0.101,-0.0468,0.0505,-0.0083,0.022,-0.066,-0.1204,-0.1257,-0.0926,0.0002,0.0204,-0.0901,0.0907,0.0315,0.1171,-0.0059,0.0581,0.1563,0.0463,-0.029,-0.1168,-0.1031,-0.0438,0.0567,0.0278,0.0069,-0.0741,-0.0187,0.0609,0.1518,-0.2106,-0.1872,-0.1509,-0.177,-0.0164,-0.022,0.0053,-0.1682,-0.1318,-0.1817,-0.0595,-0.1414,0.0097,-0.0327,-0.0883,0.1823,-0.104,-0.1131,-0.1177,-0.0033,-0.0727,-0.0471,0.1497,0.0752,-0.1813,0.0754,-0.0459,-0.0353,0.0317,0.0476,0.0342,0.0526,-0.1055,-0.1488,-0.0704,-0.1899,-0.1996,-0.0798,-0.1318,0.0905,0.156,0.0816,0.0642,0.1159,-0.1403,-0.1718,0.0194,0.0739,0.1378,0.1171,0.025,0.0118,0.0187,-0.0887,0.0369,-0.1787,-0.1094,-0.0552,-0.0752,-0.1234,-0.1955,0.0683,-0.0667,-0.002,0.157,-0.0034,0.0602,-0.1792,-0.0688,0.0148,0.0073,-0.0453,0.0692,0.2141,0.0927,0.0145,-0.0782,-0.1064,-0.1264,-0.1117,-0.0093,-0.2143,-0.0228,-0.0123,-0.0194,-0.0325,-0.0013,0.076,0.0285,-0.1053,0.1513,-0.2617,-0.1375,-0.1693,-0.1847,0.0058,-0.1996,-0.1481,-0.2705,-0.1183,-0.0359,0.1107,-0.1692,-0.1502,-0.0933,0.0852,0.029,0.0453,-0.1772,-0.1842,-0.1143,-0.0465,0.0387,0.115,-0.0733,-0.0172,-0.0342,0.0738,0.0422,0.0518,0.159,-0.0517,-0.0572,0.0606,0.0011,-0.0469,-0.07,-0.0761,-0.0694,0.0198,0.0017,0.0345,0.0552,0.0981,0.1861,0.0491,-0.0259,-0.0592,-0.2243,-0.1047,-0.0475,0.2738,0.3048,0.0401,0.0129,-0.0112,0.0568,0.2211,0.185,0.1374,0.0913,-0.1506,-0.004,-0.0804,0.0431,-0.1418,0.0462,0.0533,0.096,0.0403,0.0723,0.06,-0.0408,0.057,0.0024,-0.1396,0.1837,0.0644,0.0194,-0.0704,0.1153,0.0994,0.0019,0.0733,-0.0094,-0.0008,0.1367,0.173,0.1566,-0.1023,0.023,0.1184,-0.0276,-0.1655,-0.3501,-0.3432,0.1044,0.0856,0.1355,-0.0854,0.0083,-0.1034,-0.139,-0.1285,-0.1619,0.0324,-0.1095,-0.0076,-0.0754,0.0703,0.0127,-0.2667,-0.0971,-0.1674,-0.2179,-0.0018,-0.1264,0.0003,-0.2994,-0.1186,-0.0105,-0.0217,-0.017,0.0403,0.0228,-0.0051,-0.1465,0.2942,-0.1035,0.1325,0.0486,0.0522,0.0393,0.0871,0.0519,0.2894,0.2715,-0.1815,-0.0906,-0.0706,-0.0247,-0.1957,-0.1233,-0.0831,-0.2233,-0.1445,0.0052,-0.1489,0.0522,-0.0074,-0.0295,-0.0815,-0.2007,0.0836,0.0615,-0.2148,-0.1019,-0.0641,-0.147,-0.2926,0.1338,0.1757,-0.1268,0.0414,0.083,0.1189,-0.0329,-0.0076,-0.1642,-0.2333,-0.0942,-0.1495,0.0177,0.0888,0.1011,0.0654,-0.0324,0.1443,0.3231,0.2284,0.1889,0.2832,-0.2396,-0.2085,-0.2167,-0.0766,-0.0161,-0.0539,-0.2007,0.0021,0.0598,-0.0787,-0.0831,-0.0012,0.1806,-0.1472,0.1044,0.0315,0.1526,0.1296,0.126,0.0484,-0.0387,-0.0292,-0.0192,0.0642,0.1015,0.1631,0.0725,-0.05,0.0861,0.1384,0.1583,0.0691,-0.0347,-0.1717,0.0015,-0.0313,0.0519,-0.063,-0.0228,0.0989,0.021,0.0564,0.0152,-0.0665,-0.0598,-0.2118,-0.152,-0.0944,-0.0781,0.3237,-0.0082,0.2563,0.1263,0.1098,-0.0644,-0.0814,0.1568,0.1381,0.1816,0.3142,0.1817,0.1592,0.0643,0.1135,-0.0591,-0.0696,0.0422,0.0235,0.1851,0.1742,-0.0904,-0.0506,0.0173,0.0205,-0.0387,0.0757,-0.0222,-0.1399,0.0171,-0.0202,0.0201,-0.1059,0.0766,0.1217,0.182,0.0567,0.044,0.0862,-0.0213,-0.045,0.1689,0.1697,0.0559,0.0375,-0.0026,0.1623,0.045,0.0107,0.0251,0.1,0.1331,0.0448,-0.0709,-0.0883,-0.1648,-0.0599,0.0103,0.1518,-0.1015,-0.0852,-0.1112,-0.1076,-0.104,-0.0279,-0.0836,-0.0394,-0.0026,-0.0383,-0.0879,0.0767,0.0593,0.026,0.0216,-0.0743,0.0233,-0.0635,-0.0883,-0.0085,0.2547,0.0367,-0.0322,0.399,0.3798,0.2167,0.0169,0.1617,-0.0473,-0.0546,0.0095,-0.0779,0.0299,0.1638,0.2203,-0.0249,0.0009,0.0388,0.0728,-0.096,-0.104,-0.0697,-0.0662,-0.0938,-0.0855,-0.0416,-0.0818,0.0163,-0.1378,-0.1207,0.3011,-0.0167,-0.2152,-0.0214,0.0539,0.1425,-0.0694,-0.0694,-0.3605,-0.3099,-0.1251,-0.1436,0.2778,-0.1385,-0.0774,0.1092,-0.0217,0.0927,0.0249,0.0701,0.1693,0.1558,0.2764,0.255,0.1361,-0.0287,0.01,0.0605,0.0159,0.0019,0.0051,-0.0138,0.2754,0.1903,-0.148,-0.2866,-0.1827,-0.1498,-0.2276,-0.0043,0.0113,0.0916,0.0369,0.1513,0.0171,-0.0076,-0.2657,-0.0851,-0.1828,0.0233,-0.1639,-0.2362,0.0106,0.1019,-0.0511,-0.0891,-0.0353,-0.0915,-0.0993,-0.2429,-0.0316,-0.1655,-0.0054,-0.1272,-0.0984,-0.0348,-0.0516,0.0236,0.0404,0.0569,-0.1247,-0.1603,-0.1273,0.0485,0.155,0.0375,-0.0448,0.1674,-0.0781,-0.1252,0.052,0.0835,0.0197,-0.0338,-0.0131,0.0335,0.0071,-0.0516,0.2236,0.5151,0.411,0.1735,0.1199,-0.0374,0.2397,0.0082,0.2188,0.0382,0.4663,0.0236,0.1619,0.1295,0.0694,0.0422,0.0219,0.0193,0.0645,0.1964,0.2275,0.1499,0.1118,0.0237,-0.1671,0.0382,0.1589,0.0856,-0.2148,-0.1553,-0.2337,0.0009,-0.168,-0.0208,-0.0301,0.0753,0.0383,-0.0291,-0.1778,-0.1784,0.2366,-0.0193,-0.1124,0.0789,0.2904,0.0997,-0.0698,0.1873,0.2326,0.1365,0.0621,0.1699,-0.1045,0.0577,0.2166,0.1156,-0.079,0.2265,0.0909,0.0903,0.051,0.2823,0.0632,-0.2122,-0.1199,-0.0645,-0.0572,0.0645,-0.0437,0.0495,-0.0027,-0.0585,-0.0134,-0.2504,-0.1226,0.0992,-0.0349,-0.1812,0.1178,0.011,-0.0122,0.0822,0.0059,0.047,0.0577,-0.1124,-0.1012,-0.3041,-0.2372,0.0659,0.1614,-0.0333,-0.089,-0.0571,-0.0383,-0.0265,-0.1271,-0.1528,-0.1926,0.0024,0.069,-0.0725,-0.0742,-0.1221,0.0299,-0.1394,-0.1695,-0.0308,-0.0806,-0.1029,-0.129,-0.1056,-0.0257,-0.1456,-0.0796,-0.015,0.0402,0.1278,-0.1115,-0.0069,0.1107,0.0445,-0.1873,0.1215,-0.0349,-0.199,-0.09,-0.0352,-0.0675,0.0386,0.1765,0.2334,-0.0488,-0.1536,0.2255,0.0801,0.0058,0.2395,-0.2514,-0.1012,-0.239,0.0595,0.0483,0.138,0.0695,-0.2597,-0.2494,0.0991,0.1347,-0.0155,0.1885,0.0966,-0.0141,-0.1557,-0.1537,-0.0964,-0.126,-0.3018,-0.1274,-0.1046,0.0808,0.0139,0.1259,0.0341,0.2174,-0.0496,0.0424,-0.0396,0.1123,0.159,0.0036,-0.0255,-0.0535,-0.0513,0.064,-0.0646,0.0423,-0.1016,-0.0943,-0.109,0.0145,-0.1045,-0.0362,-0.0471,-0.0134,-0.0779,-0.0818,0.0461,0.1486,-0.0123,0.0812,-0.0662,-0.0301,-0.03,-0.0533,0.0058,-0.0938,-0.1916,-0.0693,0.1748,0.0695,0.0733,0.0031,-0.0403,-0.1084,-0.1204,0.0078,-0.0831,0.1354,0.1421,-0.2026,-0.188,0.0348,-0.1789,-0.0583,-0.0971,0.2899,0.3807,-0.2487,0.1622,-0.1306,0.0154,0.0323,-0.235,-0.2881,-0.1581,0.0293,-0.101,-0.0974,-0.0063,-0.1555,-0.1174,0.1397,0.0017,0.0018,0.0763,-0.021,0.0094,-0.1796,-0.0472,0.0744,-0.1546,0.0842,-0.1849,0.3656,-0.2439,0.2131,0.074,0.043,-0.2769,-0.2522,0.0098,-0.014,-0.0584,0.0303,0.0501,0.0056,0.0104,0.0318,0.033,0.315,0.3109,0.2725,0.0812,0.1685,0.257,-0.0383,0.1288,0.3763,0.4999,0.2658,0.1592,0.2757,0.1892,0.1062,0.246,0.1999,0.3914,0.2408,0.2176,0.2788,0.1907,0.1765,0.1974,0.4126,0.1867,0.3613,0.2509,0.3363,-0.2138,-0.0703,-0.2206,-0.0995,-0.0647,-0.3222,-0.265,-0.1755,0.1115,0.0067,-0.3318,-0.2498,-0.1706,-0.0023,0.0213,-0.2226,0.278,-0.0211,-0.0866,-0.0409,-0.1026,-0.0744,-0.0703,-0.1528,-0.2185,0.1253,-0.3171,-0.3306,0.0148,0.0078,-0.0612,0.0047,0.0056,-0.1553,0.0576,0.1286,-0.1711,0.0577,0.1748,-0.0383,0.0747,-0.0282,-0.1073,0.1769,0.1768,-0.0211,-0.0738,0.103,-0.0755,-0.0015,-0.1762,-0.03,0.156,-0.1872,-0.16,-0.0553,-0.0271,-0.0408,0.0176,subjective value judgment
trm_557b4b9ccdc4a,0.0183,0.0475,0.0748,0.0038,0.0176,0.028,0.0298,-0.0092,-0.0438,0.0247,0.0643,0.0736,-0.0074,-0.0237,0.0448,0.0469,0.098,0.0362,-0.0243,0.0816,0.065,0.0274,0.0364,0.0356,0.0319,0.0367,0.036,-0.0198,0.0047,0.0215,0.0072,0.0764,0.0348,0.0435,0.0229,0.0455,0.0282,0.0172,0.0202,0.0358,0.0781,0.0218,0.0042,0.0115,0.0327,0.0007,0.1024,-0.0084,0.0056,0.0009,-0.005,-0.1093,-0.1262,-0.0499,-0.0956,0.0174,-0.0467,0.0308,-0.0035,0.0467,0.071,0.0057,0.0556,-0.0172,0.0014,-0.0555,0.1099,0.0781,0.0252,0.0307,-0.0291,0.0499,-0.0379,0.0413,-0.0884,-0.0548,-0.0284,0.0573,0.0243,-0.0074,0.0018,-0.0217,-0.0067,-0.0017,-0.0497,-0.0177,-0.0434,0.0184,0.0556,-0.1086,0.0488,-0.0646,0.0589,0.0281,0.0678,0.0428,-0.0468,-0.0405,-0.1147,-0.0272,0.011,0.0598,-0.0311,-0.003,-0.017,0.0835,0.1176,-0.0456,-0.025,-0.0516,0.0121,0.0129,-0.0475,-0.0566,-0.0379,0.0174,0.031,-0.0246,0.0228,0.0159,0.0645,0.0319,0.0806,-0.0082,0.0111,0.0683,0.0153,0.0295,0.0415,-0.1412,-0.0182,0.0083,0.0401,-0.029,0.0225,0.0817,0.0156,0.0547,0.029,0.0077,0.0472,0.0229,0.048,-0.051,0.0731,-0.0099,0.0043,0.0042,0.09,0.0183,0.0359,0.1215,0.0765,0.0782,-0.04,0.0284,-0.0054,0.0416,0.0311,0.034,0.0323,0.0701,0.1114,0.0776,0.0311,0.0057,0.0564,0.0923,0.0924,-0.0837,0.1079,0.1462,0.0687,0.0254,-0.0235,0.0331,0.0313,0.0215,0.0016,-0.047,0.0271,0.0406,0.013,-0.0566,-0.0133,0.0265,0.0248,0.0094,0.007,0.0481,0.0382,0.0422,0.0421,0.0266,0.0241,-0.0602,-0.0321,0.0678,0.0416,-0.1692,-0.1357,0.0246,0.0593,0.0281,-0.0262,-0.0418,-0.008,0.0272,-0.0177,0.0222,0.0422,0.0379,-0.0342,-0.0284,-0.0129,-0.0229,0.0186,0.0067,-0.0062,0.0537,0.0486,0.0333,0.0761,0.0044,-0.0073,0.04,0.0363,-0.034,-0.012,-0.0374,0.0675,0.0178,0.0111,0.0341,0.0302,-0.1261,0.0123,-0.0511,-0.0333,-0.0286,0.0269,0.0143,0.0364,-0.0265,0.0072,0.016,0.0421,0.0265,-0.0598,0.0761,-0.0178,-0.0149,0.0174,-0.0458,-0.029,0.0676,-0.055,-0.0374,-0.0106,0.0067,-0.002,0.0152,0.0435,0.0116,-0.0257,-0.0171,-0.0335,-0.0285,0.0831,0.0357,0.0128,-0.0325,-0.0039,-0.016,-0.0938,-0.0452,-0.158,-0.1248,-0.0978,-0.0869,-0.0668,0.0346,0.0235,0.0476,0.0591,0.0161,0.0221,0.0088,-0.0211,-0.0219,0.0702,-0.0139,-0.0453,0.0385,0.0207,0.0266,0.0106,-0.0944,0.0393,-0.0572,-0.1224,0.0527,0.0239,0.0775,-0.0548,-0.051,0.0351,-0.0428,-0.0774,-0.0235,-0.0411,-0.0121,0.0166,-0.0968,0.0213,-0.0173,-0.0125,-0.0475,-0.0435,0.0117,-0.0166,0.0043,0.0034,0.009,0.0003,0.0245,0.0039,0.0564,0.0125,0.0856,-0.0314,0.0002,0.0357,0.0078,0.0363,0.0121,-0.1129,-0.0339,0.0741,-0.0074,-0.0121,0.0761,-0.0013,-0.024,0.0137,-0.0219,0.0448,0.0527,0.0442,0.0171,-0.0035,0.1227,0.0041,-0.0174,0.0112,0.0528,0.0153,0.0401,-0.0018,0.0138,-0.0171,0.0251,-0.1722,-0.0628,-0.078,-0.0302,0.0219,-0.0687,0.0621,0.0161,0.0231,-0.0498,0.0503,-0.0252,0.0903,-0.0139,0.0547,-0.0043,0.0211,-0.0407,-0.0217,-0.0209,-0.0407,-0.0436,-0.0087,-0.0496,0.0142,0.0261,-0.0011,-0.0095,-0.071,0.0223,0.0304,0.028,0.0096,-0.0015,0.0255,0.0369,0.0334,0.0147,0.0072,-0.0119,-0.0395,-0.0106,0.0137,-0.0579,-0.0684,0.0199,0.0529,0.0366,0.0032,0.1101,0.0083,-0.0566,0.0736,-0.0341,-0.1114,0.0128,0.0105,-0.0394,0.0118,0.0152,0.0311,0.0275,0.0185,0.0138,0.0128,0.0039,0.0146,-0.023,0.0456,-0.0482,-0.0454,-0.0057,0.0053,0.0066,-0.0467,-0.0219,0.0852,0.002,0.0763,0.0119,0.1188,0.0439,-0.0095,0.0307,-0.0125,0.0106,0.05,-0.0627,-0.0914,-0.0398,0.0101,0.0053,-0.0401,0.0623,-0.0307,0.0511,-0.0401,0.0222,0.0116,0.058,0.0227,0.0819,0.0576,0.0423,0.058,0.0156,0.0101,-0.0488,-0.0051,-0.0506,-0.0809,-0.0082,-0.0024,-0.0158,-0.0203,0.0275,0.0113,-0.0164,0.0215,-0.0169,0.0171,-0.0256,-0.1085,-0.0692,0.0196,0.0632,0.0644,-0.0126,0.0486,-0.1432,0.0618,0.0711,0.0034,0.0398,-0.1115,0.0017,0.0461,0.0259,0.0337,0.0449,0.0259,0.0604,-0.0057,0.0231,-0.0235,-0.0571,0.013,-0.0166,0.0366,-0.0421,-0.0301,-0.0168,0.0307,-0.0159,-0.0038,-0.016,-0.0821,-0.0062,-0.0384,0.0074,0.072,-0.116,-0.104,0.0278,-0.1196,-0.0931,-0.0802,-0.0074,-0.0112,-0.024,0.0459,0.1144,0.031,-0.0336,0.0951,0.0645,0.0407,0.0679,0.045,0.0355,-0.0283,-0.0568,-0.006,0.0128,0.0112,-0.0523,-0.0052,0.0886,-0.0294,-0.0216,-0.0093,-0.0568,0.0381,0.0395,0.0139,-0.0722,0.0214,-0.004,0.0821,0.044,0.0578,-0.0101,0.0045,-0.0431,0.0055,-0.0217,-0.0137,-0.0883,0.0012,-0.0183,0.0261,0.0433,0.0193,-0.02,-0.0095,-0.0472,-0.0367,-0.043,-0.092,0.064,0.0061,0.0095,-0.0621,-0.0179,-0.039,0.0069,-0.041,0.0305,0.0558,-0.035,-0.0824,-0.06,-0.0299,0.0169,0.0889,0.0098,-0.0623,-0.0072,0.0154,-0.0398,-0.001,-0.0066,0.0379,-0.0161,-0.0335,0.0172,0.0161,-0.0643,0.0439,0.0027,-0.0044,0.0212,0.0451,0.0079,0.0044,-0.048,0.0204,0.0994,0.0174,0.0983,0.0329,0.0076,0.0044,0.0005,-0.0779,0.0049,-0.0325,-0.0427,0.0138,-0.019,0.0407,-0.0449,-0.0326,0.0077,-0.0132,0.0005,0.0225,-0.1118,-0.0229,0.0166,0.003,0.032,0.055,0.0009,0.0068,-0.0007,-0.0118,0.1297,-0.0657,0.0837,0.0887,0.0981,0.0059,0.0047,-0.0258,-0.0054,0.0199,-0.0073,0.0736,0.0324,0.0078,-0.0051,-0.0157,0.0428,-0.0579,0.1384,-0.0178,-0.0245,-0.0083,0.0169,0.0386,0.017,0.0499,0.0252,-0.0437,0.055,0.0355,0.0118,0.0061,0.0072,0.0268,0.0089,-0.0314,0.0435,-0.0009,0.0238,-0.0179,-0.0395,0.0343,0.0067,-0.0041,0.0306,0.0889,0.0834,0.0088,0.0181,-0.0051,-0.0558,-0.0243,0.0033,0.0642,0.0663,-0.0048,-0.009,0.0501,0.0817,0.0508,-0.0211,0.0077,-0.0709,0.0092,-0.0503,-0.026,-0.0221,0.039,-0.0478,0.0483,-0.0072,-0.0253,-0.0362,0.1549,0.1628,0.0967,-0.0001,-0.0042,0.0309,-0.0262,-0.0072,0.0614,-0.0195,0.0246,-0.0014,0.0055,0.0367,0.0095,-0.0767,0.0038,-0.1691,0.0439,0.0194,0.024,0.0233,0.0462,0.0891,-0.0494,-0.0248,0.053,-0.0378,-0.0762,-0.0103,0.0337,0.0782,0.1017,0.0675,0.0516,0.0557,0.0332,0.0285,0.0061,-0.0259,-0.0464,-0.0022,-0.0006,0.0873,0.0241,-0.0157,0.0406,-0.0834,0.0008,-0.0264,-0.026,-0.0276,-0.0053,0.0129,0.0356,0.0309,0.0634,0.0129,0.05,0.0511,0.0333,0.0285,0.0575,0.0041,-0.0248,0.0093,-0.0177,0.0214,0.0083,-0.0049,0.0118,-0.0104,0.0024,-0.0191,-0.0353,0.0112,-0.1214,0.0204,0.0182,0.0389,0.0297,0.0939,-0.0102,-0.0312,-0.0256,-0.0327,0.0541,0.0848,0.0408,-0.0094,0.0335,0.0107,0.0065,0.0473,-0.057,-0.0605,0.0047,-0.0186,-0.0414,0.1129,0.1206,0.0455,0.0526,0.0238,0.0895,0.0158,0.076,0.0758,0.0643,0.05,0.0379,0.0395,0.0381,0.0477,-0.0385,-0.0941,-0.0415,0.0492,0.0216,0.0375,0.0277,0.0193,-0.0412,-0.0369,-0.0474,-0.0601,0.0114,-0.0161,-0.0133,0.016,0.0219,-0.0256,0.0061,0.0161,-0.0469,0.1729,-0.009,-0.023,-0.0627,-0.1171,-0.1019,-0.0544,-0.0511,-0.0329,0.0028,0.0136,0.0117,-0.0233,0.0499,0.0009,0.0172,0.0142,0.0102,-0.0619,-0.0637,-0.0415,-0.0355,-0.0105,0.0644,0.0836,0.0612,0.05,0.0196,0.0166,0.0328,0.0308,0.0359,0.0113,-0.0862,0.0076,0.0186,-0.0465,-0.0613,0.0296,0.0607,0.0227,0.0151,-0.0699,0.037,-0.0312,0.0969,0.0273,-0.0283,0.0867,-0.0256,0.0341,0.0183,0.025,0.0778,0.0988,0.0288,-0.0239,-0.0061,-0.0369,0.0127,-0.0092,-0.0071,-0.0235,-0.1003,-0.0762,-0.0319,0.0466,-0.0127,0.0201,0.0116,0.0639,0.0024,0.0435,-0.0558,-0.0122,0.0181,-0.0048,0.0189,0.0034,0.0384,0.053,0.0201,0.0412,0.0351,0.0038,-0.0116,0.0074,0.0437,-0.0441,0.0376,-0.0178,0.0092,-0.0067,0.027,0.0269,-0.0007,-0.0717,0.0062,-0.0029,-0.024,-0.0071,0.0373,0.0165,0.0009,0.0191,0.0164,-0.0014,0.03,0.0365,-0.0543,-0.0067,-0.046,-0.0567,-0.0494,-0.0093,-0.0242,-0.1556,0.0087,0.0056,0.0115,-0.0368,-0.0071,0.0635,0.0148,0.0522,0.012,0.0512,0.0261,0.0878,0.0849,-0.0528,-0.0858,-0.0106,0.0358,0.0435,0.0744,-0.0834,-0.0474,0.0059,-0.0483,-0.0,0.0096,0.0005,0.0308,0.0314,0.0179,0.0146,0.0175,0.0256,0.0086,-0.0267,-0.001,0.0144,-0.1094,-0.0157,-0.1216,0.0286,0.0434,0.0135,0.0318,-0.0015,0.0191,0.0095,-0.0238,0.0001,0.0034,0.0152,-0.0069,0.018,0.0345,0.0303,0.0039,0.0075,0.0371,-0.0135,0.0002,0.0017,-0.0613,-0.0398,-0.064,-0.0575,-0.0042,-0.0398,-0.0192,0.0206,0.0479,0.0293,-0.0288,-0.0593,0.0319,-0.0579,-0.0482,0.0118,0.0118,0.0446,0.0014,0.0655,-0.0422,-0.0458,0.0404,0.0569,-0.0002,0.0534,0.0363,-0.0247,0.0406,0.0275,-0.0632,-0.017,-0.0107,0.0746,0.0178,-0.0074,-0.0415,0.0298,0.0622,-0.0094,0.0571,-0.0137,0.0038,0.0161,0.0068,-0.0026,0.0334,0.007,-0.0016,-0.0675,0.0339,0.0173,0.0572,0.0395,-0.0101,0.0099,0.1105,0.0356,0.0467,-0.0201,0.0279,0.0677,0.0542,0.1315,0.0192,0.0248,0.0649,0.0457,0.023,0.0539,0.0203,0.0508,-0.0001,0.0335,0.0038,-0.0395,-0.081,0.0506,0.0394,-0.0839,-0.0361,-0.0459,0.0425,0.0001,-0.0581,0.0132,0.0143,0.0794,0.0108,-0.0013,-0.0237,0.0018,-0.0485,0.0052,0.0991,0.0338,0.0344,0.0448,-0.0127,-0.0462,-0.0525,0.0045,0.0575,0.0468,0.0022,0.0503,-0.0067,0.0735,0.0415,0.0019,-0.0054,-0.0269,-0.0195,-0.0036,-0.0478,0.0806,-0.0506,0.0205,-0.0243,-0.0386,0.1137,0.126,-0.0919,0.0248,0.0439,0.0049,-0.0468,-0.0219,0.0265,-0.0024,0.0526,0.0526,0.0223,0.0117,-0.004,0.0319,0.0446,0.0208,-0.0934,0.005,-0.0227,0.0572,0.0266,0.0019,-0.0092,0.0067,0.0441,0.0868,-0.0192,-0.0169,-0.1977,-0.1136,-0.0911,-0.0157,-0.0851,-0.1979,-0.0003,-0.0639,-0.1664,-0.0045,-0.0461,-0.0331,-0.0224,0.0091,-0.1181,-0.0153,-0.0077,0.0143,-0.0366,0.0061,0.0274,0.0012,0.1282,0.0456,-0.0924,0.0413,0.0331,-0.0836,0.0266,-0.0836,-0.0316,0.045,-0.0035,-0.0024,-0.0826,-0.0269,-0.0071,0.0273,0.0497,0.0489,0.0022,0.037,-0.0242,-0.007,0.0404,0.0006,0.0603,-0.0481,0.0651,0.0269,0.0617,-0.0768,-0.005,0.0697,0.0107,0.0072,0.0133,0.0078,-0.0481,0.0757,0.0862,-0.0781,0.0262,-0.0051,0.0508,-0.0169,-0.0169,0.0548,0.0705,0.0054,0.0241,0.0087,0.0087,0.0748,0.05,0.0938,0.1156,-0.1102,-0.0042,0.0579,0.0533,0.0204,0.0171,-0.0167,0.0265,-0.0048,-0.0055,0.0684,-0.0359,-0.1379,-0.0368,-0.0578,0.0603,-0.2254,-0.0739,-0.0775,-0.009,-0.0403,-0.0327,0.0475,0.0538,-0.1637,-0.0433,-0.013,0.0471,0.0313,-0.0597,0.0156,0.0414,0.0341,0.0392,-0.041,0.0378,0.0864,0.0387,0.0567,-0.0547,0.0218,0.0849,0.0028,0.0151,0.0579,-0.0391,0.0156,0.0287,-0.1354,-0.1136,0.0044,-0.0527,0.0481,-0.0366,0.0359,0.0711,-0.0545,-0.0379,-0.0712,0.0018,-0.0062,-0.0005,-0.1159,-0.106,0.0136,0.0492,-0.0506,0.0433,-0.0236,-0.0269,0.0191,0.0182,0.0719,0.0269,-0.0509,-0.1101,-0.0491,-0.0615,-0.0249,0.0429,0.0782,0.0548,0.0975,0.0806,0.0448,-0.0126,0.1513,0.1375,0.0554,0.059,0.0806,0.08,0.0222,0.054,0.0304,-0.1105,0.0247,0.0605,0.0002,-0.0345,0.0496,0.0656,0.0033,-0.0425,0.0208,0.087,0.0548,0.0134,-0.0364,-0.2261,0.0135,-0.0236,0.0514,0.0483,-0.0429,0.0831,0.0547,0.1268,-0.0186,0.0077,0.0462,0.0577,0.0334,0.0465,0.0111,0.0216,0.0563,0.0528,0.0057,-0.0091,-0.0231,0.0489,-0.0123,0.0154,0.0816,0.0317,-0.0245,0.0023,0.0009,-0.0055,0.021,-0.032,0.0482,0.0166,0.02,0.0683,0.0073,0.0118,0.0178,0.0287,-0.0323,-0.0459,-0.1286,-0.0059,-0.0038,0.012,-0.0388,-0.0196,0.0786,0.0896,-0.0758,0.0114,-0.0168,-0.0078,-0.0121,0.0403,-0.005,-0.0783,-0.0538,-0.0318,0.0351,-0.022,0.0703,0.0239,0.0259,0.0198,0.0497,-0.0101,-0.0469,-0.0135,-0.0521,-0.1855,-0.253,-0.09,0.0638,-0.0154,-0.0638,0.0033,0.0055,-0.019,0.0399,0.0279,-0.0904,-0.0085,-0.0382,-0.0275,-0.0198,-0.0074,0.0039,0.0067,0.0429,-0.0341,-0.0273,0.007,0.0563,0.0478,0.0372,-0.0421,-0.017,0.0039,-0.1138,-0.0986,-0.1026,-0.0823,-0.0711,0.0361,-0.0412,-0.0163,-0.0456,-0.045,-0.0489,0.0605,0.0424,0.013,-0.0107,-0.0201,0.0722,0.0217,0.0456,0.0375,0.0012,-0.0008,-0.0148,0.0187,-0.0027,0.0038,-0.1,0.0185,-0.0027,0.0188,0.0315,0.0169,-0.0082,-0.0207,-0.0095,-0.0018,-0.0607,-0.0064,-0.0423,0.0063,-0.0051,0.0231,0.0285,0.0196,0.1171,0.0997,-0.0289,-0.011,0.0768,0.0269,-0.0054,-0.0117,-0.0157,0.011,0.0095,-0.0104,-0.103,-0.0552,-0.0465,-0.032,0.0183,0.0083,0.0007,0.0069,0.0337,-0.0234,0.003,-0.0035,0.0011,0.0028,0.0709,0.0051,-0.0036,0.019,0.0177,-0.0352,0.0067,-0.0654,-0.0679,-0.023,-0.0156,0.0102,-0.0439,-0.0099,0.0132,0.0033,0.0088,-0.0158,-0.0102,-0.002,0.009,0.023,-0.0417,-0.0008,-0.2035,-0.0937,-0.104,-0.1363,0.0754,0.0331,0.0536,0.0462,0.0544,0.0404,-0.0571,0.0152,0.0116,0.0268,-0.0539,-0.0168,0.1282,0.0067,0.0974,-0.0854,-0.0141,-0.0408,-0.1034,-0.1255,0.0036,-0.0473,-0.0353,-0.0079,0.0444,-0.0092,0.0121,-0.0375,-0.0336,0.0109,0.031,0.0229,-0.0493,-0.0402,0.0002,0.0342,-0.0164,-0.0165,-0.1309,-0.0321,0.0636,0.0417,-0.0156,-0.0494,-0.0366,0.0504,0.0396,0.0279,-0.0126,-0.011,0.0342,0.0079,0.008,0.0474,0.0116,-0.174,-0.0032,0.0065,-0.0365,0.0337,-0.0611,-0.1481,-0.1287,-0.1722,0.0435,0.0446,0.0253,-0.1138,0.0584,0.0434,-0.001,0.0387,0.0154,0.0174,0.0871,0.0665,-0.0264,-0.0003,-0.0095,0.07,0.0797,0.0076,0.0422,0.0331,-0.0339,0.0012,-0.0365,0.0712,-0.0182,0.024,0.1198,0.0541,0.0062,-0.0083,0.0199,0.0735,-0.0326,-0.0372,0.0046,0.0457,-0.0067,-0.0443,-0.0683,-0.0091,-0.0608,-0.004,-0.0164,-0.0952,0.0567,0.0418,0.067,-0.0295,-0.0183,0.021,0.0231,0.0124,0.0233,0.0579,-0.0907,-0.039,-0.0517,-0.0609,0.0317,0.0022,0.0684,0.059,0.0736,0.0208,0.0192,-0.0248,0.0498,0.0301,0.0158,0.0705,0.0026,-0.0353,-0.0335,-0.0137,0.0065,-0.0129,0.1024,0.0572,0.0859,0.0925,0.0331,0.0177,0.0293,0.0579,0.0685,0.0113,-0.006,-0.1452,0.041,0.0354,0.0404,0.1074,0.043,0.0681,0.032,0.0689,-0.0344,0.019,0.0024,0.0609,-0.0816,-0.0149,0.0559,0.0625,0.0126,0.0639,0.0239,0.0318,0.0252,-0.0079,-0.033,0.0265,0.0791,0.0521,-0.0168,0.0053,-0.0498,0.0372,-0.019,0.0187,-0.051,-0.0673,-0.0603,-0.0022,-0.0185,0.0154,0.0406,0.0016,-0.0106,-0.0041,-0.0063,-0.0312,0.0622,0.0719,0.0834,0.044,-0.0214,0.0253,0.0365,0.1006,-0.0449,-0.0478,0.0211,-0.0524,-0.0444,-0.0735,0.0307,-0.0694,-0.0836,0.1004,-0.0586,-0.0428,0.1064,0.0522,0.077,0.0144,-0.0028,-0.0076,0.0156,0.0332,0.0495,0.0168,0.0187,0.005,-0.0281,-0.0217,-0.1237,0.1577,0.1679,-0.0621,-0.0638,-0.0159,0.0011,-0.0439,0.0111,0.0204,-0.0431,0.0441,0.015,-0.0479,-0.0082,0.0109,-0.0228,0.0673,-0.0887,-0.0094,-0.0952,0.0255,0.0257,-0.0038,0.0056,0.0383,0.0264,0.0025,0.1152,0.0788,0.1502,-0.0413,-0.0124,-0.029,-0.0112,-0.0197,0.0157,0.0121,0.0419,-0.0886,-0.0319,-0.0432,-0.0151,-0.0351,-0.0102,0.018,0.0277,0.1173,0.0185,0.0052,0.0373,0.1158,-0.0924,0.0387,0.0004,0.0276,0.0075,-0.0614,0.0334,0.0787,0.0373,0.0031,-0.1406,-0.122,-0.1176,0.0692,-0.0335,-0.0539,-0.1426,0.0513,-0.0011,-0.003,0.1216,0.1143,0.0413,-0.0452,-0.0183,0.0321,0.0552,0.014,0.0426,0.0065,-0.0015,0.0196,0.0527,0.0414,-0.0096,-0.0051,-0.0101,0.0129,0.0006,0.0939,0.1648,-0.0301,0.0637,-0.012,0.0277,0.0024,-0.0637,-0.0015,-0.0161,0.0056,-0.0078,0.0697,0.0132,0.1108,0.0515,-0.0269,0.0126,0.0086,0.0241,0.0507,0.0442,0.0306,0.0492,0.0256,-0.0295,-0.0043,0.0358,-0.0262,-0.0552,0.0708,0.0585,0.0156,-0.0849,0.0296,0.0243,0.0295,0.0035,0.0536,-0.0134,0.0,0.0663,-0.0658,-0.0313,-0.0889,-0.0018,-0.0047,-0.0294,-0.0285,-0.0347,-0.0033,0.0006,-0.0241,-0.0247,0.0006,0.0895,0.1059,0.0117,0.0631,0.0788,0.061,-0.0238,0.0787,0.069,0.062,0.0347,0.0352,-0.0065,0.0277,0.1781,0.0819,0.1069,0.0891,0.1044,0.057,0.0613,0.0691,0.0391,0.0424,-0.0463,-0.0112,0.0442,-0.012,-0.0342,0.0173,-0.0188,0.0496,0.0804,0.0286,0.0319,-0.032,0.0117,-0.0055,0.0526,0.1073,-0.0123,-0.0839,-0.0551,-0.1031,-0.1211,0.0493,0.0809,0.0518,-0.0479,0.0108,-0.0012,-0.0374,0.007,0.0244,0.0164,-0.0866,-0.0062,0.0525,0.094,0.0526,-0.0165,0.0477,-0.0051,-0.1302,0.0789,-0.0166,0.0368,-0.0367,0.0077,-0.0024,-0.0045,0.0332,0.0067,-0.0605,0.0438,0.0473,0.0224,0.0273,-0.0841,-0.032,-0.0424,-0.0418,0.0259,-0.0929,-0.0169,0.0343,-0.0586,-0.0015,0.094,0.0511,0.0989,0.0357,0.0016,0.0797,-0.0151,-0.0175,-0.029,0.0028,-0.0494,0.0439,0.0331,0.0401,0.0271,-0.0383,0.0332,0.0015,0.0378,-0.0089,-0.0195,0.1013,0.0219,0.0624,0.1136,0.1576,0.0554,0.0533,-0.1537,-0.1031,0.0563,-0.0084,0.0865,0.0383,-0.0632,-0.0125,0.0055,0.0313,0.0254,-0.0383,0.0428,0.0557,0.0493,0.044,0.0344,0.0367,0.058,0.0131,0.0224,0.0516,-0.0035,-0.0125,0.0256,0.1346,0.0594,-0.0041,0.0543,-0.0208,-0.017,0.0115,-0.0305,-0.0132,-0.0141,-0.0379,-0.027,-0.0343,-0.031,-0.0443,0.0579,-0.0342,-0.0072,0.0535,0.0153,0.0429,-0.0643,0.0005,0.0605,0.0311,0.0479,0.0201,-0.0244,0.0375,0.0325,-0.0547,0.0208,-0.0293,-0.0494,0.0138,-0.0059,-0.0916,-0.2032,0.1109,0.029,0.0002,0.0091,0.0168,-0.1314,0.0335,0.0469,0.0445,0.0108,-0.1001,-0.0997,0.0027,-0.0254,0.0046,-0.0115,-0.0539,0.0265,0.03,-0.0113,0.0204,-0.031,0.0128,0.071,0.0289,0.0289,-0.0192,0.061,0.0083,-0.0096,0.0247,0.0273,0.0972,0.0506,-0.052,0.0354,0.0063,0.0562,0.009,0.0386,0.0312,0.0398,0.0428,0.0363,0.0363,0.0501,0.0035,-0.0604,0.0747,-0.0135,0.0316,0.028,0.0789,0.027,0.1391,-0.0303,-0.0253,-0.0416,-0.0537,0.081,-0.06,0.0007,0.0533,0.0171,0.0487,0.1033,0.0001,0.077,-0.0025,-0.0783,-0.1236,-0.1152,-0.0084,-0.0436,-0.0803,-0.0693,-0.0146,0.1671,0.0741,0.0187,0.0017,0.0072,-0.0185,-0.0469,-0.0279,0.015,0.0077,-0.0344,-0.0073,-0.0209,-0.0081,0.0154,-0.0238,0.0527,-0.0135,-0.0026,0.0054,-0.0672,0.035,-0.0246,-0.0206,-0.0117,0.0115,0.0361,0.0445,-0.0782,-0.0039,-0.0092,0.0355,0.0395,-0.078,-0.0553,-0.0439,-0.0491,0.0048,0.0076,0.0268,-0.0262,-0.0185,0.023,0.0013,-0.1093,-0.0032,-0.0899,0.0281,0.0308,0.0164,0.0699,-0.0177,0.0313,-0.0157,0.0589,0.0081,-0.003,0.034,0.0021,-0.0413,0.0186,-0.0997,-0.0564,-0.0471,0.0481,-0.0342,-0.0529,-0.0432,-0.0846,-0.0276,-0.0502,-0.0062,-0.0599,-0.0232,-0.039,-0.117,-0.022,0.0276,0.0416,-0.0029,-0.0184,-0.0313,-0.0361,0.0255,-0.0086,-0.0054,-0.0285,0.006,0.013,-0.0245,-0.0044,0.0586,-0.002,0.0352,0.0221,-0.0064,0.03,0.0023,0.0016,-0.005,-0.0947,-0.0183,0.0699,0.0311,0.0312,0.0772,0.0112,0.0087,-0.0026,0.0195,0.0335,0.0826,-0.0776,-0.0211,-0.0766,0.0135,-0.0226,0.0359,0.0221,0.0028,-0.0274,-0.0497,-0.0348,-0.0098,0.0142,-0.0495,-0.0007,0.0296,0.0578,0.0312,-0.0519,-0.0515,-0.0011,0.0303,0.0227,-0.0398,-0.0182,0.004,-0.0293,-0.0049,0.0565,0.1118,0.0927,-0.0363,-0.0505,-0.0238,0.0294,0.0297,-0.098,-0.1293,-0.1245,0.052,-0.0102,0.0313,0.0416,-0.0436,-0.0263,-0.0307,0.0102,0.0366,-0.0315,0.0724,0.0352,0.0035,0.0022,0.0278,0.0228,-0.0202,-0.0524,0.059,0.097,0.0574,0.0254,0.02,-0.0367,-0.0837,-0.0307,-0.0363,0.0062,0.0022,0.035,0.0258,0.0705,0.097,-0.0219,-0.0224,-0.0034,-0.023,-0.0331,-0.0308,-0.0279,0.012,-0.0113,0.0844,0.0471,0.0659,0.1502,-0.0569,0.0102,-0.0047,0.0178,-0.055,0.0194,-0.0888,0.1408,0.0011,0.0215,-0.0446,-0.0457,0.0561,0.0627,0.0278,0.0117,0.0469,-0.0051,0.0675,0.0285,-0.0007,-0.0354,-0.0238,0.0071,-0.0338,-0.0036,-0.0216,-0.0264,0.0136,-0.0034,0.0457,0.0247,0.0224,0.0346,-0.0266,0.0609,0.0022,0.0199,-0.059,-0.0037,0.0097,-0.0142,0.0633,0.0392,0.0239,0.0296,0.0119,-0.0194,-0.0291,0.0137,0.0526,-0.0472,-0.0697,0.0038,-0.031,0.0156,0.0823,0.0599,-0.0398,0.1196,0.0075,-0.0475,-0.0403,-0.0124,-0.0286,-0.0079,-0.0316,0.0583,0.0339,-0.0461,0.0343,-0.0683,-0.0073,-0.0112,-0.0105,-0.0218,-0.0308,-0.033,-0.0031,-0.0493,-0.0732,-0.0555,-0.0929,-0.0524,-0.0425,-0.0405,0.0496,-0.015,0.1334,0.2022,0.2022,0.0499,-0.038,-0.045,0.0001,0.0237,0.0001,0.0379,0.1237,0.1009,-0.022,-0.0576,0.0024,0.0316,-0.0109,0.0447,0.0281,0.0227,0.007,0.0333,-0.0678,0.0087,0.0386,0.0608,0.0145,0.027,-0.0017,0.0359,-0.0213,-0.0183,-0.0087,0.0246,0.0339,0.0929,-0.0439,-0.0124,-0.0203,0.0356,0.0364,-0.0144,0.0509,0.0332,0.0275,0.0416,0.0268,0.0113,0.0995,0.0423,-0.0423,0.0792,0.0689,0.0729,0.0843,-0.0608,0.0025,-0.0017,-0.0292,0.0462,0.0853,0.1047,0.0102,-0.0077,-0.054,0.0234,0.0726,0.0846,-0.0074,-0.001,-0.0248,-0.0326,-0.0799,-0.0535,-0.0447,0.0435,0.0719,0.0485,-0.0078,0.0307,-0.0279,-0.0098,0.0234,0.0459,-0.0608,0.0476,-0.0168,-0.0356,0.0464,0.079,0.0965,0.0147,-0.1285,-0.0717,-0.0167,-0.0132,-0.1197,-0.1079,-0.004,-0.0131,0.0205,0.0339,-0.0032,0.0144,0.0053,-0.0089,-0.0219,0.0005,0.0176,-0.1539,-0.1074,-0.1768,-0.0615,0.0215,-0.0092,-0.0198,0.0026,-0.0269,-0.0922,-0.0507,-0.0659,0.019,0.0144,-0.003,-0.0162,-0.0317,-0.0001,0.0416,-0.049,-0.0509,-0.0204,0.0175,-0.0377,0.0533,0.108,0.0224,0.0229,0.0566,0.0466,0.0231,0.0146,-0.0592,-0.0435,0.0043,0.0129,-0.0448,-0.0548,-0.0336,0.0041,-0.0784,-0.0939,-0.0517,0.0028,0.0414,0.0328,-0.008,-0.0946,0.0805,-0.0632,-0.0145,-0.0647,-0.0219,-0.0735,-0.0134,0.0526,-0.0047,0.0319,0.0268,-0.0219,-0.0834,0.0328,-0.0404,0.0125,0.0087,-0.0318,0.0503,-0.0105,-0.0217,0.0388,-0.0515,0.0049,0.0114,0.0218,-0.0249,0.0379,-0.0347,-0.051,0.0112,0.0743,-0.0011,-0.0263,-0.012,-0.0075,0.0459,0.0454,-0.0255,-0.0871,0.0611,0.0243,0.1323,0.1311,0.0237,0.0424,0.0058,-0.0173,0.001,-0.0398,0.0555,-0.0179,0.0073,0.0056,-0.0353,0.0255,-0.1258,-0.1186,0.0711,0.0325,0.1172,-0.0366,-0.0055,0.0807,0.0498,0.0575,0.0134,0.1095,0.0278,-0.1272,-0.1471,-0.1123,-0.0259,-0.0575,0.0275,0.0552,0.0152,0.0056,-0.0024,-0.0293,0.051,0.0227,0.0136,-0.153,-0.0872,-0.098,-0.0608,0.0279,0.035,-0.0059,0.0381,-0.1795,0.1137,0.0294,0.0202,-0.0488,0.0114,-0.0166,0.1589,0.1843,0.0925,0.0329,0.0699,0.0249,0.0324,0.0297,-0.1605,0.0156,-0.0019,0.0053,-0.0267,-0.0387,-0.0676,-0.0199,-0.0117,-0.0988,-0.0926,-0.0501,0.0214,-0.027,-0.0771,-0.0779,0.009,-0.0363,0.0605,0.0648,0.0822,-0.0148,0.005,0.0326,0.0086,-0.0476,-0.0306,0.0093,-0.0481,-0.0207,0.1092,0.0793,0.0616,-0.0035,0.0496,0.0272,-0.0201,-0.0572,-0.0093,0.048,0.0049,-0.0512,-0.044,0.039,-0.0178,0.0463,-0.0158,-0.0196,0.031,0.0329,0.0074,-0.0118,0.0019,-0.0403,0.0544,-0.005,0.0168,-0.016,-0.022,-0.0687,0.0104,-0.0772,0.0045,0.0131,-0.0191,-0.0212,0.0442,0.0693,0.0026,-0.0131,-0.0049,0.0306,-0.0063,-0.0131,-0.0084,-0.0072,-0.052,0.012,-0.0859,0.0379,-0.0279,-0.0894,0.0406,-0.116,-0.0713,-0.0833,-0.0018,-0.0194,-0.0408,0.0058,-0.0057,-0.0299,-0.0172,0.052,0.0323,0.0494,0.0557,-0.0336,-0.0022,-0.0236,0.0813,0.0872,0.0718,-0.0004,0.0701,-0.1619,0.0122,-0.0265,-0.0693,-0.0192,0.0279,0.0556,0.0337,0.0045,-0.0552,-0.0652,-0.0368,-0.0312,0.0026,0.0048,-0.1318,-0.0908,-0.1356,-0.0731,-0.0615,0.0619,-0.0442,-0.0017,0.0627,0.0003,-0.0268,-0.0535,-0.0283,-0.1002,0.0307,0.0015,0.0511,0.0351,-0.063,-0.0409,0.0285,-0.0245,-0.0705,-0.1285,-0.0565,0.0269,-0.0143,0.0582,0.0066,-0.0431,-0.045,-0.0997,-0.0037,-0.0065,-0.0168,0.0441,0.027,0.0341,0.0265,0.0177,0.017,-0.0329,-0.065,-0.01,0.0319,0.0265,0.0067,-0.0097,0.0224,0.0132,-0.0579,-0.0382,-0.0559,-0.0167,0.007,0.0372,0.0598,0.1348,-0.0029,-0.0086,0.0691,0.016,0.0539,-0.0042,-0.0154,-0.0354,0.0119,0.0105,0.0184,-0.0182,0.0421,-0.0429,-0.0555,-0.079,0.0242,-0.0158,-0.0072,0.0664,0.0106,-0.083,-0.1161,-0.0333,0.0151,0.0139,0.0482,0.063,0.0391,0.0318,0.0299,0.0322,0.0002,-0.0068,0.0042,-0.0121,-0.0188,0.002,-0.0287,0.034,0.0262,0.0174,0.003,0.054,-0.0098,-0.0096,0.0142,0.0432,0.078,0.0299,0.038,0.0422,0.0263,0.0486,-0.0281,-0.003,-0.0764,0.041,-0.0301,-0.0371,-0.0585,-0.0166,-0.0296,-0.0748,-0.0231,0.0073,0.0056,0.006,-0.0493,-0.0223,0.0068,0.0414,0.0463,0.0241,-0.0375,-0.0377,0.0351,0.0139,0.0351,0.0276,0.0146,-0.0503,0.017,0.0616,0.0047,0.0005,-0.0137,0.037,0.0346,-0.0281,0.0087,-0.0456,-0.0055,0.0096,-0.0074,0.0421,0.0596,-0.0191,0.0503,0.0497,-0.0034,0.0413,-0.0817,-0.0731,0.1138,0.0849,-0.006,0.0171,-0.0147,-0.0121,0.1391,0.1021,0.0126,-0.0099,0.0295,0.0728,0.0266,0.0646,0.0693,0.0031,-0.0141,0.0252,0.0342,-0.0097,0.0284,0.0123,-0.0772,-0.0324,0.0001,0.0327,-0.0282,-0.0455,0.0595,0.055,0.0521,0.0463,-0.0059,0.0932,-0.0119,0.0399,0.0434,-0.1143,-0.0873,0.094,0.0983,-0.1114,-0.1569,-0.0577,-0.1301,-0.077,-0.0093,-0.0874,0.033,0.0237,0.0834,0.0723,0.0836,0.0346,0.0833,0.0767,-0.076,0.1045,0.1366,0.0941,0.065,-0.0455,0.0784,0.0786,0.0211,0.1172,-0.015,0.096,0.0724,0.0181,0.0326,0.0267,0.0287,-0.052,0.0607,-0.0255,0.0774,0.0619,0.0642,0.0316,-0.0753,0.0933,-0.1271,-0.1149,0.1076,0.0939,0.0854,0.0011,-0.0161,0.1369,0.1201,0.0473,0.0721,-0.0057,0.0051,0.0611,0.0425,-0.037,-0.0445,-0.0124,-0.0001,0.015,0.0863,0.0453,-0.0231,0.0651,0.0533,0.0505,0.0273,-0.0274,0.0586,0.0535,0.0641,-0.0398,0.0306,-0.0022,-0.1586,-0.04,-0.0055,-0.067,-0.1404,-0.0273,-0.1188,-0.1203,0.0484,0.0334,-0.0992,0.0232,0.0086,0.027,0.014,0.0118,0.0632,0.057,0.0041,0.0499,0.0495,-0.0416,visual word recognition
trm_4a3fd79d0a891,-0.0447,-0.0701,-0.0363,0.0012,0.0135,0.0022,-0.0187,-0.0998,-0.0765,-0.0164,0.0188,0.0482,-0.043,0.0202,-0.0135,-0.0597,-0.0131,0.1122,-0.0492,0.151,0.065,0.0666,0.0006,0.0633,0.0041,0.0166,0.0134,0.0548,0.0117,-0.0109,0.0177,0.0838,-0.0375,-0.0518,0.0652,0.032,-0.061,-0.0233,-0.0261,0.0286,-0.0014,-0.0394,-0.0734,0.0956,0.007,0.0687,0.0798,-0.0548,-0.0325,-0.0075,-0.0142,-0.1119,-0.005,-0.0142,0.0773,-0.0043,-0.0402,0.0402,0.0335,0.0295,0.0084,0.0108,0.05,-0.0024,-0.0089,-0.1583,0.0644,0.1298,0.0422,-0.0176,-0.0158,-0.0306,0.0671,0.0653,-0.0345,0.0893,-0.0877,0.061,0.0157,-0.053,0.0407,0.0731,0.0154,0.0651,0.0201,-0.0404,-0.0828,-0.0493,0.0583,-0.1978,-0.0413,-0.1664,0.0251,-0.3183,-0.2143,-0.2441,-0.0777,-0.0995,-0.1814,-0.2633,-0.0068,0.0082,-0.066,-0.2625,-0.1254,0.0243,0.0852,0.0549,-0.054,-0.0273,0.0407,0.0728,0.048,-0.0702,0.0385,0.0468,0.0514,-0.1963,0.083,0.0115,0.1085,0.0254,0.1529,0.063,0.0418,0.1037,0.1007,-0.0211,0.0181,-0.038,0.1493,0.0099,-0.0096,0.0486,0.0848,0.0927,-0.0641,0.0663,0.0265,-0.0408,-0.0006,-0.0058,0.0573,0.0894,0.0631,-0.0511,-0.1034,0.0746,-0.0153,0.0855,0.0201,0.0819,0.0008,0.0864,0.0643,-0.0798,0.0018,-0.0291,0.0702,0.028,-0.0146,0.073,0.0909,0.0172,0.0004,0.0076,0.0489,0.113,0.1145,0.0898,0.0016,0.0947,-0.034,0.19,0.068,0.0858,0.0804,0.1383,0.0853,-0.0691,0.0269,0.0307,0.0333,-0.0188,-0.0521,0.0273,-0.0502,0.168,0.1527,0.0239,0.0269,0.0409,-0.0015,0.1048,0.11,-0.0442,0.017,0.1087,0.0832,-0.238,-0.1273,-0.2086,0.1032,-0.0027,0.0518,-0.0857,0.1784,-0.0108,-0.0147,0.0246,0.1455,0.0856,-0.0556,0.0466,0.0669,0.0692,0.0757,-0.0538,-0.2819,0.0251,-0.0046,0.0426,0.0646,0.0056,-0.0546,0.0127,-0.0013,-0.0463,0.0833,0.0992,-0.2596,0.0493,0.0052,-0.069,-0.0819,-0.152,0.0928,0.094,-0.0202,-0.0088,-0.093,-0.0311,-0.0851,-0.0571,0.0094,0.029,0.118,0.0189,-0.0953,0.2057,0.0564,-0.0309,0.0443,0.024,-0.0691,0.0935,-0.0548,-0.1037,0.0372,0.106,0.0008,-0.0335,0.0273,0.0057,-0.0042,0.0128,0.0108,0.0719,0.0822,0.0394,-0.0508,-0.1081,0.0351,0.0837,-0.1907,-0.0254,-0.2163,-0.1009,-0.2042,-0.0778,-0.0516,0.1123,0.1189,0.1786,0.1632,-0.0417,0.0029,0.0475,-0.1156,-0.026,0.029,0.0375,-0.0215,0.0851,-0.04,-0.0473,0.1192,0.0026,0.0436,-0.0397,-0.0236,0.1915,-0.0587,0.0677,-0.2258,-0.2473,-0.032,-0.0168,-0.1397,0.0561,-0.035,0.0098,-0.0295,0.0963,0.0324,-0.0573,0.0108,-0.017,0.0638,0.0344,0.0234,0.0595,0.0266,0.0677,-0.0065,0.0147,0.0327,0.0054,-0.0408,-0.0418,0.0142,0.002,0.1097,0.0645,0.1156,-0.1159,0.0197,0.1102,0.0816,0.1199,0.1073,0.1115,-0.1692,-0.1294,0.0304,-0.0305,-0.0854,-0.0844,-0.0804,-0.044,-0.0929,-0.1251,-0.1747,-0.1193,-0.0157,-0.1219,-0.0228,0.0133,-0.0653,-0.0167,0.0072,-0.0043,-0.1047,-0.0693,-0.1144,-0.065,-0.0766,-0.039,0.0291,0.009,0.0451,-0.0108,-0.0193,-0.0383,0.0556,-0.0771,0.0096,0.0353,0.1814,0.0298,0.1841,-0.1955,0.0156,0.0043,-0.0114,-0.013,0.0124,-0.0067,0.0107,-0.0273,-0.1224,-0.0112,-0.1844,0.0618,-0.1282,-0.2657,-0.2604,-0.0504,-0.1002,0.0201,0.0446,0.0235,-0.0254,0.0304,-0.0286,0.0436,0.0632,0.0335,0.0268,-0.0377,-0.0773,0.0589,0.0631,0.0938,0.1177,0.1497,0.1283,0.1031,0.1135,0.0255,-0.0168,-0.107,-0.0978,-0.0337,-0.0082,-0.1039,-0.0245,-0.1785,0.0059,-0.1826,0.0218,-0.0165,-0.0132,-0.0464,0.1479,0.089,-0.1399,-0.0379,-0.0492,-0.0281,-0.0668,-0.0773,-0.0641,0.0062,0.0523,-0.0219,-0.0469,-0.1092,0.138,0.0863,0.0412,-0.0002,0.0162,-0.0173,-0.0671,0.1295,0.0114,0.0015,0.0497,0.0088,0.0141,-0.0648,0.0541,0.0809,0.049,-0.0101,-0.0403,0.1356,-0.0366,-0.0625,-0.0641,-0.0318,-0.1451,0.0108,0.0321,0.0052,-0.1299,-0.1025,-0.0051,-0.0087,-0.2064,-0.1301,-0.1555,-0.0386,0.0755,0.0526,-0.0534,-0.0637,0.1165,-0.0383,-0.0019,-0.1414,0.0397,0.0506,0.0101,0.0728,0.062,-0.0408,0.0449,0.0825,0.0792,0.0952,-0.0154,-0.0275,-0.0283,0.0232,0.0885,0.1222,0.0084,-0.0981,-0.0086,-0.1035,0.0628,-0.0036,0.0471,-0.0217,0.0538,0.0346,-0.1918,0.0079,-0.0291,-0.0419,0.0528,-0.0062,0.0443,0.0782,-0.0166,-0.0746,-0.0562,-0.0409,-0.0449,-0.0516,-0.1175,0.0169,0.1172,-0.0216,0.0508,-0.0521,0.0126,0.0287,0.0697,0.0418,-0.0466,-0.0183,0.0232,-0.0573,0.0397,0.0707,0.0366,0.0501,-0.071,0.0826,-0.0332,-0.2334,-0.0605,0.0592,0.0119,-0.0059,0.0921,-0.1058,0.0808,0.0646,0.0766,-0.0638,0.0345,-0.0341,0.0764,0.2032,0.0193,0.0817,0.0274,0.1532,-0.0898,-0.0178,-0.3597,-0.3283,-0.0582,-0.094,-0.0193,0.0033,0.01,0.0257,0.0724,-0.021,-0.0386,0.0206,-0.1845,0.0236,-0.112,0.0641,0.022,-0.0396,-0.0167,0.0104,-0.1427,-0.1013,0.0575,0.0778,-0.065,0.0324,0.0257,0.0348,0.0289,-0.0148,-0.0572,-0.3386,0.0506,0.0134,0.009,0.0678,-0.0094,-0.053,0.0653,0.0661,0.0236,0.0636,0.0133,0.0897,0.0539,0.0547,-0.0558,-0.0187,-0.0706,0.06,-0.0205,-0.0832,-0.0208,0.0667,-0.1517,-0.0037,-0.0421,-0.1894,0.0384,0.0436,-0.011,-0.1753,0.0018,-0.1332,0.0829,-0.1147,-0.0542,-0.0864,-0.0936,-0.2917,0.0016,-0.0134,0.1618,0.1338,-0.081,0.1018,0.0456,0.0085,-0.1171,0.0644,0.0487,-0.1473,-0.3097,-0.1081,0.0094,-0.0292,0.1196,-0.3012,-0.0099,-0.2669,-0.1723,-0.0678,-0.2399,0.0915,-0.2617,-0.1015,-0.0496,0.0175,-0.0444,-0.0969,0.0103,0.0076,-0.1545,0.0662,0.079,0.0363,0.0234,-0.051,0.0362,0.0014,-0.0171,0.0166,-0.0033,0.0393,-0.0163,-0.1067,-0.0237,-0.0096,-0.0889,0.0446,0.0453,0.2014,0.0217,0.0314,-0.0232,0.0406,-0.0469,0.0067,0.0224,0.062,0.0613,-0.0473,0.0085,-0.0166,-0.0395,0.0344,0.0992,0.1825,0.1495,0.0545,0.2166,0.1025,-0.0136,0.0666,0.0755,0.0037,-0.0109,0.0181,0.0908,0.0743,0.0863,0.0332,0.0063,0.0356,0.0945,-0.1356,0.0858,0.0398,-0.0914,-0.0377,-0.0418,-0.0268,-0.1478,0.0403,0.0111,0.0489,0.1351,0.0584,-0.0848,-0.0104,0.1191,0.0779,0.0668,-0.0089,0.0377,0.0135,0.0344,-0.0231,0.1129,0.1903,0.1581,0.1251,0.0057,0.1425,0.0536,-0.1407,0.0559,-0.1396,-0.0226,0.0236,-0.0459,-0.05,0.0997,-0.0075,-0.1162,0.0105,-0.0407,-0.0117,-0.0948,-0.0285,-0.054,0.0197,0.0132,0.0617,0.0426,0.0688,0.1047,0.0666,0.0643,-0.0131,0.0955,0.0431,0.0225,0.0046,-0.0379,0.0734,-0.0881,0.0184,0.092,-0.0004,-0.0356,-0.06,0.0422,0.0821,-0.0134,0.1029,0.0845,0.0282,0.1405,0.0731,0.0654,0.0736,-0.0019,-0.0519,-0.0731,-0.0716,-0.0885,-0.1468,0.0401,0.041,-0.0183,-0.0038,-0.0232,0.0519,-0.0814,-0.034,0.0549,0.027,0.0998,-0.1062,0.02,0.1432,0.1623,0.0526,0.0943,0.0748,0.1376,0.0551,0.0215,0.114,0.0198,-0.0383,0.0498,-0.1211,-0.0579,0.0681,0.009,0.0837,0.0108,0.0094,-0.0603,0.0263,-0.0218,0.0206,0.0253,-0.0509,-0.0172,-0.0476,0.0575,0.0349,0.0309,0.0373,0.0005,0.0767,0.1051,-0.0475,0.0168,0.0632,0.0312,0.0642,-0.1218,-0.2519,0.0123,0.047,-0.1843,0.0579,0.0495,0.0485,-0.3973,0.0397,-0.0816,0.0065,0.0819,-0.0091,0.0831,0.095,0.056,0.0058,0.018,0.0393,0.0028,-0.0165,0.0033,0.0538,0.0663,0.0627,-0.0313,-0.055,-0.0155,-0.0609,0.0454,-0.0113,0.0345,0.0684,0.0414,0.0279,0.0408,-0.0315,0.175,0.0328,0.0377,0.2214,0.0445,0.1094,0.0211,0.0929,0.0432,0.054,0.0937,0.0072,-0.0074,-0.0145,0.0473,-0.0361,0.0029,0.0029,-0.1128,-0.06,0.0077,0.0467,-0.2791,-0.0589,-0.0301,-0.0949,0.0243,0.0279,-0.0448,0.0427,-0.039,-0.0599,0.0108,0.029,0.0311,0.0358,-0.0296,0.0395,0.0326,0.1823,0.0881,0.2137,0.1438,0.0967,0.0864,0.0521,0.1741,0.0871,0.1994,0.1428,-0.0446,-0.0524,0.0156,0.0562,-0.0128,-0.0007,-0.0008,-0.0663,0.0581,-0.0258,0.1862,0.1989,0.1477,-0.0002,-0.1034,-0.0947,-0.0125,0.0503,0.0587,0.002,-0.0543,0.0446,0.0689,0.1133,0.014,-0.0082,-0.1088,0.0059,-0.0284,0.0526,0.0496,0.1194,0.061,0.2368,0.2077,-0.0325,-0.0665,-0.0933,-0.0007,0.1379,0.1129,-0.0336,0.007,-0.0285,-0.095,-0.0644,-0.0049,-0.0152,-0.0211,-0.0989,0.0543,0.0679,0.0842,-0.0653,-0.0345,0.1101,0.0812,0.0936,-0.018,-0.0579,-0.0694,0.0954,0.1218,0.0637,0.0458,0.037,0.003,0.0037,-0.0272,0.0546,-0.0354,-0.2034,-0.074,0.0195,0.0386,-0.0158,0.0467,0.0658,-0.0471,-0.0905,-0.2305,-0.3839,0.0115,0.0514,0.0523,-0.0609,0.0238,0.0947,0.0595,0.0753,-0.0285,-0.0516,-0.0846,-0.0705,-0.0296,-0.0121,-0.0162,0.0149,-0.1467,0.0168,-0.0251,0.0744,0.0025,-0.0268,-0.0085,-0.0443,0.0612,-0.0326,0.0165,0.0194,0.0553,0.1086,0.109,0.0335,-0.0457,-0.0025,0.0368,0.0395,-0.032,0.1039,0.1199,0.0117,0.1157,0.1576,0.0488,0.0251,-0.0048,0.0087,-0.2606,-0.0237,-0.0456,-0.0774,-0.0482,-0.1079,0.1224,0.0773,-0.001,0.0857,0.1863,0.1109,-0.1565,-0.1885,-0.2032,-0.086,-0.1495,0.0374,0.112,0.3397,0.265,0.2477,0.1689,0.3745,0.1854,0.095,0.1339,0.1294,0.0826,0.0385,-0.0488,-0.0233,0.032,-0.0981,-0.0719,0.0768,-0.0436,0.0173,0.0516,0.1195,0.1321,0.0946,-0.0242,0.0564,0.0307,-0.0242,-0.0273,0.0328,0.0568,0.1565,0.1795,0.1386,0.1264,0.0767,-0.2497,-0.0586,-0.0197,0.0752,-0.0004,0.2607,-0.0277,-0.0477,-0.1516,0.0742,-0.0139,-0.2298,-0.395,-0.331,-0.305,-0.0001,0.0436,-0.0034,-0.0461,-0.0359,-0.0535,0.075,-0.0293,0.0698,-0.2068,0.0132,-0.0273,-0.0786,0.0335,0.0084,-0.0452,0.108,-0.3076,-0.2796,0.0765,0.104,0.0086,0.0631,0.0622,-0.0635,-0.0833,0.1177,0.1033,0.0752,-0.0002,-0.158,-0.0746,0.0978,-0.0273,0.084,-0.0902,-0.0207,-0.0945,-0.2134,-0.0632,-0.0554,0.1185,0.0933,-0.171,-0.0504,0.0085,-0.0351,-0.1004,0.0182,0.0695,-0.0152,-0.0346,0.0992,0.0322,-0.0268,0.0511,0.0679,0.0313,0.0345,-0.1787,-0.0477,-0.0564,-0.1165,-0.0825,-0.0355,-0.0243,-0.0618,-0.0447,0.0686,-0.0828,0.009,-0.0456,0.3405,0.2614,0.1957,0.2931,0.0912,0.0236,0.0617,0.1193,0.052,0.0359,-0.2473,0.0192,0.1516,0.136,0.0198,-0.0751,0.0732,0.0257,0.026,-0.0762,-0.0279,-0.1953,0.1342,0.143,0.0232,-0.0928,-0.0354,0.0831,-0.1026,-0.1026,0.0877,0.0028,-0.06,-0.0203,-0.07,0.112,-0.0289,-0.2238,0.0713,0.1026,0.0816,0.0045,0.0402,0.0609,-0.0072,-0.0549,-0.1014,0.1114,0.0517,-0.0794,-0.2174,0.0034,0.0414,-0.0593,0.0777,-0.0818,-0.0464,-0.069,-0.0756,0.0773,0.006,0.0382,0.0555,0.0677,-0.1572,-0.0626,0.0698,-0.3932,-0.2834,-0.2924,-0.0378,-0.2506,0.1622,0.1332,0.0252,0.1156,-0.0389,0.0513,-0.0927,-0.0256,0.0725,0.0834,-0.2108,-0.0531,0.0174,-0.0023,-0.1916,0.0489,-0.0918,-0.0528,-0.0065,-0.2348,0.0855,-0.0647,0.0494,0.1568,-0.1593,-0.2324,-0.1743,-0.0863,-0.0711,0.0152,-0.1022,-0.0998,0.0788,0.0376,0.0088,0.1862,-0.0135,0.0579,0.0272,0.0643,0.1246,0.1107,-0.0392,-0.0239,-0.1451,-0.0534,0.1238,0.0133,0.0644,-0.0012,0.2062,0.209,0.1183,0.0047,0.0567,0.0434,0.0451,0.046,-0.0461,-0.1014,-0.0959,0.021,0.0347,-0.0636,0.0319,0.0572,-0.0471,-0.1174,-0.2398,0.0721,0.0385,-0.0617,0.1133,-0.0339,0.0443,0.0629,0.216,-0.0344,-0.07,-0.0771,0.0915,-0.0059,-0.0305,0.0532,-0.3421,0.2168,-0.0093,-0.219,-0.1801,-0.1531,0.0245,-0.0161,0.0967,0.0639,0.0682,0.1197,0.1152,0.0066,-0.0585,0.1,0.0937,0.0504,0.1267,-0.0296,0.1178,-0.04,0.0151,-0.0088,-0.0794,0.0135,0.0333,-0.0483,-0.0027,0.0984,0.0517,0.025,0.0827,-0.0174,-0.035,-0.0035,-0.049,0.0035,0.0296,0.0424,-0.066,-0.0788,0.072,0.0511,-0.0295,-0.2422,-0.2926,0.0563,0.085,0.1049,-0.0284,-0.0198,-0.0553,0.0328,0.0642,-0.0448,0.1279,-0.0305,-0.1698,-0.0417,0.0025,-0.0214,-0.0051,0.0278,0.1011,-0.1144,-0.0563,-0.0195,0.2165,-0.255,0.1098,-0.1074,0.1741,0.0184,0.0108,0.1479,0.0707,-0.0504,-0.0203,-0.0926,-0.1484,-0.0629,0.0548,0.043,-0.1278,-0.1745,-0.1627,-0.0647,-0.003,0.0264,-0.008,-0.1225,-0.0336,0.0551,-0.2296,-0.1602,-0.1514,-0.2311,-0.2303,0.0972,-0.0535,-0.0018,0.0118,-0.0958,0.0111,0.0426,0.0956,-0.0861,-0.0676,-0.1634,0.0755,0.0374,-0.0082,-0.1186,0.027,0.0084,0.0576,0.0367,0.0103,-0.0155,-0.0311,0.006,0.1111,-0.1078,-0.0115,-0.0497,0.0737,-0.075,0.0028,0.0551,-0.0302,-0.0662,-0.074,0.0133,-0.0215,-0.0714,-0.1033,-0.0922,0.0331,0.0205,-0.0823,-0.0222,-0.0736,0.0501,-0.0148,0.017,0.0606,0.0732,-0.0384,-0.0349,-0.199,0.0623,-0.1322,0.0352,-0.077,-0.1336,-0.0211,-0.3488,0.0697,0.0638,-0.0886,-0.0491,0.0412,0.0337,-0.0005,0.1815,0.1508,-0.0813,-0.1226,0.0856,0.0609,0.1851,0.0911,0.1515,-0.0316,-0.0111,-0.0618,0.0646,0.0448,0.1471,0.1089,0.1146,0.0203,-0.0806,-0.0439,0.0287,-0.0104,-0.033,-0.0128,0.011,0.0545,0.0286,-0.0096,0.0644,-0.0214,0.1093,-0.0033,0.1147,-0.0683,0.018,0.1696,0.1014,-0.0278,0.0152,0.2188,0.1443,0.0653,0.0482,0.08,-0.1043,-0.0525,-0.1301,0.0154,0.0301,0.0117,-0.0008,-0.0375,0.0094,0.0945,-0.074,-0.0458,-0.0334,0.0671,-0.0619,0.0679,0.0737,-0.0345,-0.0958,0.0136,0.0634,-0.0096,0.0133,0.1755,0.0506,0.0456,-0.0156,-0.0469,-0.3304,0.0565,0.0699,0.0368,0.0136,-0.0345,-0.036,0.026,0.1672,0.1208,-0.0176,0.0416,0.0718,0.0165,0.0279,0.0353,-0.1083,-0.0755,-0.1491,0.036,0.0359,0.0726,-0.0349,0.1215,0.1621,0.1698,-0.2648,-0.0783,-0.1077,0.0812,-0.0533,-0.1108,-0.0488,-0.1142,-0.1018,0.0424,-0.0097,0.0693,0.1574,-0.101,0.029,-0.0981,0.0482,0.0877,0.1325,0.0169,0.0246,0.0566,-0.0809,-0.3181,0.0455,-0.164,-0.149,-0.2061,-0.0594,-0.01,-0.0422,-0.0318,-0.1398,-0.0613,-0.0311,-0.0901,-0.0698,0.1157,0.0795,0.1233,0.0075,0.0891,0.1362,0.0291,0.06,-0.0324,0.0579,0.085,0.0862,-0.0664,0.0261,-0.0047,-0.1805,-0.1137,0.046,-0.0678,-0.1136,-0.119,-0.0586,0.1046,0.0406,0.075,0.0969,-0.0082,0.1773,0.2142,0.1494,0.0386,-0.1571,0.1241,0.0733,0.0565,0.082,0.0919,-0.0437,-0.0661,0.1206,0.0968,-0.0316,-0.0188,0.0746,0.0111,-0.0916,0.0057,0.0264,0.0006,0.0103,-0.0738,0.0642,0.0073,-0.0041,0.0386,0.2168,0.0129,0.0348,0.1185,0.1655,-0.0519,0.213,-0.1112,-0.0298,-0.0352,-0.0384,0.0158,0.0393,-0.0627,0.2244,0.2301,0.1766,-0.0371,0.192,0.0894,0.139,0.1211,0.0213,-0.0559,-0.023,0.0125,-0.0161,-0.0642,0.0477,0.0824,0.061,-0.0969,0.0746,0.089,0.1394,0.0486,0.042,-0.0253,0.0697,0.0454,0.1221,0.0832,0.0185,0.0397,-0.0786,0.0014,0.0457,-0.0701,-0.031,0.0145,0.1184,-0.0325,0.1141,0.0236,0.0329,0.1103,-0.08,0.0872,0.0653,-0.033,-0.2215,-0.1395,0.0012,0.0261,0.0332,-0.0522,0.0015,-0.0979,0.0488,0.073,-0.1083,-0.0666,-0.0135,-0.1141,0.0057,-0.0045,0.0676,-0.0404,0.0025,0.054,-0.0704,-0.0148,0.0868,0.0962,0.0482,-0.1273,-0.0651,-0.0683,-0.1661,-0.0566,-0.0749,0.1686,0.0638,0.0078,0.0414,0.1365,0.1198,0.0315,0.0754,0.0406,-0.4938,-0.28,-0.4046,-0.4415,-0.3025,-0.2988,-0.1345,-0.2051,-0.1413,-0.1099,-0.4304,-0.3113,-0.451,-0.4284,-0.1374,0.1668,-0.0612,-0.0214,0.039,0.0335,0.1832,-0.0316,0.0164,0.0108,-0.1642,-0.1536,0.0392,0.0594,-0.3072,-0.1587,-0.174,-0.2339,0.0038,0.1277,-0.0169,0.0346,0.0639,0.0628,0.0628,0.0939,-0.0418,0.0854,0.0335,0.0989,0.0307,0.2206,0.076,0.0374,0.1295,0.1653,0.0804,0.1623,0.1032,0.1463,0.0757,-0.2079,-0.2122,-0.1931,-0.0399,0.084,-0.1465,-0.1217,-0.1117,0.0271,-0.0063,-0.1222,-0.0109,0.0674,0.1149,-0.0097,0.0786,0.0081,-0.1025,-0.1156,-0.0323,-0.076,-0.1357,0.0379,0.1374,0.1004,0.2081,0.1998,0.1079,0.1117,0.0188,0.0282,0.1168,-0.2232,-0.0563,-0.0345,-0.0907,-0.0098,-0.0526,0.0021,0.0354,0.0137,-0.023,0.0283,0.0,0.0328,-0.0286,0.0065,0.0248,0.0555,-0.0075,-0.2229,-0.0544,0.0032,0.0641,0.0127,-0.0032,0.0264,-0.0275,0.1062,0.1539,-0.0373,0.0296,0.1917,-0.2615,0.0215,-0.0542,0.0741,-0.1337,0.0768,0.0734,0.0418,-0.0401,0.3047,0.2397,0.193,0.1126,0.1234,0.1661,0.1919,0.2046,0.1343,0.0994,-0.0337,-0.0309,-0.0485,-0.0766,-0.1043,0.1555,0.0282,0.0548,0.1146,0.0429,0.0357,0.0947,-0.028,-0.069,-0.1004,0.0634,-0.0379,0.0137,-0.2624,-0.1663,-0.3217,0.015,0.0085,-0.0076,0.0274,0.009,0.1001,-0.1011,0.1135,0.1727,0.1598,-0.1576,-0.21,-0.0511,0.1346,0.0229,-0.0924,-0.0254,0.1007,0.0952,0.0141,0.0875,0.1192,-0.2776,0.0132,0.063,0.023,-0.0493,-0.1121,-0.2866,-0.0675,-0.083,-0.0448,-0.0468,-0.3016,-0.2859,-0.2699,0.0091,0.0956,0.1163,-0.1026,0.0473,-0.006,-0.036,0.2026,0.1271,0.1502,0.0428,-0.0116,-0.0741,0.0458,-0.0497,-0.059,-0.0895,0.0333,-0.2213,-0.155,-0.0465,-0.0703,0.0206,-0.1688,0.0155,-0.2318,-0.1796,-0.0617,0.069,0.0101,-0.0481,-0.1363,-0.0121,-0.092,-0.0868,-0.1811,-0.1663,0.0386,-0.0299,0.0334,-0.0668,-0.0187,-0.0483,0.0303,0.0138,-0.1132,-0.1727,0.0486,0.0258,0.1471,0.0209,0.0556,-0.0057,0.0985,-0.0329,0.0094,0.0304,-0.0081,-0.0604,-0.1521,0.053,-0.0688,-0.0812,0.1281,0.0073,-0.0603,-0.0184,0.0066,-0.0397,0.1266,-0.1947,-0.0595,-0.0407,-0.0743,-0.1731,0.0032,-0.042,-0.0928,0.0391,-0.0793,-0.1291,-0.0904,0.0009,0.0986,0.114,0.1408,0.1268,0.0285,-0.0074,0.0209,0.109,-0.0205,-0.1404,-0.0185,-0.0807,-0.155,-0.0995,-0.0588,0.1498,-0.1243,-0.006,0.1808,0.2423,-0.1896,0.0831,0.009,-0.0371,-0.2345,-0.1921,-0.1921,-0.0582,0.024,-0.0031,-0.0349,-0.0696,-0.0434,0.0488,-0.0069,0.0603,0.0578,-0.021,0.0141,-0.0502,0.0808,0.1136,0.1085,0.001,0.0939,0.0364,0.0345,0.072,0.0493,-0.1235,-0.064,-0.1042,0.1672,0.0416,-0.0378,0.1573,0.1102,0.0558,0.0396,0.0396,0.0604,-0.049,-0.0862,0.0156,0.0099,-0.1931,-0.1372,-0.0478,0.0794,0.1011,-0.0552,-0.183,0.0307,0.0283,-0.1539,-0.1283,-0.0099,0.1014,-0.031,0.0161,0.0285,0.0164,-0.1175,-0.1342,-0.2692,-0.2328,-0.1288,0.0186,0.0024,-0.3495,-0.223,-0.0134,0.0023,0.0488,0.016,0.0507,0.0213,0.0102,0.0372,-0.0836,0.0015,0.0207,-0.1168,0.0891,0.1054,0.0326,0.0342,0.1715,0.0242,0.1739,0.0733,-0.036,-0.0594,0.0747,-0.4995,-0.4891,-0.2852,-0.2566,-0.1629,-0.0655,0.1085,0.0773,0.1443,0.0648,-0.0266,-0.0748,-0.0961,-0.0696,0.0601,-0.0,-0.1292,0.089,0.0485,0.0351,-0.003,-0.3972,-0.1133,-0.4115,-0.2798,-0.2697,-0.1739,-0.3397,0.1444,-0.1151,0.0959,0.1654,-0.0455,-0.0184,0.0745,0.0518,0.0835,0.0116,-0.0277,0.0559,0.0561,0.0829,-0.0173,0.0239,0.0972,0.1095,0.059,0.0396,-0.0196,-0.0779,-0.128,-0.1004,-0.0647,-0.2351,0.0068,0.0087,0.0279,0.0277,-0.0656,-0.0755,-0.035,-0.0383,-0.086,-0.1759,-0.0201,0.0313,0.0537,-0.0677,-0.0426,0.0017,-0.0249,-0.0464,-0.0263,-0.064,0.0183,-0.0155,0.0376,0.0445,-0.0824,-0.1108,0.1562,0.1279,0.0402,0.0569,-0.0022,-0.0032,0.0183,0.0905,0.0442,0.0844,-0.0552,0.0512,-0.0504,0.0068,-0.247,0.0491,0.0544,0.036,-0.0052,0.0782,-0.0343,0.1044,-0.0577,-0.1352,-0.0774,0.0514,-0.0125,-0.0338,-0.0162,0.0374,-0.099,0.0238,-0.0495,0.0629,-0.0978,0.025,0.0069,-0.0673,0.0451,-0.091,-0.1737,-0.0267,-0.0098,-0.0301,-0.0087,0.1047,0.0993,0.1057,0.1147,0.0018,-0.1122,0.0921,0.004,0.0389,0.1423,0.0575,0.08,0.0236,0.0054,0.0204,0.0692,0.2887,0.1649,0.0836,0.1712,0.0799,0.0757,0.1513,-0.0382,-0.1077,-0.0771,-0.0975,-0.0733,-0.115,-0.0952,-0.0322,0.0035,0.0348,0.0373,0.0824,0.0164,0.105,0.0089,-0.0188,0.0095,0.1108,-0.0006,-0.0083,0.0256,0.0497,0.0132,0.0277,-0.0151,0.0778,0.0464,-0.083,0.0567,0.051,0.0868,0.0272,-0.2249,-0.1792,0.0425,0.1152,-0.0509,0.0119,0.1044,0.1225,0.0429,0.0535,0.0729,0.0602,0.0774,0.0603,-0.1042,-0.0303,-0.0442,-0.0047,0.0029,-0.0214,-0.0034,0.0626,-0.0111,-0.0045,-0.0191,0.0787,0.1835,0.1641,-0.0089,-0.2023,0.0307,0.0278,-0.0351,-0.0054,-0.0201,-0.2078,0.0448,0.0623,0.0721,-0.0616,0.0246,-0.1582,-0.0566,-0.008,0.0435,0.0773,-0.0601,-0.032,0.0454,-0.0086,0.0387,0.1332,0.039,-0.0265,0.02,0.119,-0.0328,-0.1541,-0.1863,0.0028,-0.0354,0.032,0.0276,0.0287,-0.025,-0.012,-0.0389,0.0369,-0.009,0.1282,-0.0442,0.0687,0.0545,-0.0628,0.0184,-0.1054,-0.1646,0.0528,0.0367,0.0645,-0.0544,0.0819,-0.0008,-0.0798,0.0286,0.0529,-0.0826,-0.0179,-0.1691,0.0207,0.0226,0.1983,0.1308,0.1299,0.1132,0.0305,-0.0095,-0.0682,0.0782,-0.0425,-0.0359,0.1307,0.0455,0.0349,0.1074,-0.2049,0.1192,0.0066,0.157,0.0923,0.0105,-0.0699,0.0411,0.0563,-0.0036,-0.1441,0.0689,0.0138,0.0372,-0.0702,0.0411,-0.0016,-0.03,0.0394,-0.346,-0.1461,-0.1604,0.1192,0.1151,0.0201,0.1,0.1826,-0.0066,-0.1869,0.0497,0.0462,0.0303,0.1883,0.0003,0.0493,-0.0509,-0.0635,-0.0107,0.1693,0.181,0.1439,0.0391,-0.115,0.0429,0.0892,0.2007,-0.0084,-0.019,-0.0469,0.0837,-0.0055,-0.3738,-0.3778,0.0166,-0.0331,0.0149,0.0056,-0.0526,-0.0685,-0.0278,0.0794,-0.0238,-0.0534,0.2028,0.0064,0.0306,0.1429,0.0325,0.1089,0.0779,0.1799,0.0737,0.0525,0.1217,0.0857,0.0158,-0.2469,-0.1728,-0.032,0.1512,0.0525,-0.4103,-0.3182,-0.2903,-0.0167,0.0768,-0.2772,0.0423,0.0192,0.0002,-0.0355,-0.0746,-0.0856,0.0161,0.0285,-0.2815,-0.1789,-0.3161,-0.0792,0.0171,0.0837,-0.0216,-0.1124,-0.0615,-0.0238,-0.033,-0.0015,0.0609,-0.0282,-0.0283,0.0282,0.0512,0.0384,-0.0199,0.0589,-0.0622,0.1623,0.0585,0.1059,-0.0596,-0.064,0.0177,0.0408,0.0012,-0.1904,0.0205,-0.0968,-0.1009,-0.1012,-0.0385,-0.0448,-0.0228,-0.0077,-0.3148,-0.1515,0.0835,-0.0162,-0.1404,-0.0421,-0.0526,-0.0492,0.0454,-0.0396,-0.0291,0.0011,-0.0807,-0.3687,-0.0844,0.0995,0.0394,0.0164,-0.1776,-0.0323,0.0137,-0.0713,-0.179,-0.0543,-0.0798,-0.0867,-0.1458,-0.048,-0.1425,-0.0964,0.0144,0.0544,-0.0689,0.1033,-0.1103,-0.1506,-0.1572,0.0062,0.0165,-0.0451,-0.036,-0.4409,-0.0021,0.0445,0.0367,0.0647,0.2073,0.0856,0.0935,0.0581,0.0744,0.0983,0.0029,0.0723,-0.4308,-0.3637,-0.3417,0.0634,-0.1734,-0.1565,-0.0203,0.0436,0.0488,0.0131,-0.2226,-0.0508,-0.0687,0.0038,-0.0737,-0.0753,0.0071,-0.0473,-0.0522,-0.0167,0.0886,0.0015,0.0904,0.0537,0.0854,0.0307,-0.0432,-0.0787,0.1081,0.0867,0.0703,-0.1557,-0.1223,-0.2061,-0.0857,-0.0732,-0.066,-0.189,-0.1732,-0.0351,0.0343,0.0646,0.0397,-0.0675,0.0043,-0.0127,0.0398,0.0607,0.0239,-0.0305,-0.0346,0.0681,0.096,0.0295,-0.1383,-0.2823,-0.34,-0.139,0.1044,-0.0452,-0.078,-0.0308,-0.0396,-0.0687,-0.0792,-0.0336,0.0758,0.1431,0.0444,0.0522,-0.0324,-0.0489,-0.0527,0.0454,0.0866,-0.0272,0.0552,0.0715,-0.2344,0.026,0.0474,-0.0199,0.0177,0.0359,0.0827,0.0496,0.0959,0.0354,0.0138,-0.0598,-0.0455,-0.0388,-0.0478,0.0724,-0.0711,-0.2119,-0.068,0.0667,-0.1683,0.0723,-0.0594,0.1009,0.154,0.0108,-0.0012,0.046,0.0029,-0.0812,0.0733,0.0654,-0.0555,-0.1027,0.0441,-0.036,-0.0562,-0.0302,0.0931,0.1389,0.0755,-0.0935,0.0292,0.115,0.0861,-0.0574,-0.0074,0.0836,0.0103,-0.1425,-0.0209,-0.1293,-0.0344,-0.0125,-0.2203,-0.0568,-0.1331,-0.1758,-0.2165,-0.1146,-0.465,-0.463,0.0301,-0.0095,-0.0717,-0.0265,-0.0358,-0.3377,-0.3352,-0.0423,-0.0214,-0.0007,0.0494,-0.0324,-0.036,-0.0194,0.0505,0.032,0.1108,-0.0357,-0.0265,-0.0345,0.0939,-0.0082,-0.0358,-0.0042,0.0457,0.0659,-0.3225,0.088,0.0478,-0.3669,-0.096,-0.0969,0.0216,-0.048,-0.0419,-0.1161,-0.0092,-0.0112,-0.037,-0.0258,0.0311,-0.0109,0.0043,0.0073,0.0169,-0.0275,0.0392,-0.1456,-0.037,0.0255,-0.0584,-0.0751,0.094,0.136,0.0441,0.0483,-0.0837,-0.0144,-0.0689,0.1845,0.1435,0.1238,0.0603,0.1114,-0.0345,-0.1921,-0.0808,-0.0358,-0.0347,-0.0357,-0.0093,-0.0117,0.0801,0.0985,0.0887,0.07,0.1108,-0.0082,-0.073,0.135,0.073,-0.0295,0.0548,-0.0797,-0.1634,0.1256,0.0543,0.0827,0.0937,0.0174,-0.0001,0.0928,0.1372,-0.0709,-0.0091,0.0617,0.0316,0.0811,0.0829,-0.093,-0.1045,-0.1215,-0.1072,-0.0655,-0.0382,-0.0739,-0.0132,-0.1914,0.0445,-0.2022,0.0699,0.051,0.006,-0.1552,-0.152,0.0814,-0.0696,-0.0044,-0.032,0.0164,-0.2491,-0.0015,0.0095,-0.1237,-0.0542,0.0365,0.039,-0.0035,0.0279,-0.0916,-0.2681,0.1113,0.1292,-0.1831,-0.2111,0.014,-0.1571,0.0868,0.0356,0.083,0.1169,-0.0007,0.0428,0.0651,0.0261,0.0032,-0.0679,-0.0414,-0.0183,-0.0792,-0.1101,0.056,-0.0119,0.0063,0.0218,0.0418,0.0781,0.0209,0.0335,-0.0479,-0.0173,0.0797,-0.0063,0.0344,0.0321,0.0953,0.0466,0.0269,-0.0477,0.0134,0.0188,0.0497,0.0232,-0.0764,0.1047,-0.0988,0.0177,0.0217,0.0515,0.0731,0.0732,0.0361,0.0841,-0.0134,0.0661,-0.0547,0.0016,-0.2254,-0.0059,-0.1274,0.0044,0.0967,-0.0378,-0.0058,-0.0812,-0.0581,0.0212,0.074,-0.1239,0.0642,-0.0352,0.0037,0.2442,0.0185,0.1712,0.0167,0.0956,0.0023,-0.1033,0.1673,0.0867,-0.0658,-0.0255,0.0483,-0.0817,0.0112,0.0925,0.0048,0.0543,-0.0324,0.0131,-0.015,-0.0072,0.0231,0.1045,0.0569,0.0886,0.036,0.0565,0.0786,-0.3972,0.1135,0.2693,0.0221,0.0699,0.185,0.1566,-0.0296,0.028,-0.0418,-0.0506,-0.073,-0.1157,0.0065,0.1271,-0.0759,-0.1025,-0.0572,0.0277,0.1375,0.2189,0.1737,-0.0303,0.0255,0.1113,0.1597,0.0575,0.0049,0.2149,0.1605,0.1552,0.1305,-0.0568,0.0079,0.0581,0.0415,0.1544,-0.0207,0.0915,0.1439,-0.1182,0.1141,-0.0354,-0.1839,0.0174,0.0334,-0.017,0.1338,-0.2185,-0.0245,0.0863,0.0531,0.0484,-0.3604,-0.2283,0.1335,0.1339,-0.0025,-0.0745,0.0548,0.1541,-0.0343,0.0104,-0.0061,-0.0128,-0.024,-0.0285,-0.025,0.102,0.0493,0.0143,0.1227,0.1068,-0.0561,-0.051,-0.0439,0.0457,0.0391,0.0347,0.0007,-0.0219,0.0479,0.1387,0.1672,0.1384,0.0689,0.1198,-0.0093,-0.0195,-0.0232,0.0978,0.1103,0.0771,0.1504,0.089,0.0302,-0.0105,-0.0265,0.0772,0.0507,0.0059,0.0534,0.0472,-0.1316,memory
trm_555cfb890d721,0.0709,0.0712,0.0759,0.0907,-0.0168,0.0368,0.0588,-0.0353,-0.0382,0.057,0.0322,0.0408,0.0669,0.0474,0.0749,0.02,0.051,0.1589,-0.0096,0.1397,0.1046,0.0461,0.0488,0.0204,0.0115,-0.0055,-0.0082,0.1063,0.1236,0.0609,0.0858,0.149,0.0884,0.0476,0.1097,0.0972,0.0098,0.0229,0.1065,0.0349,0.0736,0.0606,0.0333,0.0146,0.0649,0.0807,-0.0206,0.0391,-0.0218,0.0855,0.0199,-0.1368,-0.0726,-0.0244,0.0597,0.0266,0.0262,0.0554,0.0291,0.0573,-0.001,-0.0033,0.1141,-0.1066,-0.0293,-0.151,0.1798,0.2619,0.142,-0.0042,-0.0453,-0.0468,-0.0914,0.0957,0.0294,0.0066,0.036,0.0142,-0.0146,-0.0207,-0.0064,-0.0218,0.038,0.135,-0.0325,-0.0556,-0.0445,-0.0456,0.0682,0.0277,0.0404,-0.0778,0.0219,-0.2753,-0.2177,-0.2248,-0.1559,-0.0908,-0.2637,-0.2326,-0.05,-0.0094,-0.1115,-0.2109,-0.1335,0.13,0.16,-0.0641,-0.016,0.027,0.0279,0.122,-0.0483,-0.1403,-0.0197,0.0233,0.128,-0.1008,0.0619,0.073,0.1404,0.135,0.1728,0.0344,0.0826,0.1526,0.1337,-0.0446,-0.0587,-0.0703,0.1019,0.0726,0.0223,0.1288,0.0709,0.1948,-0.0037,0.1261,0.0451,-0.0078,0.0972,0.0948,-0.0183,0.0779,0.088,-0.0658,0.0365,0.033,0.0615,0.0018,0.0638,0.1174,0.1123,0.1859,-0.068,-0.0641,-0.0233,-0.0641,0.0603,0.0684,0.0563,0.1113,0.2233,0.1748,0.0085,-0.0259,0.0576,0.189,0.1845,0.0116,0.034,0.1563,-0.0472,0.1946,0.0959,0.157,0.0966,0.1635,0.0756,0.0121,0.1011,-0.0268,0.0848,-0.0157,0.0428,0.0511,0.0149,0.1066,0.0945,0.103,0.0937,0.0875,-0.0059,0.2321,0.2168,0.0764,0.1074,0.0909,0.0615,-0.1193,-0.0956,-0.2301,0.1297,0.0961,0.0325,0.0112,0.1492,0.0256,0.0381,0.0235,0.1816,0.1097,-0.053,-0.0032,-0.015,0.0251,-0.0329,0.0165,-0.0738,-0.0171,-0.0529,0.0875,0.0995,0.0184,-0.0671,-0.0077,0.0772,-0.1461,0.045,-0.0411,-0.1217,0.0475,-0.1031,0.0601,0.0513,-0.1516,0.0464,0.0122,-0.0296,0.0485,-0.0156,0.1142,-0.0109,-0.0759,0.0684,0.0608,0.1007,0.1314,-0.0045,0.2007,0.0269,-0.0445,0.0053,-0.011,-0.0231,0.1965,-0.0352,-0.0111,-0.0754,-0.1092,-0.0697,-0.1736,0.1103,-0.0622,-0.1283,-0.1791,-0.0322,0.0238,-0.0041,0.0238,0.0412,-0.0508,0.1051,0.0214,-0.046,-0.0409,-0.049,0.0618,0.0062,-0.0566,-0.0685,0.0855,0.0635,0.2073,0.1818,0.0274,-0.0068,-0.0388,-0.0192,0.0558,0.0804,0.0394,-0.0259,0.1151,0.0479,-0.0139,0.0666,-0.0711,0.0366,-0.0778,-0.1181,0.2339,0.0413,0.12,-0.0704,-0.0863,0.0758,-0.0055,-0.079,0.0289,-0.0398,0.0013,0.0688,0.0166,0.0304,0.0196,-0.0506,-0.0578,-0.0225,0.1296,0.0091,-0.0015,0.1034,0.1158,0.0515,0.0688,0.0214,0.0593,0.0092,0.0589,-0.0097,0.0614,0.058,0.0094,0.0468,-0.0893,-0.0755,0.0936,0.0172,0.1608,0.1434,0.0419,-0.1262,-0.0745,-0.0304,-0.0298,0.1368,0.1046,0.0735,0.058,-0.0155,-0.1452,-0.0508,-0.0491,0.0151,-0.0112,0.0238,0.117,0.0798,0.0591,-0.0423,0.0473,-0.1085,-0.0568,-0.0798,-0.0872,0.0322,-0.1395,-0.031,0.1345,0.0368,-0.0697,-0.0047,-0.137,0.173,-0.0398,0.0936,-0.0446,-0.0368,-0.0618,-0.07,-0.1343,0.1168,0.0169,-0.0195,-0.0417,0.0571,0.0085,0.007,-0.0006,-0.0496,0.0394,-0.0847,0.0635,-0.1047,-0.1521,-0.0859,0.1148,0.0258,0.0807,0.0627,-0.0103,-0.0158,0.0839,-0.0278,-0.0493,-0.0132,0.0367,0.1363,-0.0068,-0.0529,0.1559,0.0647,-0.0737,0.1236,0.1195,-0.0848,0.0684,0.1415,0.026,-0.0032,0.0827,0.0342,0.1812,0.1591,0.0302,0.1009,-0.0244,0.1054,-0.0213,0.017,-0.0801,-0.0147,-0.0229,0.1074,0.0075,-0.1008,-0.0419,0.1555,0.0848,-0.0622,-0.0928,-0.033,-0.0433,0.0623,0.0567,-0.035,-0.1313,0.1339,0.063,0.0024,-0.0486,0.0849,0.0566,-0.0356,0.182,-0.0161,0.0509,0.0254,-0.0266,-0.011,0.0177,0.0395,-0.0053,0.1528,0.09,-0.0393,-0.1549,0.0819,-0.0218,-0.057,-0.0447,-0.1463,-0.0031,0.0389,0.0286,-0.1148,-0.0682,0.0017,0.0463,-0.1534,-0.0682,-0.0776,-0.0894,-0.0837,-0.0737,0.0041,-0.0358,0.1305,-0.007,-0.0548,-0.1716,0.0929,0.1116,-0.0802,0.036,0.0643,-0.0303,-0.0089,0.1304,0.1275,0.0557,0.0721,0.0565,0.0716,0.0853,0.0318,0.0411,0.013,-0.1262,0.1463,-0.0518,0.0257,0.0008,-0.0288,-0.0637,0.12,0.0922,-0.1877,0.022,0.0503,0.0514,-0.0219,-0.0874,-0.0997,0.0171,-0.0941,-0.1341,-0.0777,-0.0798,0.0016,-0.0247,-0.0191,0.1595,0.1072,-0.0191,0.1431,0.0339,0.0646,0.1172,0.0684,0.0035,-0.0421,0.03,0.0691,-0.0393,0.0328,-0.004,-0.0095,0.0359,-0.0721,0.0707,-0.0235,-0.1323,-0.0302,0.1455,-0.0466,-0.0447,-0.0106,0.0054,0.1156,0.0564,0.1035,-0.0566,0.0839,-0.0498,-0.0102,0.0954,-0.0026,0.067,0.0581,0.0788,0.038,-0.0013,-0.2159,-0.2293,-0.0847,-0.0478,-0.0641,-0.0299,-0.0076,0.1016,0.05,0.0343,-0.0724,-0.0141,-0.1036,-0.0181,-0.1115,0.0851,0.0789,-0.0301,-0.0642,-0.0649,-0.0395,-0.0332,0.2122,0.0664,-0.1311,0.0497,0.0115,-0.0309,-0.029,-0.0689,-0.0608,-0.226,0.0178,0.138,0.1345,0.0048,0.1391,0.018,0.0022,0.0925,0.1913,0.0665,0.0637,0.0157,0.0377,0.1881,0.0473,0.1447,-0.0681,0.0498,0.012,-0.1075,0.0274,0.1175,-0.0468,-0.0473,-0.0464,-0.143,0.0904,0.0027,0.002,-0.1325,-0.0507,-0.031,0.0887,-0.0454,-0.0089,-0.0997,-0.0522,-0.1456,0.0569,0.0184,0.1878,0.1344,-0.1192,0.1768,-0.009,0.1025,-0.1328,0.1212,0.0465,-0.0694,-0.1862,0.0097,0.0146,0.0223,0.1659,-0.182,-0.1404,-0.148,-0.1599,-0.0778,-0.0679,0.1562,-0.1234,-0.0135,-0.0363,0.0557,0.0422,-0.0296,0.0234,0.0673,-0.2568,0.119,0.0427,0.0464,0.0196,-0.0494,-0.0028,-0.0006,-0.1163,0.121,0.0716,0.0209,-0.0022,-0.0776,-0.0162,-0.096,-0.1202,-0.0032,-0.0241,0.1433,-0.0168,0.0435,0.046,0.003,-0.0334,0.0083,0.0625,0.1064,0.0778,0.0103,0.0853,0.0773,0.0568,-0.0401,-0.0308,0.0408,0.0913,-0.0504,0.078,0.0788,0.0285,-0.0034,0.1337,-0.0435,-0.1087,0.0507,0.224,0.2195,0.1666,0.0486,0.0342,0.1135,0.0408,-0.079,0.0242,0.0109,0.0049,-0.0711,-0.0954,-0.0177,0.0574,-0.0653,-0.082,-0.1637,0.1941,0.0323,0.0247,-0.0165,0.0648,0.1662,-0.0421,-0.0801,0.0934,-0.0273,0.0045,-0.1021,0.1861,0.2893,0.2348,0.1598,-0.0293,-0.0221,0.0256,-0.0273,0.043,-0.1268,-0.0823,-0.0306,-0.0486,-0.0139,0.096,0.0419,-0.0384,-0.0503,-0.0402,-0.0875,-0.0148,0.0122,-0.0611,0.0863,-0.0264,0.0891,0.1328,0.0432,0.1748,0.1672,0.0801,-0.0253,0.0094,0.0045,0.0167,0.0535,-0.0392,-0.0606,-0.015,0.0814,-0.021,0.022,-0.0355,-0.0445,-0.0571,0.0805,-0.0997,0.2348,0.2174,-0.0045,0.0107,-0.0408,0.0905,0.0219,-0.0531,-0.0274,-0.0348,-0.1789,-0.0389,-0.1587,-0.0823,-0.098,-0.0184,0.0143,-0.1197,-0.0943,0.0182,-0.0385,-0.0349,0.1912,0.15,0.0092,0.0803,0.0571,0.2664,0.1159,0.1534,0.1311,0.206,0.0441,0.0517,-0.032,0.0753,0.0312,0.0332,-0.0974,-0.1132,0.0174,-0.0398,-0.0005,-0.025,-0.013,-0.0542,0.0257,-0.0718,-0.0884,0.0783,-0.1118,-0.0577,0.0104,0.0845,0.0396,0.0619,-0.0215,0.0061,0.2391,0.1214,-0.0261,-0.0735,-0.0804,-0.0302,-0.0091,-0.1116,-0.1719,0.0701,0.1136,-0.1428,0.0208,0.0003,0.1231,-0.2393,0.0948,-0.117,-0.0447,0.0569,-0.0594,0.143,0.1367,0.1209,-0.1259,0.0913,0.1089,0.1066,-0.0327,0.0292,0.1502,0.1078,0.1636,-0.0551,0.0014,-0.0462,-0.0779,0.0128,-0.0714,0.1406,0.0852,0.0802,-0.0714,0.0964,-0.021,0.019,-0.0082,-0.0417,-0.1278,-0.0597,0.1122,0.0827,0.1002,0.1047,0.1035,0.0795,-0.0273,-0.1055,-0.0926,0.0155,0.0527,-0.0557,-0.1258,-0.1162,-0.0361,0.0292,0.0712,-0.0745,0.0082,0.0196,-0.0531,-0.0048,0.102,-0.038,-0.1012,-0.0291,0.0273,0.0147,-0.0453,0.0534,0.0686,0.0114,0.1519,0.1494,0.2118,0.1141,0.2104,0.0621,0.019,0.0962,0.086,0.102,0.1337,0.1317,0.1597,0.0165,-0.0276,-0.0502,-0.0227,-0.0787,-0.0035,-0.0064,-0.0492,-0.0222,-0.0882,0.0554,0.0117,0.0045,0.0399,-0.0242,-0.0672,-0.0545,-0.0615,-0.0265,-0.0661,-0.0397,-0.0533,0.0424,-0.0112,0.0403,0.0396,-0.0068,0.0008,0.0272,0.0093,0.1323,0.1515,0.076,0.2181,0.1917,-0.0725,-0.119,-0.0686,-0.0451,-0.0264,-0.0261,-0.0199,-0.006,0.0057,-0.0348,-0.0807,0.0208,0.0276,0.0572,0.0653,0.0387,-0.0184,0.0001,0.0669,0.0399,0.0864,0.1391,0.1138,-0.1212,-0.0901,-0.1197,-0.0162,0.0121,0.1043,0.0345,-0.0225,0.0116,-0.0166,0.0156,-0.007,-0.0057,-0.099,-0.0384,0.0027,0.0751,0.0152,0.0937,-0.0178,0.0693,-0.0659,-0.1998,-0.3554,-0.0367,-0.0307,0.0305,-0.0101,0.0248,0.0554,0.088,0.0934,-0.0059,-0.0502,-0.0814,-0.0119,-0.0016,-0.0482,-0.0088,0.0658,-0.0583,0.0712,0.0665,0.1146,0.0716,-0.1347,0.009,-0.0706,0.1021,-0.1493,-0.0744,-0.0073,0.0772,0.0645,0.0092,0.0108,-0.0781,0.1038,0.0889,0.0033,0.0079,0.1315,0.1073,0.045,0.0492,0.0626,0.0653,0.0576,0.0685,-0.026,-0.1804,-0.0277,-0.0394,-0.0977,0.0742,-0.0936,0.1041,0.0195,0.0112,0.1051,-0.1831,-0.1391,-0.2594,-0.2134,-0.2317,-0.0916,-0.2486,-0.0801,0.2142,-0.0149,-0.0251,0.0091,0.0016,0.0524,0.0875,0.0352,0.075,0.0691,0.0405,0.0111,-0.0782,-0.0335,0.0955,-0.1355,-0.1106,0.0366,-0.0829,0.039,0.0708,-0.002,0.0513,0.1263,0.0015,0.1201,-0.0205,-0.0316,-0.1103,0.0569,0.1496,0.1503,0.1141,0.0744,-0.0029,-0.0527,-0.1027,0.0161,0.0915,0.1399,0.051,-0.0303,0.0965,-0.171,-0.2089,0.0997,-0.0257,-0.0717,-0.2555,-0.2672,-0.2086,-0.101,-0.0614,0.014,-0.082,-0.0515,0.0655,0.1474,-0.0862,0.1134,-0.1493,0.0223,0.0186,-0.0268,0.143,0.0121,0.0007,0.0985,-0.1648,-0.1324,-0.0566,0.0912,0.0165,0.0351,-0.0921,-0.0768,-0.083,0.2396,0.2294,0.0625,0.0672,-0.0624,0.0749,0.1274,-0.0094,0.0495,-0.1583,-0.0958,-0.1122,-0.2448,-0.0358,-0.0608,0.0919,-0.0243,-0.1549,-0.1173,0.0525,-0.0817,-0.1943,0.0052,0.0748,-0.1238,-0.0885,0.0603,0.0854,-0.0263,0.1493,0.0987,0.1796,0.0366,-0.1738,0.0424,0.0037,-0.1096,0.0073,-0.0452,0.0392,-0.0218,-0.0113,0.0788,-0.0271,-0.101,-0.0087,-0.0509,-0.0274,-0.0705,-0.0483,0.1289,0.0282,0.0969,0.1228,0.0926,0.0667,-0.0843,-0.105,0.1531,0.18,-0.0893,-0.0776,0.0765,-0.0739,-0.004,-0.0541,-0.0173,-0.2302,0.166,0.1828,-0.0005,-0.1238,-0.0578,0.0468,-0.0141,-0.0141,0.2106,-0.0145,-0.0277,-0.0226,-0.0216,-0.0048,0.0169,-0.2526,0.2476,0.2564,-0.0296,0.014,0.188,0.2036,0.142,-0.0029,-0.0437,0.082,0.0306,-0.0135,-0.2047,0.0066,-0.0263,0.0225,-0.0178,0.0056,-0.1097,-0.0875,-0.03,0.0836,0.0108,0.0625,0.0642,0.0787,-0.0711,-0.0384,0.0295,-0.2514,-0.1441,-0.2263,-0.0076,-0.1908,0.1397,0.1177,0.0073,0.1523,-0.0223,0.1347,0.1231,-0.0251,0.085,0.2058,-0.0777,0.0085,0.1157,-0.0227,-0.0718,0.0019,0.0491,0.0358,0.0621,-0.0215,0.0682,-0.0616,0.0521,-0.0864,-0.1293,-0.1504,-0.1725,-0.0535,-0.0519,0.01,0.0742,0.0797,0.0454,0.1109,0.0382,0.1831,0.0098,-0.0297,-0.0074,0.0397,0.1957,0.1412,0.0093,-0.0223,-0.0253,-0.0401,0.0857,-0.0353,0.0517,0.0734,0.1792,0.2408,0.1349,0.0152,0.1671,0.1781,0.022,0.0173,-0.0286,-0.0557,-0.031,0.1154,0.1104,-0.0859,0.1236,-0.0165,-0.0063,-0.1025,-0.0494,0.129,0.0142,-0.1223,0.0615,-0.0087,0.0266,0.0669,-0.0182,-0.1025,-0.0501,-0.0497,0.1966,-0.0617,-0.0419,-0.0044,-0.2903,0.0592,-0.0243,-0.1111,-0.0804,-0.1985,0.0482,0.0106,0.1232,0.0595,0.1295,0.1566,0.1028,-0.0472,-0.0244,0.088,0.1292,-0.0003,0.0955,-0.0184,0.0512,0.0672,0.0231,0.0274,0.0091,-0.0353,0.0749,0.0197,0.0858,0.1141,0.0854,0.0547,0.0878,0.0422,-0.0657,-0.0232,-0.0852,0.0302,0.0161,0.0281,-0.0365,-0.0305,0.0697,0.1485,-0.0666,-0.0486,-0.1147,0.0198,0.0057,0.0512,-0.0431,-0.0525,0.0227,0.0352,0.0733,0.0014,0.1899,0.0172,0.0166,-0.0094,-0.0003,0.0277,0.0314,0.0701,0.1212,-0.1594,-0.1246,-0.0121,-0.0675,-0.1473,0.0209,-0.0734,-0.0067,0.0091,0.0383,0.0354,-0.1276,0.0184,-0.0249,-0.0176,-0.0228,0.0227,0.0535,-0.0283,-0.0423,-0.0829,-0.1275,-0.1185,0.0406,0.0577,0.024,-0.1114,-0.0784,-0.0466,-0.023,-0.0611,-0.072,-0.0428,-0.064,0.0081,-0.0818,-0.015,-0.0195,-0.0978,-0.0572,0.1743,0.1205,-0.0252,-0.0123,0.0326,0.0738,0.0424,0.0726,0.0157,-0.063,0.0092,0.0318,0.0059,-0.0099,-0.0672,-0.1416,0.065,0.0121,-0.0388,0.0126,0.0344,0.0555,-0.0723,-0.0092,0.0247,-0.1433,-0.0924,-0.0802,0.0837,0.0691,-0.0171,-0.2497,-0.2382,0.1249,0.0981,-0.1118,0.0419,0.0445,0.0627,0.1203,-0.0295,0.035,0.066,-0.0335,-0.0243,-0.2523,0.0655,-0.131,-0.0176,-0.0458,-0.0985,-0.1864,-0.1588,0.0908,-0.1101,-0.0667,-0.0533,-0.0292,-0.008,0.0595,0.0427,0.0418,-0.0149,-0.0819,0.0232,-0.0053,0.0161,-0.0083,0.0961,0.018,0.0517,-0.1236,0.1026,0.0038,-0.0328,0.0933,0.085,0.0057,-0.0521,0.0756,0.0668,-0.0357,0.035,-0.0892,0.0497,-0.0475,-0.0916,0.0385,0.0504,-0.0381,0.0438,0.0484,-0.0365,-0.1239,-0.0579,0.0894,-0.047,-0.0384,-0.023,-0.1108,0.1431,0.15,0.0066,0.1264,-0.1069,-0.086,-0.162,0.0703,0.0318,-0.0087,0.0245,-0.0127,0.0092,0.0785,-0.0496,-0.0414,-0.0364,0.0027,-0.1577,-0.1644,-0.1069,0.035,0.0345,0.0953,0.079,-0.0948,-0.0432,0.1051,-0.0057,-0.0208,-0.0267,-0.0759,-0.173,0.2044,0.1085,0.0201,-0.0173,-0.0176,-0.0668,-0.0284,-0.0723,-0.0864,-0.0657,0.0283,0.101,0.0139,0.0101,-0.0619,0.0074,0.0558,0.0285,-0.0246,0.033,0.0214,-0.1663,0.1637,0.1326,0.067,-0.1725,-0.0622,-0.125,0.0516,0.0088,-0.0361,-0.0576,-0.1178,-0.1066,-0.063,-0.0007,0.0374,0.0586,-0.1182,0.1244,-0.0903,0.1983,0.0798,0.1123,0.1106,0.0371,-0.011,-0.017,-0.172,0.0812,-0.0701,-0.0696,-0.0655,0.0433,0.0355,-0.0023,-0.0579,-0.0474,-0.0739,-0.1224,-0.1004,-0.151,0.2116,0.1577,0.1772,0.0014,0.0265,0.1115,0.0957,0.0865,0.0599,0.0974,-0.0533,0.0515,-0.1175,-0.0083,-0.0083,-0.1349,-0.0411,0.0173,-0.0232,-0.0513,0.0842,0.0096,0.153,0.0611,0.1049,0.0294,-0.0598,-0.095,0.0156,-0.0012,-0.0308,-0.0225,0.3108,0.1954,0.1953,0.1516,0.036,0.0019,-0.068,0.1707,0.1646,0.092,0.0344,0.0112,-0.0249,-0.0057,0.0539,0.0187,0.0335,0.1261,0.0521,0.1006,-0.0263,0.0406,0.0219,0.2513,0.0116,0.0675,0.1415,0.2711,-0.0693,0.1497,-0.0239,0.0739,0.0168,0.0251,0.0513,0.1536,0.0749,0.1969,0.0754,0.0665,-0.1057,0.0793,-0.0283,0.1496,0.0356,-0.0295,-0.1589,-0.0044,0.0074,0.011,-0.1511,0.1267,0.1501,0.1048,-0.004,0.0949,0.1507,0.1671,0.089,0.0829,0.0321,0.0502,0.0507,0.2668,0.0378,0.0288,0.0926,0.003,0.0649,0.0464,0.045,-0.0259,-0.0053,-0.0204,-0.0014,0.1019,0.16,0.0945,0.1708,0.0204,0.1676,0.1235,-0.0247,-0.1729,-0.135,-0.0156,0.0817,0.0156,-0.1479,-0.1439,-0.1599,0.1979,0.2328,-0.0338,-0.0754,-0.0236,-0.013,-0.0245,0.0346,0.0241,0.0046,0.0545,0.0921,-0.0127,0.0659,0.1032,0.0556,0.0929,-0.0813,0.0351,-0.0572,-0.1851,-0.1286,0.0163,0.1816,0.1193,0.084,0.1015,0.2827,0.1881,-0.1799,0.0615,0.1,-0.3308,-0.1766,-0.2225,-0.3327,-0.1632,-0.1562,-0.1847,-0.1021,-0.088,-0.1117,-0.2747,-0.1638,-0.2581,-0.3254,-0.2203,0.1876,-0.0161,-0.0578,-0.1628,0.0266,0.1397,-0.0642,0.0195,0.0326,-0.1208,-0.0928,0.0442,0.0323,-0.1011,-0.0257,-0.0153,-0.1293,0.0651,0.0073,-0.1439,-0.1385,0.0433,-0.0094,-0.0277,-0.0123,-0.0716,0.0186,-0.0096,0.0456,0.0151,0.3016,0.1178,0.1427,0.1489,0.1077,0.1381,0.1883,0.1194,0.0553,0.0989,0.0182,-0.0909,-0.1218,0.037,0.2467,-0.1418,-0.0138,-0.0683,-0.0257,0.0634,-0.0865,0.0895,0.0889,0.0383,0.1034,0.1089,-0.0032,0.0029,-0.1186,-0.0684,-0.0485,-0.0611,0.1052,0.055,0.0624,0.1625,0.0952,0.0679,0.0886,-0.0413,0.0444,0.0894,-0.0581,0.023,-0.0102,-0.0416,0.0504,0.0179,0.1014,0.1066,0.0482,0.0348,-0.0252,0.0707,0.0569,-0.0598,-0.042,-0.0246,0.0242,-0.0122,-0.0221,0.0374,0.1092,0.1329,-0.0795,-0.1482,-0.1276,0.0162,-0.1561,-0.0219,0.0859,0.1079,-0.1161,-0.2638,-0.0424,-0.0949,-0.0396,-0.1474,0.1392,0.1337,0.0784,0.0418,-0.1069,-0.133,-0.0678,0.0131,0.0102,-0.0389,-0.1737,-0.1667,-0.1733,0.0556,-0.0034,0.0221,-0.0024,-0.0302,-0.039,0.1604,0.0383,0.0307,0.1001,0.0925,0.0864,-0.0319,-0.0305,-0.0299,0.0556,-0.0193,-0.0665,-0.1163,-0.1367,-0.0989,-0.1621,0.034,0.0182,0.0198,0.0443,0.0824,0.0765,-0.0408,0.1556,0.2212,0.1973,-0.0969,-0.066,-0.0346,-0.0215,-0.0234,-0.1258,-0.0528,-0.0071,-0.1439,0.0373,0.1463,0.1977,-0.1513,-0.0243,0.0804,-0.1014,-0.0711,-0.1683,-0.2391,0.0839,0.0733,0.0605,0.0486,-0.2157,-0.0415,-0.0818,0.0132,0.0737,-0.008,-0.0141,0.0324,-0.0405,-0.0215,0.1462,0.0505,0.1544,0.1419,0.1016,-0.06,0.0262,0.0374,-0.022,-0.0139,-0.0205,-0.2278,-0.2068,-0.0712,-0.1276,0.0665,-0.0334,-0.043,-0.1588,-0.2248,-0.1293,0.0361,-0.0009,-0.0002,-0.1212,-0.0422,0.0026,0.006,-0.1037,-0.0989,0.0566,-0.0316,0.0206,-0.0546,-0.0245,-0.0437,-0.0288,-0.0062,-0.1468,-0.0919,-0.0477,-0.0424,0.1687,0.0939,0.1186,0.0869,0.215,-0.0596,0.0399,0.0422,0.0283,-0.1901,-0.0963,0.1806,0.0374,-0.0679,0.1311,-0.0473,-0.0276,-0.053,-0.049,-0.143,-0.1829,-0.2304,-0.1058,0.0026,-0.029,-0.1616,0.1004,0.0435,-0.0096,0.012,-0.0214,-0.104,-0.0286,0.0518,0.1062,0.1634,0.2096,0.1751,0.0649,0.0025,0.1152,0.063,0.0475,-0.0906,-0.0293,0.0076,-0.0034,-0.0109,-0.184,0.0547,-0.0788,0.0271,-0.0024,0.0787,-0.0438,-0.0236,0.1135,0.048,-0.2162,-0.0134,-0.0116,-0.0012,0.0237,-0.0306,-0.0305,-0.0089,0.0389,0.0459,0.0083,0.0051,0.0935,-0.0384,-0.0083,-0.0484,0.0177,0.1771,0.1686,0.03,0.1111,0.0544,0.0415,0.1412,0.0438,-0.1356,-0.0194,-0.0712,0.2728,0.1255,0.0747,0.2128,0.1917,0.1265,0.1463,0.1463,0.1042,-0.0062,-0.1042,0.1567,0.0156,0.0105,0.0419,0.0277,0.0491,0.2791,-0.1171,0.0029,-0.0201,0.0029,-0.1869,-0.0627,0.0104,0.1428,0.0442,-0.0067,-0.0151,0.0351,-0.137,-0.111,-0.2073,-0.2905,-0.2031,0.0173,-0.0275,-0.1954,-0.1139,-0.0168,0.1378,0.1172,0.0502,0.1024,0.0509,0.0224,-0.0067,-0.0684,0.0175,0.0416,-0.1077,-0.0342,0.0561,-0.0604,0.0065,0.1605,0.0492,0.1973,0.0639,0.031,-0.0853,0.0906,-0.3651,-0.3434,-0.1389,-0.2705,-0.13,-0.0282,-0.0456,0.0203,-0.0826,-0.05,0.0011,-0.1336,0.0053,-0.0699,-0.041,-0.0604,-0.0737,0.0698,-0.0207,0.0431,0.0272,-0.186,0.0631,-0.2122,-0.1206,-0.1809,-0.0833,-0.1128,-0.1131,-0.0414,0.0399,0.0559,-0.019,-0.0068,0.0583,0.0713,0.1352,0.015,-0.0978,-0.0623,0.042,0.0352,0.0499,-0.0169,-0.0058,-0.01,-0.0441,0.0063,-0.0553,0.0032,-0.1452,0.0101,-0.0286,-0.1777,0.02,0.068,0.0671,0.1105,0.0256,-0.0147,-0.0176,0.0456,-0.1327,-0.1057,-0.0555,-0.0005,-0.0124,-0.0824,-0.0452,0.0427,0.0529,0.0272,0.0132,-0.0642,-0.0091,-0.0222,0.0603,0.0151,-0.1328,-0.0064,0.1695,0.1227,0.123,0.136,0.005,0.0066,-0.0133,0.1298,0.0965,0.1513,-0.0165,0.0829,-0.0179,-0.0087,-0.0594,-0.051,0.0932,0.0944,0.0324,0.033,0.041,0.0556,-0.0714,-0.1045,0.0731,0.013,0.0104,0.0393,-0.0533,-0.0046,-0.0445,-0.0185,0.0464,0.112,-0.0076,0.1138,0.0926,-0.0028,0.1124,-0.0708,-0.1097,-0.1052,-0.0985,-0.1038,0.0715,0.158,0.021,-0.0948,-0.1358,-0.009,-0.0486,0.0805,0.0066,0.0385,0.0469,0.1251,0.1058,0.0978,-0.0164,0.0929,0.1726,0.0784,0.1124,0.0408,0.0149,0.0392,0.0024,0.1707,0.0346,-0.0226,-0.0068,-0.0177,-0.0663,-0.1539,-0.1368,-0.0065,0.0281,0.0487,0.11,0.08,0.0647,0.1936,0.0342,-0.0043,0.0045,0.0821,-0.0067,-0.0062,-0.0162,0.0439,-0.0844,0.194,0.1173,0.1444,0.1723,-0.0614,0.1138,0.1093,0.1928,0.0453,-0.1131,-0.2208,0.1784,0.0679,0.021,-0.0501,0.0038,0.0549,0.1235,0.1548,0.1157,0.0633,0.0198,-0.0235,-0.0446,0.0025,-0.0014,-0.0601,-0.0258,-0.0546,-0.0564,0.0375,0.0378,-0.0288,-0.0275,0.0534,0.0564,0.0773,0.0335,-0.1407,0.0412,-0.0543,-0.0079,-0.0897,-0.0758,-0.1114,0.0193,0.0696,0.1228,0.0285,0.0449,-0.2124,-0.1693,-0.1102,-0.0012,0.0507,-0.0434,-0.1594,-0.055,-0.0954,-0.0559,0.2067,0.0284,0.0225,-0.0637,0.1196,-0.0616,-0.0731,-0.0959,-0.0193,-0.0615,-0.0382,0.0771,-0.0416,-0.0432,0.0963,-0.16,-0.0507,-0.0258,0.0386,-0.07,-0.0488,0.0093,-0.0406,-0.0009,-0.0522,-0.1896,-0.1021,-0.0753,0.0223,-0.0626,0.0335,0.0297,0.0497,0.2662,0.2673,-0.0676,-0.0748,-0.16,0.0366,-0.0244,0.1121,0.1424,0.1326,0.1514,-0.0566,0.0093,-0.0331,0.0425,-0.0665,0.0222,0.173,0.0365,0.1121,0.1433,-0.1326,0.1255,0.0193,0.2597,0.1183,0.0249,-0.0077,0.0404,-0.0246,0.0057,-0.0371,0.0998,-0.1066,0.1369,-0.1261,-0.0142,-0.0323,0.0024,-0.0091,-0.1505,-0.2177,-0.181,0.1436,0.1,0.0094,0.0274,0.1763,0.0637,0.0077,0.1781,0.0864,0.0226,0.1491,-0.0421,0.0569,0.0367,0.0592,0.1265,0.05,0.0645,0.1985,0.065,-0.0553,0.0838,0.1854,0.0015,-0.0879,0.0718,-0.0277,-0.0367,-0.0335,-0.1513,-0.1407,0.121,0.1129,0.0895,0.0792,-0.0471,-0.0946,-0.0145,-0.0244,0.0218,-0.1244,-0.0926,-0.099,-0.0786,-0.1015,0.1718,0.197,0.0987,0.0443,0.0484,0.05,0.1159,0.0386,-0.0466,-0.0614,-0.0482,0.014,-0.0226,0.1213,-0.2301,-0.1737,-0.169,-0.0727,-0.0324,-0.1455,0.0497,0.0118,0.0149,-0.0987,-0.1166,-0.1037,-0.0475,0.0177,-0.1743,-0.1487,-0.2492,-0.1161,0.0374,0.1506,-0.0303,-0.0597,-0.0263,-0.0286,-0.0333,-0.0679,0.0161,-0.0346,-0.0346,0.0532,0.0483,0.1887,0.0988,0.1009,0.0789,-0.1004,0.0452,-0.0867,-0.1665,-0.1018,0.0123,0.0214,-0.0314,-0.0531,-0.0848,-0.1647,-0.0976,-0.1022,-0.0546,-0.0385,0.0209,0.0387,-0.1183,-0.1012,-0.0959,-0.0997,-0.0035,-0.0281,-0.0464,-0.0266,0.0062,0.003,0.0421,0.0938,-0.0299,-0.127,-0.0923,0.0961,-0.0653,-0.0242,-0.1628,-0.0437,0.0657,-0.0465,-0.0541,0.0164,-0.0834,-0.1343,-0.0445,-0.0599,-0.0144,-0.0726,0.0291,0.078,-0.042,0.0371,-0.1303,-0.0843,-0.012,0.0182,0.1243,0.0238,-0.0548,-0.367,0.0579,0.0468,0.0991,0.1427,0.199,0.1121,0.1108,0.0764,0.1008,0.0746,0.0881,0.0014,-0.1565,-0.121,-0.1226,0.0491,-0.0645,0.0438,0.0789,0.0039,0.0139,-0.0339,-0.0756,-0.1364,-0.1818,-0.0561,-0.017,-0.0472,0.0249,0.0357,-0.061,0.0006,0.0243,-0.1515,-0.0653,0.0746,0.0296,-0.0425,-0.0777,0.0633,0.0964,0.0628,0.0437,-0.024,-0.0136,-0.0887,0.0596,-0.0745,0.0757,-0.0301,-0.1647,-0.0348,0.1763,0.034,-0.0349,-0.1146,0.0347,0.0191,0.2789,0.2554,0.1279,0.1316,-0.1471,0.1244,0.1125,-0.0051,-0.0258,-0.1161,-0.098,-0.025,-0.0922,-0.1266,-0.2214,-0.0835,-0.1184,-0.0099,-0.0409,-0.1011,0.0772,0.0222,-0.0334,0.0004,-0.1491,-0.1259,0.0387,0.2077,0.1528,0.0695,0.1368,0.0689,-0.104,-0.034,0.0009,-0.0251,-0.0218,0.0123,0.2027,0.062,0.1694,0.0554,0.1328,0.0956,-0.0228,-0.0304,0.0091,0.0531,-0.0113,-0.0228,0.0219,0.1455,-0.0739,0.113,-0.0314,0.0714,0.0935,0.0433,0.0371,-0.0388,-0.0265,-0.0838,0.1015,0.1084,0.0614,-0.0646,-0.0279,-0.0778,-0.0048,-0.1595,0.085,0.1528,0.0055,-0.0693,-0.0056,0.1236,0.051,-0.0605,-0.0126,0.0533,-0.0616,-0.2063,-0.1899,-0.0268,-0.0299,-0.0218,-0.1152,-0.0113,-0.1938,-0.0585,-0.2304,0.009,-0.3552,-0.3521,-0.041,-0.0184,-0.0219,-0.0243,-0.014,-0.1266,-0.1292,-0.087,0.0057,0.0529,0.1284,-0.0671,-0.1256,-0.0838,0.1848,0.1347,0.2061,0.0044,0.1135,0.0022,0.0828,-0.0404,-0.0583,0.0312,0.1517,0.1829,-0.1881,0.0137,0.0886,-0.2155,-0.1798,-0.0344,0.0625,-0.0958,-0.2279,-0.1261,-0.0912,-0.1199,0.0137,-0.0266,-0.1307,-0.1048,0.0444,-0.1124,-0.0249,-0.0299,-0.0269,-0.3001,-0.0468,0.1002,0.0769,0.0117,0.091,0.0254,0.0831,0.027,0.0377,0.0495,-0.0232,0.2039,0.1078,-0.0004,0.1158,0.155,0.0142,-0.0116,0.0311,0.0125,0.052,0.0585,0.0741,0.0228,0.094,0.2321,0.1835,-0.0225,-0.0929,-0.0203,0.0026,0.0889,-0.0066,0.0008,0.092,0.0784,0.0387,0.0407,-0.0259,0.1326,0.1686,0.0913,0.0264,0.1662,0.1683,-0.0342,0.0518,0.0407,0.1138,0.0728,0.0627,0.0268,-0.0295,-0.0602,-0.0253,-0.1389,0.0521,-0.0667,-0.1061,-0.1663,0.1497,-0.0678,0.1288,0.1675,0.1033,-0.0404,-0.0226,0.0066,-0.0838,-0.0871,-0.0036,0.0947,-0.1423,0.0763,-0.0093,-0.1382,0.0888,0.0857,0.1627,-0.042,-0.0098,-0.1172,-0.1305,0.2086,0.1759,-0.0365,-0.0656,0.0278,-0.156,-0.0124,0.0834,0.1368,0.1652,0.0605,0.1303,0.2014,0.0817,0.0796,-0.0774,-0.0152,-0.0682,-0.0121,-0.1557,0.0008,-0.0296,-0.0274,-0.0506,-0.0609,0.0005,0.0082,0.0101,0.0675,-0.0033,0.0841,0.048,0.0396,0.0233,0.0851,0.0231,0.0731,0.0297,0.07,0.0379,0.0932,0.0072,-0.0008,-0.0106,-0.0024,-0.0215,-0.01,-0.0354,0.0526,0.0564,0.0018,0.0908,0.0685,0.0869,-0.161,-0.0687,-0.1701,0.0409,-0.0399,0.0738,0.1295,-0.0081,0.0767,-0.1182,-0.1207,0.159,0.1626,-0.0903,0.123,0.0035,0.0472,-0.1466,-0.1884,0.1926,-0.0237,0.0945,0.0478,0.0089,0.2051,0.1827,0.0717,-0.0622,0.027,0.021,0.011,0.172,0.035,-0.0626,0.0034,-0.026,-0.0145,0.0164,-0.0091,0.1951,0.0535,0.0035,0.1096,0.0109,0.1661,-0.3253,0.1732,-0.0505,-0.0467,-0.0275,0.2299,0.207,-0.1359,-0.11,-0.0606,-0.1512,-0.0922,-0.0665,-0.0444,0.0276,-0.0519,-0.0975,-0.0746,-0.0567,-0.0085,0.0145,-0.047,-0.0028,-0.0045,-0.098,-0.2578,-0.093,-0.1111,-0.1594,-0.0468,-0.0782,-0.1388,-0.1831,-0.1636,-0.1067,-0.0906,-0.0686,-0.0824,-0.1282,-0.0961,-0.2878,-0.1313,-0.1337,-0.1907,-0.0939,0.1497,0.0258,0.1812,-0.0483,0.0359,0.2526,0.186,0.1297,-0.1904,-0.1048,0.3135,0.2724,0.1278,-0.0077,0.0162,0.1953,-0.0949,0.0137,0.0518,-0.0336,0.0499,0.032,0.0612,0.1001,0.1645,-0.0931,0.2588,0.2593,-0.0734,-0.0182,0.0257,0.02,0.012,0.1397,-0.0629,-0.0455,0.0746,-0.082,-0.0717,0.0728,-0.027,-0.0438,0.0873,-0.1689,-0.1721,0.1036,0.1182,-0.0245,0.1116,0.0376,0.1273,0.0246,-0.1316,0.0688,0.0901,0.001,0.03,0.0641,-0.0349,relational comparison
trm_557b48f22ba99,0.0575,0.0198,0.0446,0.0467,0.0247,-0.0111,0.0386,0.0078,-0.0352,-0.0115,0.0477,0.0233,0.0245,0.0123,0.0632,0.0292,0.0676,0.0238,0.0046,0.0377,0.0841,0.0121,0.0136,-0.0141,0.072,0.0722,0.064,0.0058,0.0088,0.0274,0.048,0.0329,0.0253,0.0009,0.005,0.0632,0.0239,0.0108,0.0296,0.0711,0.0227,0.0286,0.0065,0.0001,0.0242,0.0202,0.0507,-0.0188,0.023,0.0252,0.0086,-0.0903,-0.1155,-0.0091,-0.0487,-0.0144,-0.0003,0.0086,0.0049,0.0557,0.0607,0.0298,0.0512,0.0161,-0.0339,-0.0068,0.0814,0.0723,0.0196,0.0345,-0.0298,-0.0118,-0.0801,0.0549,-0.0351,-0.0422,-0.0064,0.0518,-0.021,0.014,-0.0253,-0.0496,-0.0132,0.0027,-0.0268,-0.0029,-0.0338,0.0109,0.0084,-0.0603,0.0303,-0.0419,0.0142,-0.0349,-0.0111,-0.0266,0.0034,-0.0516,-0.0523,-0.0361,0.0162,0.0152,-0.0411,0.0152,-0.0123,0.0309,0.0942,-0.0187,-0.0067,-0.0113,0.0266,0.0213,-0.0146,-0.0588,0.0253,0.0118,0.0315,0.0285,0.0027,0.0102,0.1094,0.0316,0.0971,-0.0226,-0.0107,0.0837,0.06,0.0219,-0.0022,-0.0663,-0.0072,0.0306,0.0382,-0.0201,0.0395,0.0793,0.0122,0.0471,0.0592,0.0177,0.0368,0.0356,-0.0191,0.0208,0.0424,-0.0401,0.0042,-0.015,0.0416,-0.0128,0.0176,0.0965,0.0252,0.0752,0.0118,0.0459,-0.0452,0.0459,0.0276,0.0488,0.014,0.0649,0.0852,0.1014,0.0321,-0.0088,0.0155,0.1009,0.1012,-0.0831,0.0827,0.114,0.0483,0.0114,-0.016,0.038,0.0213,-0.0127,-0.0194,0.0256,0.0406,0.0347,0.0607,-0.0236,-0.0178,0.0036,0.0318,0.008,-0.0385,0.0194,0.0121,0.067,0.0746,0.0349,0.0169,-0.0075,0.0029,0.0874,-0.0247,-0.0912,-0.0233,-0.0,0.0445,0.017,0.0392,-0.0508,-0.0158,0.0345,0.0211,0.0057,0.0425,0.0234,-0.0593,0.0301,-0.0198,-0.0103,0.0095,0.0236,-0.0311,0.054,0.0214,0.0335,0.0438,0.0253,0.0086,0.0383,0.0261,-0.0217,-0.0299,-0.0345,0.0388,0.0131,0.0459,0.0574,0.0464,-0.0818,0.0126,-0.055,-0.025,-0.0455,0.024,0.0129,0.0096,0.0243,0.0005,-0.0122,0.0111,0.0575,-0.0036,0.0186,0.0015,-0.026,-0.0004,-0.0212,-0.0396,0.0384,-0.0549,-0.0336,-0.0062,0.037,-0.0322,0.0714,0.0274,0.0284,0.0872,0.0196,-0.0002,-0.0049,0.0655,0.0108,-0.0284,0.0027,-0.009,-0.0104,-0.0664,-0.0275,-0.0999,-0.0887,-0.0587,-0.0295,-0.0172,0.0404,0.0412,0.0605,0.0479,0.0332,-0.0006,-0.0161,0.0361,0.0063,0.023,0.0005,0.0138,0.0339,0.038,0.0347,0.0181,-0.054,0.0486,-0.031,-0.0713,0.0483,-0.0099,0.0637,-0.0163,-0.0127,0.0643,-0.0143,-0.0543,-0.0328,-0.043,-0.0527,0.0335,-0.0574,-0.0069,-0.0138,0.0093,-0.0054,-0.0091,0.0227,-0.0273,-0.0038,-0.0279,0.0036,-0.011,0.0393,-0.0088,0.0173,-0.0158,0.064,-0.0475,-0.0146,0.0365,-0.0234,0.04,-0.0409,-0.0978,-0.0144,0.0501,0.0042,-0.0036,0.103,0.0235,-0.021,0.0591,-0.0042,0.0524,0.013,0.0656,0.0131,0.0395,0.0068,0.0268,-0.0213,0.0309,0.049,0.011,-0.0001,0.0113,0.0215,-0.0002,-0.0014,-0.1509,-0.0516,-0.0507,-0.0065,0.0526,-0.0376,0.0295,0.0381,0.0421,-0.0133,0.0697,-0.0248,0.071,-0.0115,-0.0138,0.0151,0.0227,0.0417,0.0425,-0.0291,0.0045,0.0082,-0.0422,-0.05,-0.0071,0.011,-0.0415,0.0106,-0.0611,0.0208,0.0489,0.0439,-0.0127,-0.0248,0.017,0.0136,0.0104,0.0484,0.0191,0.0149,-0.0251,0.0396,0.0258,-0.0242,-0.0532,0.0364,0.0111,0.0338,0.0731,0.0895,0.0306,-0.0447,0.066,-0.0023,-0.0917,-0.0136,-0.0194,-0.0312,0.0192,0.0167,0.0017,0.0603,0.0273,0.0046,0.0591,0.0065,0.0021,0.0111,0.0047,-0.019,-0.0306,-0.0444,-0.0058,0.0139,-0.0488,-0.0194,0.0778,0.0021,0.0093,-0.0132,0.1117,-0.0239,0.0271,0.0325,-0.0479,-0.0417,0.0305,-0.0136,-0.0157,0.0112,0.0283,0.0084,-0.0611,0.0811,-0.0419,0.0372,-0.0421,0.0192,0.0552,-0.0046,-0.0085,0.0419,0.0499,0.0574,-0.002,0.0282,-0.0044,-0.0224,-0.0424,-0.0273,-0.0507,-0.0029,-0.0578,0.009,0.0042,0.0148,-0.0161,0.0143,-0.03,-0.0067,0.0196,-0.0155,-0.0086,0.0001,0.0012,0.0077,0.0638,0.0187,-0.0268,-0.1031,0.0757,0.0654,0.0514,0.0098,-0.1101,0.0566,0.0313,0.0203,0.0205,-0.0059,0.0036,0.0441,0.0161,-0.0283,-0.0546,-0.0753,0.0014,-0.0203,0.0293,-0.0423,-0.0469,0.0046,0.0186,-0.0154,-0.0089,-0.014,-0.0512,0.0024,-0.0432,0.0347,0.0141,0.0032,-0.0727,0.0219,-0.0224,-0.023,-0.0257,0.0139,-0.0174,-0.0462,0.012,0.0937,0.019,0.0055,0.0679,0.0801,0.0496,0.0463,0.0492,0.0589,-0.0445,-0.0179,-0.0159,0.02,0.0141,-0.0233,-0.006,0.1142,-0.012,0.0422,-0.0274,-0.0534,0.0095,0.0519,0.015,-0.0497,0.0551,-0.013,0.0463,0.0313,0.0233,0.0113,-0.0154,-0.0207,0.0245,-0.0353,-0.0263,-0.0593,0.0046,0.0058,0.051,0.0572,-0.0219,-0.0433,0.0216,-0.0222,-0.0297,0.0161,-0.0825,0.0576,-0.004,-0.0009,-0.0499,-0.0192,-0.0234,-0.0325,-0.0479,0.0112,0.0728,0.0093,-0.0039,-0.0646,-0.0153,0.0116,0.08,-0.0128,-0.0564,0.0265,-0.0253,0.0001,-0.0138,-0.0355,0.018,-0.0061,-0.0027,0.0441,0.0381,-0.0041,0.0185,0.0252,0.0122,-0.0514,0.0333,0.0341,0.0139,-0.0168,-0.0017,0.0625,0.0011,0.0894,0.0031,-0.0153,0.0048,-0.029,-0.0451,0.0099,-0.0145,-0.0107,-0.0034,-0.0441,0.02,-0.003,-0.0261,0.0234,-0.0068,0.0143,-0.0168,-0.1061,-0.0156,-0.0004,-0.005,-0.0052,0.0421,0.0514,0.0001,-0.0149,-0.0409,0.1066,-0.0657,0.0391,0.032,0.1541,-0.0638,0.0261,-0.0347,0.0118,0.0041,0.0308,0.0399,-0.0231,-0.0204,-0.0189,-0.0006,0.0225,-0.0199,0.1145,0.0011,-0.0166,-0.0073,0.0068,0.0526,-0.013,0.0073,0.0073,-0.0668,0.0414,0.0222,0.0053,0.0283,0.0361,0.0377,0.0304,0.013,0.0214,0.0106,-0.0081,-0.0246,-0.06,-0.0265,0.0512,0.0086,0.0463,0.2571,0.0015,0.0186,-0.0061,-0.0232,-0.0131,-0.0344,-0.019,0.0285,0.045,-0.0219,-0.0364,0.0684,0.117,0.0886,-0.0338,0.0022,-0.0424,0.003,-0.0209,-0.0215,-0.0234,0.0508,-0.0549,0.0653,0.0265,-0.0403,-0.0527,0.1302,0.1339,0.0829,0.0266,0.0082,0.0255,-0.0299,-0.0194,0.0147,-0.0268,0.0332,0.0355,0.022,0.0312,0.0246,-0.027,-0.02,-0.1318,0.027,-0.0106,0.0434,-0.0408,0.0217,0.0664,-0.0142,-0.0378,0.0529,-0.0317,-0.0265,-0.0079,-0.0122,0.0455,0.0404,0.0356,0.0551,0.0213,0.0343,0.0107,-0.0199,0.0217,-0.0352,0.0782,-0.0065,0.0216,0.0256,-0.0009,0.045,-0.0315,0.0213,0.0562,0.0137,-0.01,0.0185,0.0202,0.0267,0.0379,0.0846,0.0355,0.0516,0.0375,0.018,0.0026,0.0158,-0.0291,-0.0004,-0.0016,-0.037,0.0021,-0.0022,-0.0265,0.0179,-0.0091,0.0035,-0.0075,0.0021,-0.0167,-0.0538,0.0175,0.0182,-0.0001,0.0059,0.0253,0.0205,0.0068,-0.0654,-0.0486,0.027,0.0245,0.0202,-0.0523,0.0148,-0.001,-0.0038,0.0098,-0.0167,-0.0115,0.0158,-0.0545,-0.0418,0.0868,0.0983,-0.0025,0.0453,0.0157,0.0486,0.016,0.0492,0.0715,0.0566,0.036,0.0592,0.0184,0.0491,0.0431,-0.0289,-0.0681,-0.0117,0.0321,-0.0272,0.0458,-0.0039,0.021,-0.0022,0.0171,0.0371,0.021,0.0563,0.0117,0.001,0.0003,0.0425,-0.0002,0.0077,0.0081,-0.0403,0.116,-0.0335,-0.0205,-0.015,-0.0118,-0.0982,-0.0446,-0.0817,-0.0669,0.0162,0.0077,-0.003,0.0114,0.0299,-0.0052,-0.0046,0.0025,-0.0454,-0.0609,-0.0218,-0.044,-0.0453,-0.0215,0.048,0.053,0.0556,0.047,-0.0047,0.0324,0.0195,0.0482,0.0629,0.0019,-0.033,-0.0297,-0.0515,-0.0458,-0.0127,0.1032,0.0587,-0.0192,0.0088,-0.0573,0.0162,0.008,0.0812,0.047,0.0021,0.1102,0.0187,0.034,0.0063,-0.0096,0.037,0.0355,0.0283,-0.0587,-0.0556,-0.0282,0.0306,-0.0216,-0.0134,-0.0174,-0.0472,-0.0311,-0.0245,0.0729,-0.0148,0.0284,0.0134,0.0356,0.0423,0.0286,0.0173,-0.0232,0.0365,0.0136,0.023,0.0075,0.0473,0.0269,0.0348,0.0307,0.0251,-0.0119,-0.0223,-0.0057,0.0199,0.0163,0.0081,-0.0201,0.0238,-0.0049,-0.0063,-0.0062,-0.0205,-0.0527,-0.0157,0.0051,0.0252,0.009,-0.0019,0.06,0.0725,0.032,0.0225,0.0173,0.009,0.0046,-0.0352,0.0091,-0.0156,0.0077,-0.0495,0.0192,0.0079,-0.1079,0.0124,0.0224,-0.0092,-0.0246,0.0205,0.0729,0.0087,0.0645,0.002,0.0119,0.0363,0.085,0.078,-0.0423,-0.0446,-0.0334,-0.0217,0.0207,0.0731,-0.0031,-0.0098,0.0143,-0.0291,0.0067,-0.0186,0.0274,0.0159,0.0129,0.0261,-0.0179,-0.0127,0.0259,-0.0245,-0.024,-0.015,-0.0073,-0.0008,0.0438,-0.0604,0.0291,0.0284,0.0358,-0.0088,-0.0213,0.0315,0.0226,-0.0325,0.0429,-0.0122,-0.0082,0.0012,0.0394,0.0497,0.0173,0.03,0.0105,0.0394,0.0052,0.0048,-0.0284,-0.0223,-0.0122,0.0262,-0.0187,-0.0035,-0.0284,0.0319,0.0025,0.0139,0.0196,0.0325,-0.0581,0.0272,-0.0214,0.008,0.0232,0.0173,0.0388,-0.0454,0.0343,-0.0153,-0.0614,0.0307,0.0143,0.0126,0.0049,0.0175,-0.0161,0.0094,0.0194,-0.0561,-0.0031,0.0117,0.0399,0.0106,-0.0005,-0.0459,0.0019,0.0657,-0.0356,0.0277,-0.0288,-0.0263,0.0248,-0.0152,-0.0225,0.0404,0.0625,0.0087,-0.0049,0.0258,-0.025,0.0293,0.0074,-0.0414,-0.0058,0.099,0.088,0.0509,0.0152,0.032,0.0619,0.0338,0.1052,0.0181,-0.0002,0.024,0.0224,0.0166,0.0301,0.0013,0.0286,-0.0174,0.009,-0.0473,-0.0482,-0.0432,0.0629,0.0413,-0.0721,-0.0397,-0.0121,0.0342,-0.0229,-0.0592,-0.0132,0.0261,0.046,0.0293,0.0127,-0.0347,-0.0091,0.0241,-0.0137,0.0773,0.0037,0.0148,0.0449,-0.0039,-0.0704,-0.0204,-0.0123,0.0126,0.0528,0.0046,0.0192,-0.0212,0.0772,0.0537,-0.0615,0.0108,0.0066,-0.0269,-0.0167,-0.0427,0.1013,-0.0032,-0.0019,-0.0028,-0.0034,0.0487,0.1159,-0.0385,-0.0012,0.0056,-0.0303,-0.012,0.0109,0.013,-0.0154,0.0565,0.0241,-0.0091,-0.0014,-0.0361,0.0402,-0.0241,0.0131,-0.1059,-0.0116,0.0199,0.0649,0.033,0.0237,0.0116,0.0211,0.0456,0.0969,-0.0236,-0.0391,-0.1262,-0.0831,-0.0462,0.0108,-0.0414,-0.164,-0.029,-0.0057,-0.0643,-0.0106,-0.0668,-0.0077,-0.0149,0.0287,-0.104,0.0144,-0.007,-0.0112,-0.059,0.0404,0.0364,-0.0165,0.1063,0.0229,-0.068,0.036,0.0264,-0.0492,0.0018,-0.045,-0.0174,0.0446,0.001,0.0215,-0.0644,-0.0041,0.0163,0.0139,0.0082,0.0531,-0.0052,0.0293,-0.0228,-0.0229,-0.0106,0.0032,0.0767,-0.0129,0.0472,0.0266,0.0598,-0.0045,0.0701,0.0209,0.0102,0.0322,0.019,0.0159,-0.0199,0.0519,0.0528,-0.075,-0.0394,-0.0411,0.0559,0.0057,0.0057,0.005,0.0341,0.025,0.0233,0.0067,0.0339,0.1052,0.0088,0.0579,0.0641,-0.0388,-0.0622,0.023,0.0173,0.0303,-0.028,-0.0057,0.0448,0.0119,0.0049,0.041,0.0204,-0.0822,-0.0051,-0.0561,0.0645,-0.1634,-0.0742,-0.0466,-0.0179,-0.0397,-0.0099,0.0292,0.0695,-0.1026,-0.0247,-0.0222,0.0044,-0.0123,-0.048,0.0097,0.0124,0.0028,0.0077,0.008,-0.0089,0.0631,0.0283,0.028,-0.0323,0.0388,0.0541,-0.0134,-0.0256,0.0346,-0.021,0.0041,0.0378,-0.0811,-0.0925,0.0262,-0.0592,0.0394,-0.0222,0.0288,0.0658,-0.09,-0.0465,-0.0918,0.0261,0.0729,-0.0068,-0.0826,-0.0737,-0.0064,0.0463,-0.063,0.0488,0.0138,0.0142,0.0022,0.0071,0.0483,0.0124,-0.037,-0.0805,-0.0726,-0.0287,0.0025,0.0915,0.0134,0.0117,0.079,0.077,0.0457,0.0016,0.081,0.0625,0.0721,0.0765,0.0175,0.0566,0.0152,0.0338,0.0268,-0.0445,0.0355,0.045,-0.0167,-0.008,0.0076,0.0804,-0.0086,-0.0283,0.0089,0.065,0.0231,0.0265,-0.0406,-0.1584,-0.0274,-0.0436,0.0277,-0.0174,-0.0064,0.0575,0.0268,0.0761,0.0048,-0.0041,0.015,-0.0073,0.0626,0.0645,0.0198,0.0016,0.0679,0.0817,-0.0031,0.0316,-0.0018,0.01,-0.0175,-0.0143,0.0475,-0.0028,0.0186,-0.0057,0.0154,0.0266,0.0313,-0.0127,0.0472,0.0285,0.0424,0.0312,0.0138,0.0176,0.0041,0.0143,-0.0112,-0.0553,-0.0686,-0.0214,-0.0227,0.0272,0.0136,-0.0172,0.0375,0.0889,-0.0375,-0.0055,-0.0086,0.0174,-0.0279,0.0197,-0.0257,-0.0328,0.0144,-0.0329,0.0231,-0.0049,0.054,0.0112,0.0275,-0.0178,0.0423,0.0038,-0.0385,-0.0158,-0.0247,-0.1691,-0.1821,-0.0791,0.0133,-0.0598,-0.0158,0.0291,-0.0232,0.0108,0.0304,0.0014,-0.0344,0.0153,-0.0207,0.0135,-0.0151,0.0267,-0.026,-0.0098,0.0358,-0.0267,-0.0518,-0.0337,0.1079,0.0539,0.0406,-0.0244,0.0288,-0.0069,-0.0467,-0.0553,-0.0537,-0.0283,-0.0234,0.017,0.0408,0.0004,-0.0491,-0.0473,-0.0414,0.022,0.0255,-0.0062,-0.0027,0.0047,0.0808,-0.0074,0.0169,-0.0188,0.0149,0.0079,-0.0238,-0.0119,-0.0101,-0.0316,-0.0413,0.0099,-0.0116,0.0297,-0.0117,0.0442,-0.0317,-0.0152,-0.0079,-0.0453,-0.04,0.0314,0.0041,0.0331,0.0183,0.0102,0.0049,0.0022,0.1108,0.1059,-0.0046,0.0116,0.0667,-0.0011,-0.0202,-0.0058,0.0302,-0.0009,-0.0176,-0.0297,-0.0686,-0.0479,-0.0177,-0.0641,-0.0374,-0.0378,0.0029,-0.0242,0.0266,0.0458,0.0076,-0.0249,-0.0242,0.01,0.0247,0.0004,0.0117,-0.0416,0.0212,-0.0702,0.022,-0.1038,-0.1032,-0.0304,0.0335,0.0043,-0.0419,-0.0113,0.0112,0.0311,0.0478,-0.0277,-0.0004,-0.0062,0.0545,0.0338,-0.0362,-0.013,-0.1859,-0.1171,-0.0808,-0.1397,0.0434,0.0374,0.0001,-0.0076,0.0422,0.012,-0.0346,0.0333,-0.0031,0.0225,-0.0186,0.0266,0.0684,0.0037,0.0607,-0.0493,0.0041,-0.0324,-0.1028,-0.1312,0.0235,-0.0229,-0.0362,0.032,0.0471,0.0169,0.0312,-0.0427,-0.0282,-0.0448,0.0028,-0.0242,-0.0199,-0.0426,-0.0156,0.0358,0.0151,-0.0017,-0.0884,-0.042,0.0453,-0.0208,-0.0352,0.0025,0.0021,-0.0,0.0735,0.0531,0.0537,-0.016,0.0912,0.0619,0.0179,0.1759,0.1187,-0.1541,0.0007,-0.0209,-0.0645,0.0627,0.0034,-0.1071,-0.0889,-0.1279,0.0053,0.0242,0.0028,-0.0681,0.0393,0.0521,0.0441,-0.0474,-0.0316,-0.0255,0.0643,0.0113,-0.0432,-0.0004,-0.0379,0.0652,0.0507,0.0134,0.0186,0.0065,-0.0052,0.0219,-0.0597,0.0455,-0.0278,0.0482,0.1142,0.07,-0.0214,0.0395,-0.0159,0.0255,-0.0336,-0.0341,-0.0323,0.0624,-0.0112,-0.0104,-0.0395,-0.0223,-0.0215,0.006,0.0235,-0.0367,0.0125,0.0444,0.031,0.0049,-0.0231,0.0018,0.0391,0.0342,0.0156,0.0543,-0.0877,-0.0228,0.0007,-0.0203,0.0371,0.0235,0.0329,0.0765,0.0153,0.0026,0.0044,0.0162,0.0409,0.0495,-0.0048,0.0271,-0.0195,-0.0373,-0.0376,-0.0272,-0.0508,-0.0229,0.0582,0.0061,0.0382,0.0597,0.0598,-0.0227,0.0112,0.09,0.0488,0.0093,-0.0006,-0.1111,0.0222,0.0092,0.072,0.0144,0.0453,0.0548,0.0287,0.0118,-0.0439,-0.0043,-0.001,0.0615,-0.0297,-0.0029,0.0185,0.0264,0.0253,0.0644,0.0554,0.0564,0.0423,-0.0144,0.0014,-0.013,0.0245,0.0614,0.015,0.017,-0.0533,0.0271,0.018,0.0176,-0.0207,-0.0389,-0.0524,0.0167,-0.0006,0.0529,0.0413,0.0308,-0.001,0.0111,0.0005,-0.011,0.0445,0.0556,0.0398,0.0442,0.0064,0.0597,0.0373,0.0723,-0.0041,-0.0484,0.0251,-0.086,0.0005,-0.0474,0.0207,-0.0567,-0.067,0.0903,-0.0602,-0.0431,0.0758,0.0869,0.1052,0.0205,0.0038,-0.0037,0.0175,-0.0185,-0.0115,0.0455,-0.0091,-0.0011,0.0272,-0.0273,-0.0767,0.1255,0.1348,-0.0051,-0.0335,0.0309,-0.0105,-0.0094,0.0444,-0.0185,0.0121,0.0235,-0.0075,-0.0466,0.0061,0.0478,0.0205,0.0583,-0.063,0.0251,-0.0499,0.0007,0.0217,-0.0216,0.0219,-0.0022,-0.0093,-0.0354,0.0469,0.0039,0.037,-0.0043,0.0065,-0.0326,-0.0353,-0.0317,-0.0069,-0.0189,-0.0048,-0.078,-0.0237,0.0013,-0.0086,-0.0414,-0.0282,-0.0115,-0.0133,0.017,0.0089,-0.0182,0.0212,0.0769,-0.0748,0.0574,-0.0069,0.0257,0.001,-0.0523,0.0261,0.0136,-0.0253,-0.0143,-0.0908,-0.0968,-0.0906,0.0437,0.0086,-0.0524,-0.1006,0.0492,-0.0241,0.063,0.1355,0.0888,0.0088,-0.006,0.0103,-0.0036,0.0489,-0.0,0.0258,0.0047,-0.0078,0.0136,0.0495,0.0369,-0.0311,0.0486,-0.0108,0.0641,0.0386,0.0713,0.1134,-0.0091,0.0871,0.0148,0.0176,0.0204,-0.0471,0.0045,-0.0088,-0.0353,0.0114,0.0283,-0.0075,0.0384,-0.0191,0.0053,-0.0026,0.0363,0.0356,0.0062,0.0015,-0.0022,0.0168,0.0073,-0.0009,0.0268,0.0323,0.0014,-0.0536,0.0474,0.0194,0.0145,-0.0634,0.0587,0.0013,0.0187,-0.0314,0.0211,-0.0176,0.0191,0.0288,-0.0471,-0.0596,-0.0383,-0.0164,0.0261,-0.0554,-0.0215,0.0007,0.001,0.0026,0.0179,-0.031,0.0127,0.0128,0.0724,0.0315,0.0088,0.0151,-0.0272,-0.036,0.0258,0.0239,-0.0164,0.0211,0.0217,0.0084,0.0115,0.1424,0.0878,0.0956,0.0701,0.102,0.018,0.0322,0.0154,-0.0193,0.0147,-0.0075,-0.0002,0.0203,-0.0551,0.041,0.0035,0.0026,0.0978,0.0961,0.0274,0.033,-0.0322,0.0098,0.0373,0.0481,0.1017,-0.0175,-0.0263,-0.0465,-0.1124,-0.0529,0.0612,0.1006,0.0384,-0.0251,0.013,-0.0028,-0.0439,0.0016,0.0044,-0.003,-0.0789,-0.0362,-0.0043,0.051,0.0091,0.0219,0.0296,-0.001,-0.0861,0.1173,-0.0265,0.0287,-0.0544,-0.0262,0.0112,0.0102,0.0194,0.0385,-0.0816,0.0692,0.0676,0.0123,0.0206,-0.0546,-0.0268,-0.0537,0.0005,0.0051,-0.0405,0.0057,0.0201,-0.0133,-0.0168,0.1266,0.0741,0.128,0.036,0.0339,0.0543,0.043,-0.0231,-0.04,-0.004,0.0053,0.0147,-0.0279,0.0592,0.0075,0.0332,0.055,0.0088,-0.0381,-0.0052,-0.0002,0.0918,0.0332,0.0177,0.0811,0.1175,-0.0026,-0.0014,-0.1293,-0.1124,0.0233,-0.0359,0.0248,0.0069,-0.0607,-0.0281,0.0404,0.025,-0.023,-0.0459,0.0288,0.037,0.0117,0.0007,0.004,-0.0095,0.0234,0.0135,-0.0063,-0.0153,-0.0421,-0.0244,-0.0048,0.1335,0.0068,0.0121,0.0157,-0.0111,-0.026,-0.0266,-0.0199,-0.0405,0.0047,-0.026,0.0073,-0.0554,-0.0044,-0.0215,0.0116,0.0074,0.0204,0.0617,0.0378,0.0928,-0.0418,0.001,0.0466,0.0053,0.0128,0.0308,-0.0311,0.0433,0.0281,-0.0612,0.0187,-0.0077,0.0264,0.0504,-0.0391,-0.0728,-0.155,0.049,-0.0087,0.034,0.0113,0.0093,-0.1006,0.0351,0.0522,0.0405,-0.0174,-0.0774,-0.0815,-0.0052,0.0088,-0.0009,0.0048,-0.0578,-0.0268,0.0315,0.0256,-0.0186,-0.0276,0.0552,0.0488,0.0255,0.002,-0.0011,0.032,-0.0088,0.0102,0.0009,-0.0073,0.0499,0.0609,-0.0564,-0.0277,-0.0027,0.0424,-0.0249,0.0145,0.0398,-0.0164,-0.0126,0.0285,0.0285,0.005,0.0023,-0.0274,0.0198,-0.0004,0.0389,0.0364,0.0386,-0.0048,0.1437,-0.0678,-0.0318,-0.0012,-0.0826,0.0269,-0.0931,-0.0615,0.0561,0.0445,0.0099,0.0858,0.0533,0.0221,0.0368,-0.0533,-0.0908,-0.0611,-0.002,-0.0009,-0.0529,-0.0576,-0.0052,0.1876,0.1087,0.0094,0.0342,0.0146,-0.0078,0.0045,-0.0184,0.0303,-0.0024,0.0154,0.0201,0.033,-0.0312,0.0117,-0.03,0.0498,-0.0247,-0.0277,-0.0205,-0.0579,-0.0024,-0.0448,-0.0334,-0.0226,0.0242,0.0622,0.0446,-0.0299,-0.0287,-0.0056,0.003,-0.0144,-0.0278,-0.0277,-0.0168,-0.0499,0.0031,0.0363,-0.0527,-0.0088,-0.0147,0.018,-0.0069,-0.0909,-0.0247,-0.0191,0.0027,0.0441,-0.0181,0.0813,-0.0147,-0.0077,-0.0365,0.0685,-0.042,0.0055,0.0977,-0.0207,-0.0243,0.0054,-0.0275,-0.0336,-0.0493,0.0298,0.012,-0.0353,-0.0399,-0.033,-0.0353,-0.0407,0.0109,-0.0267,-0.0143,-0.0147,-0.1011,-0.049,0.0403,0.0507,-0.0019,0.0022,0.0006,-0.0308,-0.0262,-0.0032,-0.0504,0.017,0.0649,0.009,-0.0031,0.018,0.0549,0.008,0.0539,0.0325,-0.0061,0.0525,0.0071,0.0026,0.0193,-0.0953,-0.0649,0.0607,0.023,-0.0027,0.0495,0.0112,-0.0222,-0.0604,0.0313,0.053,0.067,0.0018,-0.0082,-0.0457,0.0465,-0.0081,0.0366,0.0115,-0.0112,-0.0097,-0.0549,-0.0019,-0.0064,0.0205,0.0096,0.0293,-0.0037,0.0508,0.0153,0.0336,-0.004,0.0104,0.0704,0.0186,0.0036,-0.0067,0.0068,-0.0302,0.0271,0.0394,0.0869,0.0533,0.0447,0.0349,0.0101,0.0065,0.029,-0.0906,-0.0884,-0.101,0.0295,-0.002,0.0447,0.0481,-0.0424,-0.0714,0.0125,-0.0033,0.0349,-0.0041,0.0597,0.0308,0.006,0.012,0.0362,-0.0053,-0.031,-0.0558,0.0594,0.073,0.0245,0.0334,-0.0306,-0.0343,-0.0813,-0.0264,-0.0743,-0.0092,0.007,-0.0188,0.0196,0.0573,0.0459,-0.0111,0.0045,0.0113,-0.0359,0.0209,-0.0287,-0.0162,0.021,-0.0145,0.0903,0.012,0.0711,0.0798,-0.0576,0.0142,-0.0039,-0.0167,-0.064,0.0017,-0.102,0.0613,0.0154,0.0396,-0.0243,-0.0275,0.0273,0.0833,0.0197,0.0149,0.0573,-0.0103,0.0206,0.0267,-0.0052,-0.0372,-0.0139,-0.0068,-0.0081,0.0353,-0.025,-0.0189,0.0426,-0.0159,0.0478,-0.0048,0.0194,0.0211,-0.0488,0.0478,0.0153,-0.0215,-0.0567,-0.0214,-0.0157,0.0176,0.0594,0.0249,0.0678,0.0324,-0.0317,-0.0206,-0.0076,0.0301,0.0374,-0.0106,-0.009,-0.0173,-0.03,0.0598,-0.006,0.0029,0.0027,0.095,0.0128,-0.0032,-0.0341,-0.0274,-0.038,0.0002,-0.0022,-0.0006,0.0236,-0.0213,0.0183,-0.0148,0.0273,-0.0363,-0.0207,-0.0253,-0.0509,0.0058,-0.0329,0.0146,0.0026,-0.0405,-0.0512,-0.0311,-0.0027,-0.043,0.0411,-0.0179,0.1076,0.1575,0.1564,-0.0123,-0.0254,-0.0138,0.0231,-0.0156,0.0189,0.0577,0.1256,0.094,0.0222,0.0276,-0.0235,0.0342,0.0528,-0.0048,0.0246,0.0452,0.0123,0.061,-0.0355,0.0176,0.0295,0.0826,0.005,0.0843,-0.0131,-0.0024,-0.0092,-0.0041,-0.0494,0.0196,0.0173,0.0619,0.0076,-0.0313,-0.0447,0.0157,0.0205,-0.0286,0.0455,0.0478,0.0315,0.0459,0.0383,0.0235,0.0449,0.0195,-0.0384,0.0806,0.0581,0.0254,0.0723,-0.0084,0.0285,-0.0061,-0.0132,0.0227,0.0944,0.0911,0.0198,0.0431,-0.0392,0.0234,0.0532,0.0153,-0.0083,-0.0171,-0.0034,0.0272,-0.0946,-0.0306,-0.0321,0.0214,0.0718,0.016,0.0242,0.0309,-0.0194,-0.0234,-0.0061,0.0223,-0.0731,0.0305,0.0172,-0.0629,0.0393,0.0548,0.0471,0.0201,-0.1167,-0.0513,0.0063,-0.0173,-0.0878,-0.0936,-0.0029,-0.0103,0.0293,0.0384,0.0359,-0.0032,0.0091,0.0098,0.006,-0.0253,0.0252,-0.1507,-0.0948,-0.1625,-0.0404,0.0365,0.0461,0.012,-0.0131,-0.0,-0.0675,-0.0288,-0.0717,0.0033,0.0322,0.0167,0.0025,-0.002,0.0076,0.0492,0.0045,0.0059,-0.0096,0.0025,0.014,0.0115,0.082,0.0292,0.0137,0.0348,0.0376,0.0066,0.0029,-0.0176,-0.0516,-0.022,-0.0061,-0.0329,-0.0258,0.0273,-0.0134,-0.0724,-0.0622,-0.0172,-0.0359,0.039,0.0077,-0.0418,-0.0008,0.0729,-0.0115,0.0196,-0.0224,-0.052,-0.0146,-0.0016,0.0505,-0.0404,0.051,0.0043,-0.037,-0.0767,0.0208,-0.0476,0.0051,0.0227,-0.0278,0.014,-0.0041,-0.0006,0.0224,-0.025,0.0185,-0.0029,0.0494,-0.0595,-0.0168,-0.0153,-0.0764,-0.0165,0.0405,-0.0083,-0.0414,-0.0232,0.0018,0.0464,-0.0052,0.0184,-0.0749,0.0473,0.0181,0.0799,0.0555,0.0,0.0352,-0.01,0.0048,-0.0138,-0.0026,0.0416,-0.0334,-0.013,-0.027,-0.0228,0.0056,-0.0742,-0.0827,0.0387,0.0476,0.0526,-0.0136,-0.0067,0.0919,0.0581,0.076,0.0159,0.0581,0.067,-0.0907,-0.1102,-0.0855,-0.0358,-0.0546,-0.0051,0.0219,0.0066,0.0298,0.0019,-0.0302,0.036,0.0202,0.0414,-0.1179,-0.0679,-0.0778,-0.0492,0.0583,0.0501,0.0083,-0.0095,-0.1302,0.1019,0.0707,0.0308,-0.0115,0.0306,-0.027,0.1334,0.1186,0.0656,0.0461,0.0016,-0.0072,0.0174,0.0169,-0.0959,-0.0265,-0.0258,-0.0114,0.0003,0.0054,-0.0128,-0.0002,-0.0072,-0.0297,-0.033,-0.0275,0.0003,0.0013,-0.0613,-0.0113,0.0179,-0.0343,0.0345,0.0592,0.0725,0.0018,0.0146,0.0064,-0.0286,-0.0213,-0.0022,-0.0042,0.0112,0.0051,0.023,0.0444,0.0314,-0.0398,0.0196,0.0454,-0.0179,-0.0536,-0.0176,0.058,-0.0028,-0.0079,-0.0371,0.0118,-0.0404,0.0645,-0.0124,0.0095,-0.0127,0.0026,0.0046,0.0137,0.0526,-0.0105,0.0231,0.038,0.0438,0.0115,-0.0678,-0.053,-0.0042,-0.0621,-0.0636,0.02,0.0305,-0.0232,0.0054,0.0524,0.0154,-0.0178,-0.0118,0.0137,0.0002,-0.0222,-0.0048,-0.058,-0.0554,-0.011,-0.0786,0.0157,-0.0318,-0.0266,0.0149,-0.0866,-0.0631,-0.0698,-0.0213,-0.0263,-0.0072,0.0104,0.002,-0.0407,-0.0348,0.0042,0.0233,-0.0175,0.04,0.0451,0.0024,0.0493,0.0389,0.0431,0.0486,0.0021,0.068,-0.1661,0.0461,-0.0328,-0.0739,-0.0163,0.0018,0.0367,0.0058,-0.0448,-0.0122,-0.0373,0.0452,0.0446,-0.0027,0.025,-0.0594,-0.0505,-0.0619,-0.0435,-0.027,0.0148,0.0119,0.0112,0.0236,0.0012,-0.024,-0.0357,-0.0644,-0.0618,0.056,0.0016,0.0303,-0.0281,-0.0544,-0.0404,-0.0062,-0.0036,-0.0475,-0.1137,-0.024,0.0167,0.0204,0.0428,0.0079,-0.0207,-0.0544,-0.0815,0.0021,0.028,0.0441,0.0558,0.0355,0.0312,0.0429,0.0256,0.0196,-0.0123,-0.0351,-0.0009,0.0643,-0.0101,-0.0202,0.0246,0.0038,0.0546,0.0101,-0.0036,-0.0588,-0.0065,-0.0085,0.0235,-0.0101,0.099,0.0025,0.064,0.0167,0.0135,0.049,0.0403,-0.0291,0.0093,0.097,0.0338,-0.012,0.0255,0.0509,0.0201,-0.0149,-0.0373,0.0336,-0.0298,-0.0057,0.0386,-0.0049,-0.0379,-0.0588,-0.0116,0.0156,-0.0219,0.0243,0.0459,0.0096,0.0365,-0.0164,0.0257,0.0003,-0.0173,0.022,-0.0012,-0.0371,0.0029,-0.0042,0.0595,0.0316,-0.0209,-0.0333,0.037,-0.0253,0.0202,0.0388,0.0273,0.0406,0.0295,0.0108,0.0071,0.0138,0.0316,0.0203,0.0218,-0.0023,0.0199,-0.0315,-0.0298,-0.0317,0.0392,-0.0137,-0.0477,0.0047,-0.0075,0.0217,-0.0382,-0.0349,-0.0345,0.0042,0.0354,0.0456,0.0337,-0.0384,-0.0348,-0.0205,0.0217,0.0183,-0.0077,0.003,-0.0167,-0.0216,0.024,-0.0046,0.0545,0.0017,0.0102,0.0119,-0.0633,0.0299,-0.0307,-0.02,0.0199,0.0159,0.0074,0.0249,-0.0263,0.0386,0.0609,-0.0159,0.0214,-0.0515,-0.0607,0.088,0.027,-0.0164,0.0075,-0.0267,0.0116,0.1071,0.0345,0.0126,0.0059,0.0039,0.0234,-0.0199,0.0301,0.0384,-0.0213,0.0002,0.0166,0.0262,0.0295,-0.0084,0.0235,-0.0176,-0.0377,0.0102,0.0116,-0.0075,-0.0305,-0.0023,0.029,0.0116,0.0212,-0.0285,0.0577,-0.0514,0.0183,0.0178,-0.057,-0.0147,0.0464,0.0535,-0.121,-0.1073,-0.0514,-0.082,-0.0742,-0.0208,-0.0695,0.0157,-0.034,-0.0007,0.0005,0.0273,0.0229,0.0318,0.0123,-0.0427,0.1046,0.0485,0.1054,0.0929,0.0033,0.1051,0.0621,0.1043,0.1125,0.0101,0.0111,0.0535,0.0168,0.0206,0.013,0.0498,-0.0398,0.0148,-0.0498,0.021,0.0553,0.0308,0.0258,-0.0259,0.0586,-0.0813,-0.0716,0.073,0.0557,0.0589,0.0038,-0.0227,0.0744,0.0453,0.0336,0.0336,-0.0074,0.038,-0.0048,0.036,-0.0138,-0.031,0.0059,-0.0156,0.0231,0.0593,0.0324,-0.0268,0.0517,0.0546,0.0594,0.0208,-0.0202,0.0623,0.0617,0.0341,-0.0487,-0.011,0.0063,-0.113,-0.0383,-0.0122,-0.0689,-0.0987,-0.0145,-0.082,-0.0832,0.0524,0.0167,-0.0717,0.0393,0.0203,0.0382,-0.0396,-0.0038,0.0649,0.0739,-0.017,0.0417,0.042,-0.0543,numerical scale judgment
trm_4c3e04d656f06,0.0534,-0.0594,0.0345,-0.0149,0.0087,-0.0432,0.0367,-0.0025,0.02,-0.005,0.01,0.0338,0.0111,-0.0014,-0.0013,-0.0334,0.0247,-0.0104,-0.0015,-0.0002,0.0091,-0.0115,0.0264,0.0485,0.022,0.0126,0.0175,0.0225,0.0064,0.0272,0.013,0.0017,0.0005,0.0055,0.0221,0.0242,0.0384,-0.0086,-0.0259,-0.0236,0.0104,0.025,0.0398,0.0107,-0.0482,-0.0224,0.0328,0.0216,0.0014,0.009,0.0154,0.039,0.0478,-0.0197,-0.01,-0.0052,0.0345,0.0032,0.0196,0.0205,0.0222,0.0318,0.001,-0.0314,-0.0794,0.0227,0.0187,0.0269,0.008,0.0156,-0.0495,0.015,-0.0168,0.0259,0.0009,0.0353,0.0323,0.0122,-0.0222,-0.0079,0.0707,0.0144,0.0054,0.0339,-0.0195,-0.0456,-0.0507,-0.0256,0.0006,0.0274,-0.0143,0.0738,-0.0201,-0.0248,0.0255,-0.0247,0.033,-0.0071,-0.0287,-0.009,-0.0267,-0.0378,-0.0046,0.0115,-0.0042,0.0078,0.0077,0.0274,-0.0096,-0.03,0.0214,-0.0056,0.0038,-0.0119,0.0046,-0.0186,-0.0082,-0.0016,0.0233,0.0058,-0.0246,0.0092,-0.0031,-0.0009,0.0119,0.0116,-0.0208,0.0049,0.0035,0.0204,0.0679,-0.0126,0.038,0.0512,0.0164,0.0121,0.0246,0.0112,-0.0098,-0.0198,0.0179,-0.0084,-0.0206,0.0149,-0.0292,-0.0757,0.031,-0.044,0.0295,0.024,0.0052,-0.0164,0.0381,0.0278,-0.0344,0.0025,-0.0329,-0.0333,-0.0025,0.0269,0.0135,-0.0019,0.0087,0.0354,0.0021,-0.0349,0.0142,0.004,0.0036,0.0127,0.0489,-0.0002,-0.0041,0.0666,0.0418,0.0475,0.0578,0.0265,0.0522,-0.0137,0.0213,0.0121,0.034,0.0005,0.0558,-0.0284,0.0488,0.0737,0.0304,-0.0478,-0.0443,0.0763,0.0619,0.0716,0.0675,-0.0098,-0.0046,0.041,-0.0299,-0.0256,0.022,-0.0262,-0.0215,-0.0194,-0.0779,0.0498,0.0708,-0.0109,0.008,0.0128,0.0218,0.0482,0.0495,0.0018,0.0219,0.0289,-0.0137,0.0471,0.0066,0.0054,-0.0082,0.0304,0.0172,0.0189,-0.0341,0.0172,-0.038,0.0191,0.0206,-0.0631,0.0086,0.0392,-0.0278,-0.0176,-0.0261,0.0341,0.0251,-0.0217,0.0067,0.0157,-0.0208,0.0452,-0.0095,0.032,-0.0093,0.0128,0.0099,0.0209,-0.0331,-0.0002,0.0698,0.0079,0.0101,-0.0219,0.0392,0.0382,-0.0259,-0.0066,0.0022,-0.0356,-0.0655,-0.0803,-0.0041,-0.0748,-0.0556,-0.0801,-0.064,0.0071,0.0347,-0.0497,-0.0236,0.0416,-0.0248,0.0181,0.0171,0.0376,0.0269,0.0351,-0.0004,-0.0135,0.0286,-0.0007,0.026,-0.011,-0.0117,0.0189,-0.0121,0.0429,0.0155,0.0207,0.0059,0.0203,0.03,0.0037,0.0223,-0.0493,0.0325,-0.0176,-0.0456,-0.0487,0.0403,0.0247,0.0103,0.021,0.0041,-0.0022,0.0148,0.0047,0.0154,-0.0065,0.0031,0.0202,-0.0547,0.0062,0.0072,0.0282,-0.0379,0.0049,-0.0123,-0.0114,-0.0082,0.0101,-0.0904,-0.1041,-0.0019,0.0153,-0.0189,0.0,0.0416,0.0132,-0.0259,0.0149,0.028,0.0334,-0.011,-0.0197,0.0117,0.0013,0.0248,-0.0004,0.0015,0.0267,-0.011,0.0142,-0.0151,-0.0077,0.047,0.0435,0.0457,-0.0053,0.0485,0.0373,0.004,0.0166,0.0276,-0.0257,0.0187,0.0083,0.0298,-0.0251,0.0036,0.0169,0.0205,0.0064,0.028,-0.0385,0.0146,-0.1083,-0.0199,0.0545,-0.0385,-0.0126,-0.029,-0.0167,0.0365,0.0311,-0.0016,0.0045,0.0473,0.0049,0.0375,0.0211,-0.0107,-0.0383,-0.0359,-0.0285,-0.0233,0.0205,-0.0312,-0.0124,0.0222,-0.0257,-0.0271,-0.0341,0.0387,0.0273,0.0405,0.0413,0.0138,0.0007,-0.0096,-0.0068,0.0165,0.0141,-0.0052,-0.0344,0.0362,-0.014,0.0493,0.0404,0.0027,0.0296,0.0251,-0.013,0.0314,0.0023,0.0225,-0.0371,-0.0372,-0.0331,-0.0292,0.0498,0.0141,-0.0234,-0.0261,-0.0168,0.0,0.0243,-0.0045,-0.0114,-0.0303,0.0182,-0.0306,-0.0078,0.0529,-0.0194,0.0184,0.0035,0.0393,0.0256,-0.0137,0.0021,0.0095,-0.0128,0.0685,0.0173,-0.0338,-0.0272,-0.0333,-0.0866,-0.0708,0.0344,-0.0409,0.0023,-0.0235,-0.0131,-0.0303,-0.0129,-0.0773,-0.0199,-0.0106,0.0168,-0.0208,-0.0323,0.043,-0.0134,-0.0294,-0.0439,0.007,0.0401,0.0087,0.025,-0.0183,0.0025,0.0229,-0.0097,-0.0044,-0.0155,-0.0062,-0.0216,-0.0184,0.0109,0.0055,-0.0455,-0.0214,-0.0465,-0.0006,-0.0133,-0.0189,-0.0064,0.0334,-0.0157,-0.0725,-0.0446,-0.0219,0.0224,-0.0057,0.0196,-0.0458,-0.0041,-0.0107,-0.0238,-0.0242,0.0009,0.0306,0.0072,-0.0194,0.0407,-0.0167,-0.0009,0.0227,-0.0052,-0.0014,0.0022,0.0208,-0.0427,0.0382,0.0547,-0.0386,0.0277,0.0026,0.0344,0.0182,-0.0121,-0.0088,0.0143,-0.0035,0.0213,0.0127,-0.0567,0.0116,-0.0437,0.0116,-0.034,0.0398,0.0026,-0.0432,-0.0611,0.0032,0.0428,0.0058,0.0048,0.0335,-0.0211,-0.0196,0.0186,-0.0342,0.0013,0.0227,0.034,0.0411,0.0134,-0.0577,-0.004,0.0109,0.0427,0.0432,0.0108,0.048,0.0228,-0.027,-0.04,-0.0436,0.0045,0.0037,0.0219,0.0212,-0.0056,-0.0297,-0.0022,-0.0585,-0.0114,0.0184,0.0192,0.0167,0.0148,0.0279,-0.0577,0.0003,-0.0122,0.0226,0.0226,0.0045,-0.0034,-0.0908,-0.0464,-0.0536,-0.088,-0.0269,0.004,0.0291,-0.0801,-0.0502,-0.0538,-0.0593,0.0184,0.0344,-0.0086,0.0187,0.0225,-0.0257,0.0165,0.018,-0.0116,-0.0265,0.022,-0.0125,0.0556,0.0545,-0.0662,0.043,-0.0108,-0.0017,-0.007,0.0392,0.0503,0.0091,-0.0595,-0.0144,0.0052,-0.0143,0.0003,-0.0181,-0.0077,-0.0039,0.019,0.0113,0.0525,0.0175,-0.0262,-0.0396,-0.0219,-0.0426,-0.0229,-0.0355,-0.0244,-0.0159,-0.0451,0.0091,-0.0541,0.0153,-0.031,-0.0378,0.0056,-0.0567,0.02,-0.0241,0.05,-0.061,0.0092,-0.0318,-0.0437,-0.0805,-0.1031,-0.0107,0.0141,-0.0178,0.014,0.0122,-0.003,0.0243,0.0087,0.0162,0.0273,-0.0016,-0.0483,0.0286,0.0349,-0.0334,-0.0054,-0.0054,0.0201,0.0166,-0.0698,-0.0285,0.0327,0.031,0.0172,0.0135,0.0325,-0.0292,-0.0217,-0.0694,0.0008,0.0093,0.0174,0.0486,0.0027,-0.0049,-0.008,0.0358,-0.0686,-0.0883,-0.0192,-0.0313,-0.0202,-0.0085,-0.0103,0.0335,-0.0175,-0.0447,-0.0447,0.043,0.026,0.0313,-0.0006,-0.0184,-0.0568,-0.0084,-0.0332,-0.0108,-0.003,-0.0141,0.0457,-0.0058,0.0067,-0.0037,0.0461,0.0156,-0.0023,-0.0107,0.0271,-0.0727,-0.073,-0.0175,-0.0003,-0.0044,-0.0079,0.001,0.0016,-0.0036,0.0101,0.0176,-0.0116,-0.0085,0.0147,0.0311,-0.0438,-0.0641,-0.055,0.0132,-0.018,-0.0164,0.0401,0.0222,0.0563,-0.0326,0.007,-0.0146,-0.0274,-0.0138,0.0045,0.0361,0.0427,0.0278,0.0225,0.0106,0.0029,-0.0167,0.0064,0.0068,0.0099,0.0002,0.03,0.004,-0.0013,0.0462,-0.0104,-0.0301,-0.039,-0.035,0.0075,0.001,-0.0001,-0.0111,0.0263,0.0335,-0.0094,0.0132,0.0046,0.0402,0.0169,0.0109,0.0098,-0.01,-0.0183,0.0042,0.0371,-0.0264,-0.0145,-0.0212,-0.0064,-0.0301,-0.0199,-0.0225,-0.0269,0.0028,-0.0339,-0.0593,0.0668,0.064,-0.0063,-0.0252,0.0189,-0.0006,-0.0112,-0.0199,0.0163,-0.063,0.0134,0.0371,-0.0361,0.0246,-0.0059,0.0342,-0.0109,0.0155,0.0214,-0.0052,0.0147,-0.0103,-0.0126,-0.0052,-0.0208,0.0059,0.0432,0.0141,-0.0074,0.0292,0.0071,0.0554,-0.0076,-0.0023,0.0487,-0.0197,0.0195,-0.0283,-0.0183,0.0119,-0.0458,-0.0428,-0.0394,0.0002,-0.0863,-0.0373,-0.0462,-0.0022,-0.0204,-0.0049,-0.0434,-0.019,0.0081,-0.0102,0.0054,0.023,-0.0239,-0.0429,-0.022,-0.0064,0.0327,-0.0107,-0.0651,-0.0713,-0.0263,0.0236,0.0133,-0.0038,0.0092,-0.0668,-0.0099,-0.0717,0.0142,-0.0152,0.0092,-0.0705,-0.0851,-0.0378,-0.0846,-0.0374,-0.0376,0.03,-0.0227,-0.0303,0.014,0.0166,-0.0343,0.0132,0.0213,0.0165,0.0414,-0.0058,0.0114,-0.0272,-0.0082,0.0222,0.005,-0.0038,-0.0016,0.0177,0.0359,0.0074,-0.0091,0.0302,-0.0057,-0.0416,0.0254,0.0128,0.0373,0.034,0.0132,-0.0038,0.0422,-0.0027,0.0223,0.0027,0.0097,0.072,0.0293,-0.0421,-0.0529,-0.0129,0.0273,-0.0683,-0.024,0.0333,0.0388,0.0267,0.0542,0.0178,0.047,0.0397,0.0476,0.012,-0.0314,0.011,-0.0231,0.0416,0.0004,0.0089,0.0536,0.0487,0.0508,-0.0109,0.0559,0.0255,0.0414,0.0096,0.0085,0.0383,0.0486,0.0579,0.0506,-0.0012,0.0145,-0.0009,0.0141,-0.0257,-0.0314,-0.0128,-0.0166,-0.0212,0.0363,-0.0237,0.0312,-0.0126,-0.0069,0.0152,-0.0309,-0.0205,-0.0312,-0.0024,-0.0004,0.0301,0.0246,0.0556,0.0197,-0.0066,0.0307,0.0326,-0.0329,-0.0461,-0.0514,0.0602,-0.004,-0.0313,-0.0247,-0.0241,0.0327,-0.0108,-0.0038,-0.0201,-0.0075,0.0155,-0.0175,-0.0124,0.036,0.0079,-0.0026,0.0009,0.0283,0.0568,-0.0434,-0.0116,0.023,0.0234,-0.0181,-0.0054,0.0292,0.0304,0.0073,-0.0474,-0.0027,-0.0255,0.0021,0.0119,-0.0387,-0.0548,-0.0339,-0.006,-0.0029,0.0073,0.0078,0.0156,0.0746,0.0112,-0.0985,-0.0314,0.0033,-0.0139,-0.0075,-0.0183,-0.0215,0.0188,-0.0499,-0.11,-0.0584,-0.0607,-0.059,-0.0016,-0.0041,0.009,0.0021,0.002,-0.0144,0.052,-0.0706,-0.0149,-0.0306,0.002,-0.0013,0.0315,0.0397,-0.0118,-0.0313,-0.0046,0.0038,-0.0279,-0.0285,0.015,-0.0043,0.035,0.0008,0.0284,-0.0244,0.0203,0.02,0.0296,0.0191,-0.0226,0.0173,0.0012,0.0232,0.0169,0.0322,0.0538,0.0726,0.0074,-0.0118,0.0195,0.027,0.0338,-0.0021,0.0311,-0.0451,-0.0461,-0.0837,0.0481,-0.0089,0.0154,0.0408,0.0562,0.0757,-0.0132,-0.0347,-0.045,0.0081,-0.0012,0.0466,0.0661,0.0763,0.0588,0.0375,0.0418,0.0829,0.0759,0.0413,0.0717,-0.0025,-0.022,-0.0123,-0.0004,-0.0515,0.0351,0.0244,0.0381,0.0318,0.0075,-0.0406,-0.0569,0.0109,-0.0101,-0.0176,-0.0276,0.0565,-0.0038,0.0491,-0.0376,-0.0149,-0.0418,0.0727,0.0822,0.0638,0.0029,0.0004,0.0275,-0.0086,-0.0119,0.042,-0.0037,0.0548,0.0657,0.0002,-0.0112,0.0247,0.0053,-0.0154,0.0099,-0.0041,0.0175,0.0107,0.0435,-0.0517,-0.0559,-0.06,0.0387,-0.0072,0.0177,0.0452,0.0094,-0.0229,-0.0247,0.0051,-0.003,-0.0165,0.0427,0.0504,0.0245,0.0245,0.0022,0.0471,-0.0067,-0.0303,-0.0366,0.0176,0.0155,0.0701,0.0696,0.0027,0.0171,0.034,0.0038,-0.0068,0.0046,0.0034,-0.0805,-0.0546,-0.0335,-0.0396,-0.0098,-0.0538,-0.009,-0.0124,-0.0126,-0.1427,0.0168,-0.0877,-0.101,-0.0322,0.0256,-0.1467,-0.1148,-0.0565,0.0025,0.0376,0.0278,-0.002,-0.0396,0.0102,-0.0489,-0.0542,-0.0561,0.0053,0.0147,0.0459,0.0236,0.0048,-0.012,-0.0283,-0.0264,-0.007,-0.0216,0.0714,0.0504,0.059,0.0695,-0.0055,0.0092,0.0049,-0.0059,-0.0508,0.0322,-0.003,0.0167,0.039,0.0291,-0.0293,0.0022,-0.0213,0.0183,0.0088,-0.0341,0.0244,-0.0166,0.0186,0.0223,0.0137,0.0064,-0.0405,-0.0108,0.0114,0.0114,0.0435,-0.0774,-0.0634,-0.0482,0.0091,0.0337,-0.0319,-0.0191,0.0769,0.0703,-0.0094,0.0199,0.052,0.055,0.0055,-0.0629,0.0299,-0.0154,0.006,0.0148,-0.0431,0.0443,0.0255,-0.0389,0.0017,0.0025,0.0038,0.0178,0.0108,-0.0491,-0.0205,0.0126,-0.0449,-0.0477,0.0389,0.0205,0.0038,0.0041,0.0223,0.0019,-0.0095,0.01,0.0599,0.0312,-0.0094,0.0077,0.0362,0.0106,0.0077,0.0044,0.0327,-0.008,-0.0129,0.0158,0.0284,0.0154,0.0048,0.0164,0.0458,0.0469,0.0188,0.017,-0.0061,-0.0371,0.0199,-0.0046,0.0405,0.0327,0.0061,0.0469,0.0189,0.0359,0.0335,0.0362,0.0249,0.0243,-0.0182,-0.0065,0.0333,-0.0096,-0.0302,-0.0006,0.0713,0.0112,-0.0283,-0.0247,0.0085,-0.0058,0.0545,-0.0192,0.0071,0.0011,0.0409,0.0478,0.0175,-0.0164,-0.0152,-0.0297,0.0159,0.0187,0.0412,0.0511,-0.0469,0.0235,-0.0106,-0.0022,0.0273,0.0043,-0.0255,-0.009,0.0052,-0.0623,-0.0142,-0.0165,0.0245,-0.0499,-0.0055,0.0015,0.0111,-0.0026,0.0143,0.0346,0.0132,0.0187,-0.0173,0.0553,-0.0081,0.0566,-0.0359,-0.0147,-0.0264,-0.0201,0.0406,0.0359,0.0184,0.0359,-0.0031,-0.006,0.0084,-0.0245,-0.0175,-0.0109,0.0123,0.0034,0.0277,-0.0338,0.0276,0.0284,-0.0004,-0.0048,0.0029,0.0234,0.0397,-0.0199,-0.0329,-0.0043,0.0085,0.0108,-0.0148,-0.0073,0.0297,0.0239,0.0127,-0.0017,0.0131,0.0053,-0.0086,0.0022,-0.0615,-0.0815,0.013,0.03,0.0125,0.0193,0.0018,-0.024,-0.0305,0.0076,-0.0003,0.0344,0.0097,0.0185,0.0279,0.0013,0.0373,0.038,0.0163,-0.0185,-0.0572,-0.0182,-0.0229,-0.0621,-0.0238,-0.0071,0.0274,-0.1446,0.0116,0.0139,0.0591,-0.0124,-0.0043,0.049,-0.0475,-0.0866,-0.0173,-0.0549,-0.0311,-0.0248,0.0659,-0.0197,-0.0022,0.0185,0.0577,0.0569,0.0202,0.0153,0.0063,-0.0562,-0.052,-0.0114,0.0268,0.0272,-0.0031,0.0296,0.007,0.0051,-0.0065,0.0216,-0.0459,0.0328,0.008,0.0491,-0.0115,-0.0264,-0.0184,0.0237,-0.079,-0.0557,-0.0872,-0.0548,-0.0227,0.029,0.0044,0.0026,-0.0662,-0.0031,-0.0306,0.0456,-0.0034,-0.0341,-0.0701,0.0124,-0.0079,-0.0017,-0.0076,0.0262,0.0349,-0.0061,0.0205,0.0412,0.0328,-0.1003,-0.0973,-0.1003,-0.0258,-0.0317,-0.0451,0.0103,0.0404,-0.0065,0.0404,0.016,0.0082,0.0274,-0.0217,-0.0227,-0.0246,-0.0264,-0.0159,-0.0075,-0.0266,-0.0872,-0.0632,0.0287,-0.0083,-0.0394,0.0173,0.0122,0.0432,-0.0124,0.0057,-0.051,-0.0479,0.0102,0.0001,-0.039,0.0077,-0.05,-0.0151,-0.0352,-0.0965,-0.0963,-0.0102,0.024,0.0201,-0.0408,0.0282,-0.0048,0.004,0.0201,0.0062,-0.0261,0.0146,0.0355,0.0274,-0.0057,0.044,0.0373,-0.0356,-0.0257,-0.0057,0.0458,0.0391,-0.0023,0.0195,0.0268,0.0205,-0.0153,-0.0437,-0.0233,0.0288,0.037,-0.0922,-0.0799,0.0437,0.0072,0.0211,-0.0102,0.0431,0.0174,0.0177,0.0189,0.0055,0.0495,0.0114,-0.0304,-0.0113,0.0059,0.0021,0.0103,-0.0304,-0.0027,0.0354,0.0273,0.0364,-0.0158,0.0498,0.0624,-0.0274,0.0436,0.0227,-0.0336,0.0346,0.0386,0.0416,0.0239,0.0778,-0.012,0.0235,0.0113,-0.025,0.0136,0.0109,-0.0075,-0.0207,-0.0012,0.0111,-0.0344,0.0054,0.0352,0.0488,0.0331,-0.021,-0.0205,-0.0268,-0.0779,0.0165,0.0369,0.0136,-0.0868,-0.072,-0.0051,0.0551,0.01,-0.0015,0.0394,0.0108,-0.0777,-0.0672,0.0394,-0.0029,-0.0094,-0.0041,0.0755,0.0181,0.0506,-0.0253,-0.0213,-0.0615,-0.0029,0.0026,-0.0097,0.0168,-0.0129,-0.0202,-0.0146,0.0012,0.0081,-0.0159,0.0013,0.0262,-0.0046,-0.0459,-0.0464,-0.074,-0.0729,0.0509,0.0352,0.0161,0.0221,-0.0707,-0.0179,0.0321,0.0587,0.0083,-0.0042,-0.0307,-0.0216,-0.0538,-0.0087,-0.0207,-0.0002,-0.0035,0.0187,-0.0159,0.0188,0.0115,0.0091,0.0585,0.0068,0.0066,0.0048,-0.01,0.0086,0.0052,-0.0229,-0.054,0.0227,0.0844,0.0416,0.0675,0.0502,-0.0041,-0.0043,0.0301,0.0066,0.031,0.0029,-0.0448,0.0078,-0.0231,-0.0135,0.0002,0.0249,0.0354,0.0416,-0.0151,0.014,-0.0303,0.0385,0.0091,-0.0336,-0.0624,0.019,0.0223,-0.0261,-0.0771,0.0189,0.055,-0.0083,-0.0266,-0.0381,0.0072,-0.0182,0.011,-0.0219,-0.0881,0.0264,-0.1252,-0.0056,0.0131,-0.0945,-0.0599,-0.0408,-0.1049,0.0067,0.0357,-0.0558,0.0221,-0.045,-0.0386,-0.0613,0.0072,0.0492,0.0291,0.0345,0.007,0.0374,-0.011,0.0063,-0.0226,0.0614,0.0486,-0.0287,0.0242,0.0026,0.034,0.0086,0.0109,-0.0792,0.0078,0.0137,0.0253,0.0374,-0.029,-0.0207,-0.0125,-0.0128,-0.064,-0.0916,-0.0113,0.0129,0.0006,-0.0338,0.0458,-0.0398,-0.0171,-0.0474,-0.0365,-0.0749,-0.0475,-0.0046,-0.0172,0.0157,-0.029,-0.0131,-0.0107,-0.0174,-0.0222,-0.0065,0.0314,-0.003,0.0163,0.0183,0.0053,0.0201,-0.0014,-0.0315,-0.0756,0.0223,0.0197,0.0402,0.0525,-0.0052,0.0311,0.051,0.0659,0.0224,0.0176,0.0181,0.0107,0.0134,0.0058,0.0313,-0.0041,0.0234,0.0223,-0.0066,0.0285,-0.0351,0.0127,0.0153,0.0204,0.0211,0.0185,0.0018,-0.0275,0.05,0.0332,0.0199,0.0194,0.0463,0.0172,-0.0035,0.0147,0.0214,0.0347,0.0253,0.0283,0.04,0.0346,0.0228,-0.0022,0.0324,0.0121,0.0634,0.0237,0.0187,0.0224,0.001,-0.065,0.0183,0.0229,-0.0845,0.0408,0.0047,0.0284,0.0353,-0.0324,0.0128,0.0076,0.0392,0.0067,-0.0022,0.0216,0.0211,0.037,-0.0104,-0.1274,-0.0671,-0.0097,-0.0581,-0.1101,-0.0671,0.0056,0.0403,0.0114,-0.0166,-0.0151,-0.0271,0.0365,-0.0139,-0.0334,0.0249,-0.0056,0.0408,0.0389,0.0341,0.0322,0.0092,-0.0211,0.0579,0.0546,0.0151,0.0212,-0.0204,0.0129,-0.0062,0.0095,-0.0076,-0.0464,-0.0673,0.0657,0.042,0.0371,-0.0283,0.0506,0.0215,-0.0145,-0.0157,-0.0212,0.0009,0.0066,0.0137,-0.0157,0.0126,-0.0061,0.0272,0.0226,0.0335,-0.0501,-0.0544,-0.063,0.0364,0.0003,0.0404,0.0086,-0.0345,0.0248,0.0262,0.0205,-0.0286,-0.0187,0.0202,-0.002,-0.0042,-0.0037,-0.0282,0.0338,0.0517,0.0271,-0.0283,-0.0012,0.0225,0.0146,0.0098,0.0597,-0.0017,-0.0022,0.0019,0.027,-0.0057,-0.0033,0.0437,0.0236,0.0376,-0.0494,-0.0179,-0.0315,0.0048,-0.0346,-0.0262,0.0299,-0.0201,-0.0278,-0.0673,0.0283,-0.0009,0.0085,-0.0189,-0.0276,-0.0547,0.0076,0.0545,0.006,0.0304,0.0361,0.0466,0.0417,-0.0658,0.0371,-0.0036,0.0312,-0.0426,-0.1145,-0.0275,0.0214,0.0378,0.0123,0.0166,0.007,0.0618,-0.0558,0.033,-0.0607,0.0237,-0.0214,0.0044,0.0507,0.0445,-0.0052,-0.0033,-0.0307,0.0283,0.018,0.0099,0.0175,0.0045,0.0114,0.005,-0.0501,-0.0673,0.0536,0.019,0.041,0.0546,0.0243,-0.0332,0.0253,0.0272,-0.0567,-0.0054,0.0134,-0.1783,-0.1568,-0.0537,-0.0655,-0.0773,-0.0898,-0.0436,-0.1173,-0.0547,-0.1339,0.0083,-0.0573,-0.0314,-0.0431,-0.0165,-0.0208,-0.0217,0.0217,-0.0009,0.0284,0.002,0.0066,-0.0282,0.0181,-0.0001,0.0175,-0.0158,-0.0022,0.0513,0.0182,0.0446,-0.0295,-0.0067,-0.0027,0.0012,0.0365,0.0433,0.0429,0.0384,-0.0014,0.0087,-0.0307,-0.0279,-0.0154,0.0422,-0.0028,0.0494,0.006,0.0126,-0.0047,0.0787,0.0331,-0.0519,-0.0852,-0.0425,-0.004,-0.0196,-0.0106,0.0388,-0.0012,0.0117,-0.0553,-0.0137,0.0046,0.0191,-0.0393,-0.0221,0.0284,0.0277,0.0049,-0.0283,0.0748,-0.052,0.0043,0.0178,0.0067,0.028,-0.0172,0.0387,0.0398,0.0084,0.0302,0.0421,0.0054,0.0028,-0.0012,0.0008,0.0255,-0.0015,-0.0835,0.0454,0.046,0.0473,-0.0253,0.0181,-0.0037,-0.0362,0.0133,0.0287,-0.0201,0.0451,0.0669,0.0266,-0.0224,-0.0755,0.0159,0.0362,0.0254,-0.0351,0.018,-0.019,-0.0071,0.031,0.0215,0.0205,-0.0555,0.0194,0.0488,0.002,-0.0016,0.0398,-0.0118,-0.0062,0.0501,0.0501,0.0155,0.0119,-0.0314,0.0203,-0.0146,0.0325,0.0316,-0.059,0.0373,-0.0511,-0.0216,0.0223,-0.0362,0.0202,-0.1197,0.0112,-0.0052,0.0353,-0.031,0.0358,-0.0116,-0.0156,-0.0796,0.0249,-0.0126,-0.0167,-0.0149,-0.0473,-0.0053,0.0159,0.0167,-0.0125,-0.226,-0.0898,0.024,0.0567,-0.0016,0.0299,0.0298,-0.0146,0.0256,0.0322,-0.0241,0.0278,0.0029,0.0197,0.0334,-0.092,-0.0435,-0.0958,-0.0188,-0.0715,-0.0942,0.0075,-0.0035,0.0063,-0.007,-0.034,-0.041,0.0473,0.0098,0.0304,-0.0142,0.0146,0.0105,-0.0256,0.0223,-0.0131,-0.0295,-0.0245,0.0303,-0.0429,-0.021,-0.0109,-0.0388,0.0525,0.0332,0.0352,0.0346,0.032,0.0301,-0.0001,0.0648,0.023,0.0032,0.0321,0.0113,0.0304,0.0146,0.0111,-0.0038,0.0116,0.0278,-0.0349,-0.0289,-0.0182,0.0481,0.002,-0.0122,0.0034,-0.0743,-0.0384,0.002,-0.0078,0.0349,-0.0055,0.0121,0.0271,0.0334,0.0286,-0.0146,0.0287,0.0469,-0.0167,0.0374,0.019,-0.0007,0.0269,0.0226,-0.0016,-0.0564,-0.0316,-0.0409,-0.0685,-0.0104,0.0094,-0.0089,-0.0117,-0.0164,0.0303,-0.0187,0.0253,0.0433,0.0277,-0.01,0.0065,-0.0101,-0.0129,0.0026,0.0054,-0.012,0.011,0.0233,0.0125,0.0013,-0.0081,0.0155,-0.0184,0.0253,-0.0745,0.0558,0.0535,0.037,-0.0542,-0.0607,-0.0241,-0.0046,-0.0303,0.024,-0.0195,-0.0137,-0.0185,0.018,0.0124,0.009,0.0206,0.0166,0.0505,0.0158,0.0396,0.0277,0.0542,0.0248,-0.0006,-0.0323,-0.0137,-0.0113,-0.0066,0.0107,0.0343,-0.0308,0.0159,0.0447,-0.0124,0.0291,-0.0227,-0.0767,-0.0184,-0.1022,-0.035,0.0259,0.007,-0.0053,-0.0282,0.0228,0.0075,-0.011,-0.0072,0.0321,0.0416,0.0047,-0.0449,0.0283,-0.0194,0.0382,0.0169,-0.0013,-0.0976,-0.0245,-0.0174,0.0276,-0.0083,0.0154,0.0519,0.0072,-0.0394,-0.008,-0.0045,-0.0112,0.0124,-0.0038,-0.002,0.0083,-0.0449,0.0116,0.0253,0.0472,0.0548,-0.0204,0.0298,0.0314,0.0308,0.0247,0.0059,0.003,0.0017,-0.0295,0.0333,-0.0397,0.03,-0.0426,-0.0808,-0.0273,0.0315,-0.0257,-0.005,-0.0095,-0.0536,-0.0152,-0.0044,0.0165,0.0224,-0.0307,-0.0292,-0.0111,0.0044,-0.03,-0.0069,-0.0027,-0.043,-0.025,-0.0209,0.0133,0.0249,0.011,0.0585,-0.0117,0.041,0.0286,0.0065,0.0219,0.0278,0.02,0.0394,-0.0139,-0.0178,0.0155,0.0321,-0.0265,-0.0145,-0.012,-0.0669,-0.0032,-0.0567,-0.0303,-0.0004,0.0189,-0.0118,0.0107,0.0815,-0.0307,-0.0162,-0.0301,0.0133,-0.0236,0.0092,0.0039,0.0204,-0.0815,0.0529,-0.0422,0.0,-0.0294,-0.0629,-0.0335,-0.0306,0.0075,0.0547,0.0222,-0.0525,-0.0359,-0.0299,-0.0264,0.0769,0.0057,0.0047,0.0097,-0.0064,-0.0313,-0.0342,0.0164,0.037,0.0345,0.0498,-0.0434,-0.074,-0.0276,-0.0635,-0.0319,0.0052,0.0302,0.0019,-0.0451,-0.0273,-0.0037,0.0239,0.0278,0.0375,-0.001,0.0323,0.0364,0.0282,-0.0012,-0.0065,-0.0098,0.0341,0.0072,0.0078,-0.0814,0.0039,0.0308,-0.0092,-0.0721,-0.0528,-0.0711,-0.0646,0.0138,0.0046,0.0008,-0.0546,-0.0359,0.0392,-0.0257,-0.0487,0.0158,0.0171,0.0218,0.0287,-0.0075,-0.0138,0.0222,0.0053,0.0217,-0.0152,-0.0116,0.0386,0.0379,0.0172,0.0182,-0.0072,-0.0046,0.0519,0.0146,0.0265,0.0376,-0.0368,0.0027,0.0269,0.0135,-0.0078,0.0065,0.0142,0.0174,-0.0096,0.0188,0.0271,0.0331,-0.0401,-0.0351,-0.0827,-0.0323,-0.0873,0.0281,-0.0157,-0.0331,0.0025,-0.0287,-0.0356,0.0407,0.0234,0.0039,-0.0004,-0.0121,0.0166,0.0233,-0.0041,0.0099,-0.0085,0.0482,0.0603,0.0325,0.0417,0.0181,-0.025,-0.0205,-0.0025,-0.0159,-0.0241,0.0015,0.0227,-0.0267,-0.0797,-0.0262,0.0338,-0.0106,-0.0347,-0.0103,0.011,-0.0092,0.044,0.012,0.0333,-0.0149,0.0609,-0.0124,-0.1036,-0.055,-0.0185,-0.0127,0.038,0.0217,0.0107,0.0415,0.0046,-0.0092,-0.0209,0.0256,-0.0392,-0.0303,-0.0498,0.0334,0.0277,-0.0529,-0.0002,-0.1242,-0.0678,0.0336,0.005,-0.012,-0.0355,-0.0162,0.0509,0.001,0.0416,0.0277,0.0446,0.022,0.0434,0.0021,-0.0136,0.0292,0.0307,0.0107,0.0041,0.0378,0.0299,0.0459,-0.0333,0.0492,-0.0303,-0.0203,0.0043,-0.0172,0.0153,0.0294,0.0073,0.0074,0.0492,0.0192,0.0175,0.0316,0.0233,-0.0574,-0.0529,0.0083,-0.007,-0.0431,0.0174,0.0182,0.0269,0.0354,-0.0213,-0.0165,0.0072,0.0237,0.0151,-0.0208,-0.0011,-0.002,-0.0091,-0.013,-0.0335,0.0214,0.0064,-0.0117,-0.0778,0.0239,0.0299,-0.0109,-0.0336,0.0092,0.0253,0.0024,0.0309,-0.0157,0.0227,0.0188,-0.0882,-0.0688,-0.0454,-0.0247,-0.0135,0.0446,0.0383,0.0344,0.0367,0.0505,-0.0031,-0.0356,0.017,-0.0254,0.0313,-0.0291,0.0051,0.0401,0.0292,0.0276,0.0445,0.0174,0.0233,0.0012,0.0405,-0.0162,0.0361,-0.0603,0.0519,-0.0023,-0.0192,-0.0354,-0.0144,0.0218,0.0023,-0.0282,-0.015,-0.0203,-0.0191,0.0284,0.0525,0.046,0.0001,0.0419,0.0229,0.0231,0.0168,0.0564,-0.0062,-0.0099,-0.0981,-0.0538,-0.0341,-0.0284,-0.007,-0.0062,-0.0395,-0.0583,-0.0384,-0.0161,-0.0096,-0.0007,0.0369,0.013,-0.0019,0.0189,-0.0403,0.0573,-0.0145,0.0361,-0.0212,-0.0249,-0.0069,0.0882,0.0238,0.0639,0.0812,0.0294,0.0507,-0.0048,0.0639,-0.0194,0.0173,-0.0164,0.0487,-0.0034,0.0356,0.0333,0.0225,-0.0285,0.0388,0.0306,-0.013,-0.0418,-0.035,-0.0641,-0.0247,0.0033,0.0376,-0.0129,0.0528,-0.005,-0.0235,-0.0092,-0.0321,-0.0202,0.0,0.0393,0.0016,0.0334,0.0108,-0.0331,-0.0425,-0.0403,0.0398,-0.014,-0.0494,-0.0566,0.0175,0.05,-0.0048,0.0056,-0.0336,-0.0363,-0.0064,-0.0726,0.047,-0.0178,-0.0088,-0.0141,-0.0439,0.0386,-0.004,0.0288,-0.0436,-0.0573,0.0145,-0.0154,-0.0148,0.002,-0.0301,-0.0435,-0.0487,0.0313,0.0038,-0.0084,-0.0213,0.0723,-0.0147,-0.0226,-0.0151,0.0219,0.0262,0.069,0.0575,-0.0056,0.0384,-0.0209,0.0081,-0.0655,-0.0034,0.0136,-0.086,-0.0937,0.007,0.0045,-0.0583,-0.0248,-0.0437,-0.0003,-0.0852,-0.0284,-0.0353,-0.0516,-0.0635,0.016,-0.075,0.0167,0.0617,0.022,0.0234,0.0659,0.042,-0.0128,0.0095,0.0404,0.0635,-0.0068,0.0561,0.0349,0.0389,-0.0025,0.0479,0.0401,0.046,-0.0238,-0.0618,-0.0848,-0.0512,-0.0557,-0.0104,-0.051,0.0655,0.0473,0.0171,0.0181,-0.0082,0.0355,0.0159,0.0027,0.0141,0.0512,0.0263,0.0225,0.0166,-0.0137,-0.0502,-0.0633,-0.003,0.0482,0.0437,-0.0218,0.0214,-0.0114,-0.0103,-0.1122,0.0364,0.0172,0.0637,0.0179,0.0317,-0.0748,-0.0349,0.0136,0.0099,-0.0005,0.0406,0.0253,0.0148,-0.0884,0.0598,0.0414,0.0173,0.0104,-0.0538,0.0304,0.0411,0.0241,0.0356,0.012,-0.0968,0.0231,0.0164,0.048,0.0506,0.0589,0.0217,0.0199,0.0037,0.0496,0.0223,0.0218,0.0016,-0.0001,0.024,0.0159,-0.0256,-0.0168,0.0444,0.0149,0.0083,0.0224,0.0472,0.0309,-0.0288,-0.0421,-0.004,-0.0782,0.0187,-0.0142,-0.0341,0.0255,0.0147,-0.0295,-0.0072,0.0058,-0.0195,0.0032,0.0051,-0.0572,-0.0363,-0.054,-0.002,-0.0492,-0.0079,0.0038,-0.0362,-0.0501,0.0039,0.0085,0.0502,-0.0066,-0.0035,0.0317,0.0406,0.0345,0.0144,0.0354,0.0279,0.0697,-0.0195,0.0105,0.0475,0.013,-0.0198,-0.0631,0.0243,-0.0179,0.0213,-0.0077,0.0195,-0.0096,0.0323,0.0056,-0.0114,-0.0274,0.0417,-0.0159,0.0388,0.0077,0.0181,0.0419,0.0357,0.0516,-0.0858,0.0403,-0.0137,-0.0023,0.0245,0.0437,0.0409,0.0541,0.0009,0.026,-0.006,0.0139,0.0295,-0.0137,0.0075,-0.0075,-0.0104,-0.0073,-0.0114,0.0352,0.0068,0.029,-0.0186,0.0045,-0.0191,0.0239,0.022,0.042,-0.0494,-0.0619,0.0163,0.014,0.0335,-0.0187,-0.0038,-0.0068,0.0445,0.036,-0.0829,-0.0182,0.0406,-0.0038,-0.0019,0.0333,0.0098,0.0568,0.0672,-0.0138,-0.0922,-0.0262,0.036,-0.0506,0.0192,0.073,0.0578,0.024,0.0177,0.0308,0.0186,0.0543,-0.0459,0.0224,-0.0205,0.0227,0.0217,-0.0197,0.0327,-0.055,-0.0417,-0.0717,0.0353,-0.0001,0.0064,0.0501,0.0373,0.0713,0.0572,0.0265,-0.0574,0.0088,0.0579,0.0588,0.0106,0.0109,-0.0159,0.034,0.0273,-0.0249,-0.0204,-0.0758,0.0233,0.0461,0.0282,0.0331,0.0713,-0.0452,0.0832,0.0826,0.0071,-0.0149,-0.0073,0.011,0.0117,0.0092,-0.0692,-0.101,0.0154,0.0163,0.0304,-0.0065,0.0521,0.0385,-0.0147,-0.122,-0.121,-0.023,-0.0223,0.0386,0.0063,-0.0137,-0.0081,0.0104,0.0231,0.0061,0.0066,-0.0032,-0.0507,-0.0463,0.0296,interference resolution
trm_55b6b910b4b23,0.0785,0.1083,0.0617,0.1118,-0.034,0.0053,0.028,0.0538,0.0439,0.0706,-0.0074,-0.0173,0.1097,0.0388,0.0626,0.0755,0.0712,0.0458,0.0553,-0.0403,0.0273,-0.0337,-0.0077,-0.0409,-0.0208,-0.0555,-0.0532,0.1163,0.1472,0.042,0.0526,0.0395,0.0861,0.0612,0.1035,0.0736,-0.0068,0.0535,0.0946,0.032,0.069,0.1064,0.0475,-0.0645,0.0586,0.0564,-0.2138,0.0709,-0.0016,0.15,0.0684,-0.0218,-0.0363,0.0016,0.0353,0.0633,0.0814,-0.0142,-0.0173,0.007,-0.0656,-0.0819,0.1158,-0.1044,0.0071,-0.0132,0.1265,0.149,0.081,-0.0158,-0.0516,-0.0472,-0.1116,0.027,0.1154,-0.03,0.1387,-0.0701,-0.0521,0.0387,-0.0453,-0.0711,0.0164,0.0881,-0.0211,-0.0092,0.0555,-0.011,-0.0035,0.3441,0.0684,0.0886,0.0,-0.1255,-0.1492,-0.1222,-0.1255,0.0109,-0.1607,-0.0381,-0.0496,-0.0551,-0.0557,-0.0368,-0.0976,0.0947,0.108,-0.0773,0.0579,0.0668,-0.0215,0.0712,-0.0764,-0.1091,-0.0258,0.0249,0.0439,0.0084,-0.0009,0.0534,0.0372,0.1198,0.0522,0.0299,0.089,0.071,0.0789,-0.0613,-0.076,-0.0076,0.0211,0.0584,0.0045,0.1472,0.0217,0.1103,0.0195,0.0575,0.0239,0.0013,0.0696,0.0936,-0.0458,0.0258,0.0198,-0.0163,0.0886,-0.032,0.0623,-0.0679,0.0586,0.0281,0.0913,0.1197,-0.1357,-0.0068,-0.0464,-0.0331,-0.0115,0.0276,0.0721,0.0469,0.1321,0.155,0.0146,-0.002,0.0094,0.1105,0.0991,0.0157,-0.0042,0.0597,-0.0523,0.0855,0.0873,0.1055,0.0672,0.0631,0.0472,0.0384,0.1634,-0.0847,0.0415,0.0199,0.0713,0.0451,0.0546,0.0179,0.0028,0.0714,0.0689,0.0212,-0.0132,0.1293,0.112,0.2034,0.1618,-0.0187,0.003,0.1267,0.0536,-0.1321,0.0709,0.1119,-0.004,0.1429,0.0789,0.0154,0.0202,-0.0164,0.0699,0.001,0.0339,-0.0487,-0.0646,-0.0293,-0.1321,0.0827,0.1252,-0.0763,-0.1137,0.0415,0.077,0.0366,-0.0248,-0.0628,0.0766,-0.1052,0.0464,-0.079,0.0486,0.0514,-0.1757,0.0955,0.0914,0.0323,0.0017,-0.0176,0.0012,0.0727,-0.0245,0.1218,0.041,-0.0009,0.047,0.0403,0.052,0.1293,0.1037,0.0289,-0.0093,-0.037,0.0492,-0.0331,0.049,0.1278,0.04,0.0854,-0.1242,-0.2735,-0.0296,-0.2537,0.0533,-0.124,-0.1716,-0.2607,-0.0654,-0.009,-0.0719,-0.0055,0.0551,0.0185,0.0811,-0.0763,0.1673,0.041,0.2937,0.2923,0.2451,0.136,0.0406,0.0037,-0.0046,0.113,0.0945,0.0689,-0.0418,-0.0335,0.083,0.0855,0.0672,0.035,-0.0111,0.0282,0.0718,-0.0243,-0.0061,-0.0221,-0.0015,-0.0378,-0.0538,0.0712,0.1088,0.0475,0.0772,0.0734,0.0925,0.0362,0.0531,-0.0063,0.0406,0.004,0.0853,-0.0708,-0.042,0.076,-0.0809,-0.0794,-0.0699,0.119,0.0041,-0.0665,0.074,0.1046,0.054,0.0513,-0.0028,0.0406,0.0439,0.0757,0.0032,0.0447,-0.0541,-0.0579,-0.0587,-0.0149,-0.0288,0.0202,-0.0714,0.0837,0.0709,-0.1137,-0.0069,0.0389,-0.081,-0.0099,0.1627,0.1323,0.1065,0.0704,0.0528,-0.1204,0.0667,0.056,0.0166,0.062,0.0322,0.1061,0.1162,0.098,-0.0581,0.0592,0.1007,0.0033,0.0317,-0.0718,0.0858,-0.09,-0.0365,0.0981,-0.0256,-0.083,0.0181,-0.0829,0.1268,0.0699,0.0983,-0.1118,-0.1723,-0.0835,-0.1909,0.0009,0.0881,0.0026,-0.0046,-0.0153,0.0584,0.0036,-0.0353,0.0247,0.0742,0.048,0.0124,-0.0037,-0.0606,0.0011,0.077,0.1132,0.0943,0.0912,0.0463,-0.0227,0.0304,0.0489,-0.0713,-0.0488,-0.0861,-0.0139,0.0753,0.0179,-0.0088,0.0729,0.0152,-0.2043,0.0306,0.054,-0.194,0.0054,0.0756,0.0041,-0.0028,0.1718,0.0997,0.2499,0.2126,0.0993,0.1304,0.069,0.0836,0.1242,-0.0262,-0.0139,0.0184,0.0576,-0.0231,-0.0773,0.0322,0.0507,0.1746,0.1053,-0.0407,-0.0831,-0.0286,-0.0503,-0.0112,0.054,0.0324,-0.0559,0.0652,0.0649,0.0211,-0.048,0.0917,0.1024,0.0105,0.0786,-0.0047,0.0665,0.067,-0.0211,-0.0505,0.05,0.0365,-0.0811,0.0618,0.1274,-0.0487,-0.3106,0.1176,0.0692,-0.0143,-0.0462,-0.0328,0.025,0.084,0.0436,-0.0243,-0.0019,0.0306,0.0127,-0.0076,0.0187,0.0528,-0.0518,-0.1085,-0.1061,0.0427,-0.0057,0.0219,0.0093,-0.0488,0.0089,0.0836,0.1056,-0.0969,-0.0568,0.1742,0.0078,-0.0157,0.0709,0.0691,-0.0099,0.0866,0.0891,0.0822,0.0621,-0.0173,-0.011,0.0038,-0.1121,0.1703,0.0304,0.025,0.0035,-0.0977,-0.0176,0.0696,0.0623,-0.0275,0.0392,0.1136,0.0948,-0.1155,-0.0495,-0.099,-0.066,-0.0529,-0.0695,-0.003,-0.0624,0.0571,0.0274,0.0628,0.1423,-0.0001,0.0198,0.0729,0.0758,0.0562,0.0863,0.0117,-0.0649,0.0536,0.0388,0.0395,0.0293,-0.0012,-0.0301,-0.0025,-0.0611,-0.0688,0.0224,0.0374,0.0645,0.0349,0.0915,-0.0767,-0.0178,-0.084,0.0514,0.0447,-0.0054,0.053,-0.0328,0.0978,-0.0196,-0.062,0.009,0.0089,0.0578,0.0543,-0.0248,0.1312,-0.0058,-0.0079,0.0188,-0.041,0.0179,-0.0448,-0.0498,0.0459,0.0673,-0.0042,0.0269,-0.0295,-0.0431,0.0477,0.0048,0.0002,0.0466,0.1072,0.0065,-0.0667,-0.0242,0.0685,0.0532,0.143,0.0031,-0.1017,0.061,-0.0072,-0.0665,-0.0773,-0.0331,-0.0752,-0.0212,0.0103,0.1003,0.0981,-0.0229,0.1296,0.052,-0.08,0.058,0.1536,-0.0192,0.0316,-0.0288,-0.0055,0.1414,0.0773,0.1387,-0.0463,-0.0392,0.004,-0.054,0.0977,0.0799,0.0754,-0.0104,-0.0342,-0.0172,0.0707,-0.0136,0.0516,-0.0321,-0.0472,0.0522,0.0323,0.0845,0.0755,-0.0842,0.0077,0.0449,0.0739,0.0242,0.1073,0.0762,-0.0686,0.0973,0.0078,0.0917,-0.1243,0.0486,0.007,0.0555,0.003,0.0783,-0.0018,0.0541,0.0688,-0.0117,-0.1407,0.0391,-0.0373,-0.0587,0.1099,0.0585,0.0831,0.0136,0.0374,0.0323,0.0505,0.0496,0.0416,0.0533,-0.1492,0.0356,-0.0173,0.0257,-0.0167,-0.073,-0.0563,0.0193,-0.0648,0.1417,0.0614,-0.0174,0.004,-0.0053,-0.0367,-0.1326,-0.0843,-0.0646,-0.1526,0.0189,-0.0548,0.0466,0.0638,-0.0023,-0.0015,0.0175,0.0407,0.0562,0.0572,0.08,0.0857,0.0551,0.0611,-0.0117,-0.1184,-0.047,-0.0225,-0.0352,-0.0582,0.0157,0.0229,0.0412,0.0361,-0.0323,-0.0693,0.0396,0.1571,0.1655,0.0908,0.0239,0.034,0.053,-0.019,0.0343,-0.1024,0.0216,0.0663,-0.0762,-0.0772,-0.0014,0.1301,-0.1129,-0.1271,-0.1325,0.0955,0.014,0.0783,-0.0256,-0.0582,0.0752,-0.0759,-0.0482,0.022,-0.0061,0.0223,-0.093,0.1116,0.1569,0.1358,0.0947,-0.0791,-0.2086,-0.0355,0.0952,0.0268,0.008,-0.0214,-0.0766,-0.0299,-0.0098,0.0165,0.0543,0.0418,-0.0499,-0.0606,-0.1436,0.0483,0.0096,-0.0268,0.0718,-0.0713,0.0275,0.0795,0.03,0.0891,0.0851,0.0401,-0.0593,-0.0881,-0.0035,0.0469,0.0268,-0.0005,-0.1101,0.0231,0.1187,-0.1119,0.0323,0.0071,-0.0123,-0.0686,0.0708,-0.0749,0.1459,0.1423,-0.0919,-0.1218,-0.185,0.0131,-0.0191,-0.0509,0.0375,-0.0315,-0.2127,-0.0224,-0.072,-0.1174,-0.1674,-0.0417,0.0299,-0.1107,-0.161,0.1068,-0.0054,-0.0273,0.1477,0.0822,0.0632,0.0796,-0.087,0.1404,0.0308,0.1043,0.0401,0.0978,-0.0743,-0.0265,-0.1277,0.0544,0.035,0.0073,0.022,-0.0688,-0.0425,-0.0374,-0.0788,-0.011,0.0298,0.0017,0.0251,-0.1193,-0.1742,0.0634,-0.1121,-0.0431,0.0172,0.0395,0.0502,0.0491,-0.0911,0.0573,0.1599,0.0719,0.0257,-0.0611,-0.0648,0.059,0.0009,0.0428,0.0291,0.0548,0.0717,-0.0591,0.0425,-0.0616,0.0935,0.0006,0.0686,-0.1062,-0.0024,0.0075,-0.016,0.1285,0.1063,0.0587,-0.2093,0.0584,0.0504,0.0904,-0.0644,-0.0218,0.1044,0.0301,0.1225,0.0315,0.0651,-0.0576,-0.0236,-0.0132,-0.1311,0.1021,0.0549,0.0397,-0.0288,0.0789,-0.0065,-0.1906,-0.0703,-0.0885,-0.3801,-0.1122,0.0212,0.0624,0.0289,0.0466,0.0285,0.0239,-0.0072,-0.1057,-0.0968,-0.0342,0.0621,-0.1129,-0.1495,-0.0021,0.0674,0.0419,0.005,0.1356,0.0363,0.047,-0.0149,-0.0604,0.0715,0.0536,-0.1533,-0.0274,0.1062,0.0051,-0.0444,-0.001,0.0147,0.0101,0.1008,0.1055,0.1384,0.1077,0.1023,-0.0541,-0.0427,0.0506,0.0921,0.0016,0.1223,-0.0043,0.1067,0.066,0.0576,-0.0117,-0.0701,-0.0815,0.0249,-0.0559,0.0465,-0.068,-0.0906,-0.1288,-0.1856,-0.1072,0.0567,0.0565,-0.036,0.0223,-0.0798,-0.0873,-0.0822,0.0284,0.0124,-0.0468,-0.1237,0.0296,0.0487,0.0249,-0.0584,0.1397,-0.0897,0.1365,0.0359,-0.0016,0.009,-0.0096,-0.0467,-0.0257,-0.0055,-0.0802,-0.1701,-0.1691,0.0309,0.0087,0.0036,0.0266,-0.0367,-0.0172,-0.0061,0.048,0.1118,0.015,-0.0834,-0.0689,0.1126,0.0828,-0.0065,0.1269,0.0494,-0.1428,-0.0483,-0.1008,-0.0872,-0.1153,0.0537,0.0045,-0.0455,0.0238,-0.0038,0.0509,-0.0522,0.0578,0.0447,0.0118,-0.0545,0.0635,-0.0152,0.066,-0.0486,0.0889,-0.0096,-0.0939,-0.106,0.0077,-0.0387,-0.0103,0.0665,-0.0085,0.0339,0.0617,0.0762,0.0123,-0.0025,-0.0015,0.066,0.0488,0.0014,-0.0224,0.0302,0.0484,0.053,0.1407,0.0916,0.086,-0.098,-0.0313,-0.0803,0.1012,-0.1939,-0.1126,0.0025,0.0061,-0.0271,-0.037,0.0038,-0.0847,0.0832,0.0835,-0.0057,0.0815,0.1045,0.0076,0.0519,-0.0796,-0.0696,0.0426,0.0373,0.0855,-0.0387,-0.0093,-0.0037,-0.0276,-0.0399,0.0946,-0.0028,0.0221,-0.0737,0.0253,0.0318,-0.4578,-0.3485,-0.2773,-0.1473,-0.1752,-0.0679,-0.2703,-0.1926,0.1087,-0.295,-0.2899,-0.2235,-0.1786,-0.2663,-0.0561,-0.0833,-0.0414,0.0096,-0.0051,-0.0151,-0.0608,-0.028,0.0694,-0.0291,-0.0557,0.0057,-0.0691,0.0236,0.0717,-0.1187,-0.0626,0.0438,0.0227,0.0737,-0.0143,-0.0191,-0.1472,0.0176,0.0756,0.045,-0.0361,-0.0428,-0.1157,-0.0639,0.0764,0.0674,0.1371,0.0762,0.0661,-0.2811,0.0867,-0.2638,-0.2017,0.0674,-0.0177,0.0806,-0.0133,-0.0567,0.0093,-0.1961,-0.0813,0.0222,-0.036,-0.0177,0.0293,0.0602,-0.0319,0.0493,0.0012,0.0061,0.0796,0.0386,0.11,0.0143,-0.0112,-0.0117,0.0984,0.0238,-0.1539,-0.0091,-0.0064,0.0246,-0.0858,-0.0185,0.0015,0.1167,0.1281,0.0234,0.0812,0.0588,0.1082,-0.0049,0.031,0.019,-0.0227,-0.0569,0.0027,-0.1774,0.0504,0.0944,0.0456,-0.0629,0.0408,-0.0897,0.1117,-0.0707,-0.1699,-0.0199,0.169,-0.1396,-0.1128,0.0062,0.1318,-0.0145,0.1086,0.0592,0.1369,-0.013,-0.0558,0.0821,0.0591,0.0133,0.0891,0.0389,0.0927,0.0374,0.0577,0.0403,0.0647,-0.1185,0.0271,-0.378,-0.285,-0.2644,-0.3105,0.0325,-0.0101,0.0683,0.0427,0.0737,-0.0123,0.0764,-0.2112,0.0503,0.0695,-0.0779,-0.0607,-0.0171,-0.1016,-0.0452,0.0137,-0.0386,-0.0584,0.0505,0.0705,0.0944,-0.0653,-0.0035,-0.0145,0.0456,0.0456,0.1537,-0.0735,-0.0077,-0.0284,0.0373,-0.1064,0.0157,-0.1945,0.2028,0.1884,-0.033,0.0454,0.1476,0.1545,0.1661,0.0365,0.0341,-0.0139,-0.017,0.0303,-0.1143,0.033,0.0186,0.0941,-0.0643,0.0158,0.0086,-0.0129,0.07,0.0311,0.0351,0.091,0.0103,-0.0028,0.1743,0.0433,-0.044,-0.0456,0.0069,-0.0345,0.0055,-0.1098,0.0351,-0.0065,-0.0295,0.0649,-0.0293,0.1198,0.1847,0.0161,0.0301,0.1309,0.0283,0.053,0.1288,0.0183,0.0683,-0.0342,0.3023,0.1718,0.0618,0.1442,0.0033,-0.0238,0.0096,-0.3157,-0.0295,-0.0039,-0.0067,0.035,0.0008,0.0494,0.2883,0.2814,-0.0257,0.0688,0.1266,0.0196,-0.0114,-0.0548,-0.0518,-0.0304,0.0825,0.0596,0.0356,0.0628,0.0884,0.0456,0.016,-0.0998,0.0017,0.0715,0.0119,0.0792,0.0557,0.0177,0.0946,0.1219,-0.0443,-0.0512,-0.0498,-0.0804,0.0219,0.055,0.0487,-0.0087,0.087,-0.0512,0.0385,0.0205,0.1068,0.1151,-0.0083,-0.091,-0.0495,-0.0123,-0.0113,0.03,-0.1646,0.0136,-0.0141,0.0271,0.1344,-0.0628,0.0108,-0.1152,-0.0671,-0.2108,-0.0193,0.0817,0.0314,-0.1623,0.0406,-0.0218,0.0385,-0.0046,0.0596,0.0477,0.0275,-0.0705,0.0505,0.0121,0.0679,0.0162,-0.0252,0.0369,-0.001,0.1231,-0.013,0.0241,0.058,-0.0719,0.0508,0.0359,0.0757,0.0388,0.0481,0.0381,0.0148,0.0402,-0.0394,0.0227,-0.0159,0.023,0.0391,-0.0099,0.0352,0.0352,0.0191,0.1345,-0.0429,0.0885,0.0326,-0.0053,-0.0772,-0.0846,-0.0622,-0.0481,0.0852,0.041,0.0154,0.0303,0.1215,-0.0056,0.1132,0.0207,-0.0569,0.0329,0.0526,0.0743,0.0672,-0.005,0.0334,0.0848,-0.2627,0.0211,-0.0244,-0.044,-0.1529,0.0036,0.0645,-0.082,-0.1568,0.054,-0.0057,0.0438,0.0533,0.0355,0.0466,-0.0548,0.0115,0.0707,-0.0182,-0.1048,0.0084,0.0344,0.0173,0.0112,-0.032,-0.0598,0.2125,0.0931,0.0676,0.1874,0.158,-0.0618,-0.0774,0.0205,-0.014,0.0567,-0.0456,0.1459,0.0191,0.0874,0.0633,0.1636,0.0126,0.0211,0.0588,0.1066,-0.1141,0.0003,0.0096,0.0068,-0.0001,-0.0955,-0.1256,0.0181,-0.0491,0.0133,0.0205,0.0592,0.0242,-0.0317,0.0278,0.0453,-0.0952,-0.0807,-0.0296,0.0319,0.0644,0.037,-0.2756,-0.2602,0.1207,0.0872,-0.0356,0.0568,0.0727,0.0326,0.1329,0.0066,-0.0079,0.0226,-0.0197,0.0012,-0.0919,0.061,-0.0311,-0.0433,0.0274,-0.0193,-0.2456,0.0481,0.0328,-0.2515,0.0002,-0.0388,-0.0501,-0.0574,0.0233,-0.1129,-0.0894,0.0494,0.012,-0.0101,-0.041,-0.0868,-0.0633,0.0008,0.0109,0.0284,-0.104,0.0671,-0.0631,-0.165,0.0078,0.0458,-0.0587,0.029,0.099,0.0226,-0.0687,0.0217,0.0893,0.1838,0.0431,-0.0173,0.0154,-0.0041,-0.0301,-0.0555,-0.0316,-0.1858,-0.065,-0.1715,-0.0662,-0.1548,-0.0174,-0.0356,-0.4068,0.0456,0.1,-0.0088,0.1128,0.0101,0.0195,0.0027,0.0316,0.0277,-0.0229,0.0534,0.0012,-0.0138,0.0184,0.0319,0.0503,-0.0207,-0.0806,-0.1125,-0.2161,-0.1944,0.0658,0.0702,0.0773,0.0552,0.0149,-0.0125,-0.0355,-0.0814,-0.06,0.0215,-0.0833,0.0489,0.1531,0.074,-0.0372,-0.0385,-0.0271,-0.0738,-0.0868,-0.2715,-0.2126,0.1174,-0.0427,0.0575,0.0076,-0.0435,-0.038,0.2628,0.2656,0.3575,-0.0923,-0.0269,-0.0594,-0.1167,0.0709,0.0028,-0.0499,-0.0612,-0.0125,-0.1138,-0.0519,0.0041,0.0295,-0.0445,-0.0735,-0.1328,-0.2094,0.0061,-0.0331,-0.0382,-0.0158,0.0685,-0.0101,0.1738,0.0446,0.0137,0.0551,-0.0079,-0.0176,0.0686,0.0269,0.0403,0.0081,0.0059,0.011,0.0478,0.0424,-0.0032,-0.0037,0.083,0.0151,-0.1315,-0.0298,-0.0733,0.1237,0.1012,0.103,-0.005,-0.0154,0.0075,0.0684,0.045,0.1072,0.0255,-0.0458,0.0219,-0.103,-0.0306,-0.0307,-0.0361,0.0053,-0.0512,-0.0439,0.0431,0.163,0.0127,0.0682,0.0297,0.0557,-0.0551,-0.0679,-0.2574,-0.1859,-0.0818,-0.0784,0.0994,0.2215,0.1478,0.1536,0.0924,-0.058,0.0219,-0.0455,0.0587,0.1117,0.1194,0.0523,0.0787,-0.0046,0.0501,-0.0172,-0.0173,0.0119,0.1013,0.0977,-0.0093,-0.0401,0.0398,-0.0145,0.1071,0.0477,0.0569,0.0607,0.1948,-0.033,-0.0385,0.0514,0.0769,0.0279,0.062,0.026,0.1291,0.0693,0.0301,-0.0883,-0.1077,-0.0641,-0.0912,-0.0679,0.069,-0.0186,0.0005,-0.1179,0.0489,0.0039,0.0315,-0.119,0.1062,0.1353,0.0739,0.025,0.0324,0.0946,0.0437,0.0466,0.0604,0.0737,-0.0222,-0.0033,0.1609,-0.0303,0.0524,0.0643,0.1039,0.0509,0.0949,0.1027,0.075,-0.0098,-0.2388,0.0909,0.0983,0.1601,0.0935,0.0822,0.0643,0.1397,0.0977,0.0223,-0.0766,-0.0888,0.008,0.0467,-0.0457,-0.08,-0.1228,-0.0239,0.1593,0.1694,0.0502,-0.0398,-0.0041,0.0925,-0.0286,0.0354,-0.022,0.0258,0.0788,0.0667,0.0432,0.0609,0.0507,-0.0229,0.0583,0.0778,0.0255,0.0367,-0.1046,-0.1267,0.0881,0.0893,0.0923,0.1272,0.1022,0.1595,0.0964,-0.3208,0.0423,0.0586,-0.0041,0.0095,0.0523,-0.0084,0.0057,0.0126,-0.0665,0.0461,-0.0311,-0.0284,0.0605,-0.003,0.0171,-0.0847,-0.2352,0.1007,0.0132,-0.0743,-0.3133,0.0936,-0.0201,-0.0358,0.0561,-0.0124,0.0049,-0.0306,-0.0012,0.0275,0.1075,0.2833,0.2789,0.1374,0.0289,-0.0697,-0.1462,-0.0972,0.0223,-0.0129,-0.075,-0.1599,-0.1244,-0.0634,-0.0335,-0.0348,-0.0477,0.1498,0.0989,0.108,0.0766,-0.0248,0.0997,0.024,0.0254,-0.0493,0.0559,0.1686,0.062,0.0429,0.0664,0.1699,-0.029,0.0895,0.027,-0.0565,0.0945,0.042,0.1015,0.0539,0.0215,0.1008,0.0139,-0.0374,0.076,-0.0904,-0.069,-0.0544,0.0131,0.0793,-0.0305,0.0126,0.0183,-0.0682,-0.0119,0.0542,-0.0876,-0.0203,0.0039,0.1309,0.0696,-0.007,-0.0213,0.1122,0.0549,0.1136,0.0821,0.0381,0.0608,-0.092,0.1244,0.0256,0.0193,0.026,0.052,-0.0016,-0.0338,0.1524,0.0377,0.0867,0.0875,-0.1128,-0.1559,-0.1475,0.0373,-0.3884,-0.2475,0.142,0.1027,-0.4058,-0.1373,-0.0239,-0.1259,-0.1431,-0.088,0.0851,0.0816,0.0632,0.0856,-0.5317,-0.4469,-0.3104,-0.1068,-0.1974,-0.2255,-0.435,-0.42,-0.3638,-0.058,-0.0004,0.0562,0.0047,0.06,0.0616,0.0734,0.048,-0.0228,-0.0136,0.0786,0.0519,-0.0836,-0.0093,0.0151,0.0907,-0.0874,-0.0919,-0.1186,0.0599,0.0666,0.1223,0.0014,-0.0255,-0.0171,0.0849,0.0772,0.033,0.0389,0.0756,0.1271,0.1191,0.0671,0.1311,-0.0181,-0.2158,-0.0847,-0.1172,-0.1166,-0.0244,-0.1807,-0.0538,0.114,0.1322,0.0704,-0.0646,0.0353,-0.1316,-0.0857,-0.1131,-0.0022,0.1062,0.1048,0.0728,0.0586,-0.0076,0.1796,0.1262,-0.0047,0.0246,-0.0439,0.0456,-0.0142,-0.0171,0.028,-0.069,-0.0655,-0.0115,0.1023,0.129,-0.0241,-0.0727,0.0511,0.0486,0.0611,-0.0292,-0.1676,-0.1548,-0.0216,-0.1493,0.0444,0.0036,-0.0697,-0.0645,-0.1599,-0.1257,-0.0692,-0.0465,0.0012,-0.1004,-0.144,0.0323,0.0333,0.089,0.0666,0.0285,-0.0202,0.0032,0.0218,0.0119,-0.0122,-0.0295,-0.0517,-0.0929,0.1174,-0.1352,-0.0965,0.0851,0.1213,0.0756,0.1001,0.1217,-0.0928,-0.0314,0.0374,0.0492,-0.1677,0.0245,0.1339,0.0586,-0.0217,0.0368,-0.0143,0.0319,-0.0215,-0.0571,-0.1191,-0.346,-0.1182,-0.0708,0.0559,0.007,-0.0336,0.0804,0.0828,0.0696,-0.0467,0.0717,-0.056,0.0819,0.0725,0.0094,0.1105,0.1033,0.074,0.0663,-0.0145,0.0897,0.0316,0.058,-0.009,0.0203,0.0353,0.0917,0.1834,-0.0118,-0.1046,-0.0031,0.0244,-0.155,-0.1287,0.2502,-0.131,0.0975,0.0656,-0.09,0.2479,0.2545,0.0174,-0.0191,-0.0563,-0.0285,0.0596,0.0531,-0.0143,0.0054,-0.0519,0.1137,-0.0523,-0.0375,-0.0718,-0.0322,0.1434,0.0786,0.0363,0.0625,0.036,0.0206,0.0761,-0.0198,0.001,0.0288,-0.0225,0.1649,0.1014,0.1135,0.1219,0.0948,0.0885,0.0949,0.0949,0.0488,0.0109,-0.0134,0.153,0.015,0.0732,0.0722,0.0383,0.0514,0.1998,-0.0576,0.1618,-0.038,0.0599,-0.1592,0.0862,0.0901,0.0815,0.0862,-0.0517,-0.1024,0.033,-0.1209,-0.0354,-0.0082,-0.101,-0.0695,-0.0057,-0.0193,0.0319,0.0482,0.0195,0.0585,0.0479,0.0413,0.0551,0.0264,0.0065,0.0047,-0.0074,-0.0117,0.029,-0.0164,-0.1292,-0.0044,-0.1089,-0.0498,0.0862,0.0251,0.1195,0.005,0.0835,-0.033,0.0319,-0.0386,-0.0283,0.0588,-0.112,-0.0848,-0.013,-0.0734,-0.0454,-0.229,-0.0849,0.0202,-0.1176,0.1195,-0.0541,-0.04,-0.0665,-0.0153,0.042,-0.0459,0.0323,0.0126,0.0951,0.2665,0.0702,0.0806,0.0081,0.0601,0.117,-0.3582,0.0081,-0.0579,-0.0788,-0.0051,-0.0005,0.0101,0.0213,0.1087,0.0543,-0.1326,-0.0788,0.0783,-0.0003,0.0458,-0.003,-0.0528,-0.0757,-0.036,-0.002,0.014,0.0725,-0.0211,0.0963,0.0392,0.0931,0.055,0.0876,0.0278,0.0773,0.0517,0.0236,0.0038,0.0813,-0.1027,0.0475,-0.062,-0.0121,-0.0572,-0.056,-0.0308,0.0497,0.0709,0.0558,0.0446,0.0087,-0.0776,0.0092,0.0459,0.0043,-0.0172,0.0652,0.0479,0.0477,0.1157,0.1084,-0.0468,0.0109,-0.0217,0.0561,0.0583,0.0558,0.0554,0.066,0.0686,-0.0127,0.091,-0.1556,0.0825,0.0434,0.0396,0.0163,0.089,0.0133,-0.1032,-0.0285,0.1739,-0.0512,-0.0502,0.065,-0.081,-0.0609,0.0004,-0.098,0.033,0.089,0.0577,0.134,0.1225,0.0226,0.0907,-0.0271,-0.0152,-0.1282,-0.1229,-0.1172,0.1039,0.088,0.0025,-0.1179,-0.1631,-0.0221,0.0384,0.0046,-0.0126,0.1048,-0.0519,0.1258,0.0823,0.039,0.0198,0.0464,0.1152,-0.1614,-0.05,-0.0205,-0.1791,-0.0196,0.0122,0.0574,0.0282,0.0026,-0.0112,0.062,0.0421,0.0008,-0.0034,0.0773,0.0383,0.0071,0.0603,-0.0152,0.029,0.1206,0.0345,0.0184,-0.0059,0.014,0.016,0.0082,-0.0105,0.0435,-0.094,0.124,0.0946,0.0974,0.1108,0.0342,0.1002,0.0693,0.1826,0.0991,0.0828,-0.041,0.123,-0.0179,0.0856,-0.0847,-0.0842,-0.0688,0.044,0.0948,0.0701,-0.0379,-0.0284,-0.1011,0.064,0.0214,0.0455,-0.0503,-0.0574,-0.0254,-0.0512,0.0138,0.0752,-0.0334,0.0031,-0.0289,-0.0958,-0.0468,0.0325,0.0287,0.0028,-0.1045,0.0218,-0.0521,-0.0702,0.0329,0.0084,-0.0034,0.113,0.0726,-0.0211,-0.1022,-0.1451,-0.1019,-0.0309,-0.0039,0.0273,-0.1246,-0.1466,-0.1005,-0.1106,0.1249,0.0157,0.0543,-0.1461,0.0357,-0.032,0.0029,0.0133,-0.0076,-0.0376,-0.0287,0.0318,-0.1078,-0.0084,0.1052,-0.1051,-0.0539,-0.0345,-0.055,-0.0192,-0.0554,-0.016,0.0169,-0.0242,0.0253,-0.0744,-0.1623,-0.1293,0.0159,0.0244,-0.1054,0.0361,0.0629,0.209,0.2003,-0.0301,-0.0331,-0.033,0.0379,-0.0292,-0.0205,0.0619,0.0088,0.0505,-0.0779,0.0457,0.023,-0.0053,-0.0523,0.0408,0.0898,-0.0125,0.0943,0.0692,0.0347,0.0725,-0.0437,0.1379,0.037,-0.0368,0.0383,-0.0071,-0.095,0.0346,0.0612,0.0428,-0.1947,0.0845,-0.0929,-0.0359,-0.039,-0.0064,-0.095,0.093,-0.1854,-0.1624,0.0894,0.0029,0.0249,-0.0408,0.0064,0.0642,0.1904,0.1308,0.0528,-0.0511,0.0205,-0.0347,0.0166,0.0702,0.1381,0.1352,-0.1585,-0.156,0.1185,0.0687,0.0389,0.0525,0.1094,-0.1659,-0.1447,0.0986,-0.042,-0.1402,-0.0051,0.1206,0.121,0.1417,0.147,0.0519,0.0383,-0.0778,-0.0486,-0.0145,-0.0799,0.0241,-0.088,-0.2966,-0.1626,-0.0878,-0.263,0.1551,0.1174,0.0775,0.0301,0.0461,0.0466,0.0816,0.0237,0.001,0.1339,0.1125,0.0412,-0.1631,0.0916,0.0402,0.0125,0.0237,-0.0731,-0.0759,0.0377,0.1734,0.1305,0.1917,-0.0301,-0.082,-0.0918,-0.0853,0.0204,0.0219,0.0186,-0.0462,-0.0062,0.0363,0.064,-0.021,0.0169,-0.0108,0.0024,-0.0253,-0.0563,-0.0187,-0.0544,-0.0366,0.0307,0.0096,0.153,0.1181,0.0556,0.0891,-0.3432,0.0046,-0.2344,-0.1138,-0.0435,-0.0156,-0.036,-0.0447,0.0804,-0.1424,-0.1563,0.0047,-0.0319,-0.0337,0.0065,0.0491,0.0854,0.1,0.0109,-0.2491,-0.0851,0.0981,0.0271,-0.0054,0.034,-0.0393,-0.0039,0.1069,0.0907,0.0364,0.1391,0.0571,0.0413,-0.0798,-0.0844,-0.0802,-0.0172,-0.0173,0.0229,0.0479,0.021,-0.0613,-0.1181,0.0592,-0.0364,0.0887,-0.0645,0.0444,0.0892,0.0433,-0.1344,-0.0535,0.0483,0.1143,0.0372,0.0747,0.0654,-0.0321,-0.0178,0.0472,0.0006,0.0222,0.0612,0.0768,0.079,0.0888,0.0816,0.0679,0.0138,0.0632,-0.0332,0.116,0.1109,0.1046,0.0098,0.1976,0.3362,0.0836,-0.0352,-0.1192,-0.0101,0.1551,-0.2652,-0.2808,-0.1209,0.0158,-0.0435,-0.0164,0.2446,0.0527,0.1457,-0.0433,-0.1148,-0.1828,0.02,-0.0205,-0.0712,-0.0096,0.251,0.0434,-0.0016,0.02,0.301,0.2346,0.1479,0.2629,-0.0602,0.1164,0.1009,-0.1053,0.1843,0.1238,-0.0282,-0.0838,-0.0652,0.0647,0.0666,0.2358,0.1846,0.0886,0.1683,-0.1725,0.0547,0.0236,-0.0626,0.2223,0.0733,0.0975,0.0327,-0.1584,-0.0774,-0.1967,-0.1176,-0.1041,0.0899,0.045,-0.0644,0.0517,-0.0554,-0.0418,0.0217,-0.1584,-0.0772,0.0572,0.1788,0.0562,0.0591,0.0946,0.0319,0.0787,-0.044,-0.0345,-0.0236,-0.0515,-0.0429,0.1439,-0.014,0.0879,0.0402,0.1488,0.1281,0.0275,0.1043,-0.0087,-0.0054,0.06,0.1241,0.0717,0.1159,0.0883,0.0564,0.0531,-0.0016,-0.0394,-0.0015,0.0384,-0.0875,-0.0074,-0.0179,0.0538,0.0481,0.1104,-0.0098,-0.0805,0.0133,0.0576,-0.0858,0.0322,0.0629,-0.0713,0.03,-0.0404,0.0114,-0.0237,0.0076,0.0242,-0.0263,-0.1401,-0.1142,-0.2402,0.0456,0.0695,-0.0242,0.1287,0.0226,-0.134,0.1186,-0.1897,0.2409,0.0077,0.0233,-0.0428,0.041,0.0592,-0.0302,0.0039,0.1179,0.0975,-0.0768,-0.0398,0.0504,0.0953,-0.0801,-0.1044,-0.1074,0.1276,0.0986,0.1218,0.0232,0.1012,0.1734,0.0142,0.0021,-0.015,0.0205,0.1265,0.1117,-0.0375,-0.0298,0.0581,0.0562,-0.1954,0.0076,0.0461,-0.129,-0.1973,-0.0807,-0.0153,-0.1376,0.0844,0.0064,-0.2079,-0.0809,0.053,-0.155,-0.0475,-0.0536,-0.0542,-0.1647,-0.0603,0.0861,0.1043,0.0956,0.1315,-0.0146,0.0996,0.028,0.1808,0.2073,0.0934,0.1249,0.0447,-0.1746,0.0788,0.1263,0.1413,0.2545,0.083,0.0409,0.0771,0.0571,0.0514,0.0406,0.0455,0.1515,0.1102,-0.0792,-0.173,0.0292,0.0143,-0.0131,-0.0361,0.0106,0.0922,0.0927,0.1334,-0.078,-0.0465,0.1022,0.1351,0.062,0.0344,0.0666,0.1012,0.0034,0.0513,0.0114,0.1015,0.0276,0.0023,0.0717,-0.0183,0.0118,0.0608,-0.1106,0.0752,-0.0226,-0.1275,-0.0009,0.1489,0.0405,0.0952,0.1089,0.0664,0.1591,0.2074,-0.0658,-0.0616,-0.1222,0.0007,0.0559,-0.0561,0.0389,0.0182,-0.0852,0.12,0.0693,0.1175,-0.0637,-0.0232,-0.0923,0.0541,0.138,0.0907,0.0235,0.0165,-0.0134,-0.0668,-0.1293,0.0072,0.0627,0.0451,0.0478,0.0966,0.1707,0.0691,0.0909,-0.0404,-0.0179,-0.0849,0.0338,-0.0907,-0.0102,-0.0235,-0.0329,-0.0825,-0.0812,-0.0607,-0.0018,-0.0264,0.0856,0.004,0.0479,0.0278,-0.004,-0.0199,0.0151,0.0105,0.087,0.0742,0.0459,0.0159,0.0685,-0.0158,0.05,-0.1018,0.0266,-0.0198,-0.0442,-0.0576,0.0046,-0.0238,0.0099,0.0191,0.1336,0.061,-0.1296,-0.0476,-0.0122,0.0708,0.0874,0.0948,0.085,-0.0198,0.0763,-0.0786,-0.0645,0.1314,0.1168,-0.0116,0.0529,0.057,0.0449,-0.4648,-0.2817,0.1048,-0.0731,0.0475,-0.001,0.0814,0.0688,0.1035,0.1445,-0.0661,0.0055,0.0531,-0.0009,0.1254,0.0413,-0.0888,0.014,-0.0227,0.0088,0.0138,0.0251,0.1153,-0.0046,-0.1395,0.1097,-0.0672,0.1084,-0.0818,0.1004,-0.3648,-0.0422,-0.0677,0.1118,0.0982,0.0033,-0.0042,0.0102,-0.0618,0.0539,-0.0183,0.0063,-0.0889,-0.0345,-0.0813,-0.0698,-0.1061,-0.1308,-0.2209,-0.2544,0.0624,-0.0909,-0.2944,-0.5464,-0.2258,-0.0885,-0.4643,-0.2726,-0.2337,-0.3617,-0.1809,-0.2743,-0.2154,-0.2008,-0.2712,-0.1335,-0.2915,-0.226,-0.2783,-0.1982,-0.2109,-0.1263,-0.2221,0.1179,0.0788,0.0757,0.2365,0.232,0.1704,0.1638,0.0596,0.0548,0.074,0.177,0.1531,0.1191,0.0069,-0.0074,0.1008,-0.121,0.0148,0.0957,0.0273,0.1014,0.0543,0.0578,0.0069,0.1095,-0.0738,0.1489,0.1571,-0.091,0.0287,0.089,-0.0456,-0.0467,0.0917,-0.0713,-0.0614,0.0754,-0.0816,-0.2302,0.0186,-0.0567,-0.0196,0.1092,-0.1121,-0.1114,0.0378,0.0339,-0.0596,0.0155,-0.0122,0.0839,0.0367,-0.1263,0.001,0.0351,-0.0069,-0.0016,0.0211,0.0399,right finger response execution
trm_5519b7525d7a2,0.0181,0.0373,0.0687,0.0763,0.0052,-0.0107,0.0114,-0.0369,-0.0818,0.025,0.0012,0.0126,0.0502,0.0562,0.0611,0.0146,0.0987,0.1379,-0.0055,0.0834,0.0802,0.0151,0.0007,-0.0248,0.0483,0.0093,0.01,0.1703,0.1121,0.0428,0.0949,0.0795,0.0808,0.0528,0.1712,0.1417,-0.0054,0.0177,0.0436,0.0455,0.1025,0.0606,0.0316,-0.0076,0.0868,0.1428,-0.1538,0.008,-0.105,0.1232,0.0501,-0.0125,0.001,-0.071,0.1485,0.0573,0.0993,0.0232,-0.0567,0.0293,0.0074,-0.0498,0.1785,-0.0658,-0.0111,-0.1035,0.192,0.2345,0.0937,0.0255,-0.126,-0.0362,-0.0484,0.0908,0.0243,0.0672,0.0785,-0.042,-0.0863,0.0415,0.0267,-0.0609,0.0829,0.0999,-0.0524,-0.0922,-0.0201,-0.0084,0.0143,0.275,0.1063,0.0173,0.0123,-0.4066,-0.2945,-0.3223,-0.1396,-0.116,-0.2679,-0.1864,-0.0603,0.0349,-0.1064,-0.212,-0.1698,0.1094,0.2173,-0.1393,0.0188,-0.0037,-0.0182,0.0713,-0.0921,-0.1618,0.0094,0.0274,0.0669,-0.1741,0.0189,0.0151,0.134,0.1653,0.1797,0.0599,0.148,0.1813,0.1319,-0.1064,-0.0983,0.0082,0.1399,0.0298,0.0177,0.2589,0.0922,0.242,-0.0445,0.1175,0.0614,-0.0314,0.0677,0.0825,-0.0092,0.0895,0.0865,-0.1013,0.0076,-0.0311,0.061,0.0064,0.0628,0.1231,0.0956,0.1667,-0.1211,0.0314,-0.1341,-0.0568,-0.0201,0.061,0.043,0.1028,0.1807,0.1561,0.0148,-0.0116,0.0105,0.2262,0.2136,0.0643,0.0625,0.1536,-0.0721,0.2584,0.1428,0.2301,0.1602,0.1209,0.102,-0.0051,0.2274,-0.0457,0.0987,-0.0586,0.0824,0.0502,0.0518,0.1768,0.094,0.1056,0.1058,0.1216,0.0662,0.1375,0.122,0.1678,0.134,0.1202,0.0423,0.0094,-0.0666,-0.4465,0.2321,0.179,-0.0556,0.1643,0.3149,0.0476,-0.0048,-0.0097,0.1808,0.0466,0.0271,0.0296,0.0031,0.0083,-0.0653,0.0765,-0.0283,0.0188,-0.1612,0.1252,0.1544,0.0768,-0.0948,-0.055,0.0901,-0.0831,0.1046,-0.195,-0.1328,0.1519,-0.2256,0.0579,0.0501,-0.0507,0.0854,-0.0161,-0.0037,0.1055,-0.0964,0.1216,-0.0095,0.0442,0.043,0.0983,0.1041,0.1728,0.0531,0.183,-0.0053,-0.0481,0.0597,-0.0532,0.0079,0.1738,-0.0144,0.0275,-0.1297,-0.1825,-0.096,-0.3326,0.0687,-0.1357,-0.2336,-0.3809,-0.1751,0.026,-0.0082,0.0627,0.005,0.0137,0.1505,0.0346,0.0802,0.0665,0.1769,0.2225,0.1139,0.0777,0.0557,0.1251,0.1083,0.3912,0.3367,0.0605,-0.0536,-0.0218,0.0447,0.1172,0.0534,0.0859,0.0392,0.0606,0.0694,-0.0636,0.0624,-0.0786,0.0148,-0.183,-0.0134,0.1865,0.0819,0.1049,-0.1442,-0.1678,0.0896,0.1038,-0.0514,0.0096,-0.0086,0.0009,0.041,-0.0587,-0.071,-0.0124,-0.1751,-0.0554,-0.0372,0.1531,-0.0001,-0.0182,0.134,0.2128,0.0265,0.0628,0.0259,0.0558,-0.006,0.0615,0.0246,0.0968,0.0214,-0.01,-0.0068,-0.1469,0.0056,0.0542,0.0839,0.1465,0.1279,0.0328,-0.067,-0.0367,-0.0894,-0.069,0.1279,0.0668,0.0795,0.0604,0.0396,-0.2638,-0.031,-0.0515,0.0469,-0.0133,0.0328,0.1379,0.0811,0.0856,-0.0238,-0.0211,0.0762,-0.032,-0.0242,-0.1231,0.1194,-0.2923,-0.0128,0.0668,0.0389,-0.1056,0.0272,-0.1758,0.1099,0.0324,0.0855,-0.0651,-0.011,-0.0502,-0.0046,-0.1642,0.0172,-0.0849,-0.0886,-0.1232,0.0685,0.0001,-0.0677,0.0137,-0.0885,0.0413,-0.0527,0.0664,-0.1055,-0.1262,-0.0888,0.0739,0.0306,0.0984,0.0931,0.006,-0.0095,0.0088,-0.0656,-0.0619,-0.0277,-0.0693,0.0682,0.0182,-0.0103,0.1442,0.0417,-0.1646,0.1819,0.1488,-0.1627,-0.0162,0.0612,0.008,-0.0292,0.1197,0.0521,0.2577,0.2361,0.0213,0.158,-0.0989,0.076,-0.0431,0.0416,-0.0033,0.0596,0.0367,0.075,-0.0613,-0.0528,0.0109,0.172,0.1005,-0.0607,-0.1231,0.0262,-0.0553,0.0607,0.0269,-0.0354,-0.2344,0.1877,0.0559,-0.0597,-0.0597,0.0989,0.0776,-0.0483,0.1863,0.0475,0.0539,0.0439,0.0115,-0.0509,0.005,0.0644,0.0124,0.0922,0.1266,-0.0894,-0.324,0.0586,0.0589,-0.0573,-0.0592,-0.126,0.0829,0.1503,0.0337,-0.0635,-0.0385,0.0479,-0.0281,-0.2083,-0.0514,-0.0584,-0.1105,-0.0303,-0.0734,-0.0323,-0.0492,0.1328,0.0081,-0.0577,-0.1102,0.1245,0.1988,-0.053,0.0218,0.361,0.0159,-0.0008,0.0662,0.0496,0.0011,0.0421,0.0801,0.0641,0.1201,0.055,0.1172,0.047,-0.2037,0.136,-0.0885,0.1415,-0.0148,-0.1312,-0.0912,0.1212,0.0903,-0.1822,0.0663,0.0468,0.0861,-0.052,-0.1266,-0.1195,-0.0435,-0.1085,-0.1925,-0.0307,-0.0791,0.1082,0.0221,0.0102,0.2066,0.1407,0.024,0.166,0.0672,0.0411,0.1567,0.0468,-0.0369,0.0137,0.0428,0.0797,0.0323,0.0078,-0.0251,0.0412,0.0693,-0.1188,0.0987,0.0409,-0.0908,-0.0103,0.1766,-0.0533,-0.0642,0.0278,0.0023,0.0884,0.0166,0.1646,-0.0494,0.1319,0.0308,-0.015,0.2417,0.0503,0.1333,0.1223,0.116,0.0782,-0.0183,-0.2598,-0.1897,-0.0509,-0.0686,-0.0398,-0.0213,0.0179,0.0592,0.0428,-0.0192,-0.1241,-0.0361,-0.2224,-0.0188,-0.1316,0.0351,0.1425,-0.0556,-0.1458,-0.0708,-0.0134,-0.017,0.1878,0.0463,-0.1777,0.123,-0.0183,-0.0187,-0.0792,-0.0148,-0.1257,-0.2434,0.1144,0.0843,0.0668,-0.0755,0.1857,0.0412,-0.068,0.0132,0.1775,0.0841,0.0517,0.0238,-0.0014,0.2105,0.0289,0.1445,-0.1104,-0.036,0.0552,-0.0935,0.0205,0.1219,-0.0018,-0.0541,-0.0769,-0.159,0.0515,-0.0096,-0.0991,-0.1657,-0.0681,-0.0177,0.1104,-0.0397,0.0302,-0.1777,-0.0593,-0.1689,0.1082,0.069,0.2881,0.1798,-0.2168,0.2517,-0.0228,0.188,-0.3081,0.1918,0.0541,0.0392,-0.2465,0.0122,0.0063,0.1141,0.2121,-0.2161,-0.1486,-0.1415,-0.1674,-0.1433,-0.0635,0.1311,-0.136,-0.0331,0.0278,0.0596,0.0493,0.0114,0.0363,0.0739,-0.1617,0.0862,0.0155,0.0699,-0.0414,-0.1332,-0.0958,-0.0169,-0.1142,0.1617,0.0506,-0.0325,-0.0548,-0.0585,-0.0214,-0.2208,-0.2164,-0.0827,0.0167,0.1224,-0.0195,0.0298,0.0413,-0.0139,-0.023,-0.0066,0.0639,0.1316,0.1,0.0174,0.1287,0.1258,0.0984,-0.0305,-0.0514,0.0441,0.0156,0.0814,0.0638,0.0706,-0.0012,0.1015,0.1237,-0.0135,-0.0424,0.0973,0.3615,0.3432,0.2748,0.0277,0.0458,0.0671,0.008,-0.0192,-0.0488,0.0606,-0.0156,-0.0856,-0.1454,-0.0273,0.0304,-0.1138,-0.1646,-0.1808,0.1924,-0.0154,0.0152,-0.035,0.0219,0.1219,-0.0649,-0.0336,0.0003,0.0054,-0.003,-0.0596,0.169,0.2606,0.2312,0.1726,-0.033,-0.1456,0.031,0.0974,0.086,-0.0682,-0.0855,-0.0118,-0.0384,-0.0429,0.1382,0.0282,-0.0505,-0.0951,-0.134,-0.1463,0.035,-0.0348,-0.0815,0.0829,-0.0523,0.1074,0.1141,0.105,0.1733,0.1279,0.0829,-0.142,-0.0626,0.0019,0.02,0.0214,-0.0648,-0.1101,-0.033,0.0901,-0.0184,0.0308,-0.0206,-0.0757,-0.1053,0.1522,-0.1196,0.1365,0.135,-0.1575,-0.0981,-0.1901,0.0218,0.0524,-0.0626,0.0099,-0.136,-0.2806,-0.0697,-0.1503,-0.0982,-0.1543,-0.0983,-0.0658,-0.2154,-0.1405,0.0319,-0.0151,0.0008,0.1329,0.1984,-0.0932,0.0749,0.0185,0.2425,0.0508,0.1804,0.1287,0.2298,-0.0229,-0.0358,-0.0274,0.1064,0.033,0.0128,-0.1077,-0.0631,-0.0087,-0.0683,-0.1388,-0.0055,-0.0781,-0.0564,-0.0177,-0.1234,-0.1367,0.1387,-0.1377,-0.0582,-0.0057,0.0806,0.0909,0.0822,-0.1035,-0.1112,0.3148,0.2273,-0.0042,-0.0386,-0.0403,-0.0025,0.0286,-0.0315,-0.1565,-0.0168,0.042,-0.25,0.0687,-0.0597,0.1738,-0.3284,0.0551,-0.1311,-0.1836,-0.0188,-0.1927,0.2801,0.2843,0.0544,-0.2761,0.0556,0.0591,0.057,-0.077,-0.0436,0.0661,0.0635,0.1317,-0.0094,0.0004,-0.0432,-0.1368,0.0514,-0.0764,0.1235,0.0884,0.0162,0.0437,0.0901,-0.0655,-0.029,-0.0801,-0.1139,-0.1564,-0.1509,0.0945,0.0925,0.1292,0.0638,0.0828,0.0787,-0.1003,-0.186,-0.0881,0.0444,0.0767,-0.1605,-0.1646,-0.1055,0.0182,0.0451,0.0545,-0.0003,0.047,0.0621,-0.1068,-0.0139,0.1269,0.0322,-0.0083,-0.0259,0.0604,0.0678,0.0101,0.1406,0.0138,0.0074,0.1182,0.1094,0.3408,0.1807,0.3343,0.0707,0.1038,0.1319,0.1847,0.1571,0.2191,0.1987,0.3193,0.0955,0.0748,0.0361,-0.05,-0.1284,0.0461,-0.087,-0.0517,0.0392,-0.0745,-0.0463,-0.0281,0.0243,0.0746,-0.058,-0.1009,0.0855,0.0229,-0.025,-0.061,0.0004,0.0612,0.0692,-0.0739,0.0829,0.0242,-0.0254,-0.0711,0.0677,-0.046,0.1873,0.1034,0.0959,0.248,0.2079,-0.1028,-0.0387,-0.1043,-0.0547,-0.0831,-0.0538,-0.088,-0.0742,-0.0329,0.0065,-0.0789,-0.0135,0.0049,0.0512,0.0369,0.0472,-0.0352,0.0036,0.0594,0.0799,0.1419,0.2214,0.1555,-0.1248,-0.0915,-0.1612,0.0136,-0.0388,0.1487,0.0962,-0.0266,0.0153,0.0651,0.0388,0.0236,0.0427,-0.0069,-0.0151,-0.0658,0.0979,0.0119,0.1285,-0.017,0.0848,-0.0735,-0.2395,-0.4263,-0.1146,-0.064,-0.0314,-0.0889,-0.012,0.0241,0.055,0.0813,-0.0122,-0.0184,-0.0333,-0.0334,-0.0121,-0.0733,-0.0476,0.0522,-0.0672,0.1306,0.1201,0.2032,0.1018,-0.1339,-0.0019,-0.0494,0.1906,-0.2193,-0.0811,0.0419,0.0337,0.0243,0.0757,0.0632,-0.0907,0.0692,0.1081,0.058,0.0461,0.1698,0.0821,0.1148,0.042,0.1176,0.103,0.0685,0.1085,-0.0164,-0.1303,0.0454,-0.0414,-0.0692,0.0715,-0.11,0.1266,-0.0017,0.0339,0.1307,-0.2839,-0.1927,-0.3544,-0.2867,-0.3215,-0.0844,-0.3167,-0.0623,0.133,-0.0319,-0.0698,-0.0435,-0.0345,0.0273,0.1226,0.0002,0.0835,0.0922,-0.0271,0.0439,-0.0658,-0.0166,0.116,-0.0516,-0.0649,0.021,-0.0996,-0.0056,0.1426,-0.0898,0.0321,0.1258,-0.0318,0.0759,-0.0983,-0.0467,-0.2223,0.0206,0.1843,0.1746,0.114,0.0425,-0.0988,-0.0611,-0.1246,0.0781,0.2039,0.1662,0.0347,-0.0765,0.0617,-0.2581,-0.2822,0.1212,-0.0338,-0.0938,-0.3654,-0.3688,-0.2595,-0.1787,-0.0383,-0.0757,-0.1109,-0.0919,-0.0038,0.1649,0.0356,0.091,-0.2243,-0.003,0.0971,-0.0185,0.0688,0.0494,-0.0763,0.0405,-0.0373,-0.2023,-0.0523,0.1015,0.0074,0.0317,-0.0992,-0.0751,-0.0663,0.143,0.1326,0.1684,0.1328,0.0114,0.1036,0.1019,0.035,0.0673,-0.1132,-0.0827,-0.123,-0.3588,0.0626,0.0855,0.091,-0.0542,-0.0182,-0.2744,0.1684,-0.2431,-0.4219,-0.0615,0.2797,-0.3118,-0.2772,0.0243,0.1945,0.0137,0.1398,0.1118,0.2242,0.0304,-0.1997,0.0816,0.074,-0.0514,0.0191,0.0803,0.0733,0.0891,0.0582,0.1532,-0.0079,-0.0394,-0.0068,-0.0997,-0.0907,-0.1045,-0.07,0.1152,-0.0394,0.0435,0.0792,0.037,0.0647,-0.1647,-0.1592,0.205,0.0735,-0.0519,-0.0512,-0.0187,-0.095,-0.0092,-0.0314,-0.0105,-0.1436,0.0773,0.0956,0.118,-0.1444,-0.0605,0.0249,-0.0635,-0.0635,0.1717,-0.1494,-0.0929,-0.0964,-0.0047,-0.012,0.0496,-0.4002,0.255,0.2387,-0.0105,0.0713,0.1757,0.1958,0.1591,0.0169,0.0188,0.0864,-0.0046,-0.0313,-0.316,0.1516,0.1268,0.0544,0.0016,0.0208,0.0443,-0.0586,0.0187,0.0893,0.005,0.1819,0.0955,0.1007,0.1365,-0.0019,0.0306,-0.3874,-0.217,-0.2889,-0.0306,-0.3534,0.1783,0.0859,-0.0356,0.1164,0.008,0.1763,0.1197,-0.0027,0.0686,0.1648,-0.1238,-0.0245,0.1809,0.0078,-0.0528,0.0058,0.2799,0.104,0.0734,0.0132,0.0537,-0.0894,0.037,-0.1791,-0.131,-0.1826,-0.1086,0.0359,0.0048,0.0736,0.205,0.203,-0.02,0.1031,0.0731,0.1108,0.0331,0.0121,-0.062,0.0544,0.1574,0.1495,-0.0357,0.0465,-0.0376,-0.0056,0.1209,-0.0164,0.0634,0.1222,0.2085,0.2859,0.1162,0.0417,0.1352,0.1225,0.0016,0.0063,-0.073,-0.1359,-0.0575,0.061,0.0649,-0.018,0.1388,0.0272,-0.0627,-0.0472,-0.072,0.2098,-0.0124,-0.1402,0.0608,0.0128,0.0211,0.066,-0.0812,0.0533,0.0136,0.0299,0.2233,-0.1249,0.0201,-0.0144,-0.2719,-0.0709,-0.0097,-0.0038,-0.0952,-0.25,0.0759,-0.0361,0.0964,0.0126,0.13,0.1386,0.0653,-0.1298,-0.0139,0.0852,0.1492,0.0297,0.0837,0.0034,0.1509,0.1246,-0.0037,-0.0241,-0.0168,-0.0995,0.0604,-0.0021,0.0418,0.0837,0.0518,0.0721,0.0669,0.0482,0.0218,0.0628,-0.1114,-0.0022,0.0302,0.0384,-0.0578,-0.0738,0.0835,0.2298,-0.1158,-0.1306,-0.2713,-0.0022,-0.0261,-0.0498,-0.1262,-0.1039,0.1025,0.1035,0.0836,0.0035,0.2557,-0.0196,-0.0026,-0.0101,0.0456,0.0302,0.0527,0.1562,0.1644,-0.121,0.0501,0.0384,-0.1001,-0.3448,0.0465,-0.1465,-0.0128,0.0043,0.0238,0.005,-0.1384,-0.0824,-0.0605,-0.0748,-0.0356,-0.0207,0.1262,-0.0017,-0.0859,-0.08,-0.1325,-0.1449,0.0638,0.0821,0.0304,-0.0781,-0.0493,-0.0219,0.0908,-0.0073,-0.0422,0.0534,0.0141,-0.0268,-0.121,-0.0128,-0.0321,0.0253,-0.0145,0.1447,0.0231,-0.025,-0.0053,0.1151,0.1284,0.037,0.1102,0.003,-0.1032,0.0565,0.0514,0.0433,0.0029,-0.1891,-0.2873,-0.0158,0.0265,-0.0595,-0.0086,0.035,0.0974,-0.081,0.0058,0.0565,-0.1447,-0.156,-0.0742,0.0451,0.0622,-0.0899,-0.5653,-0.5549,0.1982,0.1277,-0.1178,0.0697,0.0101,0.024,0.1555,-0.0297,0.0808,0.0902,-0.029,-0.0447,-0.2273,0.0732,-0.1602,-0.07,0.0068,-0.234,-0.4576,-0.1972,0.0921,-0.2183,-0.0358,-0.0969,0.0187,-0.0162,0.0481,-0.0655,-0.0223,-0.0025,-0.054,0.0153,0.0037,0.0564,0.0265,0.1426,0.0881,0.0918,-0.103,0.1347,0.0063,-0.0324,0.1165,0.1351,0.0146,-0.0067,0.0851,0.0495,-0.0791,0.0507,0.1851,0.2721,0.1441,0.0154,-0.0023,0.0629,-0.0221,0.0193,-0.0202,-0.0503,-0.1062,-0.0789,0.0533,-0.1951,-0.078,-0.0346,-0.3563,0.1399,0.1371,-0.1105,0.2825,-0.0759,0.0316,-0.0935,0.0323,-0.0505,-0.0266,0.0529,-0.0304,-0.0723,0.0364,-0.0933,-0.0023,-0.0894,-0.0328,-0.12,-0.1592,-0.2195,0.0981,0.0461,0.0625,0.036,0.0961,0.0326,0.1576,-0.0104,0.0118,-0.0488,-0.084,-0.1407,0.2307,0.1021,-0.0189,-0.1255,-0.0292,-0.0695,-0.0648,-0.0043,0.0119,0.1875,0.0082,0.0807,0.0276,-0.043,-0.0224,0.2556,0.2577,0.3083,-0.012,0.0571,0.0275,-0.2577,0.193,0.1554,0.1241,-0.3254,-0.205,-0.1711,0.0384,-0.0463,-0.0558,-0.0343,-0.1911,-0.2801,-0.2346,0.0112,-0.0344,0.038,-0.0941,0.0691,-0.0868,0.2164,0.0441,0.1409,0.1279,0.0187,0.0342,0.0013,-0.2072,0.0353,-0.1536,-0.1364,-0.1898,0.046,-0.057,-0.0159,-0.021,-0.0377,-0.0689,-0.221,-0.1209,-0.2208,0.2084,0.0962,0.1833,0.0291,-0.084,0.0552,0.126,0.125,0.1076,0.1104,-0.0914,0.052,-0.2413,-0.0652,-0.0277,-0.1468,-0.0282,0.0063,-0.024,-0.044,0.1373,0.0279,0.1347,0.0723,0.099,0.0069,-0.0664,-0.189,-0.0882,-0.0147,-0.0624,0.0036,0.2607,0.1583,0.1819,0.1539,0.0051,-0.0266,-0.0822,0.1606,0.185,0.0856,0.0543,0.1759,0.0329,-0.0298,0.0109,-0.0014,0.01,0.1174,0.0894,0.039,-0.1293,-0.0153,-0.0095,0.3763,0.034,0.1207,0.1646,0.4242,-0.0565,0.1679,-0.0032,0.0474,-0.0243,0.0109,-0.029,0.0838,0.0524,0.2998,0.0156,0.0438,-0.2053,0.0302,-0.0281,0.1561,0.015,-0.052,-0.2858,0.0863,0.0562,0.0623,-0.1431,0.2739,0.331,0.2336,-0.0109,0.0505,0.1658,0.139,0.1115,0.1243,0.0065,-0.0172,-0.0302,0.217,0.0261,0.0151,0.0595,0.0622,0.0522,0.2199,0.1142,-0.0271,0.0307,-0.0679,0.1167,0.3154,0.2649,0.1337,0.1873,0.0008,0.3353,0.2699,-0.0229,-0.223,-0.1814,0.0219,0.0424,0.0007,-0.1279,-0.1503,-0.1385,0.3086,0.3352,-0.0216,-0.1097,0.0475,-0.0216,-0.0638,0.0262,-0.0061,0.0053,0.071,0.0897,-0.05,0.0512,0.091,-0.0087,0.1137,-0.0323,-0.0075,-0.1231,-0.2445,-0.2159,0.0426,0.205,0.259,0.1414,0.15,0.2324,0.1547,-0.2562,0.0463,0.0429,-0.3538,-0.2283,-0.2068,-0.2972,-0.1456,-0.195,-0.2501,-0.158,-0.1474,-0.092,-0.1668,-0.2595,-0.2843,-0.392,-0.3574,0.2886,-0.0162,-0.0926,-0.3082,0.1888,0.1551,-0.0588,0.1088,-0.0413,-0.1656,-0.1368,0.061,0.057,-0.0726,0.1777,0.1833,-0.0934,0.0001,0.0702,-0.0959,-0.0377,0.1114,0.101,0.0409,-0.0559,-0.0949,-0.0643,-0.0312,0.0186,-0.0392,0.3291,0.165,0.1259,0.1603,0.1037,0.1762,0.1822,0.1155,0.0391,0.1466,0.0456,-0.0296,-0.0614,0.1126,0.3299,-0.1636,0.0454,-0.0237,-0.0614,0.1227,-0.0734,0.1146,0.1078,0.0973,0.0467,0.0532,-0.0292,0.0563,-0.1803,-0.1737,-0.198,-0.0411,0.1165,0.0033,0.0909,0.1814,0.0762,0.1145,0.1363,-0.0857,0.0152,0.0473,-0.0065,0.1202,-0.02,-0.0784,0.1554,0.0343,0.089,0.0676,0.0407,0.0129,-0.0677,0.1482,0.0718,-0.0748,0.0887,0.1318,0.0181,-0.0059,0.0254,-0.0012,0.0254,0.096,-0.2159,-0.3247,-0.2778,0.0574,-0.3865,-0.148,0.0747,0.1121,-0.3417,-0.3245,-0.0488,-0.1829,-0.1275,-0.1854,0.0655,0.0612,0.0622,0.0589,-0.2971,-0.2665,-0.1218,0.0114,-0.0931,-0.1249,-0.3194,-0.3089,-0.256,0.0009,0.0083,0.0102,-0.0164,-0.0039,0.0152,0.2075,0.0943,0.0535,0.1091,0.1406,0.1143,-0.0657,0.0043,-0.0177,-0.0075,0.0209,-0.1897,-0.2282,-0.0679,0.0022,-0.0497,0.0133,0.0287,-0.0302,0.0155,0.0904,0.0765,0.0091,0.1897,0.2266,0.2052,-0.1139,-0.0225,-0.023,-0.1906,-0.1105,-0.2041,-0.1236,-0.0187,-0.1342,0.0165,0.1525,0.175,-0.1006,-0.0542,0.1026,-0.1086,-0.0843,-0.1557,-0.0981,0.0846,0.0792,0.0612,0.0458,-0.2576,0.0263,-0.0521,-0.0141,0.0928,0.0072,-0.0635,0.0579,-0.052,-0.0251,0.2111,0.0744,0.2087,0.1835,0.1893,-0.079,-0.0002,-0.0113,-0.1034,-0.0182,-0.0686,-0.5221,-0.4678,-0.1992,-0.2877,0.1653,-0.1804,-0.0877,-0.3565,-0.3114,-0.3196,-0.0722,-0.1041,-0.0232,-0.2143,-0.1313,-0.1102,-0.0993,0.0745,0.0022,0.0794,-0.0017,0.0608,-0.0519,-0.0325,-0.0072,-0.059,-0.0077,-0.1985,0.0451,-0.101,-0.0612,0.2366,0.1668,0.1447,0.0899,0.1376,-0.1172,0.0033,0.0859,-0.0157,-0.1946,-0.0643,0.2661,-0.067,0.0329,0.186,-0.0182,-0.0098,-0.037,-0.107,-0.1292,-0.2714,-0.2996,-0.2543,-0.0503,0.0371,-0.1754,0.0413,0.1096,-0.0512,0.0048,0.0337,-0.0658,0.0982,0.0517,0.1865,0.2871,0.2471,0.2275,0.1311,0.0749,0.1659,0.0392,0.041,-0.0772,-0.0145,-0.0067,-0.0238,0.13,-0.0402,0.0774,-0.0634,0.0646,0.0326,0.0787,0.0761,0.0033,0.095,0.0379,-0.3181,0.1455,0.1549,-0.0157,-0.002,-0.027,-0.0333,-0.0353,0.0253,0.0466,-0.005,0.0154,0.1976,-0.0634,-0.0216,-0.1603,0.0053,0.3362,0.0969,-0.0427,0.1214,0.0114,-0.0148,0.1301,0.0316,-0.0572,-0.0426,-0.1581,0.3481,0.1257,0.1263,0.2778,0.1557,0.1033,0.1083,0.1083,0.0923,0.0091,-0.0966,0.1902,0.0422,-0.0826,-0.0158,0.1082,0.148,0.401,-0.1017,0.0359,-0.015,0.1554,-0.4177,0.0685,0.1308,0.1667,0.0514,-0.0349,-0.0474,0.028,-0.3121,-0.0973,-0.2333,-0.3273,-0.246,0.0132,-0.035,-0.1944,-0.0951,-0.0073,0.141,0.1642,0.0289,0.1062,0.0454,-0.0167,0.0053,-0.054,-0.0011,0.1074,-0.113,0.0005,0.1039,-0.0943,0.0298,0.1285,0.0252,0.1827,0.041,-0.0472,-0.2157,0.1004,-0.4341,-0.3852,-0.1755,-0.3131,-0.2869,0.0435,-0.0538,0.008,-0.1305,-0.0306,0.0084,-0.1451,0.0186,-0.0701,-0.0103,-0.052,0.0059,0.0837,-0.0105,0.0216,0.0256,-0.1662,0.2044,-0.2003,-0.1016,-0.1839,-0.012,-0.1727,-0.1142,-0.1259,-0.0035,0.048,-0.0034,-0.026,0.0207,0.1103,0.1081,0.031,-0.1211,-0.0883,0.0239,-0.0096,0.025,-0.0555,-0.0398,0.035,-0.0348,-0.0277,-0.0096,-0.0206,-0.0439,0.045,0.0067,0.0333,-0.0013,0.0912,0.0645,0.0362,0.0219,-0.0675,-0.0284,0.0678,-0.0519,-0.0674,-0.0371,-0.0744,-0.0976,-0.1912,-0.0537,0.0209,0.0526,0.0644,0.0673,-0.0841,-0.0428,0.0228,0.0267,0.0496,-0.0034,0.1224,0.1775,0.1471,0.1475,0.1646,0.0016,-0.0178,-0.0528,0.1895,0.1165,0.1457,0.0164,0.0887,-0.0149,0.0069,-0.1318,-0.1858,0.1379,0.115,0.0224,0.041,0.0637,0.1226,-0.1364,-0.0815,0.1237,-0.0428,-0.0059,0.0239,-0.0767,-0.057,-0.0586,-0.0217,-0.019,0.1884,-0.0062,0.1765,0.1768,0.0408,0.08,-0.1274,-0.2194,-0.2001,-0.1662,-0.1882,0.1194,0.146,0.1204,-0.027,-0.0113,0.0056,0.0013,0.1064,0.0229,0.1477,0.029,0.1903,0.1624,-0.008,0.0287,0.079,0.1056,0.0073,0.035,0.031,-0.0807,0.0171,0.0256,0.1952,0.0524,0.0029,-0.0049,0.0325,0.0084,-0.1423,-0.0643,0.0493,0.073,0.0417,0.0528,0.0369,0.1081,0.3043,0.0269,0.0604,0.0259,0.0668,0.0467,0.0102,0.0035,0.1214,-0.0322,0.1241,0.029,0.1615,0.1367,-0.0226,0.1752,0.1082,0.2674,0.1108,-0.0671,-0.1762,0.1211,0.0377,0.0793,-0.1106,-0.0336,-0.043,0.1113,0.2025,0.0928,0.0736,0.0662,-0.1043,0.0303,0.0332,0.087,-0.0671,-0.0714,-0.0163,-0.0968,0.0462,0.0484,-0.0302,0.0247,0.0267,0.0742,0.1561,0.1035,-0.1067,-0.0256,-0.0716,-0.024,-0.0267,-0.1078,-0.1451,0.0261,0.0697,0.2016,0.0655,-0.0084,-0.2639,-0.2291,-0.0711,0.058,0.0226,0.0071,-0.253,-0.164,-0.1354,-0.1262,0.2304,0.0267,0.0392,-0.0497,0.108,-0.0478,-0.1418,-0.0942,-0.0052,-0.1119,-0.0138,0.0544,-0.0843,-0.0666,0.1197,-0.2028,-0.0497,-0.0204,0.0153,-0.1017,-0.0244,0.031,0.0184,-0.0878,-0.0991,-0.2494,-0.171,-0.2236,0.0883,-0.0356,-0.008,0.0013,0.1223,0.3428,0.3417,-0.0668,-0.118,-0.139,0.0985,-0.06,0.1271,0.1752,0.199,0.213,-0.0318,0.1267,0.0176,0.0384,-0.1065,0.078,0.1365,0.0569,0.1062,0.1039,-0.0858,0.2232,-0.0409,0.228,0.0631,0.0546,0.0071,0.0064,-0.036,0.0255,-0.0899,0.0975,-0.2906,0.1132,-0.1943,-0.1196,-0.1425,-0.0269,-0.0428,-0.1773,-0.2678,-0.2335,0.2009,0.1166,0.062,0.0537,0.162,0.0864,0.1159,0.2176,0.1159,0.0068,0.1859,-0.0622,0.077,0.049,0.1092,0.1734,0.0215,0.0374,0.2578,0.1458,-0.1093,0.0928,0.2217,-0.0379,-0.2038,0.0672,-0.0741,-0.0521,-0.0403,-0.1235,-0.12,0.1617,0.1699,0.1028,0.0372,-0.096,-0.0942,-0.0452,-0.0552,0.0039,-0.2126,-0.2227,-0.2191,-0.1311,-0.1451,0.2708,0.296,0.1576,0.2766,0.1083,0.1202,0.2631,0.1506,0.0319,-0.0412,-0.0027,-0.0052,-0.0391,0.1456,-0.2149,-0.1794,-0.1667,-0.1367,-0.0877,-0.1208,0.3166,0.1733,0.3099,-0.0934,-0.1542,-0.2202,-0.0479,0.0013,-0.2375,-0.1943,-0.2762,-0.1127,0.029,0.0694,-0.0208,-0.0199,-0.0147,0.0141,-0.0681,-0.0843,-0.0449,-0.0777,-0.0824,0.0788,-0.0092,0.1603,0.1203,0.0569,0.0463,-0.3499,0.0106,-0.2147,-0.0931,-0.079,0.0362,0.0356,-0.1509,-0.0477,-0.1824,-0.2505,-0.0632,-0.1573,-0.079,0.0028,0.0494,0.0503,-0.1429,-0.087,-0.0784,-0.0828,0.0385,-0.0123,-0.0447,-0.0424,-0.0086,-0.0325,0.0581,0.0962,-0.034,-0.066,0.0247,0.0793,-0.0319,-0.0892,-0.2258,-0.1144,-0.0116,0.0241,-0.0436,0.0179,-0.1627,-0.1404,-0.0479,-0.0601,-0.0322,-0.1191,0.1082,0.0605,-0.0661,-0.1363,-0.1664,-0.0452,0.0003,0.0632,0.1184,0.0643,-0.089,-0.3148,0.0433,0.0417,0.0437,0.0847,0.3397,0.2383,0.2371,0.206,0.1068,0.144,0.0888,-0.1049,-0.1606,-0.1419,-0.1019,0.0886,0.0792,0.2464,0.0922,0.0459,-0.1552,0.0083,0.0682,-0.4017,-0.3473,-0.1625,-0.0633,-0.0659,0.0355,0.2646,0.0655,0.1344,0.0444,-0.1537,-0.1763,-0.0026,0.043,0.0043,-0.0616,0.21,0.1493,0.1029,0.0901,0.2816,0.2144,0.0999,0.2139,-0.1151,0.077,-0.0045,-0.3056,0.2342,0.2118,0.037,-0.0999,-0.143,0.1111,0.0788,0.4089,0.274,0.1501,0.2992,-0.2247,0.1034,0.0927,-0.0449,0.2041,-0.1293,-0.1186,-0.1069,-0.0983,-0.0865,-0.2791,-0.1946,-0.2346,-0.0404,-0.0687,-0.1415,0.0349,0.0193,-0.0348,0.0257,-0.1883,-0.1056,0.1571,0.212,0.1454,-0.0208,0.0535,0.0508,-0.0562,-0.0123,0.0412,-0.0568,-0.1324,-0.085,0.165,0.0432,0.1298,0.0605,0.1655,0.1783,-0.0193,0.2014,-0.0367,0.1111,0.0218,-0.0156,0.0383,0.1474,0.0038,0.1338,-0.0062,0.0872,0.1211,0.0433,0.1168,0.0009,-0.074,-0.0697,0.0592,0.0669,0.0725,-0.0852,-0.1009,-0.0168,0.0177,-0.2415,0.0543,0.121,-0.0152,-0.0929,-0.0365,0.0588,0.1143,-0.0777,0.0452,0.0794,-0.1184,-0.2858,-0.4501,0.0811,0.1413,-0.0316,0.0379,-0.0334,-0.271,0.0987,-0.4482,0.2908,-0.3368,-0.3122,-0.0776,0.0118,0.0644,-0.0234,-0.0356,-0.101,-0.1251,-0.1513,-0.0043,0.0313,0.1453,-0.1088,-0.1841,-0.155,0.1658,0.1499,0.1645,-0.0073,0.0836,0.2126,0.0523,-0.0297,-0.0058,0.0498,0.0944,0.1183,-0.2963,0.0596,0.1511,-0.2521,-0.3202,-0.0607,0.0606,-0.2205,-0.3653,-0.1867,-0.079,-0.1628,0.0431,-0.0387,-0.1981,-0.221,0.0839,-0.2236,-0.1066,-0.1465,-0.0174,-0.368,-0.0993,0.1008,0.0989,0.0087,0.3682,0.1247,0.1682,0.1126,0.1883,0.3197,0.0844,0.3249,0.2354,-0.068,0.1497,0.315,0.2495,0.1549,0.0409,0.1344,0.1869,0.176,0.1717,0.0764,0.0811,0.1602,0.1162,-0.0677,-0.1183,0.0622,-0.0043,-0.0269,-0.0469,0.079,0.1394,0.0732,0.0357,0.0545,-0.0275,0.2754,0.339,0.0678,-0.022,0.1422,0.2671,-0.0306,0.1124,0.1126,0.1991,0.1151,0.0769,0.0216,-0.0379,-0.0432,0.0102,-0.2032,0.0784,-0.1274,-0.2113,-0.0787,0.1694,-0.1359,0.269,0.1247,0.0865,0.0797,0.09,-0.038,-0.1357,-0.1666,0.0138,0.1016,-0.2329,0.1295,0.0191,-0.2069,0.0825,0.0906,0.128,-0.0258,-0.0541,-0.1785,-0.1236,0.2665,0.2397,-0.1618,-0.1877,-0.0501,-0.1811,-0.0621,0.0138,0.1098,0.1391,0.0333,0.1351,0.2085,0.0743,0.0846,-0.1309,-0.0608,-0.1903,-0.0229,-0.2537,0.0894,-0.0675,0.0047,-0.0602,-0.0577,-0.0298,0.0316,0.0287,0.0428,-0.1059,0.0065,-0.028,0.0297,0.0415,0.0794,0.0088,0.0426,-0.0354,0.079,0.0597,0.1676,0.0059,0.0077,-0.0542,-0.0338,-0.007,0.0353,0.0675,0.0675,0.0257,0.0103,0.0012,0.148,0.1235,-0.226,-0.1193,-0.0994,0.0193,-0.0317,0.1579,0.0879,-0.0219,0.0726,-0.1322,-0.1107,0.1895,0.1273,-0.0589,0.1036,0.0202,0.0455,-0.1523,-0.2873,0.2842,-0.03,0.1083,0.0383,0.0198,0.1824,0.1707,0.158,-0.0551,0.0325,0.0612,-0.023,0.1297,0.0725,-0.0924,-0.0655,-0.0338,-0.0227,0.0068,0.0234,0.159,0.0197,-0.078,0.1516,-0.0834,0.2367,-0.3567,0.139,-0.1477,-0.0923,-0.0447,0.3088,0.2705,0.0794,-0.0292,0.0356,-0.1029,0.0751,-0.0437,-0.0533,-0.0156,-0.0435,-0.0922,-0.1011,-0.0458,-0.0125,-0.0578,-0.1141,0.0904,-0.0847,-0.2303,-0.3913,-0.1972,-0.0539,-0.2067,-0.1088,-0.0871,-0.2067,-0.2491,-0.2328,-0.1644,-0.2018,-0.1922,-0.1416,-0.1458,-0.104,-0.382,-0.1189,-0.3434,-0.3463,-0.2683,0.1328,0.1022,0.23,0.1551,0.2428,0.2343,0.1725,0.1099,-0.2153,-0.0774,0.2632,0.2223,0.1308,-0.0237,0.0532,0.2116,-0.137,0.06,0.0641,-0.0076,0.0882,0.0032,-0.0342,0.0467,0.0877,-0.0772,0.1824,0.1773,-0.0845,-0.0244,-0.0337,0.0117,0.0048,0.1663,-0.225,-0.1676,0.121,0.0497,-0.0635,0.0947,0.0364,0.145,0.1078,-0.3086,-0.3146,0.1565,0.0881,0.0322,0.1225,0.0545,0.1312,0.0076,-0.1058,0.1377,0.1021,0.0103,0.0362,0.0505,-0.0371,discrimination
trm_557b4add1837e,0.0345,-0.0602,0.0215,0.0457,0.0121,-0.0259,0.0144,-0.0088,-0.0192,0.0202,0.0213,0.0357,0.0077,0.0479,0.0264,-0.0229,-0.0004,0.133,0.0041,0.1413,0.0902,0.0344,-0.0135,0.0541,0.007,0.0101,0.0088,0.0555,0.0053,-0.0002,0.0843,0.0822,-0.0067,-0.0183,0.0736,0.0547,-0.0594,0.0098,0.0214,0.0469,0.023,-0.0117,-0.0085,0.0297,0.0293,0.0566,0.0443,0.0047,0.0033,0.015,-0.0141,-0.0799,-0.0496,0.017,0.0362,-0.0044,-0.0099,0.0461,0.0459,0.0724,0.0497,0.0307,0.0576,0.0027,-0.0154,-0.1093,0.1055,0.1832,0.1115,0.0094,-0.0264,-0.0323,-0.0122,0.0749,0.0155,0.0178,-0.0338,0.0514,-0.0081,-0.0839,0.0048,0.0478,0.0409,0.0938,-0.0005,-0.0557,-0.021,-0.082,0.0385,-0.2124,-0.0249,-0.1203,-0.0041,-0.2364,-0.166,-0.2153,-0.0784,-0.0805,-0.1699,-0.2272,-0.0252,0.0357,-0.0967,-0.2119,-0.0921,0.0438,0.1115,0.0275,-0.035,-0.004,0.0921,0.1046,0.015,-0.0639,0.0405,0.0038,0.0946,-0.1408,0.0914,0.0625,0.1308,0.0472,0.1475,0.0241,0.063,0.1245,0.1327,-0.008,-0.007,-0.0652,0.1323,0.057,-0.0016,0.0503,0.0588,0.1337,-0.0183,0.0552,0.0089,-0.0121,0.0612,0.0303,-0.0069,0.1009,0.0718,-0.0942,-0.0273,0.0506,0.0155,0.0264,0.0422,0.0743,0.0044,0.1442,0.0445,-0.0759,0.0032,-0.0218,0.0189,0.0086,0.0207,0.0726,0.138,0.0776,0.0098,-0.0312,0.0512,0.1296,0.1331,0.0159,-0.0241,0.1046,-0.0555,0.1775,0.093,0.0953,0.0762,0.1277,0.087,-0.0391,0.0449,0.0149,0.0288,-0.0149,-0.0158,0.0096,-0.0088,0.1003,0.118,0.0246,0.0274,0.067,0.0182,0.1714,0.1656,0.0155,0.075,0.0931,0.0437,-0.134,-0.0727,-0.2153,0.0967,-0.0017,0.0523,-0.0979,0.0976,0.0312,0.0496,0.0507,0.1723,0.0953,-0.0868,0.0359,0.0572,0.0333,0.0169,-0.0316,-0.2273,-0.0002,0.0077,0.0398,0.043,0.008,-0.0294,0.0184,0.0312,-0.0551,0.0259,0.0936,-0.1494,0.0517,-0.0174,0.0094,-0.0102,-0.1527,0.0678,0.0595,-0.0512,-0.0721,-0.0362,0.0359,-0.02,-0.0283,0.063,0.0421,0.0831,0.0436,-0.0616,0.1589,0.0254,-0.0108,-0.0109,0.0072,-0.0409,0.1099,-0.0861,-0.0522,0.0041,0.0616,-0.0564,0.032,0.0779,0.004,0.0032,0.0317,0.0745,0.0713,0.0583,0.0104,-0.0364,-0.0472,0.0433,0.0506,-0.1788,-0.1144,-0.2884,-0.2126,-0.218,-0.1327,-0.1403,0.0732,0.0879,0.1548,0.127,-0.0146,-0.0664,0.0053,-0.0333,-0.0063,0.0392,0.0421,0.0108,0.0928,0.0053,0.0219,0.1236,-0.0413,0.0367,-0.0344,-0.047,0.2061,-0.0511,0.0291,-0.1389,-0.1518,0.0164,-0.0263,-0.1755,0.059,-0.0535,0.0124,0.0398,0.1183,0.0411,-0.0244,0.0471,-0.0015,0.0619,0.0837,0.0282,0.0595,-0.0209,0.0212,-0.031,0.054,0.0628,0.0128,0.0132,-0.0328,0.0098,0.041,0.1227,0.0308,0.1009,-0.099,-0.0358,0.1089,0.0864,0.158,0.1407,0.094,-0.1139,-0.086,0.0375,0.0079,0.0053,-0.0237,-0.0086,-0.0017,-0.047,-0.1087,-0.1074,-0.0864,-0.0144,-0.0742,-0.0196,0.0197,0.0064,0.0134,0.044,0.0128,-0.1334,-0.0964,-0.1129,-0.0874,-0.0143,-0.0031,-0.0285,0.0703,0.0404,0.0247,0.0067,-0.1044,0.111,-0.0336,-0.0001,0.0021,0.0872,-0.0052,0.0817,-0.1647,0.0926,0.0688,-0.0535,-0.0554,0.0032,0.0107,0.0157,0.0058,-0.1268,0.0035,-0.1281,0.0623,-0.0781,-0.1909,-0.1535,0.0033,-0.0776,0.0152,0.0612,-0.011,-0.0305,0.0373,-0.0198,0.021,0.0246,0.017,0.0293,-0.0255,-0.0239,0.0866,0.0722,0.0345,0.1118,0.1051,0.045,0.0948,0.1191,0.0378,-0.025,-0.0227,-0.0417,0.0622,0.0548,-0.0397,0.0378,-0.1187,0.0546,-0.1002,0.0373,-0.0477,-0.0087,-0.0629,0.1116,0.0256,-0.1256,-0.0944,0.0258,0.0341,-0.0894,-0.0369,-0.0341,-0.0191,0.0275,0.0016,-0.0897,-0.125,0.1194,0.1307,0.0898,-0.0027,0.0552,0.0139,-0.0344,0.1448,-0.0439,0.0443,0.0148,0.0367,0.0471,-0.0325,-0.0023,0.0186,0.0749,-0.0043,-0.0356,0.0996,-0.0164,-0.0768,-0.0813,-0.0622,-0.0929,0.0095,-0.027,0.0262,-0.0924,-0.0879,-0.0249,0.037,-0.18,-0.0569,-0.0999,-0.0342,0.0392,0.0066,-0.0386,-0.0495,0.1331,0.0019,-0.0822,-0.1569,-0.0191,0.0155,-0.0049,0.0558,-0.0565,-0.0027,0.0241,0.0875,0.0731,0.0545,-0.0012,0.008,0.0338,0.0173,0.0054,0.0355,0.0212,-0.0754,0.043,-0.1085,-0.0012,0.0078,0.0098,-0.025,0.0808,0.0502,-0.189,0.0316,0.0101,-0.0432,0.0454,0.0635,0.0095,0.0818,-0.0157,-0.0655,-0.0535,-0.0354,-0.0444,-0.0793,-0.0742,0.059,0.1053,-0.016,0.0627,-0.034,0.0284,0.0564,0.07,0.0326,-0.0445,-0.0368,0.0371,-0.0343,0.0353,0.0395,-0.034,0.0654,-0.0475,0.1027,-0.0616,-0.206,-0.0568,0.0787,-0.0247,0.0038,0.0365,-0.051,0.0761,0.0552,0.0733,-0.0441,0.046,-0.0929,0.0258,0.1049,0.0164,0.0261,0.0288,0.088,-0.0324,-0.0134,-0.3166,-0.3012,-0.0186,-0.0888,-0.0436,0.0301,-0.0133,0.06,0.0647,0.0366,-0.0597,0.0069,-0.0626,0.004,-0.0891,0.067,0.0268,-0.0038,0.0005,0.0091,-0.1034,-0.0342,0.138,0.0508,-0.0916,0.0238,-0.0217,0.0123,0.0741,-0.0671,-0.0042,-0.2284,0.0477,0.0696,0.0703,0.0675,0.0412,-0.0322,0.078,0.0394,0.0943,0.1091,0.0504,0.0479,0.0311,0.0485,-0.0293,0.0273,-0.0667,0.0034,-0.0509,-0.1045,0.0108,0.0842,-0.0968,-0.0223,-0.0272,-0.1354,0.0172,0.0821,0.0233,-0.1158,-0.013,-0.0694,0.0913,-0.1108,-0.0258,-0.0539,-0.0756,-0.2312,0.0374,0.0037,0.1426,0.1261,-0.0807,0.1172,0.0529,0.0169,-0.0667,0.0887,0.0387,-0.1271,-0.224,-0.0637,-0.007,-0.0054,0.1199,-0.235,-0.0049,-0.1704,-0.1425,-0.0926,-0.1442,0.1014,-0.2486,-0.0186,-0.0621,0.0359,0.0086,-0.1451,-0.0122,0.0567,-0.1119,0.0588,0.0382,0.0668,0.0092,-0.0404,0.0419,-0.0026,-0.0903,0.0519,0.0329,0.0028,-0.0019,-0.0962,-0.0002,0.0738,-0.032,0.0516,0.0532,0.1371,0.0065,0.036,0.0336,0.0717,-0.0384,0.0175,0.0292,0.0664,0.0796,-0.0138,0.0233,0.0479,-0.0211,0.0242,0.0584,0.1269,0.1413,-0.0104,0.1605,0.0702,0.0073,-0.0128,0.081,-0.0165,-0.0215,-0.0147,0.1042,0.0882,0.0901,0.0354,0.0377,0.0928,0.0854,-0.0551,0.0321,0.0174,-0.0372,0.0387,-0.0121,0.0023,-0.0854,0.0342,-0.0191,0.0071,0.1271,0.0158,0.0116,-0.0019,0.1095,0.0816,0.0548,-0.0429,0.0406,0.0008,0.0071,-0.0192,0.1344,0.2195,0.1778,0.1442,0.0099,0.0916,0.0172,-0.0854,-0.021,-0.0918,-0.0269,-0.01,-0.0482,-0.0229,0.0986,0.0337,-0.0727,-0.0003,-0.0739,-0.0251,-0.0473,-0.0114,-0.0402,0.0219,0.0111,0.0477,0.0743,0.0685,0.1151,0.0945,0.099,-0.0093,0.0573,-0.0041,-0.0058,0.0107,-0.0036,0.0399,-0.0958,0.0248,0.0605,-0.0018,-0.0682,-0.0698,0.0114,0.0883,-0.0017,0.1617,0.1528,0.038,0.0885,0.0646,0.0819,0.0455,-0.0259,-0.0466,-0.0448,-0.0403,-0.0022,-0.1368,-0.0123,-0.0016,-0.0318,-0.0405,-0.0765,0.0068,-0.0913,-0.0479,0.0266,0.0903,0.1286,-0.059,0.0072,0.0791,0.2185,0.0974,0.1132,0.115,0.1601,0.0787,0.043,0.0731,0.04,0.0006,0.0629,-0.0962,-0.0241,0.0287,-0.0516,0.0609,-0.0411,-0.0002,-0.0175,0.0436,0.0179,0.013,0.0386,-0.0915,-0.0311,-0.0413,0.0639,0.0477,0.0354,0.037,0.0348,0.0956,0.0993,0.0121,-0.033,0.008,-0.0304,0.0514,-0.0928,-0.2443,0.0798,0.0783,-0.1114,0.0696,0.0097,0.0628,-0.2888,0.0653,-0.0998,0.0312,0.0809,0.0175,0.0788,0.093,0.0948,0.0033,0.0484,0.0904,0.0326,-0.0275,0.0184,0.1059,0.0832,0.0921,-0.0452,-0.0503,-0.0545,-0.0854,0.0517,-0.0219,0.0876,0.0348,0.0587,-0.0346,0.068,-0.0248,0.1272,0.0706,0.0479,0.1235,0.0426,0.1154,0.033,0.0459,0.0913,0.0131,0.0912,-0.0169,-0.0233,0.0156,0.0374,-0.0082,-0.0071,-0.0273,-0.0784,-0.0956,0.0223,0.0409,-0.2333,-0.0591,-0.0648,-0.0812,0.0314,0.0763,-0.0405,-0.0175,-0.0014,-0.0162,0.008,0.0014,0.0298,0.0444,0.032,0.0777,0.0762,0.1595,0.072,0.1736,0.1242,0.0825,0.0641,0.037,0.1333,0.0767,0.1251,0.1123,-0.0396,-0.0579,-0.0157,0.0341,0.0278,0.0022,-0.0175,-0.0349,0.033,-0.0066,0.1504,0.1445,0.0765,-0.0106,-0.0895,0.0033,-0.0174,-0.0116,0.0286,0.009,-0.0102,-0.0265,0.0703,0.0687,-0.0297,0.0316,-0.033,0.0198,-0.058,0.0393,0.0728,0.1058,0.11,0.1873,0.1684,-0.0653,-0.052,-0.0651,-0.0151,0.0439,0.0631,0.0346,0.0443,0.0068,-0.064,-0.024,0.012,0.0088,0.0133,-0.063,0.0257,0.0113,0.0253,-0.0342,-0.0129,0.1169,0.0689,0.0921,-0.0259,-0.0781,-0.0484,0.0354,0.0779,0.0462,0.0523,0.0369,0.0434,0.0391,-0.0386,0.0573,-0.029,-0.2012,-0.054,0.0695,0.0351,-0.0006,0.0481,0.044,0.0161,-0.0657,-0.1478,-0.2758,0.0344,0.0514,0.0808,0.0039,0.0471,0.0685,0.0523,0.0713,-0.0473,-0.03,-0.0696,-0.0739,0.0063,0.0036,0.023,0.0173,-0.0985,-0.0045,-0.0244,0.0573,0.013,-0.082,-0.0243,-0.0813,0.0413,-0.0338,0.0098,0.0057,0.078,0.1128,0.0108,0.0289,0.0021,0.025,0.0663,0.0233,-0.0279,0.0929,0.0905,0.0226,0.0772,0.1169,0.0182,0.0319,-0.0136,-0.0202,-0.2158,-0.0407,-0.0488,-0.034,-0.0311,-0.1147,0.0842,0.0357,-0.058,0.0537,0.0826,0.0681,-0.0134,-0.0337,-0.0455,0.032,-0.0276,0.0434,0.1714,0.1951,0.1304,0.1322,0.1212,0.2367,0.1373,0.0551,0.1138,0.0463,-0.0027,0.006,-0.0421,-0.0056,0.0675,-0.1034,-0.0688,0.0561,-0.0409,0.0451,0.0317,0.0391,0.0909,0.0784,-0.0169,0.0915,-0.0217,-0.046,-0.0394,0.0472,0.0718,0.1268,0.1538,0.1191,0.0735,-0.0121,-0.1804,-0.0189,0.0028,0.086,0.0174,0.1406,0.0254,0.0283,-0.0419,0.0607,-0.0291,-0.2157,-0.3367,-0.268,-0.2651,0.0523,-0.0175,0.0221,-0.0542,0.0131,0.0044,0.091,-0.0215,0.0231,-0.1768,-0.0262,-0.0024,-0.0181,0.0498,0.0227,0.0178,0.0953,-0.1995,-0.2189,-0.0366,0.1147,-0.005,0.0535,-0.0257,-0.1011,-0.0369,0.1822,0.1683,0.0076,0.029,-0.168,-0.0931,0.1068,0.0278,0.0328,-0.0771,0.0035,-0.079,-0.0476,-0.0665,-0.1014,0.0862,0.0558,-0.1278,-0.0679,0.0033,-0.0185,-0.0862,0.061,0.0106,0.0071,0.0011,0.0451,0.029,0.0157,0.1112,0.0771,0.0792,0.0362,-0.1445,-0.037,-0.0836,-0.1047,-0.0767,-0.0446,-0.0068,-0.1097,-0.0703,0.0808,-0.0039,0.0299,-0.0318,0.1767,0.1364,0.1049,0.1401,0.0944,0.0405,0.0621,0.0907,0.1063,0.0175,-0.1527,0.0446,0.1227,0.1682,-0.0065,-0.0763,0.084,-0.0065,0.034,-0.039,-0.012,-0.1483,0.1652,0.1348,-0.0137,-0.1358,-0.0085,0.0605,-0.033,-0.033,0.1026,-0.0095,-0.0456,-0.0081,-0.0213,0.1227,-0.0216,-0.2105,0.1119,0.1149,0.0477,-0.0023,0.0989,0.1069,0.0449,-0.0373,-0.0764,0.1038,0.0756,-0.0518,-0.1392,-0.0466,-0.0564,-0.0642,0.0046,-0.0382,-0.0573,-0.0947,-0.0396,0.0607,0.0049,0.0148,0.02,0.1076,-0.2101,-0.0635,0.0388,-0.3121,-0.2048,-0.2283,0.0251,-0.1986,0.1403,0.1209,0.0374,0.1036,-0.0398,0.0612,0.0084,0.011,0.1007,0.1089,-0.1805,-0.0379,0.062,0.0197,-0.1478,0.0427,-0.0999,-0.1226,0.0262,-0.168,0.0709,-0.0333,0.055,0.0947,-0.1804,-0.1816,-0.1661,-0.1306,-0.0995,-0.0354,-0.1733,-0.1694,0.0653,0.0817,-0.0585,0.1758,-0.0544,0.0224,0.0187,0.0711,0.1199,0.0955,-0.0495,-0.0819,-0.151,-0.0306,0.072,0.0134,0.015,-0.0023,0.1917,0.2068,0.1133,-0.0211,0.0827,0.0637,0.0182,0.0218,-0.0732,0.0171,-0.0579,0.0884,0.0909,-0.0628,0.0788,0.0129,-0.0787,-0.0921,-0.2173,0.0205,0.0478,-0.0883,0.0898,-0.0591,0.0258,0.0217,0.1154,-0.0525,-0.0796,-0.0669,0.1142,-0.0241,-0.0438,0.0188,-0.2197,0.1634,-0.0022,-0.1436,-0.1209,-0.1458,0.0539,-0.034,0.1007,0.0281,0.1244,0.1349,0.0871,0.0513,-0.0328,0.0811,0.1457,0.0141,0.0962,-0.0484,0.0812,-0.004,0.0301,0.019,-0.0548,0.0466,0.0296,-0.004,0.0307,0.1113,0.0942,0.0696,0.0554,0.0259,-0.0133,-0.0243,-0.0323,0.0385,0.0461,0.0769,-0.0147,-0.0894,0.0109,0.0031,-0.0399,-0.1836,-0.2708,0.0717,0.0266,0.0447,-0.0132,-0.0141,0.0123,0.0157,0.0783,-0.0289,0.1624,-0.0029,-0.1028,-0.0257,0.0219,-0.0122,-0.0001,-0.0039,0.0674,-0.1487,-0.1198,-0.0332,0.1036,-0.2008,0.0775,-0.0445,0.0732,-0.0074,0.0381,0.0778,-0.0182,-0.0017,0.0034,-0.0084,-0.0448,0.0191,0.0143,0.0211,-0.045,-0.1207,-0.176,-0.1164,0.0431,0.0532,-0.0279,-0.1076,0.0107,0.0365,-0.1252,-0.0977,-0.1146,-0.1273,-0.1414,0.0617,-0.0407,-0.0455,-0.0402,-0.1695,0.0093,0.0847,0.1152,-0.0743,-0.0154,-0.1119,0.0549,0.0527,-0.0265,-0.1095,-0.0313,0.0377,0.0573,0.0126,-0.005,-0.0302,0.0138,0.0339,0.0408,-0.0586,-0.0052,-0.0164,0.0489,-0.0523,-0.0094,-0.0193,-0.0699,-0.0299,-0.0234,0.071,0.0411,-0.0872,-0.0773,-0.0778,0.0158,0.0156,-0.0347,0.0069,-0.0336,0.0154,0.0233,-0.0009,0.0615,0.0746,-0.064,-0.0436,-0.1473,0.0813,-0.0732,-0.0232,-0.0777,-0.0944,-0.0205,-0.2818,0.0789,0.0245,-0.0635,-0.0218,0.0058,-0.0276,-0.0096,0.0942,0.121,-0.0424,-0.0899,0.0165,0.0252,0.0823,-0.0034,0.0821,-0.0033,0.0053,-0.0726,0.0882,0.0097,0.0726,0.0928,0.0329,0.0626,-0.0588,0.0311,0.0342,-0.0572,-0.0001,-0.1084,-0.0666,-0.0173,-0.0495,0.0037,0.0391,-0.0423,0.0515,0.0094,0.0826,-0.0591,0.0182,0.1133,0.0371,-0.0207,-0.0239,0.0922,0.1386,0.0421,0.04,0.0567,-0.0928,-0.0555,-0.1687,0.0586,0.0423,0.0215,-0.0046,0.0097,0.0429,0.1228,-0.0667,-0.0383,-0.0306,0.0274,-0.0601,0.0169,0.0218,-0.0235,-0.0202,0.0577,0.0261,-0.0846,-0.0555,0.1418,0.0221,0.011,0.0044,-0.036,-0.2152,0.1042,0.1059,0.0567,-0.0135,-0.0268,-0.0543,0.0203,0.1514,0.1123,-0.1081,0.0699,0.0899,0.0001,0.0179,0.0099,-0.1844,-0.1225,-0.1987,0.0213,0.0368,0.0834,-0.0023,0.1061,0.1672,0.0946,-0.1955,-0.059,-0.0587,0.0717,-0.0809,-0.1567,-0.0259,-0.0978,-0.0517,0.041,0.0649,0.0761,0.1341,-0.0401,0.0873,-0.0701,0.0698,0.0976,0.0942,0.0348,0.052,-0.0355,0.0062,-0.258,0.0525,-0.0969,-0.0919,-0.1517,-0.0656,0.0046,-0.0194,-0.0318,-0.0695,-0.0235,-0.039,-0.0297,-0.0014,0.1598,0.0859,0.1435,0.036,0.0529,0.1274,0.0714,0.0324,-0.0257,0.0564,0.0026,0.0465,-0.0631,-0.0035,0.0283,-0.1176,-0.1111,0.0218,-0.0406,-0.0902,-0.074,-0.0186,0.1237,0.0304,0.0663,0.0551,-0.0175,0.0748,0.1175,0.0601,0.0098,-0.127,0.171,0.0862,0.093,0.0836,0.0703,-0.0756,-0.0627,0.1431,0.1264,0.0443,0.0129,-0.041,-0.025,-0.0807,0.0575,-0.0039,-0.0394,0.083,-0.0458,0.0757,0.018,0.0307,0.0448,0.2138,0.0777,0.0336,0.108,0.1401,-0.009,0.1727,-0.0948,0.0156,0.0188,-0.0157,0.052,0.0751,-0.1001,0.1767,0.1924,0.1335,-0.0314,0.1397,0.0623,0.1254,0.1104,0.0157,-0.0233,0.0129,0.0249,0.0319,-0.0365,0.0403,0.0475,0.0504,-0.0351,0.09,0.1178,0.1373,0.0437,0.004,0.0084,0.0738,0.0419,0.1995,0.0958,0.027,0.0775,-0.0696,0.0662,-0.0043,-0.0322,-0.0343,0.0116,0.0795,-0.0631,0.0309,0.0451,0.037,0.1206,-0.0646,0.054,0.0317,-0.0464,-0.1722,-0.1169,-0.0094,0.0144,0.0319,-0.1089,-0.1059,-0.1744,0.0636,0.0944,-0.0796,-0.0749,-0.031,-0.0886,0.0118,0.0338,0.0123,-0.0259,0.0088,0.0706,-0.0728,0.0412,0.0993,0.0903,0.0646,-0.0952,-0.0208,-0.0399,-0.1094,-0.0263,-0.0042,0.1858,0.0555,0.0402,0.0583,0.1606,0.1253,0.0128,0.0948,0.0647,-0.3699,-0.2494,-0.3072,-0.2919,-0.2078,-0.2228,-0.0766,-0.1535,-0.1141,-0.0646,-0.3051,-0.2398,-0.3035,-0.29,-0.0946,0.1506,-0.0359,-0.0589,0.0446,-0.0166,0.181,-0.049,-0.0378,0.0064,-0.108,-0.1643,0.0025,0.0216,-0.1995,-0.1667,-0.1703,-0.2077,0.0304,0.0708,-0.049,-0.0427,0.003,-0.0237,0.0506,0.0829,-0.0507,0.0409,0.0474,0.0742,0.0447,0.219,0.0687,0.061,0.1269,0.1306,0.1247,0.1662,0.0993,0.0808,0.0759,-0.1264,-0.1345,-0.1376,-0.0498,0.1009,-0.0806,-0.0951,-0.0728,0.0225,0.0219,-0.1177,0.0357,0.0587,0.1031,0.0258,0.0801,-0.0087,-0.0397,-0.0999,-0.0134,-0.0562,-0.1122,0.0579,0.0948,0.0354,0.1542,0.1592,0.0958,0.0797,-0.0034,0.0478,0.1018,-0.1543,-0.0241,-0.0443,-0.0548,-0.1031,-0.0494,0.0132,0.0748,0.0149,-0.0159,-0.0114,0.0067,0.0191,-0.0574,-0.0248,0.0092,0.0103,-0.0291,-0.1534,0.0111,0.0847,0.0931,0.0317,0.0116,0.0245,0.0146,-0.0183,0.0578,0.035,0.0681,0.0401,-0.2111,-0.0099,-0.0458,0.0257,-0.1556,0.081,0.0772,0.0318,-0.0352,0.1693,0.1333,0.1081,0.0401,0.1034,0.1109,0.0727,0.0628,0.0137,0.0978,-0.0085,0.0222,-0.0348,-0.0622,-0.1456,0.1327,0.0457,0.0668,0.0869,0.0652,0.0594,0.0443,-0.0325,-0.0362,-0.0419,-0.0209,-0.0018,-0.0069,-0.2427,-0.153,-0.2572,-0.0063,-0.0184,0.0021,0.0009,0.0446,0.0653,-0.059,0.1,0.1754,0.1645,-0.1499,-0.2049,-0.0424,0.0926,0.0089,-0.0317,-0.0163,0.0503,0.0067,0.0247,0.103,0.1496,-0.2161,-0.0073,0.0126,-0.0027,-0.0319,-0.0734,-0.2363,0.0022,-0.0099,-0.0019,-0.0017,-0.2318,-0.1964,-0.2211,0.0054,0.0567,0.0454,-0.033,-0.0284,-0.0174,-0.033,0.1985,0.1081,0.1636,0.0406,0.0065,-0.0455,0.0548,-0.052,-0.0069,-0.0196,0.0111,-0.1594,-0.1071,-0.0495,-0.0405,0.015,-0.084,0.0224,-0.1749,-0.0983,-0.0452,0.0547,0.018,-0.0618,-0.0774,0.0135,-0.0515,-0.0453,-0.1612,-0.153,0.0363,-0.0623,0.0357,-0.0674,0.007,-0.0796,0.0131,-0.0006,-0.1352,-0.1661,0.0374,-0.0391,0.1054,0.0389,0.0929,0.037,0.1235,-0.0366,0.0112,0.0163,0.0127,-0.0489,-0.141,0.0925,-0.0236,-0.1118,0.0971,0.0178,-0.0806,-0.0548,-0.0432,-0.1451,-0.002,-0.1662,-0.0012,-0.0039,-0.0265,-0.1144,0.0295,0.0269,0.008,0.0121,-0.0435,-0.0616,-0.0924,-0.0152,0.0778,0.113,0.1669,0.1287,0.0252,0.0238,0.0571,0.0755,0.0142,-0.0768,0.0187,-0.043,-0.1409,-0.1391,-0.1374,0.1092,-0.1294,0.0336,0.1046,0.1659,-0.2118,0.0576,0.0742,0.0028,-0.1549,-0.2254,-0.2304,-0.0161,0.0248,-0.008,-0.0079,-0.0421,0.0332,0.0483,-0.0105,0.0598,0.0455,-0.0119,0.0602,0.0012,0.0393,0.1105,0.1249,0.025,0.098,0.0374,0.0372,0.0959,0.0722,-0.1561,-0.0868,-0.0307,0.1773,0.0587,-0.0137,0.1727,0.1291,0.0618,0.0804,0.0804,0.0461,0.0078,-0.086,0.0646,-0.0173,-0.1678,-0.1126,-0.0665,0.0414,0.146,-0.0982,-0.1268,0.0531,-0.0576,-0.1044,-0.1577,-0.0952,0.0903,-0.0255,0.0035,-0.0245,-0.0241,-0.0696,-0.095,-0.156,-0.1388,-0.0652,0.0185,-0.0117,-0.2157,-0.1215,-0.0156,0.0707,0.0604,0.0637,0.1022,0.0362,0.0515,0.0665,-0.101,0.0691,0.0034,-0.0833,0.0666,0.0886,0.0178,0.0023,0.1641,0.0305,0.164,0.0809,-0.0272,-0.0265,0.0861,-0.3632,-0.3542,-0.2326,-0.1575,-0.0619,-0.0549,0.0537,0.0616,0.0232,0.0097,-0.0622,-0.0865,-0.0719,-0.0867,-0.0001,-0.0091,-0.0647,0.0186,0.0494,-0.0078,0.0289,-0.3479,-0.195,-0.3067,-0.2066,-0.229,-0.141,-0.3218,0.1075,-0.0215,0.0407,0.0975,-0.0386,-0.0068,0.0346,0.0727,0.0963,0.0316,-0.0421,0.0271,0.0568,0.0678,0.0134,0.0192,0.0662,0.0488,0.02,-0.0029,-0.0555,-0.0712,-0.107,-0.0932,-0.069,-0.2163,0.0014,-0.0094,0.0435,0.0705,0.0265,-0.0427,-0.0384,-0.0193,-0.0966,-0.1566,-0.0842,0.0807,0.0359,-0.0437,-0.0472,0.0149,-0.015,0.0164,0.0135,-0.0389,0.0151,-0.0188,0.0286,0.0263,-0.1258,-0.1098,0.142,0.1079,0.082,0.0612,-0.0644,-0.017,0.0084,0.0982,0.048,0.1255,-0.0182,0.0545,-0.0435,-0.0102,-0.1343,0.0513,0.022,0.0253,0.0135,0.0304,0.014,0.0422,-0.0613,-0.0996,-0.0009,0.031,-0.0269,-0.0214,0.0089,0.0164,-0.0686,0.0443,0.0054,0.04,-0.0709,0.0467,0.0303,-0.0164,0.1131,-0.0151,-0.1046,0.0386,0.0466,0.0018,0.0119,0.0983,0.03,0.0141,-0.0109,-0.0447,-0.0957,0.0534,0.0198,0.0015,0.0982,0.0553,0.0549,0.0731,-0.0152,0.0417,0.1228,0.1496,0.1342,0.0432,0.1068,0.0294,0.0258,0.148,-0.0268,-0.0869,-0.0562,-0.0961,-0.0921,-0.1159,-0.0972,-0.0738,0.0182,0.0375,0.0364,0.0824,0.0104,0.0845,-0.027,-0.0014,0.0025,0.0803,-0.0325,-0.0106,-0.0029,0.0288,-0.0662,0.0922,0.0265,0.0933,0.0809,-0.0809,0.0726,0.0592,0.0982,0.0545,-0.1555,-0.1731,0.0634,0.1175,-0.0105,0.011,0.0514,0.0899,0.0604,0.0645,0.0691,0.0684,0.0235,0.0275,-0.0436,-0.0046,-0.0193,-0.0255,-0.0203,-0.0337,-0.0418,0.0571,0.0158,0.0098,-0.0012,0.0754,0.1329,0.104,-0.0143,-0.1628,0.0591,0.0135,-0.0183,-0.0614,-0.0541,-0.1785,0.0496,0.07,0.1035,-0.006,0.0152,-0.1612,-0.1236,-0.0212,0.0108,0.0303,-0.0481,-0.0432,0.0088,-0.0197,0.0419,0.0892,-0.0049,0.0245,0.0113,0.0952,0.008,-0.0983,-0.1313,-0.012,-0.073,0.0026,0.0077,0.0331,0.0177,0.0181,-0.0377,-0.0008,-0.0152,0.0889,-0.0732,-0.0203,0.0128,-0.0556,0.0368,-0.004,-0.0967,0.004,0.0258,0.047,-0.0471,0.055,0.0124,-0.0294,0.088,0.096,-0.0966,-0.0331,-0.092,0.0021,0.0409,0.1341,0.0881,0.1202,0.1147,0.0263,0.0029,-0.0615,0.0584,0.0144,-0.009,0.1497,0.0743,0.0771,0.1209,-0.1678,0.0895,0.0279,0.2049,0.0864,0.0221,-0.0602,0.0322,0.0634,-0.0231,-0.0756,0.0895,0.0187,0.0419,-0.0166,0.0462,-0.0017,-0.0208,0.0108,-0.3278,-0.0004,-0.0068,0.1128,0.0859,0.0091,0.0517,0.1733,0.0216,-0.1515,0.0935,0.0555,0.0416,0.1306,0.0131,0.0883,-0.0474,-0.0292,0.0414,0.1149,0.1159,0.1135,0.0079,-0.0497,0.0384,0.1232,0.0999,-0.02,0.0105,0.0009,0.0853,-0.0639,-0.3125,-0.3333,0.0519,0.0284,0.0249,0.0484,-0.0556,-0.0705,-0.024,0.0181,0.009,-0.0477,0.1019,0.0254,-0.0369,0.0324,0.0746,0.0829,0.1042,0.0347,-0.0205,0.019,0.0886,0.0001,-0.0291,-0.167,-0.1128,-0.0292,0.0596,0.0722,-0.3138,-0.239,-0.2886,-0.0583,-0.0112,-0.2497,-0.0655,-0.0505,-0.1149,-0.0194,-0.0445,-0.0745,-0.013,-0.0081,-0.2044,-0.1542,-0.202,-0.043,0.0123,0.1125,-0.0072,-0.0919,-0.0394,0.0221,0.0222,0.0014,0.0294,-0.0035,-0.0384,0.0245,0.0521,0.0898,0.0427,0.0826,-0.041,0.0748,0.0205,0.0149,-0.0341,-0.1187,0.0041,0.0358,-0.0025,-0.1093,0.0441,-0.0588,-0.1014,-0.0838,-0.0569,-0.0656,-0.0124,-0.0265,-0.3039,-0.1036,0.0149,-0.0534,-0.0819,-0.0692,-0.047,-0.0029,0.0685,-0.0589,-0.0651,0.0184,-0.0655,-0.3214,-0.141,0.0633,-0.0402,-0.0205,-0.1659,-0.0198,0.0222,-0.0526,-0.1589,-0.0602,-0.0821,-0.0614,-0.1431,-0.047,-0.123,-0.1162,0.0068,0.0282,-0.0389,0.0786,-0.118,-0.1521,-0.118,0.0295,0.0703,-0.0138,0.0013,-0.309,-0.0328,0.0661,0.0524,0.0686,0.1703,0.0679,0.078,0.044,0.0622,0.0773,0.0152,0.0569,-0.3708,-0.322,-0.3,0.0417,-0.258,-0.2213,-0.017,-0.0126,0.0533,0.0136,-0.2068,-0.0127,-0.0165,-0.0238,-0.0451,-0.098,-0.0001,-0.1181,-0.0696,-0.0776,0.0643,-0.0408,0.0154,0.0528,0.0585,-0.0077,-0.0464,-0.1679,0.0792,0.0377,0.0699,-0.2031,-0.1704,-0.194,-0.1255,-0.022,0.0058,-0.1242,-0.0708,-0.1464,0.056,0.0204,0.0601,-0.0595,0.0035,-0.0182,0.094,0.1096,0.0354,0.0079,-0.0266,0.0642,0.0924,0.0565,-0.1867,-0.2503,-0.2752,-0.1241,0.0049,-0.0886,-0.1343,-0.032,-0.0437,-0.0078,-0.026,-0.0086,-0.009,0.0594,0.0184,0.0322,-0.0857,-0.0951,-0.0278,0.1004,0.1243,0.0334,0.0983,0.0316,-0.1635,-0.0137,0.0546,-0.037,0.0959,0.0955,0.0948,0.029,0.1209,0.0035,0.0092,0.011,-0.0215,-0.0966,-0.0218,0.0284,-0.0672,-0.1095,-0.0368,0.0773,-0.17,0.0841,-0.0375,0.086,0.1299,0.046,0.0071,0.0169,0.0141,-0.0411,0.068,0.1094,-0.0116,-0.0619,0.0143,-0.069,0.0086,-0.0248,0.0514,0.1166,0.052,-0.0871,0.0065,0.0559,0.0519,-0.0544,-0.0035,0.0313,0.0137,-0.1581,-0.0243,-0.1243,-0.0811,-0.0236,-0.2109,0.0345,-0.1096,-0.1597,-0.1359,-0.1847,-0.3245,-0.3372,0.0269,-0.0085,-0.0536,-0.0334,-0.0254,-0.3389,-0.3306,-0.0813,-0.0066,-0.0352,0.044,0.024,0.0028,0.0279,0.1014,0.06,0.152,-0.0348,0.0292,-0.1032,0.0788,-0.0271,-0.027,0.0077,0.0722,0.0876,-0.3404,0.0332,0.087,-0.2992,-0.0527,-0.1245,0.0004,-0.0293,-0.0156,-0.0898,-0.0122,-0.0037,-0.0178,-0.0058,-0.0033,-0.0149,0.0041,-0.03,-0.0079,0.0251,-0.0181,-0.135,-0.0456,0.0907,-0.0336,-0.0685,-0.0323,0.0077,0.0055,-0.0362,-0.106,-0.1135,-0.0947,0.1325,0.0652,0.0914,0.0265,0.1069,-0.0971,-0.2304,-0.0429,-0.0655,-0.0412,-0.0195,0.0144,0.0286,0.1039,0.1618,0.1265,0.0764,0.0443,0.0015,-0.0076,0.1251,0.0141,-0.0162,0.0436,-0.0088,-0.053,0.0765,0.0458,0.0751,0.061,0.0101,-0.0216,0.1037,0.1061,-0.0171,-0.019,0.0587,0.0255,0.1152,0.0952,-0.0534,-0.0214,-0.0833,-0.1448,-0.0217,-0.0075,-0.003,0.0143,-0.1826,0.0462,-0.1766,0.0334,0.0775,0.0281,-0.132,-0.1931,0.0952,-0.1239,-0.1169,-0.0232,0.0675,-0.2905,0.0119,0.0224,-0.0852,0.0274,0.0463,0.088,-0.0067,0.0083,-0.0576,-0.154,0.1597,0.1391,-0.1284,-0.1567,0.0408,-0.1356,0.0828,0.0428,0.0949,0.1218,0.0325,0.053,0.0854,0.0309,0.0048,-0.0234,-0.0138,0.026,-0.0415,-0.0982,0.0258,0.0028,0.0383,-0.0033,-0.0038,0.0721,0.0122,0.0154,-0.0033,0.0524,0.0619,0.0376,0.0342,0.0247,0.0782,0.0663,0.003,-0.0576,0.058,0.0157,0.0432,0.0243,-0.0602,0.0147,-0.0622,-0.0471,0.0098,0.0045,0.0252,0.0629,0.0122,0.0952,0.0061,0.0169,-0.0386,-0.0028,-0.134,-0.0186,-0.0797,-0.0187,0.0975,-0.0574,-0.001,-0.0644,-0.0936,0.0431,0.0812,-0.055,0.0437,-0.0091,0.0179,0.119,-0.001,0.1584,0.0034,0.0642,0.048,-0.0932,0.1571,0.1242,-0.0426,-0.0424,0.0075,-0.0287,0.0532,0.0651,0.0361,-0.0203,-0.0488,0.0033,-0.018,0.0179,-0.0267,0.1265,0.0711,0.0432,0.0545,0.0293,0.0524,-0.337,0.1297,0.1329,-0.0034,0.0294,0.1503,0.1352,-0.0925,-0.0077,-0.0206,-0.0387,-0.1084,-0.0663,0.0219,0.0815,-0.0476,-0.1186,-0.0914,-0.0135,0.058,0.1248,0.1071,-0.0443,0.043,-0.0033,0.0538,0.0479,-0.0752,0.1163,0.0822,0.0751,0.0711,-0.0294,-0.0321,-0.0266,0.0452,0.0703,-0.0463,0.0368,0.0343,-0.1561,-0.0204,-0.0565,-0.1177,0.0241,0.0822,-0.0004,0.1278,-0.1871,-0.0694,0.128,0.0805,0.0959,-0.253,-0.1898,0.1574,0.1543,0.0123,-0.0549,0.0402,0.1435,-0.0735,0.0348,-0.0137,-0.0473,-0.0275,0.0108,0.0109,0.0836,0.0775,-0.0256,0.177,0.1692,-0.0387,-0.0199,-0.0199,0.0159,0.0121,0.0367,0.0511,-0.0245,0.1016,0.0163,0.0495,0.0751,-0.0218,0.0057,-0.0297,-0.006,-0.0079,0.0298,0.103,-0.0077,0.114,0.0495,0.0784,-0.0037,-0.0697,0.1008,0.0877,0.0119,0.0185,0.0442,-0.0779,task difficulty
trm_557b4b3a6a34d,-0.0985,-0.1132,-0.1247,-0.0944,0.0082,-0.0373,-0.0885,-0.0333,0.0003,-0.0774,0.0001,-0.0006,-0.1106,-0.0771,-0.1078,-0.0457,-0.1014,-0.1293,-0.0656,-0.0511,-0.0827,0.0119,-0.0325,0.0549,-0.0216,0.0259,0.0217,-0.1695,-0.1813,-0.085,-0.132,-0.1097,-0.1525,-0.0871,-0.1838,-0.1483,-0.0477,-0.0513,-0.1155,-0.0458,-0.1161,-0.1068,-0.0612,0.0505,-0.086,-0.118,0.1973,-0.0695,0.0806,-0.133,-0.054,0.0138,0.0316,0.0785,-0.0899,-0.0788,-0.1446,-0.0147,0.0278,-0.0279,0.0105,0.061,-0.1722,0.1154,0.0316,0.0657,-0.2263,-0.2796,-0.1339,0.0054,0.1132,0.0402,0.1641,-0.1098,-0.0807,0.0141,-0.1539,0.0695,0.084,-0.0728,0.0016,0.1074,-0.0543,-0.1564,0.0771,0.0747,0.0029,0.0149,0.0009,-0.3405,-0.1141,-0.0852,-0.0022,0.2955,0.2454,0.2465,0.1656,0.0618,0.274,0.1547,0.0794,0.0239,0.1254,0.1044,0.1368,-0.1631,-0.1826,0.162,-0.0413,-0.0415,0.0295,-0.1131,0.1372,0.1985,0.031,0.0142,-0.0967,0.0739,-0.0241,-0.0701,-0.1185,-0.1879,-0.1426,-0.0422,-0.109,-0.173,-0.0925,0.1036,0.1137,-0.0034,-0.1097,-0.0552,-0.0349,-0.3074,-0.0393,-0.2327,0.0026,-0.1412,-0.0329,-0.022,-0.105,-0.1219,0.0346,-0.0663,-0.0453,0.1039,-0.0933,0.0426,-0.0938,0.0865,-0.0779,-0.1095,-0.1499,-0.1859,0.1937,-0.0316,0.122,0.0524,0.019,-0.0775,-0.0552,-0.1076,-0.2284,-0.2346,-0.0246,0.0139,-0.0132,-0.2059,-0.1911,-0.0381,-0.0598,-0.1379,0.0906,-0.2605,-0.1613,-0.2268,-0.17,-0.1485,-0.1066,-0.0303,-0.2075,0.0709,-0.0942,0.0262,-0.1178,-0.0816,-0.1122,-0.1414,-0.0873,-0.0463,-0.0413,-0.1107,-0.0489,-0.2157,-0.1952,-0.2229,-0.1773,-0.0744,-0.0208,-0.1162,-0.0304,0.3252,-0.1777,-0.1748,0.0985,-0.1656,-0.2364,-0.036,-0.0537,0.0109,-0.196,-0.0628,-0.0289,0.0086,0.0459,0.0095,0.115,-0.1242,-0.0915,0.0504,0.1505,-0.1285,-0.1523,-0.0818,0.0992,0.047,-0.074,0.1231,-0.0696,0.2725,0.0018,-0.1547,0.2222,-0.1377,-0.1301,0.0513,-0.0655,0.0727,0.0184,-0.1256,0.0503,-0.1925,-0.0251,-0.0151,-0.0862,-0.0979,-0.0959,-0.1669,-0.076,-0.1293,0.0104,0.0324,-0.039,0.0688,-0.0207,-0.2089,0.0045,-0.058,0.1526,0.2805,0.0942,0.3813,-0.1083,0.202,0.2589,0.4396,0.1937,-0.0243,0.0567,-0.0214,-0.045,-0.0353,-0.1776,-0.0118,-0.1474,-0.0647,-0.2451,-0.3017,-0.21,-0.0857,-0.0511,-0.0978,-0.068,-0.2756,-0.2226,-0.0939,0.0536,0.0586,-0.1095,-0.1395,-0.1018,-0.1055,-0.0339,-0.0592,-0.1046,0.0455,-0.0453,0.1064,0.0079,0.1906,0.0435,-0.1876,-0.121,-0.1312,-0.0286,-0.0055,-0.1339,-0.078,-0.032,-0.0143,-0.0132,-0.0177,-0.0948,0.0859,0.0882,-0.0348,0.191,0.057,0.0888,-0.1731,-0.0014,0.0403,-0.1483,-0.1893,-0.0797,-0.0596,-0.0008,-0.0593,-0.0556,-0.1232,0.0276,-0.1057,-0.0102,0.0242,0.0486,0.1233,0.0458,-0.0263,-0.0351,-0.1648,-0.1409,0.0182,0.0463,0.0024,0.102,0.0473,-0.2526,-0.1685,-0.1647,-0.1167,-0.1112,0.1636,-0.0668,-0.036,-0.0672,-0.0602,-0.0389,-0.1535,-0.171,-0.1177,0.0274,-0.0252,-0.0675,0.0038,-0.0098,0.1099,-0.1505,0.327,0.0535,-0.1605,0.0154,0.1437,-0.0095,0.145,-0.1521,-0.0336,-0.1092,0.1243,0.1234,0.1322,0.1558,0.0903,-0.0899,0.0615,0.0578,0.0855,-0.0951,-0.0363,0.0681,-0.0518,-0.0298,-0.0346,-0.01,-0.0366,0.12,0.0601,-0.0334,-0.1599,-0.0868,-0.0917,-0.0788,0.014,-0.0105,-0.0486,0.0607,0.0824,0.0629,0.03,-0.1185,-0.0389,-0.0168,-0.1626,-0.0365,0.2602,-0.1619,-0.0928,0.2698,0.0418,-0.0582,0.0026,0.0277,-0.2308,-0.1338,-0.3147,-0.2754,-0.0798,-0.1948,-0.0376,-0.1438,-0.0763,-0.0177,0.0445,-0.0359,-0.0309,-0.0485,0.0847,0.0151,-0.01,-0.2779,-0.144,0.0269,0.1202,0.0092,0.0841,-0.0724,-0.0938,0.0388,0.1841,-0.1114,0.008,0.0847,0.0835,-0.1298,-0.083,0.0515,-0.1524,-0.0077,-0.0385,-0.0048,0.0374,0.1016,-0.0283,-0.0657,0.0833,-0.1388,-0.1424,0.087,0.433,-0.1178,-0.0757,0.0198,0.0264,0.1395,-0.0541,-0.1498,-0.0338,0.0559,0.0504,-0.0435,-0.0261,0.1263,0.0298,0.029,0.0943,0.1193,0.1454,-0.0164,0.0345,-0.1099,-0.0256,0.077,0.1042,-0.1027,-0.1481,0.1104,0.0141,-0.2713,-0.0269,0.0394,-0.1014,-0.0872,0.0381,-0.0699,-0.1142,-0.111,-0.1157,0.0181,-0.0231,-0.0299,0.1894,-0.2053,0.0453,-0.0629,0.019,0.1124,0.0888,-0.1491,-0.1213,0.1251,-0.0892,-0.1107,-0.1071,0.1095,0.1513,0.1875,0.0668,0.1388,0.1669,0.0238,0.1094,-0.0851,-0.0497,-0.0649,-0.2122,-0.105,0.0005,-0.163,-0.0669,-0.031,-0.1532,-0.0267,0.0424,0.0039,-0.0661,-0.1062,-0.0235,0.0279,0.0437,-0.0199,-0.038,0.0949,-0.0535,-0.0197,-0.0006,-0.0121,-0.1758,0.1023,0.055,0.0558,-0.0435,-0.0803,0.0041,-0.112,0.0508,-0.1208,0.0022,0.0791,-0.1222,-0.0123,-0.1082,-0.1092,-0.038,-0.137,-0.0154,0.0868,0.0544,0.0544,0.0525,0.0733,0.0841,-0.0145,-0.1051,-0.0252,-0.0299,0.1391,0.0789,0.1272,0.0494,0.1117,-0.0399,-0.1389,0.0544,0.1627,0.113,-0.0407,-0.0161,-0.2454,-0.035,0.196,-0.1077,0.0334,0.0403,0.1018,0.0302,0.1022,0.1103,-0.0613,-0.1738,-0.1605,0.1188,-0.2096,-0.0658,0.1013,-0.0534,-0.2795,-0.0799,-0.0887,0.0381,0.0195,-0.2427,-0.0717,-0.2211,0.0895,0.0238,-0.0602,0.0989,-0.0689,-0.1595,-0.0446,0.0546,0.0867,0.1011,-0.0573,0.0272,0.086,0.1116,0.1004,-0.024,-0.0805,-0.0392,-0.0719,0.1443,0.0326,0.0225,-0.0887,-0.058,-0.2248,-0.1817,0.1777,-0.1961,0.0576,-0.1605,0.2899,-0.1408,-0.0411,-0.0494,0.1193,-0.0749,-0.0233,-0.1119,-0.1785,0.0867,0.1984,0.0235,0.094,0.17,-0.1037,-0.1628,0.0043,0.0036,-0.0478,-0.0842,-0.061,-0.0251,-0.0361,-0.0816,0.2192,-0.1058,-0.0039,-0.0523,0.0462,0.1002,0.0934,0.0239,0.1145,-0.1873,-0.1071,0.0343,0.0325,0.014,0.0704,0.2562,0.2049,0.1025,0.0946,-0.0575,0.0646,-0.059,-0.0825,0.0196,0.0322,-0.0016,-0.0605,-0.1259,-0.1128,-0.0645,-0.136,-0.0879,-0.1022,0.0486,0.1196,0.0493,0.0174,0.0188,0.0325,-0.0268,-0.0075,-0.0601,-0.1341,0.029,0.101,-0.1052,-0.2828,-0.2809,-0.2051,-0.0245,-0.047,-0.1066,0.0149,-0.0208,0.0666,-0.0471,-0.0377,0.1243,0.1605,0.0125,-0.1479,0.1585,0.1882,0.2868,-0.1948,0.0005,-0.0841,0.0196,0.0237,-0.1589,0.116,0.067,-0.0328,0.0245,-0.0034,0.0534,-0.2056,-0.2983,-0.2502,-0.19,0.0712,0.233,-0.0012,-0.1393,-0.0637,0.0458,0.0878,0.0404,0.0615,0.0331,-0.1013,-0.0928,-0.0226,0.1136,0.1098,0.1606,-0.0739,-0.0263,0.0571,-0.0998,0.0748,-0.0939,-0.1535,-0.0389,-0.1897,-0.1664,-0.1007,0.1322,0.1212,0.0414,-0.0295,-0.0382,0.0431,0.1851,-0.0237,-0.1079,0.06,-0.0081,0.0135,0.0358,0.1232,-0.0982,0.1671,-0.2264,-0.2254,0.1714,0.1499,0.2489,-0.0284,-0.0477,0.074,-0.0186,0.1041,0.2824,0.0606,0.1228,0.1254,0.18,0.0671,0.0321,0.1816,0.1859,-0.119,0.0475,0.0584,-0.1942,-0.1516,-0.0049,-0.1294,-0.0034,-0.2754,-0.0824,-0.2004,-0.1203,-0.2307,0.0322,-0.0022,0.0972,-0.0813,-0.0382,0.0205,0.0848,0.1277,0.0725,0.0938,0.181,0.0253,0.0895,0.0461,0.0208,0.1494,0.1743,-0.1521,0.1766,0.0813,-0.047,-0.0718,-0.1104,-0.0737,0.1463,0.0972,-0.2729,-0.1807,-0.0144,0.0771,0.1384,0.0358,0.0329,0.0217,0.0575,-0.038,-0.0894,0.2107,-0.0481,0.1053,-0.1782,0.1793,-0.0926,0.1482,0.1984,0.0402,0.2057,-0.2542,-0.2407,-0.0923,0.2995,-0.0652,-0.0927,-0.1193,0.0996,0.01,-0.1449,-0.0569,-0.1866,0.0463,-0.0655,0.0233,0.1024,-0.0323,0.1245,-0.1575,-0.1118,-0.0515,0.0328,-0.1224,0.0315,0.0991,0.0817,0.1333,0.3332,0.1534,-0.1074,-0.1,-0.1165,-0.0543,-0.1059,-0.0492,0.0711,0.2128,0.0827,-0.0146,-0.1396,0.1738,0.2353,0.0824,-0.0496,-0.0353,-0.0359,-0.1356,-0.0802,-0.0752,0.017,0.0497,-0.1605,-0.0595,0.1043,0.0165,-0.101,-0.0559,0.0456,-0.0939,-0.0407,-0.0445,-0.1545,-0.1527,-0.3208,-0.1874,-0.3244,-0.0326,-0.0675,-0.1228,-0.192,-0.1253,-0.2301,-0.1511,-0.2913,-0.1451,-0.1539,-0.0064,0.0822,0.1424,-0.0403,0.0816,-0.001,0.0273,0.111,0.1346,0.1619,0.0895,-0.0768,-0.0218,0.0542,-0.036,0.0826,0.096,0.1061,-0.0055,0.0323,-0.0504,0.1166,-0.088,-0.0703,-0.0194,0.0689,-0.0901,0.0754,-0.2073,-0.0823,-0.0693,-0.1047,-0.0814,0.0547,0.0929,0.0782,0.1136,0.1647,0.1341,0.0551,0.0475,-0.0015,-0.0309,0.0761,-0.0166,-0.0384,-0.0643,-0.1173,-0.0476,0.1152,0.0896,-0.1275,-0.1127,-0.0974,-0.2304,-0.1178,0.2057,0.0926,0.1734,0.0902,0.0867,-0.1161,-0.0393,0.0673,-0.0136,-0.059,-0.0444,0.0259,-0.0756,-0.0693,0.0055,0.0993,-0.1058,-0.0038,-0.1166,0.0594,-0.133,0.0681,0.1515,0.32,0.1593,0.1149,0.0549,0.0634,0.0041,-0.0156,-0.0635,-0.0891,0.0014,0.0085,0.0225,-0.0009,-0.0189,0.0566,0.0007,-0.0685,-0.0243,-0.1468,-0.1898,-0.1795,-0.1454,0.2072,0.0248,0.0888,-0.2043,0.2793,0.1494,-0.0498,-0.0349,-0.0035,0.0172,-0.0441,0.0905,-0.1098,-0.1092,-0.0296,-0.0489,-0.174,-0.0489,-0.1214,-0.0198,-0.0888,-0.0827,-0.0791,-0.1069,0.0221,0.0172,-0.0297,0.0367,0.0686,-0.1067,0.0789,-0.1082,0.0334,-0.0473,-0.1122,0.4452,0.2994,0.3909,0.2882,0.3198,0.0954,0.354,0.1743,-0.1986,0.2015,0.2285,0.1513,0.1295,0.1347,-0.0845,0.0068,-0.0813,-0.041,0.0207,-0.0074,0.0585,0.0503,-0.1409,0.056,0.0705,-0.0054,0.0971,-0.0214,-0.1254,0.1476,0.0642,-0.1141,-0.0031,-0.1202,0.1038,0.0242,0.2029,-0.0406,-0.1757,-0.1661,-0.0841,-0.0184,0.1315,0.0971,-0.0276,-0.1159,-0.2506,-0.1726,-0.0965,0.2332,-0.1126,0.316,0.2954,-0.0973,-0.0023,-0.0175,0.1607,0.2203,0.1201,0.2267,0.0783,0.0407,0.1101,0.0828,-0.0559,-0.1596,0.0165,-0.1095,0.14,0.0082,-0.1049,-0.0333,-0.1412,-0.0565,0.0088,-0.0573,-0.09,0.0492,0.1598,-0.0571,0.0171,-0.0065,0.1697,0.0335,0.054,-0.2117,-0.2126,-0.102,-0.1212,-0.0902,-0.1691,-0.0846,-0.0279,-0.0374,0.1482,0.1117,0.0887,0.349,-0.0554,-0.0681,-0.0423,0.1224,-0.0142,0.2658,-0.1363,0.2561,0.4309,0.0549,-0.2282,0.3467,0.2864,-0.0038,-0.1999,-0.012,-0.1762,-0.1105,-0.2184,-0.0307,0.1309,-0.0841,-0.0683,0.0283,-0.0469,-0.0632,-0.1132,-0.0581,-0.0435,-0.1092,0.0203,0.0946,-0.0272,0.3102,0.2336,0.2406,0.253,-0.106,-0.0019,-0.08,-0.0896,-0.0627,-0.0657,-0.0077,0.2039,-0.1715,-0.1043,0.1136,0.0444,0.0241,0.1386,0.0575,0.0189,0.0029,0.1371,-0.0654,-0.0999,-0.0752,0.1303,0.061,0.0002,-0.0139,-0.0139,-0.2175,0.1528,0.0786,0.09,-0.0348,0.0893,-0.0528,0.3278,-0.3314,-0.2994,0.0722,-0.0651,-0.2531,-0.2643,-0.2228,-0.037,-0.0713,-0.0534,-0.0032,-0.0076,0.2592,-0.1097,-0.0458,-0.0961,0.0526,-0.0261,-0.0175,0.0488,-0.0913,-0.0767,-0.0184,-0.1285,-0.0566,-0.056,-0.1705,0.0098,-0.0079,0.199,0.0865,0.1616,0.0143,0.2331,-0.1689,-0.0891,0.0422,-0.1206,-0.0235,-0.1886,-0.2517,-0.0024,-0.0715,-0.2207,0.0177,-0.0463,-0.1973,-0.0216,-0.0565,0.0246,-0.3277,-0.1454,-0.1151,-0.1513,-0.0503,0.0831,-0.0539,0.2862,0.095,0.1127,0.0994,-0.0721,0.0091,-0.0904,-0.2899,-0.2846,0.0309,-0.107,-0.0788,-0.1172,-0.0337,0.0309,0.0685,-0.0004,-0.1968,-0.1409,0.0046,-0.0272,-0.0349,-0.0137,-0.083,0.0596,-0.0566,-0.1305,-0.1175,-0.2268,-0.1259,-0.0637,-0.1515,-0.158,0.0258,0.0279,0.0124,0.0634,0.021,-0.1028,-0.099,0.0336,-0.2004,0.0296,0.0141,0.0055,-0.0946,-0.1559,0.0443,0.1388,-0.0235,0.0241,0.0037,-0.0662,0.1787,-0.0226,0.0165,-0.0085,-0.2453,0.1187,-0.0411,0.0657,0.1964,0.1364,0.0101,-0.0719,0.0289,0.22,-0.0796,0.0104,-0.1237,-0.0137,-0.1189,-0.1165,-0.0368,0.1404,-0.0073,-0.0861,-0.1501,-0.0066,-0.0323,-0.0162,-0.0904,-0.1768,0.0124,0.0028,-0.0639,0.1111,-0.085,-0.0523,-0.0646,-0.0659,-0.0851,-0.0839,-0.0446,-0.039,-0.0001,-0.0585,0.1056,-0.0472,-0.0185,-0.0327,0.044,0.0156,-0.022,-0.186,0.0896,-0.0432,0.0613,0.0221,0.0607,0.092,0.0959,0.0712,-0.1095,-0.0839,-0.0969,-0.0451,-0.2585,0.0182,-0.1508,-0.027,-0.0443,-0.0653,-0.0697,-0.1461,-0.1401,0.1218,-0.0251,-0.0356,0.2467,0.2125,0.0404,0.0962,0.155,-0.0191,-0.0364,0.0249,0.2202,0.0185,0.0297,-0.0183,-0.0697,-0.0471,-0.1218,0.0421,0.0289,-0.0146,0.0769,0.1209,-0.0842,-0.0851,-0.0419,0.0562,0.1149,0.0842,-0.2619,-0.0836,-0.0453,-0.2163,-0.1658,0.0683,0.1205,-0.0081,0.0237,-0.0231,0.0219,-0.1977,-0.0231,-0.0192,-0.0523,-0.2296,-0.0761,-0.0374,-0.1231,-0.0582,0.1403,-0.046,-0.0374,-0.0385,0.0099,0.1625,0.2963,-0.0367,0.0512,0.0334,0.0174,-0.1013,-0.0776,0.0532,-0.0163,-0.0367,0.1754,0.1243,0.0434,-0.0707,-0.0977,0.0592,0.5688,0.554,-0.1984,-0.1256,0.0912,-0.0934,-0.0845,-0.021,-0.214,0.0375,-0.0432,-0.0732,0.0098,0.0357,0.2529,-0.0389,0.1801,0.0725,0.0229,0.1668,0.4877,0.0018,-0.0887,0.2906,0.0264,0.1048,0.0549,0.0568,-0.0856,0.1732,0.1296,-0.0026,-0.0139,0.0129,0.0348,0.0924,0.067,-0.0342,-0.0687,-0.0743,0.1196,-0.1404,0.0308,0.158,-0.0559,-0.0642,0.0049,-0.0125,-0.1525,-0.0463,0.0597,-0.0919,-0.0957,-0.2321,-0.0395,0.0712,0.004,-0.0258,0.0348,0.0119,0.0179,0.135,0.1241,0.1364,0.0035,0.2501,0.0755,0.0517,0.4711,-0.1368,-0.096,0.1264,-0.228,0.0486,0.0081,0.0999,-0.0572,0.016,0.028,-0.0475,0.0211,0.054,-0.0312,0.0397,0.0097,0.0859,0.0627,0.1541,0.288,0.3092,-0.1117,-0.1291,-0.1016,-0.0442,-0.0037,0.0129,-0.0648,0.0238,0.0205,0.0385,0.1154,0.0122,-0.2992,-0.1124,-0.0145,0.1391,0.0177,0.0615,0.0785,0.1678,0.1333,-0.1122,-0.0129,-0.068,-0.0095,0.0473,0.0796,-0.2823,-0.2897,-0.3613,0.0727,-0.0163,0.0256,0.3237,-0.1334,-0.0893,-0.0148,0.2687,0.1485,0.2118,-0.0438,-0.0062,-0.0086,0.0203,0.1825,0.2439,0.2623,-0.0314,0.0726,0.0508,0.0694,-0.1376,0.0997,-0.2679,-0.0533,-0.0776,-0.1326,-0.0155,0.0191,-0.0501,0.0407,-0.0579,0.029,0.0229,0.0589,-0.1003,0.0087,-0.0114,0.0014,-0.0271,0.0829,0.2509,0.1585,0.2626,-0.2518,-0.1448,-0.2066,-0.0383,0.0984,-0.0258,-0.1585,-0.1145,-0.1611,-0.0969,0.1467,-0.0003,0.2226,0.0865,0.0361,0.0817,0.0001,0.0279,0.0131,-0.0046,-0.2252,-0.0347,-0.1369,-0.0556,-0.1098,0.0038,0.1183,0.3028,0.182,0.0987,0.1011,-0.0974,-0.35,-0.2036,-0.2613,-0.1879,0.0195,-0.0162,0.0678,-0.1394,-0.214,-0.1611,-0.0684,-0.1014,-0.0128,-0.0213,-0.0515,0.001,-0.0517,-0.1942,-0.1617,-0.0725,0.1074,0.009,-0.0132,-0.2852,-0.0239,-0.1086,-0.1622,-0.3736,0.0726,-0.0773,-0.0782,-0.0775,-0.024,-0.0224,-0.0212,-0.1491,-0.1211,-0.1801,0.1746,0.0539,0.2325,0.0575,0.1057,-0.0657,0.0827,0.0934,0.3138,-0.1034,-0.0496,-0.0172,0.1844,-0.2383,-0.2964,-0.2112,-0.0519,-0.0929,-0.1677,-0.128,-0.097,-0.1312,-0.0467,0.0451,0.0496,-0.2748,-0.0121,-0.0355,-0.0887,-0.107,-0.1163,-0.1194,-0.1544,0.042,-0.0202,0.1644,-0.0936,-0.1973,-0.2354,-0.1257,-0.1543,-0.0758,-0.3003,-0.2435,0.0421,0.1311,0.1034,-0.0154,-0.0809,0.0287,0.121,0.1879,0.139,-0.2589,-0.2921,-0.0497,0.0884,-0.0371,-0.0601,0.0702,-0.072,0.0284,-0.0422,-0.0821,-0.1179,-0.0182,-0.0939,-0.1104,0.01,-0.098,0.0001,-0.0319,0.1023,0.204,0.1776,-0.0898,-0.2067,-0.226,-0.1838,-0.1615,-0.2963,-0.1649,0.343,-0.0638,-0.0977,0.1528,0.0853,0.0181,0.1517,0.0445,0.0626,0.2247,0.028,0.0917,0.06,0.0007,0.0904,0.097,0.2359,0.31,-0.2205,-0.009,0.0806,0.3634,-0.155,-0.0797,0.0682,-0.1113,0.0322,0.0852,0.0844,-0.0257,-0.0381,-0.0979,-0.2452,-0.2516,-0.0203,-0.0509,0.0349,0.162,0.1503,-0.083,-0.0517,0.0593,0.1498,0.1066,0.0956,0.0408,0.0198,0.0581,-0.3477,-0.1681,-0.1649,-0.1784,-0.0786,-0.1818,-0.1793,-0.1163,-0.0107,-0.1137,-0.1945,-0.0733,0.0799,-0.0974,-0.2926,0.1258,-0.043,0.0106,0.0833,-0.1455,0.0218,-0.1587,-0.1141,-0.0295,-0.1141,-0.0646,0.056,-0.1182,0.11,0.1363,0.1339,-0.0215,-0.1385,0.074,-0.0593,-0.1745,-0.0334,-0.0958,-0.1211,0.1311,0.0191,-0.0131,-0.1078,-0.1127,0.0023,0.0338,-0.1737,-0.0969,-0.133,-0.0811,-0.0323,-0.0516,0.0908,-0.1474,-0.0799,0.0673,-0.0151,-0.0648,0.0132,0.0077,-0.1541,-0.0332,-0.1032,-0.1531,0.2637,0.3649,0.3305,-0.0756,0.473,0.2617,-0.169,-0.1278,0.4378,0.2572,0.0571,0.172,0.1399,0.1373,-0.1071,-0.1005,-0.0822,-0.105,0.5001,0.4192,0.2704,0.0522,0.1936,0.21,0.4697,0.463,0.4021,0.0073,-0.0336,-0.0412,-0.0093,-0.0387,-0.0404,-0.1958,-0.1148,-0.0261,-0.0484,-0.1092,-0.0965,0.1213,0.0085,0.0053,-0.0855,0.0565,0.2157,0.2811,-0.0197,-0.0612,-0.0839,-0.0233,-0.0101,0.0074,-0.0286,-0.1038,-0.0437,-0.0525,-0.1935,-0.2594,-0.234,0.0379,-0.0572,0.0326,0.2379,0.1125,0.2336,0.1143,0.0799,0.2577,-0.0337,-0.1818,-0.1982,0.0015,0.1081,-0.0961,0.1692,0.1189,0.1698,0.0706,-0.1673,-0.1636,-0.1186,-0.0981,0.1219,-0.213,-0.1079,0.0282,-0.0396,0.1069,-0.0139,-0.0244,0.0883,0.0463,-0.1057,-0.0039,-0.1391,-0.1896,-0.2124,0.0611,-0.0069,-0.0712,0.0601,-0.034,0.0804,0.4739,0.4433,0.1815,0.2943,-0.1395,0.1031,0.1214,0.2872,0.303,0.3477,0.0831,0.1028,-0.0121,0.2177,0.1967,0.0255,0.0188,-0.1082,-0.0612,-0.0622,0.0139,-0.0281,0.029,0.0178,0.0101,0.0698,0.0173,0.1792,-0.0983,0.1308,0.0718,-0.1705,-0.1786,-0.1329,-0.1349,-0.1953,0.1036,-0.0536,-0.0871,-0.0339,0.2297,0.0499,-0.228,-0.021,-0.0231,-0.1485,-0.0015,-0.0205,0.0233,0.1242,0.1072,0.3761,0.2949,0.2754,0.0249,-0.0104,0.1477,-0.1104,-0.1678,-0.0009,0.0276,-0.051,0.0136,-0.1109,-0.1184,-0.1161,-0.2167,-0.2348,-0.2255,-0.1252,-0.0582,-0.1777,0.0009,-0.0776,0.0353,-0.0051,-0.0539,-0.0959,-0.1626,0.128,0.0207,0.0102,-0.1242,0.0916,0.0045,-0.1901,0.0621,-0.1645,-0.084,0.2507,-0.2288,-0.2357,-0.0271,0.0279,0.0362,0.0361,-0.0368,-0.0606,-0.0291,0.0001,0.0204,-0.2346,0.0692,0.0265,0.1566,0.0125,-0.2983,-0.1151,0.0117,-0.1076,-0.0407,-0.0172,-0.1391,-0.0125,0.0375,0.0278,0.0949,-0.3732,-0.1618,-0.1656,-0.2834,-0.1984,-0.1418,-0.1443,-0.1443,-0.0796,-0.0289,0.102,-0.2296,-0.0624,-0.0942,-0.1057,-0.0317,-0.0816,-0.3419,0.1312,-0.1803,0.0734,-0.0714,0.4001,-0.0785,-0.0961,-0.1839,-0.0731,0.0192,0.071,-0.0279,0.2954,0.0545,0.1404,0.2862,0.228,-0.007,0.0285,0.0538,-0.0029,-0.0171,-0.099,-0.1166,-0.0508,-0.1275,-0.0471,0.0015,-0.0092,0.0421,-0.0277,-0.0881,0.0774,0.0769,-0.0619,0.1331,-0.0149,-0.0707,0.0172,-0.1295,-0.0168,-0.003,0.1915,-0.1067,0.2501,0.2161,0.0468,0.2505,0.2482,-0.0438,0.0952,0.0089,0.2594,0.1105,0.0142,0.1523,-0.1263,0.0579,0.0807,0.0879,-0.0333,-0.0635,0.0574,-0.0375,0.0055,-0.0475,-0.2762,0.0072,-0.0581,0.063,-0.0351,-0.0629,0.2608,0.0651,0.0563,0.0403,0.0269,-0.0023,0.0057,-0.0966,-0.1539,-0.0492,0.1268,0.1311,-0.0069,0.0418,-0.0849,0.044,0.1053,0.0457,0.1448,0.0569,0.0136,-0.0689,0.0389,-0.0993,-0.0451,-0.0516,-0.0164,-0.1058,-0.0833,-0.0855,-0.0944,-0.0002,0.0169,-0.1149,0.0789,0.0051,0.0398,0.0876,0.1225,0.1656,0.0683,-0.0307,-0.0841,-0.0971,-0.0651,0.0542,0.052,-0.0294,-0.0404,-0.0352,0.0234,-0.1278,-0.1692,-0.1239,-0.1746,-0.1745,-0.0114,-0.0079,0.0511,-0.1632,-0.1306,-0.1451,-0.0383,-0.1014,-0.0244,0.0303,-0.0603,0.1816,-0.1602,-0.1292,-0.0695,0.0171,-0.0963,-0.0833,0.136,0.055,-0.2047,0.0606,0.003,-0.0584,0.0755,0.0514,0.0337,0.0634,-0.0598,-0.2024,-0.06,-0.2093,-0.2458,-0.0433,-0.1139,0.1039,0.1468,0.1957,0.1657,0.1909,-0.1453,-0.1851,-0.0364,0.1499,0.1823,0.0202,-0.0535,-0.0479,-0.0038,-0.132,0.0544,-0.1524,-0.1717,-0.0413,-0.0388,-0.0907,-0.1695,0.1514,0.0322,0.0298,0.1581,0.0144,0.0156,-0.1002,-0.0688,-0.0405,-0.0236,-0.0655,0.011,0.128,0.0693,-0.046,-0.0768,-0.0317,-0.1071,-0.0385,-0.0529,-0.2414,-0.0466,-0.0368,-0.0176,-0.0479,-0.0164,0.0132,0.0229,-0.0935,0.0857,-0.2089,-0.1062,-0.1865,-0.1584,-0.0113,-0.1835,-0.1426,-0.3142,-0.1389,-0.0595,0.1834,-0.1574,-0.042,-0.0602,0.0974,0.0997,0.1321,-0.1087,-0.2088,-0.0923,-0.054,-0.0119,0.1438,-0.0511,-0.0666,-0.0798,0.0889,0.0874,0.0472,0.1597,-0.0143,-0.0594,0.0739,-0.0365,0.0556,0.023,-0.0357,-0.0883,0.0367,0.0199,0.1132,0.0247,0.0825,0.1402,0.0416,0.0252,-0.0478,-0.2004,-0.1267,-0.0166,0.226,0.272,0.0999,-0.0143,0.0035,-0.001,0.3076,0.2078,0.1612,0.1941,-0.242,-0.0244,-0.0611,0.0819,-0.1122,0.0651,0.0261,0.0257,0.0151,0.0619,0.0473,-0.0666,0.1162,0.0645,-0.1614,0.2336,0.0911,0.0332,0.0333,0.0845,0.0641,-0.0182,-0.0392,0.0215,0.0309,0.1971,0.2228,0.2568,-0.1166,0.001,0.0366,-0.0586,-0.1392,-0.3517,-0.3392,0.0636,0.0882,0.0982,-0.0958,0.0688,0.0338,-0.085,-0.112,-0.1558,0.0709,-0.1109,-0.0234,0.0087,0.1033,-0.0225,-0.17,-0.048,-0.1682,-0.1134,-0.0077,-0.1816,0.0226,-0.2222,-0.07,-0.0336,-0.0518,0.0199,0.1102,-0.0036,-0.0107,-0.1006,0.3212,-0.1075,0.1852,0.1807,0.1695,0.0231,0.0583,-0.0224,0.3048,0.2585,-0.2006,-0.094,-0.021,-0.025,-0.1276,-0.1086,-0.2086,-0.2407,-0.1168,-0.0054,-0.1381,0.0636,-0.0396,-0.09,-0.1549,-0.2107,0.0513,0.0349,-0.2331,-0.1398,0.0205,-0.1239,-0.2404,0.1252,0.1953,-0.113,0.0733,0.132,0.069,-0.0868,-0.0924,-0.1873,-0.1939,-0.1046,-0.0809,0.0309,0.1228,0.0532,0.1185,-0.0044,0.2403,0.3325,0.256,0.1553,0.2618,-0.2919,-0.2372,-0.1713,-0.0985,-0.0672,-0.07,-0.1596,-0.0795,0.0228,-0.1207,-0.1243,-0.0561,0.1469,-0.1747,0.0294,0.0149,0.0291,0.1086,0.1055,0.0226,-0.2332,-0.1304,-0.2459,0.0636,0.1661,0.1762,0.0666,0.0025,0.1274,0.119,0.166,0.0997,-0.0153,-0.118,-0.0001,-0.029,0.0169,0.0011,0.0452,0.1526,0.0624,0.064,0.064,-0.0889,-0.0095,-0.2155,-0.1832,-0.1005,-0.1263,0.4286,0.0045,0.2764,0.1575,0.1049,-0.0394,-0.0385,0.1559,-0.0319,0.2517,0.2442,0.0455,0.1519,0.0653,0.0126,-0.0795,-0.0674,-0.049,0.0225,0.1912,0.1055,-0.1095,-0.0212,0.0204,0.0017,0.0029,-0.0179,-0.0884,-0.1135,-0.0117,-0.1244,-0.037,-0.0744,0.0994,0.0976,0.1559,0.0816,-0.0171,-0.0408,-0.0399,-0.0456,0.14,0.1883,-0.0185,0.0492,-0.0581,0.0859,-0.092,-0.077,0.0228,0.16,0.1251,-0.0117,-0.1298,-0.0859,-0.1492,-0.1108,0.0721,0.1775,-0.0798,-0.0414,-0.0608,-0.123,-0.2865,-0.185,-0.1823,-0.1891,-0.1342,-0.1074,-0.1079,0.146,-0.0874,-0.0864,-0.0907,-0.0594,-0.1368,-0.316,-0.1052,-0.0083,0.1583,0.0395,-0.1263,0.4052,0.3806,0.1842,0.0128,0.0656,-0.0396,-0.2744,-0.0394,-0.1434,0.0092,0.1906,0.2304,-0.0103,0.0112,0.0521,0.1082,-0.268,-0.1336,-0.0929,-0.0678,-0.309,-0.2378,-0.1448,-0.2311,0.0845,-0.1592,-0.1149,0.2808,-0.1943,-0.2406,-0.004,0.1316,0.149,-0.1084,-0.1018,-0.4103,-0.298,-0.1312,-0.322,0.202,-0.1329,-0.0888,0.0706,-0.2403,-0.0063,-0.0878,-0.0182,0.1372,0.1175,0.2775,0.1881,0.2323,-0.0404,0.0004,0.1799,0.0063,0.083,0.0606,0.0173,0.2254,0.1408,-0.161,-0.2766,-0.1438,-0.0664,-0.1436,-0.0356,-0.0511,0.0301,0.0083,0.0518,0.1479,0.0961,-0.2293,-0.0442,-0.1754,-0.0947,-0.2182,-0.2524,-0.0074,-0.1566,0.015,-0.0891,-0.0377,-0.1512,-0.1018,-0.1983,-0.079,-0.1449,-0.0287,-0.0504,-0.0405,-0.0375,-0.0916,0.0656,0.083,0.0636,-0.0885,-0.1095,-0.1404,0.0252,0.1206,0.0556,-0.0624,0.2902,-0.0215,-0.0767,0.0639,0.0559,0.0013,-0.0444,-0.043,0.0672,-0.0288,-0.055,0.1734,0.3005,0.4739,-0.0943,-0.1162,0.0486,-0.037,0.031,0.2503,-0.1185,0.4333,-0.2996,0.1652,0.1358,0.1146,0.0012,-0.0359,0.0187,0.0268,-0.0207,0.0038,0.1227,0.0368,-0.0529,-0.1461,0.1126,0.2161,0.1988,-0.2168,-0.1719,-0.2006,-0.0101,-0.1655,-0.1956,-0.0323,0.049,0.01,-0.0582,-0.1611,-0.1804,0.1044,-0.0103,-0.1347,0.091,0.323,0.0213,-0.0844,0.2164,0.4481,0.1829,0.0968,0.2287,-0.0754,0.0597,0.237,0.2522,-0.102,0.2716,0.1067,0.1353,0.0701,0.4194,0.0887,-0.1596,-0.1331,-0.0787,-0.267,-0.0273,-0.1571,-0.0658,-0.2137,-0.2703,-0.0663,-0.2583,-0.166,0.1233,-0.1241,-0.2872,-0.2193,-0.2357,-0.056,-0.1253,-0.1792,-0.1641,-0.1558,-0.074,-0.0843,-0.2492,-0.177,0.1443,0.2475,-0.0257,-0.0237,0.068,0.0463,-0.0575,-0.1297,-0.1362,-0.178,0.0283,0.0734,-0.2521,-0.3121,-0.1104,-0.0203,-0.1579,-0.2068,0.0154,-0.1046,-0.0698,-0.1801,-0.1187,-0.0848,-0.1021,-0.0186,-0.0009,-0.0264,0.2011,-0.1114,0.0653,0.2348,0.0308,-0.2142,-0.0029,-0.2437,-0.1686,-0.111,-0.1414,-0.1827,0.0666,0.1191,0.1589,-0.0086,-0.1026,0.0834,-0.1085,0.0096,0.1736,-0.1892,-0.1325,-0.206,0.0379,0.0459,0.1746,0.0136,-0.2674,-0.2291,0.0405,0.054,0.0061,0.1513,0.1122,-0.0219,-0.1239,-0.1358,-0.0708,-0.1594,-0.2999,-0.1284,-0.0822,0.1228,0.0292,0.2068,-0.0207,0.2078,-0.0197,0.0499,0.0105,0.0963,0.1256,0.0669,-0.0006,-0.011,-0.0811,0.0814,-0.0213,0.0281,-0.0562,-0.0514,-0.0408,-0.0033,-0.1061,-0.0342,-0.0807,-0.0489,-0.175,-0.0251,-0.0161,0.1231,-0.0496,0.0342,0.0084,0.0241,-0.0395,-0.0302,-0.0017,-0.0451,-0.2144,-0.1152,0.2368,0.1541,0.0255,-0.0682,-0.0463,-0.1705,-0.1014,-0.0042,-0.105,0.1523,0.0932,-0.2068,-0.2005,0.0544,-0.1517,-0.0705,-0.0696,0.3677,0.3368,-0.2792,0.049,-0.1122,-0.0422,-0.0826,-0.1675,-0.2074,-0.2094,0.0572,-0.0183,-0.1019,0.0093,-0.1538,-0.0716,0.1558,0.0274,0.0294,0.0075,-0.0118,0.0017,-0.19,-0.0275,0.1077,-0.1645,0.1177,-0.2201,0.2439,-0.1829,0.3115,0.0971,0.097,-0.2655,-0.2261,0.0038,0.1389,-0.0003,0.1746,-0.035,0.034,0.0849,0.0715,0.0811,0.0662,0.0631,0.0803,0.1093,0.1234,0.1779,-0.1031,0.1272,0.3214,0.5775,0.2829,0.1403,0.3795,0.2024,0.1885,0.3305,0.259,0.3113,0.201,0.2796,0.2827,0.1597,0.234,0.2748,0.4112,0.2475,0.3658,0.2672,0.3123,-0.2138,-0.1118,-0.1969,-0.2583,-0.2332,-0.3073,-0.2473,-0.121,0.0725,-0.0432,-0.3357,-0.2795,-0.1941,-0.0244,-0.013,-0.2112,0.1177,-0.0266,-0.0978,-0.0014,-0.1172,-0.0749,-0.0388,-0.0591,-0.1685,0.1227,-0.2603,-0.2648,0.0982,0.0021,-0.0497,0.0225,0.0276,-0.2007,0.2273,0.2014,-0.1456,0.128,0.2533,0.0115,0.0542,0.0267,-0.1433,0.3762,0.381,-0.1114,-0.059,0.0583,-0.094,-0.0305,-0.1604,-0.0463,0.1322,-0.0639,-0.0982,0.0504,0.0091,-0.0273,-0.0179,visual form recognition
trm_558c7b707f606,0.0719,0.0814,0.055,0.1386,0.053,0.0359,0.0411,0.0698,0.0342,0.0672,0.0189,0.025,0.089,0.0337,0.0587,0.0309,0.0809,0.072,0.077,-0.026,0.0305,-0.017,0.0118,-0.0371,-0.0008,-0.0185,-0.017,0.0623,0.1094,0.0491,0.0437,0.071,0.0495,0.0781,0.0565,0.0505,0.0287,0.0348,0.1016,0.0306,0.0667,0.0473,0.0428,-0.0934,0.0455,0.0321,-0.1355,0.0514,0.0114,0.089,0.0454,-0.0006,-0.0187,0.0208,0.0247,0.066,0.0486,-0.0169,-0.0122,-0.0205,-0.0328,-0.0117,0.0813,-0.0734,0.0483,-0.0234,0.1226,0.1437,0.0944,-0.0102,-0.0132,0.019,-0.1162,0.0281,0.1495,-0.126,0.1012,0.0063,-0.0392,0.0348,-0.0663,-0.0279,-0.0106,0.0791,0.0065,0.0096,0.0491,-0.0027,-0.0224,0.1517,0.049,0.0693,-0.0201,-0.0278,-0.0781,-0.0493,-0.0928,-0.0017,-0.0948,0.0011,-0.0427,-0.0213,-0.027,0.0138,-0.0255,0.0835,0.0341,-0.1892,0.0186,0.0437,0.0281,0.0681,-0.0629,-0.1219,-0.0218,-0.0134,0.0524,-0.0069,0.0022,0.0558,0.05,0.0892,0.034,0.0028,0.0631,0.0466,0.0524,-0.0237,-0.0437,-0.017,-0.035,0.0532,-0.0483,0.1151,0.0183,0.0761,0.0176,0.0267,-0.0044,0.0213,0.089,0.0848,-0.0286,0.0164,-0.0124,-0.016,0.0913,-0.0031,0.0451,-0.0978,0.0436,0.0363,0.0974,0.0824,-0.1015,0.0257,-0.0318,0.0003,0.006,0.0643,0.0511,0.0497,0.1197,0.1243,-0.006,-0.035,0.0141,0.0354,0.03,-0.0374,0.0189,0.0643,0.0018,0.0255,0.0353,0.0704,0.0276,0.0363,0.0191,0.0216,0.0374,-0.0538,0.0771,0.0136,0.0469,0.0467,0.0587,-0.0095,-0.0204,0.0612,0.0446,0.0233,-0.0166,0.1107,0.0944,0.1806,0.1741,-0.0708,-0.0133,0.1252,0.091,-0.0261,0.0491,0.094,0.0451,0.0416,-0.0244,0.0644,0.0507,0.0071,0.062,0.0121,-0.0105,-0.0131,-0.0729,-0.0497,-0.1234,0.1059,0.1615,-0.06,-0.06,0.0365,0.0629,0.013,0.0111,-0.0013,0.0476,-0.1043,-0.0313,-0.017,0.0716,0.0648,-0.0719,0.1466,0.1426,-0.0082,-0.0432,-0.0366,-0.0098,0.0047,0.0365,0.1042,0.0346,-0.0197,0.0578,0.0191,0.0285,0.0874,0.0693,-0.0081,-0.0553,-0.0398,-0.0094,-0.0679,0.0286,0.0678,0.0016,0.0564,-0.1397,-0.203,0.0089,-0.0934,0.0667,-0.0459,-0.0571,-0.1329,-0.0208,0.0284,-0.0632,-0.0191,0.0531,0.0129,0.0043,-0.0551,0.0548,-0.0688,0.1114,0.1072,0.1308,0.0449,-0.0321,-0.0377,-0.0463,0.0526,0.019,0.0484,-0.0925,-0.0979,0.0753,0.0929,0.0701,0.0279,0.0386,0.04,0.0682,0.0679,-0.0331,-0.0268,0.034,-0.0473,-0.0482,0.0858,0.0853,0.0608,0.094,0.0951,0.1145,0.0232,0.0388,0.0027,0.0241,-0.0061,0.1284,-0.0388,-0.0588,0.0539,-0.0824,-0.0667,-0.0192,0.0875,0.0183,-0.032,0.074,0.0667,0.0639,0.0549,0.0012,-0.0084,0.0554,0.0782,-0.0207,0.0646,0.0205,-0.0329,-0.0124,-0.0139,-0.064,0.002,-0.0821,0.0924,0.0867,-0.0201,0.0107,0.0286,-0.0794,0.0,0.1768,0.1293,0.1241,0.0863,0.063,-0.0789,0.0937,0.0316,0.0198,0.0701,0.0644,0.0512,0.0914,0.0675,-0.0258,0.0059,0.0716,0.0737,0.049,-0.0186,0.1021,-0.0133,-0.0191,0.1009,-0.016,-0.0189,0.0165,-0.053,0.0816,0.0545,0.0601,-0.0889,-0.2699,-0.13,-0.288,0.0581,0.1026,0.0453,0.0066,-0.0268,0.0754,-0.0191,-0.0156,0.0524,0.0834,0.0355,0.1102,0.0079,-0.0359,0.0223,0.0781,0.1117,0.1001,0.0867,0.022,-0.0353,0.0103,0.0464,-0.0145,-0.006,-0.1239,0.0017,0.0627,0.0258,0.028,0.0603,0.0263,-0.2706,0.0153,-0.0294,-0.2308,0.0614,0.082,0.0562,0.0093,0.1622,0.1067,0.2339,0.1996,0.0874,0.1281,0.0995,0.0819,0.1338,-0.0062,-0.0602,0.0001,0.0188,-0.0666,-0.0376,-0.0188,0.0023,0.1863,0.1016,-0.0261,-0.0317,0.0238,-0.0863,0.0084,0.0717,-0.012,-0.0475,0.0471,0.0867,0.0465,-0.0512,0.0905,0.0909,0.0456,0.0433,-0.0616,0.0678,0.0427,-0.03,-0.0125,0.0587,0.0361,-0.0687,0.027,0.0864,-0.0244,-0.2685,0.1111,0.0412,0.0304,-0.0116,0.0097,0.0003,-0.004,0.0516,0.0021,-0.0112,0.01,0.0188,-0.004,0.0159,0.035,-0.0578,-0.0452,-0.0843,0.0281,0.0322,0.0485,0.0365,-0.1045,0.009,0.1091,0.0919,-0.0285,-0.067,0.0389,0.0763,-0.0203,0.0781,0.0784,-0.036,0.0778,0.0871,0.0752,0.0172,-0.1065,-0.1055,0.0127,-0.0262,0.1355,0.0342,-0.0072,0.0346,-0.024,-0.013,0.0584,0.0597,-0.0025,0.0416,0.0802,0.0667,-0.0545,0.0055,-0.0651,-0.0438,-0.0582,-0.0683,-0.0515,-0.0317,0.032,-0.0119,0.0683,0.1135,0.0012,-0.0353,0.029,0.0605,0.0169,0.0648,-0.0154,-0.0746,0.0127,0.0069,0.0441,0.0579,-0.0099,-0.0772,-0.0344,0.0212,-0.082,0.0092,0.028,0.0362,-0.0048,0.0361,-0.1107,-0.0272,-0.0882,0.049,0.0063,-0.0071,0.0095,-0.0257,0.0011,-0.0873,-0.0835,-0.057,0.0204,0.0174,0.0716,-0.0499,0.1656,0.0038,0.0853,0.0558,-0.0554,-0.0006,-0.0463,-0.0728,-0.0261,0.0481,-0.0244,0.048,-0.0209,-0.017,0.1281,-0.0054,-0.0027,0.0584,0.0584,0.0376,-0.0256,-0.0271,0.1047,0.0573,0.1291,0.019,-0.1069,0.0494,-0.0439,-0.0584,-0.0235,-0.0395,-0.0153,0.046,-0.0395,0.1039,0.1009,-0.0122,0.0999,0.0297,-0.0505,0.0184,0.1473,-0.0047,0.0512,-0.0254,-0.003,0.1291,0.0809,0.1228,-0.0257,-0.0086,0.0503,0.0055,0.1223,0.0549,0.0701,-0.0062,-0.0082,0.0212,0.0043,0.0154,0.0843,0.0118,0.0048,0.0628,0.0183,0.0509,0.0604,-0.0071,-0.0125,0.0994,0.0759,0.0002,0.103,0.0624,0.0138,0.0716,0.0311,0.0584,0.0052,0.0085,0.0065,0.0854,0.0374,0.0694,0.0055,0.0582,0.0918,0.048,-0.0797,0.0704,0.0193,-0.0243,0.1013,0.0682,0.0767,0.0341,0.0403,0.0278,0.0066,0.0606,0.0206,0.0708,-0.0914,0.0343,-0.0195,0.0075,-0.0201,-0.0615,-0.0754,-0.0105,-0.0829,0.1103,0.0665,-0.0172,0.0161,0.042,-0.0275,-0.0442,-0.0102,-0.0528,-0.0325,-0.0142,-0.0284,0.0158,0.0599,0.0294,-0.0136,-0.0039,-0.0081,0.0435,0.0559,0.0561,0.0463,0.054,0.0641,-0.0297,-0.1074,-0.0,0.0807,-0.1271,-0.0188,-0.03,0.0189,-0.0374,0.0429,-0.0267,-0.0937,0.0283,0.1211,0.1311,0.0425,0.0121,0.0107,0.0621,-0.049,0.0239,-0.07,-0.0155,0.065,0.0235,-0.0117,-0.016,0.1362,-0.0589,-0.0667,-0.1275,0.044,0.0233,0.0814,-0.0236,-0.0312,0.0655,-0.066,-0.0871,0.0331,0.0255,0.0002,-0.059,0.0907,0.1408,0.109,0.0879,-0.0223,-0.1677,-0.006,0.0745,0.0163,0.0244,-0.0167,-0.0449,-0.0419,-0.0142,-0.0236,0.0583,0.0698,-0.0635,-0.0266,-0.0815,0.0517,0.0404,-0.0198,0.0478,-0.0392,0.0119,0.0635,0.0068,0.0635,0.0573,0.0591,-0.0697,-0.0835,-0.0358,0.0174,0.0099,0.0254,-0.0969,0.0234,0.0777,-0.1118,-0.0336,-0.0152,-0.0088,-0.0359,0.0143,-0.0499,0.1148,0.1144,0.0072,-0.135,-0.1101,-0.0476,-0.0489,-0.0313,0.0241,0.0393,-0.0599,0.02,-0.0242,-0.1005,-0.1607,-0.046,0.0298,-0.1083,-0.0942,0.0752,-0.0322,-0.0662,0.1127,0.0214,0.0771,0.0804,-0.0838,0.1419,0.0429,0.0917,0.0503,0.0628,-0.0454,-0.006,-0.0944,0.0087,0.0528,0.0226,-0.0232,-0.0555,-0.0689,-0.0649,-0.0298,-0.0293,0.015,-0.001,0.0003,-0.0489,-0.0952,0.0331,-0.0819,-0.065,0.0275,0.0207,0.0302,0.0424,-0.0413,0.0948,0.1117,0.0735,0.0342,-0.036,-0.0859,0.0111,-0.0249,-0.0432,0.0265,0.094,0.0696,0.043,0.0648,-0.0212,0.0994,0.0672,0.0479,-0.0561,0.0664,0.0327,0.0566,0.0849,0.0576,0.0213,-0.0578,0.0457,0.0577,0.0887,-0.0354,0.0078,0.1015,0.0244,0.0869,-0.0008,0.0599,-0.0426,-0.021,-0.0093,-0.0505,0.1098,0.0463,0.0301,-0.0642,0.0791,0.0065,-0.1079,-0.0144,-0.0398,-0.217,0.0139,-0.0061,0.0664,0.036,0.0418,0.0533,-0.0167,-0.0303,-0.0947,0.0047,-0.0638,0.1018,-0.033,-0.1467,0.0515,0.0411,0.0497,-0.0199,0.1306,0.0598,0.0508,0.0205,-0.0249,0.0385,0.0258,-0.1232,-0.0194,0.0986,0.0065,-0.0562,-0.0056,0.0045,0.0439,0.0754,0.0835,0.0662,0.0592,0.0498,-0.0623,-0.0422,0.0189,0.0762,-0.0118,0.0552,-0.0243,0.0472,0.0439,0.0311,0.0002,-0.0544,-0.0272,0.0243,-0.0238,0.0572,-0.0177,-0.0872,-0.1136,-0.2077,-0.1325,0.0316,0.0998,0.0458,-0.0426,-0.0953,-0.0782,-0.055,0.0092,-0.0828,-0.0645,-0.1018,-0.0108,0.014,0.0361,-0.0587,0.0338,-0.0456,0.1097,0.0234,0.021,-0.0413,-0.0464,0.0024,-0.0121,0.0175,-0.0629,-0.1334,-0.1429,0.081,0.023,0.0131,0.0157,0.0138,-0.0152,0.0158,0.0541,0.1315,0.0519,-0.1074,-0.098,0.0753,0.1015,0.0104,0.1052,0.0372,-0.1106,-0.0183,-0.0873,-0.084,-0.1176,0.0109,-0.0309,-0.0467,-0.0085,0.0029,-0.0046,-0.0166,0.0494,0.0602,0.0247,-0.0292,0.0615,-0.0405,0.0102,-0.0327,0.1165,0.0349,0.0128,0.0038,0.0472,-0.0401,0.0352,0.0838,0.0358,-0.0217,0.0144,0.0514,-0.0254,-0.0265,-0.0206,0.0788,0.0452,0.0355,0.0459,0.0227,0.0879,-0.0049,0.0951,0.0356,0.0306,-0.1433,0.0173,-0.0051,0.0798,-0.1575,-0.1262,-0.0119,-0.0309,-0.0086,-0.0579,-0.007,-0.0149,0.0774,0.0599,0.0005,0.0368,0.0486,-0.0148,0.0084,-0.1177,-0.0967,0.0096,0.0084,0.0266,-0.0547,0.0498,-0.0158,-0.0325,-0.0382,0.0718,0.0341,0.016,-0.0352,0.037,-0.001,-0.3473,-0.2516,-0.0704,0.0094,0.003,0.0444,-0.0641,-0.1208,0.1038,-0.4122,-0.4266,-0.2893,-0.1982,-0.3648,-0.1241,-0.1185,-0.0747,-0.044,-0.0874,-0.0252,-0.0596,-0.0052,0.0798,-0.0413,-0.0586,-0.0539,-0.0703,0.0218,0.0267,-0.2203,-0.1082,0.033,0.0296,0.08,-0.0688,0.0313,-0.0737,0.037,0.0396,-0.0157,-0.0826,-0.092,-0.0866,-0.1564,0.1102,0.061,0.0778,0.0097,0.0536,-0.418,0.0835,-0.0576,-0.0179,0.0294,-0.0514,0.0504,0.0731,0.0294,0.061,-0.0718,-0.0291,0.029,0.0106,0.0173,0.078,0.0633,-0.041,0.0284,0.043,0.0341,0.0755,0.0564,0.0578,-0.0037,-0.0005,-0.0427,0.1116,0.0735,-0.2382,-0.0632,-0.0038,0.041,-0.1045,-0.0097,-0.0036,0.1138,0.1098,-0.0141,0.0997,0.1081,0.0827,-0.0,-0.0017,0.0215,0.0082,-0.0142,-0.0214,-0.0039,0.0096,0.0398,0.0348,-0.0585,0.0422,-0.0261,0.0351,0.0019,-0.0646,0.0175,0.0622,-0.0302,-0.0183,0.0593,0.0461,-0.0261,0.1076,0.0715,0.111,0.0104,0.0081,0.0342,0.0679,-0.0128,0.0643,-0.0334,0.0716,0.0049,0.035,0.0713,0.0725,-0.0495,0.0331,-0.5412,-0.4205,-0.3463,-0.4724,0.064,0.0632,0.0729,0.0785,0.1089,-0.0103,0.096,-0.1251,0.0111,0.0653,-0.0502,0.0086,-0.0209,-0.1034,-0.0292,0.0123,-0.0093,-0.0318,0.0611,0.0316,0.0475,-0.0892,0.0071,0.0014,0.0869,0.0869,0.1164,-0.0044,0.0262,0.0133,0.0398,-0.0561,0.0239,-0.1081,0.1725,0.1582,-0.0746,0.0133,0.1308,0.1288,0.1659,0.0493,0.0438,0.0159,0.0099,0.0028,-0.0016,-0.0965,-0.1425,0.0369,-0.0995,0.0204,0.012,-0.0717,0.035,-0.0105,0.0369,0.0111,-0.0278,0.0225,0.031,-0.011,-0.049,0.0567,0.0666,0.015,0.0565,0.0028,-0.0035,0.009,0.0157,0.0809,0.0072,0.0773,0.1964,0.0302,0.0498,0.1257,0.0692,0.0699,0.1053,0.002,0.0928,-0.0251,0.1363,0.0286,0.0672,0.143,-0.0005,0.0254,0.0179,-0.1656,-0.0732,0.0202,-0.0266,0.036,0.0283,-0.0111,0.1061,0.1031,0.0082,0.04,0.0528,0.0438,-0.0216,-0.0284,-0.0156,-0.0377,0.0494,0.0491,0.064,-0.0208,0.0591,0.0612,0.0138,-0.0621,0.0023,0.0448,-0.0667,0.0136,0.041,-0.0289,0.1026,0.1122,-0.0051,-0.0076,0.0038,0.0088,0.0017,0.0729,0.0584,0.0085,0.0705,-0.0154,0.0112,0.0658,0.1274,0.0973,-0.0426,-0.0645,-0.0746,-0.0492,-0.0243,-0.002,-0.2492,-0.002,-0.0235,0.006,0.0858,-0.0732,0.0243,-0.1128,0.0116,-0.2323,-0.0343,0.0709,0.0506,-0.0679,0.0814,-0.0089,0.0416,0.0088,0.0336,0.01,-0.0293,-0.0094,0.0565,0.0525,0.0373,-0.0324,-0.0606,0.021,-0.0233,0.1042,-0.0255,-0.0104,0.089,-0.0338,0.0559,0.0804,0.0373,0.0584,0.0609,0.0606,0.0024,0.0345,-0.0345,0.0174,-0.0427,0.003,0.0209,0.0314,0.0305,0.0279,0.0035,0.1148,-0.0182,0.113,0.0883,-0.0205,-0.0848,-0.0863,0.0184,-0.0006,0.04,0.0066,0.0288,0.0251,0.0981,0.0271,0.126,0.0129,-0.0079,0.0495,0.0538,0.0501,0.0337,-0.0713,-0.0417,0.0368,-0.3035,0.042,-0.0646,0.0015,-0.2523,0.0114,0.0529,-0.0922,-0.159,0.0831,0.014,0.101,0.1305,0.0718,0.0296,-0.0502,0.0628,0.0832,-0.0484,-0.1325,0.0008,0.0254,0.0198,0.0055,0.009,-0.0244,0.1871,0.1005,0.0422,0.1865,0.162,-0.1165,-0.0267,-0.0378,-0.0276,-0.0314,-0.0336,0.1097,0.0716,0.0801,0.0704,0.1679,0.0376,0.072,0.0435,0.0791,-0.1006,0.0006,-0.0024,-0.0354,0.0056,-0.0788,-0.0498,0.0594,-0.0801,0.0571,0.0616,0.0756,0.0341,-0.0061,-0.0033,-0.0096,-0.0877,0.0067,0.0118,0.0424,0.0554,0.064,-0.1163,-0.1067,0.0923,0.0956,0.0252,0.0182,0.086,0.025,0.1018,-0.0362,-0.0037,-0.0304,0.0046,-0.0113,-0.0654,0.0706,-0.0085,-0.0723,0.0577,-0.0097,-0.0997,0.1191,0.0488,-0.2038,-0.0345,-0.0006,-0.0927,-0.1153,0.0355,-0.1376,-0.0907,0.0575,0.058,-0.064,-0.0051,-0.1102,-0.0743,-0.0102,0.007,0.0223,-0.0813,0.0488,-0.0345,-0.1506,-0.0044,-0.0167,-0.0306,-0.016,0.1364,0.0347,-0.0905,0.044,-0.0519,0.0566,-0.0611,-0.1181,0.0225,-0.0054,-0.0156,-0.1142,-0.0111,-0.0966,-0.0208,-0.1109,-0.0654,-0.1634,0.0278,-0.0709,-0.4048,0.0609,0.0501,0.0377,-0.0081,0.0254,-0.0533,-0.0717,0.0583,0.034,0.001,0.0371,-0.0027,-0.0072,0.0134,0.0615,0.0265,-0.0216,-0.0748,-0.1225,-0.1924,-0.2167,0.0665,0.1118,0.0667,0.0102,-0.1194,-0.1096,-0.0606,-0.0676,-0.1064,0.0044,-0.0794,0.1045,0.1302,0.0877,-0.0157,-0.0544,0.0292,-0.0117,-0.0332,-0.1287,-0.0573,-0.0313,0.0039,0.0362,-0.0008,-0.0343,-0.0424,0.1002,0.0934,0.1358,-0.0772,0.0212,0.0079,-0.0465,-0.0147,-0.049,-0.1001,-0.0085,-0.0069,-0.0754,0.0144,0.0269,-0.0251,0.0082,-0.0352,-0.0523,-0.1115,0.0552,-0.0395,-0.0911,0.0151,0.0753,-0.0082,0.1122,0.0651,0.0066,0.0504,0.0085,-0.069,0.0722,0.1,0.0365,0.0787,0.0664,0.099,0.1117,0.0636,0.0049,-0.006,0.0808,0.0514,-0.0351,0.0241,-0.0031,0.121,0.0887,0.0925,-0.0204,0.0151,0.0999,0.0285,-0.0311,0.0884,0.0145,-0.089,-0.0066,-0.0949,-0.0373,0.0084,0.0279,-0.0037,-0.0076,0.0015,0.0717,0.1685,0.0096,0.0876,0.054,0.0077,-0.0448,-0.0797,-0.2532,-0.2071,-0.0788,-0.0767,0.081,0.1844,0.1058,0.1281,0.0964,0.0065,0.0256,0.0285,0.0138,0.0994,0.1218,0.031,-0.0605,-0.025,0.0398,0.0616,0.0229,0.0461,0.1145,0.0947,0.0153,-0.0466,-0.0055,0.0158,0.0705,0.0587,0.0504,0.062,0.1388,0.0257,-0.0932,0.0529,0.0741,0.0584,0.0734,0.0337,0.0966,0.1053,-0.0404,-0.0968,-0.1262,-0.0238,-0.0729,-0.0928,0.0337,-0.0164,-0.0207,-0.0405,0.0651,0.0349,0.0365,-0.0675,0.0397,0.0719,0.0289,0.0744,0.0411,0.0611,0.0369,0.0563,0.0147,0.0621,-0.0101,-0.0095,0.1402,-0.0625,0.0465,0.0635,0.0281,0.0546,-0.0176,0.0625,0.0782,-0.0266,-0.1736,0.0151,-0.0328,0.1154,0.0316,0.0348,0.0875,0.082,0.0606,-0.0203,-0.028,-0.0193,0.0365,0.0465,-0.0274,-0.059,-0.1326,-0.0671,0.1339,0.1315,0.1009,-0.0236,-0.0245,0.0775,-0.0111,0.019,-0.024,0.0081,0.0483,0.0245,0.0263,0.0413,0.0697,-0.0014,0.0647,0.0522,0.0588,0.06,-0.0001,-0.0407,0.0618,0.0753,0.0588,0.0917,0.0574,0.1293,0.0605,-0.1963,0.0526,0.0621,0.0883,0.059,0.1107,0.0487,0.0392,0.0803,-0.0311,0.0648,0.0189,-0.0106,0.0947,0.0892,0.1095,0.0246,-0.0606,0.099,0.0234,-0.0419,-0.1033,-0.0309,-0.0604,-0.0351,0.0133,-0.0162,0.0434,-0.0678,-0.052,-0.0731,0.0989,0.1484,0.1572,0.0911,0.0545,-0.0811,-0.1786,-0.1694,-0.0616,-0.0723,-0.0694,-0.1475,-0.0481,-0.0753,0.0093,-0.0357,-0.0376,0.1183,0.0612,0.0885,0.015,-0.0475,0.066,0.0518,0.0363,-0.0304,0.0072,0.1625,0.0633,0.052,0.0702,0.1165,0.0188,0.0953,0.0369,-0.0393,0.0736,0.0226,0.1251,0.0598,0.0035,0.0789,0.0392,-0.0174,0.0722,-0.0141,-0.0371,-0.0117,0.0265,0.0632,-0.069,-0.0301,-0.011,-0.0966,0.006,0.0189,-0.0682,-0.029,0.021,0.1351,0.0607,0.0292,0.0281,-0.0189,-0.0045,0.0543,0.056,0.0317,0.0267,-0.0558,0.0813,0.0245,-0.0032,-0.0414,-0.0297,-0.0693,-0.074,0.147,0.0429,0.0925,0.0784,-0.0136,-0.0599,-0.0571,0.0194,-0.4112,-0.3039,0.1312,0.0676,-0.4595,-0.0635,-0.0511,-0.0908,-0.1607,-0.0795,0.0844,0.0817,0.0628,0.0865,-0.4217,-0.2895,-0.2597,-0.0524,-0.1267,-0.2504,-0.4337,-0.4326,-0.3974,-0.0566,-0.0032,0.0627,0.0079,0.0603,0.0223,0.0605,0.0358,0.0324,-0.0412,0.0445,0.0428,-0.0818,0.0308,0.0453,0.0987,-0.0559,-0.0359,-0.0518,0.0542,0.0264,0.1204,0.0241,-0.0124,-0.0013,0.0651,0.0588,0.0527,-0.0012,0.0599,0.1082,0.1062,0.0712,0.0909,-0.0052,-0.134,-0.0245,-0.0485,-0.0235,-0.0475,-0.2607,0.021,0.1234,0.1238,0.049,-0.079,-0.0386,-0.1083,-0.0664,-0.0981,0.0071,0.1263,0.1231,0.0896,0.0835,0.0545,0.1716,0.1462,-0.0338,-0.0251,-0.155,0.0869,-0.0131,-0.0475,0.0511,-0.1342,-0.1216,-0.0549,0.0725,0.0778,0.0267,-0.0195,0.1015,0.0597,0.0809,-0.0675,-0.0268,-0.0119,0.0134,-0.0722,0.0228,0.0318,-0.0438,-0.0072,-0.0904,-0.0393,-0.0343,-0.04,0.0049,-0.0036,-0.0377,0.0665,0.0619,0.0465,0.0264,0.0264,-0.015,0.0082,0.0158,0.0346,-0.059,-0.0148,-0.0749,-0.0672,-0.0061,-0.1603,-0.1205,0.0352,0.1015,0.0518,0.0786,0.1069,-0.0629,0.0036,0.0024,0.0591,-0.1173,-0.007,0.1151,0.0705,0.0048,-0.0356,-0.0338,-0.0508,-0.0808,-0.1291,-0.1943,-0.3112,-0.0512,0.0061,0.0514,0.0472,0.0245,0.1069,0.0619,0.0883,-0.0116,0.0655,0.0279,0.0242,0.0538,-0.0069,0.0513,0.0929,0.0711,0.0484,0.0541,0.0667,0.0413,0.0591,0.0296,0.0087,0.0204,0.0465,0.0901,-0.1152,-0.1271,-0.0531,0.062,-0.1845,-0.1782,0.1427,-0.1864,0.1099,0.0685,0.0153,0.0868,0.092,0.0555,-0.0183,-0.0417,0.0043,0.0878,0.0488,-0.0533,-0.011,-0.0523,0.0765,-0.0174,0.0004,-0.0077,-0.0364,0.0818,0.059,0.0446,0.0237,0.0632,0.0401,0.0341,0.0017,-0.014,-0.0086,0.0504,0.1453,0.082,0.0962,0.1016,0.1054,0.0854,0.0715,0.0715,-0.0084,0.0523,0.0077,0.0901,-0.0321,0.0932,0.0856,-0.0218,-0.0444,0.1299,-0.1156,0.1402,-0.0517,-0.0503,-0.0015,-0.045,-0.0361,0.083,0.0793,-0.039,-0.0508,0.0325,0.0095,-0.0,0.0652,-0.0344,0.0115,-0.0393,0.0036,0.095,0.0673,0.0148,0.0773,0.0311,0.054,0.0441,0.0484,0.037,0.0319,0.017,0.0086,0.0405,-0.0116,-0.0903,0.0224,-0.1526,-0.0494,0.1171,0.0504,0.1374,0.0187,0.0448,0.016,0.002,0.0592,0.0645,0.0652,-0.001,0.0096,0.009,-0.1109,-0.0729,-0.2745,-0.1039,-0.012,-0.0483,0.1017,-0.0129,-0.0799,-0.0867,0.028,-0.0224,-0.0451,-0.0088,-0.0304,0.1461,0.1091,0.1185,0.1064,0.0655,0.0611,0.1536,-0.1623,0.0363,-0.0934,-0.1831,0.0224,-0.0465,-0.0095,0.0619,0.1079,0.0563,-0.0465,-0.0376,0.0601,0.0086,0.1024,-0.0196,-0.0583,-0.0755,-0.0564,-0.0102,-0.0536,0.0774,-0.0228,0.0666,-0.0131,0.0292,0.0362,0.0335,0.0007,0.0535,0.0649,0.0341,-0.0161,0.0484,-0.0735,0.037,-0.1016,0.019,-0.018,-0.0102,0.02,0.0757,0.0726,0.0415,0.034,0.0209,-0.0735,-0.0096,0.0293,-0.0198,-0.0886,-0.0135,0.0528,0.0407,0.1054,0.0742,-0.0173,-0.0111,-0.0412,0.0436,0.0211,0.0641,0.0142,0.0646,0.0144,-0.0002,0.1172,-0.0928,0.0154,0.0441,0.0628,-0.0295,0.0778,-0.036,-0.0419,-0.0213,0.1332,-0.0599,-0.0165,0.0543,-0.0584,-0.0684,-0.0029,-0.0625,0.0792,0.036,0.0912,0.1131,0.0958,0.0579,0.085,0.0208,0.0402,-0.0464,-0.0463,-0.0569,0.1062,0.062,-0.0721,-0.1575,-0.2442,-0.0761,0.0438,0.0034,0.0216,0.0608,-0.0034,0.053,0.0481,0.0956,0.0021,0.0453,0.1065,-0.2929,-0.0599,-0.0617,-0.2067,-0.0705,-0.0945,0.0224,0.0361,0.062,0.014,0.0631,-0.0045,0.0243,0.002,0.0139,0.0216,0.0042,0.0494,-0.0632,0.0537,0.0783,-0.0055,0.0177,-0.0005,0.0083,-0.017,0.0251,0.0135,0.0449,-0.0861,0.126,0.0621,0.0751,0.1108,-0.0016,0.0747,0.0621,0.1377,0.0942,0.0919,-0.0145,0.1133,-0.0072,0.0663,-0.0177,-0.0584,-0.0203,0.052,0.0963,0.0227,-0.0117,-0.0706,-0.0941,0.0679,-0.0146,0.0351,-0.0449,-0.0351,0.0027,-0.0651,0.0003,0.0687,-0.0031,-0.0063,-0.0077,-0.1103,-0.0642,0.0322,0.0411,-0.0171,-0.2099,0.0284,-0.2178,-0.1618,0.0801,-0.015,-0.0386,0.0827,0.0628,0.0206,-0.0692,-0.1989,-0.0692,-0.0641,-0.0451,0.0393,-0.0659,-0.1282,-0.063,-0.0555,0.0768,0.0112,0.0802,-0.1138,0.0002,0.0147,0.0606,0.019,-0.0436,-0.0083,-0.0603,0.0336,-0.0539,0.0179,0.1052,-0.0589,-0.0878,-0.0075,-0.0383,-0.0768,-0.1269,-0.0183,-0.0734,-0.0177,0.0559,0.0099,-0.0597,-0.092,-0.0552,0.0272,-0.1142,0.014,0.0925,0.2015,0.1948,-0.0465,-0.024,0.0325,-0.0058,-0.009,-0.0761,0.0175,-0.0201,0.0368,-0.1097,0.0158,-0.008,0.0458,-0.0012,-0.008,0.0871,-0.0153,0.0995,0.0857,0.0457,-0.0118,-0.0182,0.1466,0.0529,-0.0226,0.0516,-0.0077,-0.0877,0.0539,0.1237,0.0691,-0.1206,0.0503,-0.0214,0.0088,-0.0118,0.0008,-0.0748,0.1321,-0.0072,0.0105,0.0363,0.0172,0.0309,-0.0296,0.0144,0.085,0.1194,0.1054,0.047,-0.0131,-0.0619,-0.0625,0.0135,0.0784,0.0951,0.1409,-0.1729,-0.2171,0.1069,0.0447,0.0713,0.0648,0.0988,-0.2457,-0.038,0.045,0.0272,-0.0539,-0.0716,0.1428,0.1392,0.1103,0.1343,0.057,0.0663,-0.073,-0.0219,-0.0233,-0.0405,0.0701,-0.0052,-0.3235,-0.0587,-0.124,-0.3352,0.1601,0.0793,0.0532,-0.1241,-0.0086,-0.0162,-0.0062,-0.0357,-0.0606,0.1535,0.0967,0.0198,-0.2026,0.045,0.0864,0.0912,0.0537,-0.0288,-0.1403,0.0669,0.0485,0.0655,0.0606,-0.0067,-0.0834,-0.0028,-0.0263,-0.0428,0.0812,0.035,0.0029,0.0085,-0.0144,0.0625,-0.0217,0.0207,-0.0065,-0.006,0.026,-0.0693,-0.031,-0.0141,-0.0168,0.0482,0.0203,0.1155,0.1122,0.0548,0.0801,-0.2581,0.019,-0.1998,-0.0707,-0.02,-0.0196,-0.0294,-0.0199,0.0997,-0.0436,-0.0764,-0.0305,-0.0403,-0.0147,-0.0105,0.049,0.0565,0.1242,0.0353,-0.1032,-0.1336,0.1,0.0239,-0.0153,0.0384,0.0039,0.0061,-0.0019,0.0594,-0.0085,0.1467,-0.0287,0.0459,-0.1435,-0.0586,0.0006,-0.0261,0.0145,0.0075,0.0844,0.0509,-0.0118,-0.0705,0.0219,0.0113,0.0658,-0.049,0.0142,0.09,0.0084,-0.0941,-0.0425,0.0181,0.1183,0.0401,0.0744,0.1041,-0.0065,0.0505,0.0383,0.0214,0.0493,0.0766,0.0193,0.0233,0.0555,0.0411,0.0277,-0.0101,0.0315,0.0085,0.1543,0.1447,0.1407,0.0642,0.0435,0.1079,0.0795,-0.0473,-0.0357,0.0062,0.0869,-0.1179,-0.1065,-0.0811,0.0575,-0.0472,0.0198,0.0464,-0.0353,0.0247,-0.0834,-0.1312,-0.2033,-0.0006,-0.0607,-0.0584,-0.0252,0.1121,-0.0091,-0.0173,-0.0033,0.0927,0.0885,0.0692,0.1013,-0.0172,0.1567,0.0988,-0.0162,-0.0255,0.129,-0.0226,-0.0324,-0.0398,0.0268,0.0547,0.2117,0.169,0.0898,0.1498,-0.1248,0.0326,0.0003,-0.0194,0.0583,0.1069,0.1741,0.0981,-0.1993,-0.111,-0.1416,-0.0448,-0.0545,0.0853,0.0582,-0.0621,-0.0457,-0.0466,0.0189,0.0336,-0.1934,-0.0697,0.0636,0.1514,0.0598,0.078,0.1178,-0.0052,0.0939,-0.0812,-0.0355,-0.0522,-0.0109,-0.0126,0.1259,0.0146,0.1075,0.0196,0.1115,0.0992,0.0192,-0.0556,0.0346,0.011,0.0333,0.1241,0.0707,0.0973,0.056,0.0373,0.0671,-0.0569,-0.1158,-0.009,0.062,-0.0407,0.0004,0.0115,0.0595,0.0224,0.076,0.0149,-0.0949,0.0068,0.0226,-0.0456,0.0081,-0.023,-0.0362,0.0224,-0.0398,0.0031,-0.048,0.0401,-0.0214,-0.0395,-0.0954,-0.0971,-0.0969,-0.0208,-0.0624,0.0081,0.0069,0.0753,-0.0578,0.0607,-0.067,0.0307,0.0889,0.0833,-0.0949,-0.0014,0.0566,0.0005,-0.0572,0.0776,0.0636,-0.0234,-0.0806,0.0469,0.0483,-0.0371,-0.0438,-0.0152,0.1063,0.0447,0.1124,0.0413,0.0903,0.0822,-0.0334,-0.0216,0.0047,0.016,0.0758,0.0698,0.0513,-0.0609,0.0886,0.0904,-0.0712,-0.0032,0.0136,-0.0518,-0.1085,-0.0246,-0.0382,-0.0943,0.0795,0.0384,-0.1684,-0.0228,0.0505,-0.1377,0.027,-0.0149,-0.0317,-0.1201,-0.051,0.0669,0.1277,0.1126,-0.0878,-0.2108,0.0152,-0.0883,-0.0003,0.005,0.014,-0.0138,-0.0491,-0.1325,0.0233,0.0672,-0.0392,0.092,0.095,0.0026,0.0304,0.0242,0.0152,0.0487,0.0339,0.1174,0.0785,-0.1055,-0.1993,0.0244,0.0231,-0.0447,-0.0508,0.0145,0.0299,0.1024,0.1461,-0.0989,-0.0677,0.0518,0.0635,0.0589,0.0327,0.0713,0.0287,0.0598,0.0731,0.0156,0.0834,0.0091,0.001,0.0618,0.0788,0.0051,0.0521,-0.0198,0.0667,0.0346,-0.0744,0.0355,0.0837,0.1068,0.0588,0.0877,0.0326,0.0864,0.1173,-0.025,-0.0327,-0.0861,0.0302,0.0774,0.013,0.0236,0.0495,0.0085,0.1173,0.0672,0.1039,-0.0688,-0.012,-0.0849,0.0576,0.126,0.0909,0.1015,0.1014,0.0002,0.0274,-0.0795,0.0154,0.0558,0.0575,0.0468,0.0729,0.1656,0.0477,0.0605,0.0073,-0.0054,-0.0232,0.0358,-0.0708,0.0116,-0.0425,0.0218,-0.0713,-0.1177,-0.0689,-0.032,-0.03,0.0751,0.0324,0.0614,0.0199,0.0317,0.0108,-0.0157,0.024,0.0914,0.0639,0.0328,-0.0002,0.0354,0.0283,0.0271,-0.2121,0.0421,-0.1149,-0.0911,-0.0658,-0.0449,-0.0801,-0.0168,0.0491,0.0921,0.0146,-0.0515,-0.0102,0.0309,0.0355,0.0687,0.0749,0.0489,0.0144,0.0369,-0.0284,-0.0446,0.1141,0.101,0.0354,0.0791,0.057,0.0606,-0.2194,-0.1385,0.0455,-0.0098,0.0588,0.0263,0.0775,0.0683,0.1263,0.1247,-0.0283,-0.009,0.0448,0.0108,0.0765,0.014,-0.1271,0.0422,-0.0032,0.0073,-0.0046,-0.0223,0.0702,0.0019,-0.1337,0.0839,-0.0583,0.083,-0.0177,0.1095,-0.4283,0.0012,-0.0195,0.0935,0.0889,-0.0167,-0.0284,0.0098,-0.0347,-0.0194,0.0056,0.0295,-0.076,-0.0297,-0.0229,-0.0418,-0.1063,-0.1626,-0.187,-0.2716,0.0335,-0.0668,-0.1874,-0.4188,-0.1385,-0.1622,-0.284,-0.1654,-0.1239,-0.1864,-0.0887,-0.1135,-0.2106,-0.1562,-0.2234,-0.0379,-0.2771,-0.3298,-0.1798,-0.2113,-0.125,0.0131,-0.0794,0.109,0.0759,0.0904,0.1058,0.0156,0.1289,0.1362,0.0389,0.1088,0.0963,0.1308,0.1233,0.0886,0.0051,-0.0337,0.0569,-0.1112,0.0013,0.0853,-0.0266,0.0676,0.0808,0.0833,0.0043,0.0876,-0.0928,0.1338,0.1526,-0.0692,0.0446,0.0722,-0.0107,-0.0116,0.0671,0.008,-0.0259,0.0725,-0.2024,-0.334,-0.0213,-0.1456,-0.1795,0.0646,-0.0349,-0.035,0.0149,0.036,-0.1777,-0.0368,-0.0725,0.0523,-0.0125,-0.1397,-0.0154,0.0308,0.0125,-0.0184,0.0188,0.0578,left hand response execution
trm_55b6b9d7c9435,-0.0462,-0.0973,-0.0737,-0.0235,0.0426,-0.0219,-0.0542,-0.01,0.0135,-0.0287,0.0415,0.033,-0.0868,-0.0367,-0.0673,-0.0543,-0.103,-0.0327,-0.0247,-0.0126,-0.0323,0.04,-0.0635,0.0453,-0.03,0.0179,0.0137,-0.0867,-0.1228,-0.0592,-0.0833,-0.0484,-0.121,-0.0578,-0.121,-0.129,-0.0605,-0.046,-0.0763,-0.0229,-0.1065,-0.1127,-0.0727,0.0505,-0.0478,-0.0751,0.1053,-0.0332,0.072,-0.088,-0.051,0.0186,0.0467,0.1275,-0.0217,-0.0558,-0.148,-0.0048,0.035,-0.0362,-0.0141,0.0503,-0.1116,0.0933,0.0722,0.0087,-0.129,-0.1481,-0.0656,-0.0285,0.1009,0.0199,0.1638,-0.0739,-0.0119,0.0128,-0.1393,0.0754,0.0903,-0.1333,-0.0076,0.1242,-0.0435,-0.0915,0.0924,0.0244,0.007,-0.0312,0.0158,-0.4371,-0.1309,-0.0865,-0.0315,0.1677,0.1061,0.108,0.0981,0.022,0.1799,0.0503,0.0408,0.0199,0.0925,0.0073,0.0826,-0.13,-0.1405,0.1081,-0.0523,-0.0184,0.0536,-0.0407,0.1352,0.1325,0.0435,0.0199,-0.0194,-0.0141,0.0506,-0.035,-0.0535,-0.122,-0.0646,-0.0134,-0.0565,-0.1072,-0.0252,0.0668,0.0943,-0.0485,-0.0553,-0.0456,-0.0617,-0.2359,-0.0165,-0.1361,0.0113,-0.0891,-0.0522,-0.0486,-0.0577,-0.0739,0.0367,-0.0218,-0.0044,0.0567,-0.0428,0.0916,-0.0914,0.0735,-0.0266,-0.0737,-0.1257,-0.0825,0.1594,-0.0484,0.0958,0.0337,0.0344,-0.0511,-0.0335,-0.0849,-0.1183,-0.1758,-0.0344,-0.0098,-0.0125,-0.139,-0.1227,-0.007,-0.102,-0.079,0.029,-0.1568,-0.1022,-0.1728,-0.1257,-0.0414,-0.0406,-0.022,-0.193,0.0276,-0.0717,0.0612,-0.107,-0.0566,-0.1611,-0.0947,-0.0244,-0.0104,-0.0001,-0.0736,-0.0459,-0.0914,-0.075,-0.1375,-0.0654,-0.0485,-0.0041,-0.1246,-0.0335,0.2018,-0.0991,-0.1742,0.1601,-0.2276,-0.1954,-0.0019,-0.0167,0.0325,-0.1035,-0.0317,-0.0532,0.0052,0.0518,0.0171,0.063,-0.1025,-0.1535,0.0183,0.0914,-0.0899,-0.1474,-0.0673,0.0793,0.0187,-0.0387,0.0407,-0.0806,0.3033,-0.0979,-0.1482,0.1506,-0.1187,-0.1206,-0.0272,-0.0336,0.1279,-0.0028,-0.1187,0.0197,-0.1476,-0.0491,-0.0039,-0.0139,-0.0749,-0.0399,-0.1068,-0.1066,-0.0445,0.0285,0.0185,-0.0265,0.0807,-0.0406,-0.12,0.0048,-0.0374,0.1111,0.1887,0.0574,0.2737,-0.0367,0.1486,0.1974,0.3653,0.1885,0.0249,0.0023,-0.005,-0.0422,-0.0728,-0.1338,0.0103,-0.2357,-0.193,-0.3867,-0.4233,-0.3244,-0.1824,-0.1425,-0.0779,-0.0405,-0.1876,-0.1527,-0.1069,0.0153,0.0282,-0.1092,-0.1042,-0.0705,-0.0497,-0.0373,-0.0287,-0.0953,0.0305,0.01,0.1169,0.0288,0.1766,0.0445,-0.0414,-0.1364,-0.1328,-0.0175,-0.0014,-0.1078,-0.0714,-0.1137,0.0377,-0.0128,-0.0041,-0.0123,0.1492,0.0798,-0.0237,0.1831,0.0234,0.1023,-0.0777,0.0523,0.0614,-0.1026,-0.102,-0.0744,-0.014,-0.006,-0.089,-0.0278,-0.126,0.0253,-0.0586,0.059,0.0412,0.0908,0.0614,0.056,0.0469,-0.0427,-0.0329,-0.0194,0.0038,-0.0209,-0.0226,0.069,0.0475,-0.2132,-0.1421,-0.1457,-0.1244,-0.1298,0.0308,-0.1142,-0.0716,-0.0797,-0.0904,-0.0125,-0.1225,-0.1375,-0.0998,0.0504,-0.0058,-0.0269,0.0256,-0.0134,0.0754,-0.1454,0.3158,0.0066,-0.0917,0.0144,0.1615,-0.0347,0.1057,-0.0685,-0.0411,-0.0993,0.105,0.0703,0.0413,0.0789,0.0555,0.0244,0.1254,0.0571,0.072,-0.0557,-0.0249,0.0741,-0.0118,-0.0386,-0.0471,-0.0535,-0.0255,0.1427,0.0476,-0.0931,-0.1358,-0.1126,-0.054,-0.0248,0.0156,-0.0044,-0.0349,0.0202,0.1199,0.078,0.0259,-0.093,-0.0443,-0.0146,-0.1174,-0.0074,0.2032,-0.1258,-0.0424,0.2583,0.109,0.0264,0.0654,0.0321,-0.1693,-0.1182,-0.2104,-0.182,-0.0695,-0.1585,-0.0334,-0.0623,-0.0618,-0.0237,0.0006,-0.0136,-0.0229,-0.0153,0.1023,-0.0606,-0.0374,-0.2175,-0.0822,-0.0338,0.0706,-0.0312,0.0545,-0.0737,-0.0735,-0.0275,0.0666,-0.0124,0.159,0.2021,0.0846,-0.0927,-0.0382,0.0909,-0.0818,-0.0488,0.0148,0.0442,0.0445,0.1334,-0.0211,-0.0666,0.0164,-0.0936,-0.1329,0.0661,0.3817,-0.1352,-0.1267,0.0001,-0.0097,0.1308,-0.0603,-0.1489,-0.0224,0.012,-0.0138,-0.0508,0.0105,0.0011,0.0008,-0.0291,0.1007,0.1527,0.1387,-0.036,0.0003,-0.0311,-0.0255,-0.0438,0.0704,-0.1054,-0.1505,0.064,-0.0122,-0.2321,-0.0081,0.0196,-0.0083,-0.0019,0.046,-0.0783,-0.0861,-0.0641,-0.0926,0.0258,-0.008,-0.0259,0.1197,-0.1275,-0.0105,-0.0141,0.0195,0.0828,0.0979,-0.0574,-0.0405,0.0266,-0.0503,-0.0388,-0.1117,0.0889,0.2277,0.2239,0.0891,0.1139,0.0872,-0.0244,0.079,-0.0856,-0.0557,-0.0956,-0.1771,-0.0455,-0.0325,-0.1275,-0.0828,-0.0306,-0.1367,-0.0199,0.0346,-0.0237,-0.0846,-0.0461,-0.0555,0.0686,0.0394,-0.0258,-0.0377,0.064,0.003,0.0005,-0.0631,-0.0414,-0.1484,0.0896,0.0705,0.034,-0.0848,-0.0498,0.0219,-0.076,0.0177,-0.1154,-0.0784,0.0405,-0.0734,-0.0071,-0.045,-0.0441,0.0286,-0.1305,-0.0191,-0.056,-0.0452,0.002,0.0117,0.0411,0.0805,-0.0083,-0.0546,0.0073,-0.0149,0.1506,0.0934,0.1693,0.0604,0.0695,0.0076,-0.1184,0.095,0.1833,0.1347,-0.0245,-0.0086,-0.1363,0.0078,0.1359,-0.115,-0.0322,0.0458,0.1036,-0.0223,0.0516,0.0189,-0.0707,-0.1058,-0.0917,0.1866,-0.1259,-0.0658,0.102,-0.0229,-0.1757,-0.0177,-0.0343,0.0631,-0.0163,-0.1901,-0.0406,-0.1721,0.0066,0.0136,-0.1032,0.0295,-0.0003,-0.1035,-0.0388,0.0516,0.06,0.0751,-0.0541,0.0829,0.1939,0.0477,0.134,-0.0612,-0.0351,-0.0198,-0.0723,0.082,0.0058,-0.0612,-0.0591,-0.0549,-0.0944,-0.0683,0.1744,-0.1505,0.1682,-0.1514,0.1919,-0.1385,-0.006,-0.0855,0.0577,-0.0592,-0.0048,-0.0879,-0.1202,-0.0453,0.1456,-0.0348,0.0368,0.0843,-0.116,-0.1451,-0.0954,0.0532,-0.0543,-0.047,-0.0718,-0.1229,-0.0238,-0.0292,0.0796,-0.0763,-0.0108,-0.0222,0.0795,0.0448,0.0805,-0.0108,0.0116,-0.1123,-0.0772,0.0219,0.0332,-0.0216,0.1284,0.2436,0.1935,0.0715,0.0464,0.0084,0.0458,-0.0596,-0.0516,0.0869,0.0829,0.0432,-0.0315,-0.0763,-0.0512,-0.01,-0.1368,-0.1361,-0.1576,0.0744,0.1017,0.1416,0.1144,0.0089,0.145,0.0141,0.0294,-0.0976,-0.1109,0.0408,0.0454,-0.0634,-0.2279,-0.2319,-0.164,0.0118,0.0033,-0.0362,0.0749,-0.0515,-0.0013,-0.0294,-0.0691,0.1461,0.1447,-0.0421,-0.1558,0.1765,0.1792,0.3252,-0.1135,-0.0134,-0.0456,-0.0188,0.0388,-0.0958,0.124,-0.0014,-0.0177,0.0381,0.0056,0.0249,-0.0674,-0.1351,-0.1208,-0.0782,0.0147,0.1621,0.0149,-0.1839,-0.0474,-0.0061,0.0786,-0.0173,0.0439,-0.0006,-0.0584,-0.0485,-0.0565,0.1183,0.0406,0.0855,-0.1069,-0.0054,0.0464,-0.0766,0.0575,-0.077,-0.1181,-0.0189,-0.1075,-0.1122,-0.0535,0.1071,0.111,0.0256,-0.0154,-0.0241,0.0475,0.161,-0.0395,-0.0559,0.0578,-0.032,-0.0083,-0.0014,0.1147,-0.0673,0.1835,-0.1116,-0.1159,0.1667,0.1284,0.1413,-0.0218,-0.0339,0.0649,-0.022,0.0428,0.1692,0.006,0.0643,0.107,0.129,0.0173,0.0058,0.1015,0.1499,-0.1662,0.0098,0.0465,-0.1236,-0.1047,-0.0292,-0.0923,-0.0066,-0.1077,-0.006,-0.1096,-0.0719,-0.1348,-0.0138,0.0155,0.0369,-0.0514,-0.0145,0.0894,0.0414,0.0896,0.0612,0.0575,0.1483,-0.0105,0.0942,0.0462,0.0314,0.1409,0.1568,-0.1255,0.152,0.0911,-0.0865,-0.029,-0.0592,-0.0371,0.1717,0.2182,-0.2217,-0.0687,-0.0207,0.0522,0.1377,0.0554,0.0811,-0.0482,-0.0363,0.0359,-0.0242,0.1625,0.0394,0.0848,-0.1033,0.0571,-0.0382,0.1058,0.3478,0.1297,0.3309,-0.1244,-0.1178,-0.0249,0.1876,-0.0213,-0.024,-0.0999,0.0627,-0.0316,-0.0483,-0.0171,-0.1069,0.0335,-0.0792,-0.0595,0.0714,-0.0173,0.0388,-0.0698,-0.0563,-0.0221,0.0147,-0.0339,0.0416,0.0637,0.1006,0.1311,0.2425,0.1434,-0.0495,-0.0284,-0.0667,-0.0017,-0.1214,-0.0089,0.0588,0.1654,0.0875,-0.0271,-0.1064,0.1547,0.1882,0.0672,-0.0485,0.0014,-0.0251,-0.1958,-0.086,-0.0718,-0.0232,0.0418,-0.1199,-0.0789,0.0518,-0.0041,-0.0724,-0.0228,0.0231,-0.1123,-0.0379,-0.0367,-0.0724,-0.0695,-0.2136,-0.087,-0.2099,0.0061,-0.0395,-0.1185,-0.1233,-0.0655,-0.1624,-0.0905,-0.2197,-0.1333,-0.1414,-0.012,0.0659,0.1212,-0.0516,0.058,-0.0322,0.0151,0.0418,0.1404,0.1778,0.1023,-0.0621,-0.044,0.0509,-0.0261,0.058,0.0854,0.0741,-0.0255,0.0308,-0.0825,0.0805,-0.0983,-0.0392,-0.0524,0.0221,-0.1206,0.0428,-0.1233,-0.0163,-0.0043,-0.0218,-0.0052,0.0613,0.0772,0.0465,0.0795,0.1183,0.0813,0.1283,0.1119,-0.0258,-0.0077,0.0662,-0.0058,-0.0324,-0.0501,-0.1273,-0.0205,0.0977,0.0758,-0.1402,-0.071,-0.034,-0.1383,-0.0377,0.164,0.0425,0.1918,0.066,0.0762,-0.0662,-0.0342,0.0561,-0.0092,-0.0563,-0.0458,0.0357,-0.0655,-0.1729,-0.0222,0.1352,-0.0532,-0.0339,-0.0795,0.0705,-0.091,0.0714,0.0574,0.1865,0.2681,0.1843,0.1309,0.1346,0.0211,0.0478,-0.0159,-0.0369,-0.0216,0.0145,-0.0184,0.0079,-0.0028,0.0968,-0.0049,-0.0714,-0.0384,-0.1962,-0.1699,-0.1398,-0.0935,0.1404,0.0138,0.0239,-0.1433,0.1548,0.0795,-0.0064,-0.0316,0.0316,0.0304,-0.0171,0.0414,-0.0784,-0.0615,-0.0431,-0.0274,-0.0962,-0.0417,-0.1121,-0.0426,-0.0657,-0.0394,-0.1026,-0.0927,0.0017,-0.0564,-0.0756,-0.0118,0.0534,-0.1123,0.0845,-0.0461,0.0397,-0.0498,-0.1011,0.2872,0.1903,0.2598,0.2156,0.2129,0.034,0.2197,0.099,-0.0788,0.1613,0.147,0.1153,0.0954,0.1286,-0.0721,-0.0525,-0.0631,-0.0115,0.0039,0.0148,0.0117,0.0229,-0.107,-0.0128,0.0064,0.005,0.0377,0.0151,-0.0548,0.1122,0.063,-0.0294,0.0175,-0.0393,0.0809,-0.022,0.1387,0.0017,-0.1331,-0.0941,-0.0478,0.001,0.0918,0.0091,-0.0882,-0.1114,-0.2388,-0.1427,-0.0484,0.1624,-0.049,0.2285,0.1542,-0.0421,-0.0464,-0.0962,0.0546,0.1391,0.0584,0.1487,0.0535,0.0826,0.1281,0.0971,-0.0818,-0.1021,0.0454,-0.0534,0.0447,0.0044,-0.097,-0.0353,-0.0968,-0.0533,-0.0187,-0.0173,-0.1554,-0.0148,0.0639,-0.0183,-0.0143,0.0297,0.1335,-0.0442,0.0213,-0.0899,-0.0885,-0.0913,-0.0453,-0.1378,-0.2067,-0.0399,-0.0079,0.0401,0.2046,0.1516,0.0708,0.2519,-0.0342,-0.0005,0.0688,0.1468,-0.0128,0.2704,-0.0808,0.2857,0.3728,0.1064,-0.1515,0.3258,0.2541,0.0705,-0.1543,-0.0251,-0.0637,-0.036,-0.1678,-0.0175,0.0728,-0.1047,-0.0939,-0.0196,-0.0944,-0.0838,-0.0565,-0.1406,-0.0743,-0.0477,0.1049,0.078,-0.04,0.2209,0.1611,0.1699,0.1729,-0.0268,0.0205,-0.0231,-0.0221,0.0296,-0.0812,-0.0032,0.0998,-0.0948,-0.0057,0.0738,-0.0539,0.0754,0.0887,0.0527,-0.0138,0.0053,0.0787,0.0351,0.0083,-0.0144,0.0202,0.0684,0.0023,0.0184,0.0184,-0.1211,0.1249,0.057,0.0772,-0.039,0.1213,-0.0817,0.164,-0.2088,-0.1814,0.0868,-0.074,-0.1608,-0.1622,-0.1522,-0.0151,-0.0747,0.0108,0.0287,-0.0287,0.1483,-0.1483,-0.0838,-0.104,0.0374,-0.0276,0.0229,0.0136,-0.0777,-0.0256,0.0288,-0.0866,-0.0449,-0.0273,-0.28,-0.0406,0.0178,0.0488,0.0111,0.0872,0.0098,0.09,-0.1151,-0.0529,0.0844,-0.0234,-0.0773,-0.1329,-0.146,0.0015,-0.0022,-0.1144,-0.032,-0.0322,-0.1489,0.0096,-0.0868,0.0676,-0.3229,-0.2113,-0.0852,-0.1768,-0.045,0.0862,-0.0221,0.1837,0.0056,0.0342,0.0499,-0.1181,-0.0358,-0.082,-0.3863,-0.3816,0.0864,-0.0876,-0.1056,-0.0135,-0.0726,0.012,0.0824,0.0041,-0.1202,-0.0434,0.016,-0.0308,-0.1029,-0.004,-0.0637,0.0362,-0.0692,-0.1422,-0.0383,-0.1242,-0.0228,-0.0781,-0.1196,-0.1169,0.0215,0.0176,-0.09,0.0385,0.0167,-0.0405,-0.03,0.0292,-0.1515,0.0254,-0.0018,0.009,-0.1717,-0.1486,0.0246,0.0984,-0.0486,-0.0532,-0.0139,-0.0525,0.1456,0.0253,-0.0071,-0.0273,-0.1419,0.0228,-0.0329,0.0238,0.0657,0.1302,0.0054,-0.0879,0.007,0.1239,-0.0507,-0.0199,-0.029,0.0429,-0.0492,-0.0666,0.0176,0.1581,-0.0077,-0.0371,-0.0452,-0.0053,-0.0314,-0.0167,-0.0766,-0.1366,0.0046,0.0114,-0.0773,0.1029,-0.0773,-0.0194,-0.0775,0.0173,-0.0211,-0.0289,-0.0096,-0.0305,-0.0151,-0.0527,0.0717,-0.0261,0.0008,0.0096,0.0478,-0.0173,-0.046,-0.1857,0.0513,-0.0634,-0.0034,0.0368,0.0562,0.0939,0.087,0.0645,-0.1028,-0.0655,-0.0635,-0.0448,-0.1521,-0.0059,-0.1909,-0.0358,-0.0795,-0.0749,-0.0156,-0.1251,-0.0681,0.1179,0.0005,-0.01,0.1594,0.166,0.0902,0.0739,0.1058,-0.0102,-0.0567,0.0365,0.1539,0.0758,0.049,0.0439,-0.0563,0.0015,-0.0888,0.0357,0.0402,0.0032,-0.0489,-0.0088,-0.0809,-0.0427,-0.0621,0.0698,0.1148,0.1038,-0.2671,-0.1008,-0.0802,-0.2238,-0.1804,0.0402,0.0471,-0.0494,0.0441,-0.1642,0.0083,-0.1003,0.0628,-0.0478,-0.0458,-0.2426,-0.03,0.0205,-0.1023,-0.0977,0.0876,-0.0364,-0.0166,-0.078,0.0115,0.0692,0.3017,-0.0164,0.0498,0.0181,0.0481,-0.1168,-0.0409,-0.0159,-0.0004,-0.0513,0.1227,0.1344,0.0453,-0.0361,-0.0698,0.0561,0.4215,0.4198,-0.1947,-0.1177,0.0851,-0.0846,-0.1087,0.0052,-0.1754,0.0203,-0.0145,-0.0623,0.0198,0.0146,0.1821,0.0457,0.1489,0.016,0.0289,0.1317,0.3936,-0.0958,-0.0376,0.2169,-0.0431,0.073,0.0162,0.0233,-0.0567,0.1848,0.1658,0.023,-0.0816,0.055,0.0285,0.137,0.086,0.0265,-0.0467,-0.0424,0.0612,-0.0584,0.0259,0.1556,-0.0415,-0.0309,0.0204,-0.0365,-0.1135,-0.0333,0.0462,-0.0618,-0.0954,-0.2092,-0.0372,0.033,-0.0074,-0.0153,0.0086,-0.0137,-0.0031,0.1332,0.0586,0.0902,0.0568,0.2426,0.1463,0.0466,0.3011,-0.0333,-0.0583,0.2426,-0.2088,-0.0024,-0.0456,0.0373,-0.0518,0.0199,0.0295,-0.0349,-0.0044,0.0923,0.0422,0.0201,-0.015,0.0685,0.0405,0.0757,0.233,0.2329,-0.1067,-0.1386,-0.0612,0.0026,-0.0368,-0.0239,-0.0188,0.0014,0.0179,0.0473,0.1088,-0.0838,-0.2386,-0.0318,-0.0279,0.1063,-0.0107,-0.0315,0.0807,0.1264,0.106,-0.1254,0.0225,0.0151,0.0224,0.0245,0.081,-0.3518,-0.3216,-0.43,0.0323,0.0133,0.0846,0.3416,-0.0648,-0.0038,0.0048,0.1843,0.1369,0.2001,-0.0643,-0.0742,-0.1133,-0.0158,0.1034,0.1114,0.1941,-0.0071,0.0965,0.1015,0.0625,-0.0444,0.1084,-0.2249,0.0244,-0.0257,-0.1312,-0.015,-0.0393,-0.0118,-0.059,-0.0368,0.0078,0.0035,-0.0094,-0.1596,0.0061,-0.0002,0.0164,-0.0346,0.1084,0.2098,0.1538,0.291,-0.1198,-0.0488,-0.0858,-0.0429,0.1431,0.0795,-0.1281,-0.1319,-0.1357,-0.0488,0.1277,0.0423,0.1733,0.062,0.0095,-0.0124,-0.0744,0.0176,-0.0057,-0.0231,-0.2463,-0.0286,-0.0537,0.0019,-0.0812,0.0224,0.0848,0.2511,0.1785,0.1359,0.0927,-0.1279,-0.191,-0.1247,-0.1677,-0.1227,0.0389,-0.0409,0.0496,-0.0811,-0.1121,-0.1053,-0.0568,-0.0989,-0.0632,-0.0416,-0.0369,-0.0153,-0.0457,-0.133,-0.1802,-0.0437,0.0981,0.0288,-0.0006,-0.1299,0.0719,-0.0584,-0.0817,-0.2328,0.0164,-0.0006,-0.1391,-0.087,0.0176,0.0221,0.0009,-0.0603,-0.189,-0.0956,0.2822,0.0845,0.2463,0.0993,0.1478,0.011,0.1668,0.1611,0.3081,-0.0514,0.0106,0.0122,0.1228,-0.1737,-0.2233,-0.1545,-0.041,-0.0388,-0.088,-0.0596,-0.0491,-0.1471,-0.0308,0.072,0.079,-0.1405,0.0306,0.0319,-0.0225,-0.12,-0.0444,-0.1126,-0.1545,0.1058,0.0212,0.0888,-0.1253,-0.1829,-0.2282,-0.0925,-0.1027,-0.0969,-0.2085,-0.1768,0.0085,0.0272,0.0226,-0.0394,-0.0099,0.0279,0.0086,0.0936,0.0253,-0.2185,-0.2383,-0.0482,0.0426,-0.0607,-0.0551,0.082,-0.0774,-0.0221,-0.0391,-0.0468,-0.0949,-0.0745,-0.0698,-0.0335,0.0557,-0.0665,-0.0124,-0.0151,0.1261,0.1084,0.0977,-0.0557,-0.0635,-0.1577,-0.1345,-0.1113,-0.1815,-0.0807,0.137,0.021,-0.0397,0.0148,0.0248,-0.1001,0.0295,-0.0244,0.0117,0.2232,-0.0083,0.0636,0.0461,-0.0773,0.0042,-0.0336,0.0734,0.1604,-0.09,0.0101,0.0443,0.2082,-0.1548,0.0095,0.0356,-0.1316,0.0505,0.085,-0.1231,-0.0633,-0.0692,-0.1646,-0.2777,-0.2846,-0.0771,0.0091,0.065,0.0784,0.0868,-0.1372,-0.1003,0.0518,0.1278,0.0271,0.0875,0.0647,0.0664,0.0408,-0.1779,-0.0932,-0.0995,-0.0927,-0.0388,-0.0929,-0.076,-0.0656,0.0375,-0.0604,-0.1988,-0.1656,0.0122,-0.1163,-0.2312,0.0913,-0.0562,-0.0223,0.0645,-0.0989,-0.0377,-0.1106,-0.0669,0.0349,-0.0731,0.0014,0.0565,-0.1173,0.0395,0.1361,0.071,-0.0665,-0.0775,0.1228,-0.0476,-0.1172,0.0038,-0.0454,-0.0709,0.1167,0.0283,0.0733,-0.1365,-0.1141,-0.0225,0.0417,-0.2346,-0.142,-0.1146,-0.0083,0.0247,-0.0377,0.0407,-0.1172,-0.0419,0.0891,-0.0198,-0.0287,0.0104,-0.0383,-0.1531,0.0403,-0.0045,-0.0883,0.254,0.3438,0.2962,-0.0428,0.2855,0.1408,-0.1052,-0.0728,0.2801,0.0984,0.0771,0.0841,0.0703,0.0305,-0.0158,-0.0116,-0.0339,-0.0773,0.334,0.2819,0.1794,0.0334,0.1408,0.1664,0.3171,0.3077,0.2548,0.0132,-0.0485,-0.017,-0.0736,-0.0502,-0.0994,-0.0811,-0.09,-0.0097,-0.0579,-0.0361,-0.03,0.114,0.0159,-0.0035,-0.1235,-0.004,0.1999,0.2672,-0.11,-0.0701,-0.1418,-0.0305,-0.0621,-0.0237,0.0198,-0.0743,0.0123,-0.0872,-0.095,-0.1069,-0.0931,0.0056,-0.133,-0.0145,0.1863,0.1136,0.1727,0.063,0.0927,0.2087,-0.0544,-0.0902,-0.072,-0.0795,0.0918,-0.1186,0.129,0.086,0.0828,-0.0342,-0.1459,-0.1459,-0.1236,-0.1057,0.0391,-0.2491,-0.1623,0.0132,-0.0429,0.1022,0.0184,-0.0465,0.087,0.0324,-0.0459,0.0103,-0.0771,-0.155,-0.1805,0.0203,0.0294,-0.0599,0.1073,-0.0011,0.0505,0.3522,0.3526,0.1723,0.2265,-0.1007,0.0387,0.1109,0.1845,0.2039,0.3196,0.0539,0.0873,-0.0376,0.1012,0.0868,0.0267,0.0228,-0.1106,-0.0701,-0.0585,-0.0336,-0.0368,0.017,0.0738,-0.0463,0.0552,0.0133,0.0696,-0.2095,0.0856,-0.0177,-0.0721,-0.1383,-0.0355,-0.0692,-0.0814,0.0163,-0.046,-0.0787,0.0002,0.1576,-0.008,-0.1953,-0.0309,-0.1098,-0.0919,-0.0065,-0.0872,-0.0396,0.0263,-0.081,0.2334,0.2625,0.3104,0.0559,0.0265,0.1023,-0.0806,-0.1149,0.0093,0.0215,-0.0896,-0.0461,-0.1297,-0.0698,-0.0777,-0.1242,-0.118,-0.116,-0.0688,-0.0231,-0.1204,0.1385,-0.0341,-0.0074,-0.0001,-0.0945,-0.1575,-0.1826,0.0835,-0.0063,-0.0925,-0.0969,0.073,0.0336,-0.2949,0.0416,-0.0858,-0.0448,0.2006,-0.3559,-0.3581,-0.0549,0.0305,-0.0067,0.0265,-0.029,-0.0475,-0.0411,-0.0003,0.0315,-0.1806,0.0202,0.019,0.1293,0.0315,-0.2061,-0.0148,0.0536,-0.0209,0.0074,0.033,-0.1021,-0.0383,-0.0365,-0.0262,0.0285,-0.2461,-0.0978,-0.14,-0.1739,-0.0891,-0.0786,-0.0614,-0.0614,-0.0696,-0.0391,0.0646,-0.181,-0.0788,-0.1739,-0.1586,-0.1374,-0.1094,-0.2711,0.0845,-0.2644,0.0901,-0.0754,0.2687,-0.1894,-0.138,-0.1197,-0.0645,-0.0128,0.0,-0.0734,0.203,0.0001,0.1163,0.2762,0.2377,0.0076,0.0482,-0.021,-0.0295,-0.0044,-0.1196,-0.0983,-0.0389,-0.0825,-0.0054,0.0463,0.0566,0.0177,0.0239,-0.0892,0.0359,0.0201,-0.0298,0.0956,-0.0492,0.1562,0.0492,0.0958,0.0827,0.0571,0.2533,-0.0386,0.0908,0.0639,-0.0376,0.1616,0.1436,-0.108,0.0938,0.0187,0.1566,0.05,-0.02,0.0919,-0.113,0.0134,0.0896,0.0693,-0.0767,-0.0293,0.0728,-0.0183,-0.0052,-0.1973,-0.3761,-0.1111,-0.1561,-0.0192,-0.1385,-0.1637,0.176,0.0271,0.0296,0.0357,0.004,-0.0319,0.0577,-0.071,-0.0647,0.0036,0.0725,0.1659,0.028,0.1071,-0.0776,0.0354,0.128,0.0095,0.1653,0.0929,0.0042,-0.1068,-0.0435,-0.1067,-0.1059,-0.1517,0.009,-0.1022,-0.0599,-0.0096,-0.0878,-0.0241,0.0318,-0.0856,0.0345,-0.0569,-0.0714,0.1041,0.1386,0.0996,0.0829,0.0025,-0.0819,-0.0784,-0.0541,0.0833,0.0579,-0.066,-0.0283,-0.0318,-0.048,-0.1786,-0.0701,-0.0539,-0.0935,-0.1132,-0.0819,-0.0042,0.0844,-0.0975,-0.1174,-0.0872,-0.0394,-0.0326,-0.0622,0.0257,-0.078,0.1403,-0.1293,-0.0965,-0.0458,0.0638,-0.0337,-0.0331,0.0813,0.0231,-0.1846,0.0196,-0.0268,-0.0662,0.0287,0.0424,-0.0072,0.0499,-0.0385,-0.1712,-0.0574,-0.1499,-0.1941,-0.0091,-0.0543,0.063,0.0691,0.1854,0.1751,0.1659,-0.0897,-0.1105,-0.0067,0.1531,0.125,-0.0173,-0.087,-0.0267,0.0262,-0.0343,0.1415,-0.0719,-0.1112,-0.0015,0.0002,-0.0791,-0.0678,0.1254,0.0666,0.0275,0.1392,-0.0229,0.021,-0.0292,-0.1152,-0.0817,-0.066,-0.0923,-0.0105,0.1164,0.0494,-0.0254,-0.0592,0.0182,-0.066,0.0111,-0.0494,-0.1847,-0.0691,-0.0379,-0.0128,-0.0047,-0.0252,0.0219,0.0299,-0.0507,0.0217,-0.1411,-0.0841,-0.1191,-0.1224,-0.0308,-0.0687,-0.0631,-0.1785,-0.0559,-0.1184,0.1695,-0.1147,0.0268,-0.0605,0.0796,0.1626,0.1375,-0.0363,-0.1308,-0.0632,-0.0598,-0.0204,0.1279,-0.0691,-0.0967,-0.0638,0.0479,0.0655,0.0301,0.0851,0.0246,-0.0291,0.0744,-0.0111,0.0993,0.0671,0.0065,-0.0994,-0.015,0.0339,0.0583,0.0376,0.0004,0.0506,0.032,0.0132,-0.0177,-0.1054,-0.1427,0.0042,0.0747,0.156,0.0614,-0.0416,0.0062,-0.0125,0.2883,0.178,0.1336,0.1952,-0.1509,-0.0007,-0.0088,0.0066,-0.0498,0.0802,0.0037,-0.0136,-0.0179,0.0608,0.0103,-0.0475,0.0848,0.1244,-0.117,0.2162,0.0398,-0.0032,0.0958,0.0289,0.0139,0.0065,-0.0767,0.016,0.0923,0.1641,0.2014,0.2445,-0.1189,0.0041,-0.0358,-0.0475,-0.1473,-0.2893,-0.2712,-0.0028,0.054,0.0718,-0.1064,0.0752,0.1045,-0.0395,-0.075,-0.0981,0.0421,-0.1086,-0.0737,0.0594,0.0489,-0.0509,-0.0578,-0.0293,-0.1112,-0.0214,-0.0297,-0.1464,0.0192,-0.0714,-0.03,-0.0414,-0.0817,0.0484,0.1061,0.0147,0.0372,-0.0419,0.2252,-0.0776,0.1691,0.2199,0.199,0.0027,0.0219,-0.1268,0.2346,0.1867,-0.1504,-0.0714,-0.0189,-0.0007,-0.0284,-0.0646,-0.2861,-0.1831,-0.086,-0.009,-0.0856,0.0472,-0.0125,-0.0725,-0.1059,-0.1525,0.0305,0.0237,-0.1154,-0.1378,0.0637,-0.0719,-0.1457,0.054,0.1516,-0.1089,0.0751,0.1127,0.0728,-0.1898,-0.2143,-0.1123,-0.1786,-0.0686,-0.0533,-0.0194,0.1083,-0.0051,0.1484,0.018,0.2437,0.2119,0.1775,0.114,0.1338,-0.2095,-0.178,-0.0853,-0.0467,-0.0371,-0.0547,-0.0872,-0.0568,0.0505,-0.1531,-0.1551,-0.0707,0.0401,-0.1424,-0.114,-0.0877,-0.1556,0.0611,0.0319,-0.0757,-0.1742,-0.093,-0.2281,0.066,0.0972,0.1113,0.0407,-0.0242,0.0864,0.0977,0.0805,0.0982,-0.0548,-0.0113,0.0034,-0.0669,-0.0087,0.0076,0.0514,0.1396,0.0585,0.065,0.0682,-0.0374,0.0142,-0.1397,-0.1268,-0.0684,-0.0939,0.3357,-0.0158,0.1919,0.1474,0.0679,-0.0078,-0.0032,0.1202,-0.1086,0.2533,0.1646,-0.0126,0.1111,0.0682,-0.0276,-0.0671,-0.0647,-0.1444,0.0298,0.0891,0.0276,-0.1293,-0.037,-0.0072,0.0248,0.031,-0.0948,-0.1155,-0.0936,-0.028,-0.2294,-0.1274,-0.0621,0.0339,0.0451,0.0557,0.0943,-0.0497,-0.0638,-0.1119,-0.0601,0.0867,0.084,-0.108,-0.0086,-0.0802,-0.0049,-0.0538,0.0117,0.0249,0.1536,0.0655,-0.0718,-0.1231,-0.0488,-0.1228,-0.1046,0.0631,0.09,-0.0734,-0.0085,-0.0448,-0.0882,-0.1748,-0.143,-0.1075,-0.1449,-0.0964,-0.0759,-0.1061,0.1758,-0.2486,-0.2014,-0.2208,-0.0158,-0.2823,-0.4316,-0.114,-0.084,0.0897,0.0111,-0.237,0.2798,0.2651,0.1176,0.0153,-0.0611,-0.0442,-0.3164,-0.091,-0.1789,0.0256,0.1006,0.1466,-0.0079,0.0257,0.0226,0.0912,-0.3385,-0.0897,-0.0578,-0.0341,-0.401,-0.3069,-0.2588,-0.2819,0.0478,-0.1352,-0.107,0.19,-0.2617,-0.1983,-0.0245,0.1349,0.071,-0.0948,-0.0717,-0.3378,-0.2097,-0.0998,-0.2831,0.0586,-0.1115,-0.0612,0.0549,-0.3368,-0.0999,-0.2128,-0.0838,0.0178,0.0452,0.1218,0.1466,0.2206,-0.007,0.0318,0.2054,-0.0119,0.1259,0.1315,0.0772,0.065,0.0363,-0.1714,-0.1825,-0.0866,0.0083,-0.0433,-0.0191,-0.1051,-0.0093,-0.0131,0.0212,0.2021,0.1434,-0.144,-0.0354,-0.089,-0.0801,-0.179,-0.2253,-0.0018,-0.2587,0.0175,-0.1003,-0.0453,-0.1354,-0.0841,-0.1228,-0.1268,-0.1037,-0.0264,-0.0266,0.0104,-0.0185,-0.0757,0.0672,0.1177,0.0503,-0.0059,-0.0456,-0.1213,-0.0258,0.1008,0.0357,-0.0564,0.2591,0.0549,-0.0061,0.0561,0.0048,-0.0236,-0.0346,-0.023,0.058,-0.0229,-0.0234,0.0972,0.1104,0.3815,-0.1544,-0.2033,0.0229,-0.1889,0.0872,0.19,-0.1803,0.2792,-0.4142,0.0685,0.0444,0.1232,0.0143,-0.0382,-0.0253,-0.0317,-0.1418,-0.1259,0.0494,-0.0239,-0.0918,-0.082,0.0957,0.2078,0.2223,-0.1357,-0.1211,-0.0991,0.0079,-0.1556,-0.156,-0.0287,0.0323,0.0195,-0.0231,-0.0957,-0.1211,-0.0666,0.0136,-0.0512,0.0291,0.2144,-0.0489,-0.0555,0.1571,0.4587,0.1771,0.1244,0.2144,-0.0276,0.0436,0.171,0.2468,-0.0757,0.2239,0.1214,0.1426,0.0661,0.3669,0.059,-0.1034,-0.1445,-0.0784,-0.3131,-0.0964,-0.153,-0.1267,-0.2457,-0.327,-0.0834,-0.1801,-0.1585,0.0706,-0.0955,-0.2014,-0.3071,-0.3581,-0.0537,-0.1521,-0.1811,-0.1525,-0.1277,-0.0118,-0.0132,-0.1327,-0.0918,0.1661,0.2379,-0.0401,-0.0251,0.1367,0.0721,-0.0835,-0.0439,-0.1157,-0.1285,0.0506,0.1157,-0.1618,-0.2232,-0.0826,-0.0264,-0.1244,-0.1142,-0.0083,-0.0602,-0.0033,-0.1134,-0.0482,-0.0221,-0.0676,-0.0532,-0.0646,-0.1231,0.1677,-0.1306,0.0672,0.2132,-0.0067,-0.1626,-0.0861,-0.1744,-0.0884,-0.0586,-0.2023,-0.2486,0.0989,0.0361,0.0797,-0.0068,-0.0281,-0.082,-0.0794,0.0277,0.0986,-0.1146,-0.0803,-0.1287,-0.003,0.0516,0.1144,-0.0626,-0.1469,-0.0975,-0.0143,-0.0146,0.0109,0.0727,0.0934,-0.0017,-0.038,-0.081,-0.0307,-0.1105,-0.1689,-0.0817,-0.0626,0.125,0.0342,0.2495,-0.059,0.1401,0.0074,0.0778,0.0171,0.058,0.0919,0.0645,-0.0278,-0.0296,-0.0228,0.0854,0.0599,0.049,-0.0256,-0.0439,-0.0044,0.0526,-0.0636,-0.0362,-0.0557,-0.0454,-0.1455,-0.0088,-0.0367,0.0694,-0.0972,-0.0692,-0.009,0.022,-0.0486,-0.0377,0.0111,0.0299,-0.1663,-0.1112,0.1644,0.1948,-0.0308,-0.0611,-0.0721,-0.1666,-0.0263,0.0003,-0.1195,0.1341,0.0367,-0.1648,-0.145,0.0261,-0.0888,-0.0293,-0.0546,0.2562,0.168,-0.187,0.0671,-0.0558,-0.0268,-0.1086,-0.0891,-0.1208,-0.1913,0.0153,-0.0041,-0.0923,0.0402,-0.0625,-0.0832,0.0957,0.0309,0.0493,-0.0117,0.0059,-0.0352,-0.0959,-0.0292,0.0708,-0.1179,0.1263,-0.1959,0.0741,-0.09,0.2023,0.1706,0.1563,-0.1661,-0.1447,0.0254,0.2111,0.0197,0.2295,-0.0611,0.06,0.1602,0.0775,0.1076,-0.0155,-0.0028,-0.0166,0.0487,0.0761,0.0992,-0.0765,0.1069,0.1563,0.3527,0.1595,0.0003,0.2482,0.1153,0.1229,0.2085,0.1812,0.1563,0.0623,0.2327,0.1985,0.0828,0.11,0.1909,0.2392,0.1728,0.2418,0.1677,0.2386,-0.1512,-0.0386,-0.1297,-0.3427,-0.2861,-0.1896,-0.1543,-0.0678,-0.0222,-0.0766,-0.2261,-0.171,-0.167,-0.0812,-0.0272,-0.0919,0.041,-0.0332,-0.0504,0.0214,-0.1003,-0.0461,0.016,-0.0255,-0.1038,0.0795,-0.1374,-0.1324,0.027,0.0032,-0.0205,0.0152,0.0215,-0.1846,0.2681,0.1831,-0.0707,0.1221,0.1681,0.0388,0.0198,0.009,-0.1142,0.424,0.4282,-0.0943,0.0152,0.0167,-0.0579,-0.0405,-0.1234,-0.0184,0.0563,0.0258,-0.0211,0.0865,0.0065,-0.0241,-0.0052,working memory maintenance
trm_55c298bbe56d5,0.0336,0.0357,0.052,0.0041,-0.0089,0.0101,0.0359,-0.0052,0.0241,-0.0041,-0.0027,0.0107,0.0173,0.0256,-0.0021,0.007,0.0401,0.0169,0.0179,0.0059,0.0182,0.0145,0.0158,-0.0056,0.0214,0.0051,0.0136,0.0233,0.0371,0.0232,0.0277,0.0297,0.0669,0.0005,0.0135,0.0499,0.0258,-0.0035,0.0105,-0.0151,0.0387,0.0259,0.0512,0.0192,-0.0088,0.0295,0.0127,0.009,-0.0125,0.0031,-0.0307,-0.0023,0.0244,-0.0197,0.0036,0.0338,0.0233,0.0037,-0.0345,-0.0,0.0036,-0.0259,0.0174,-0.0221,-0.0354,-0.0359,0.0622,0.0793,0.045,0.0291,-0.0612,0.0102,-0.0469,0.0236,-0.0128,0.02,0.0542,-0.0103,0.013,0.0483,0.0277,-0.0403,0.0191,0.0003,-0.0391,-0.0509,-0.0542,0.0137,0.0251,0.0624,0.077,0.0674,0.0363,-0.0328,-0.0352,-0.005,-0.0297,-0.0217,-0.0459,-0.0289,-0.0009,0.0169,-0.0265,-0.0071,-0.0446,0.0977,0.0398,-0.0313,-0.0297,-0.0051,-0.0034,0.0059,-0.0304,-0.0423,0.0043,-0.0457,0.0263,0.0411,0.0257,0.0613,-0.0056,0.0408,0.0291,0.0246,0.0078,0.0344,-0.0155,0.0045,0.0171,-0.0344,0.0286,-0.014,0.0249,0.0595,0.0035,0.0563,0.0382,0.0229,0.0354,-0.0097,0.0415,0.0387,-0.0071,-0.0006,-0.0062,-0.0064,0.0386,-0.0345,0.0185,-0.0226,0.0004,0.0261,0.0263,0.0465,-0.0602,0.0238,-0.012,-0.0229,0.0008,0.0308,0.018,0.0266,0.013,0.0482,0.0035,0.0147,-0.0019,0.0423,0.0388,0.013,0.066,0.0302,-0.0002,0.0336,0.0131,0.0138,0.0272,0.0123,0.0287,0.0405,0.0244,0.0011,0.0269,-0.0356,0.0785,-0.0014,0.0885,0.0422,0.0068,-0.0115,-0.0222,0.0585,0.0349,0.0601,0.052,-0.0068,-0.0006,-0.0012,0.0398,-0.0116,-0.0171,-0.0842,0.0065,0.046,-0.0484,0.0404,0.0419,0.0202,-0.0131,0.0064,0.0221,0.0289,0.1189,-0.0095,-0.0268,-0.0199,-0.0026,0.057,0.0425,-0.0064,-0.0251,0.0213,0.0697,0.0172,-0.0264,0.0119,0.0199,0.0238,0.0174,-0.1089,0.0467,0.001,-0.0793,0.0245,0.0271,0.1026,-0.0137,-0.0395,-0.0342,-0.0028,-0.0479,0.0406,0.026,-0.0112,-0.0068,0.0226,0.0084,0.006,-0.0262,0.0104,0.021,-0.0087,0.0076,-0.0264,0.0076,0.0557,0.0211,0.0453,-0.043,-0.0721,-0.0428,-0.1643,0.033,-0.0794,-0.1127,-0.1615,-0.102,-0.0383,0.0205,-0.0323,0.0402,0.0594,0.025,0.0248,0.0341,0.0038,0.0473,0.0607,0.074,-0.0407,0.0156,0.0113,-0.0058,0.027,0.0154,0.0362,-0.0206,-0.0087,-0.0132,0.0197,0.0167,-0.0136,-0.0049,-0.0361,0.0088,-0.0655,0.001,-0.0124,-0.008,-0.0609,0.0054,0.0008,-0.0057,0.0716,0.0164,0.0163,0.0429,-0.001,0.0197,0.003,0.0017,0.0036,-0.0184,-0.0656,-0.0235,-0.0153,-0.0598,0.0315,-0.072,0.0186,-0.0164,0.0068,0.0004,0.0049,0.0082,0.0226,0.0095,0.0122,0.0261,0.037,-0.026,0.0232,-0.0243,-0.0255,-0.0172,-0.0256,0.0734,-0.0247,0.0183,0.0061,0.0087,0.015,-0.0125,-0.0217,0.0161,-0.0202,0.078,0.0744,0.0343,0.0401,0.0071,0.0103,0.0252,0.02,0.0414,0.0107,0.0073,0.0718,0.0612,0.0307,0.0019,-0.0219,0.0167,0.0487,0.0488,0.0043,0.041,-0.1663,0.0224,0.0505,-0.0186,-0.0742,-0.0227,-0.0794,0.0395,0.0524,0.0449,-0.017,0.0115,-0.0153,0.0115,0.0404,-0.0136,-0.0565,-0.0059,-0.0164,-0.0153,0.0199,-0.0084,-0.0164,0.0081,0.0168,0.0099,-0.0012,0.0161,0.0362,0.0666,0.0684,0.0555,0.0045,-0.0007,0.0158,-0.0476,0.0043,-0.0143,-0.0737,-0.0169,-0.0278,0.0318,-0.0258,-0.0064,0.0616,-0.0006,-0.0394,0.0546,0.0231,-0.0352,-0.0408,-0.0201,-0.0066,-0.01,0.0606,0.0239,0.0267,0.0368,0.0197,0.0176,0.0032,0.0455,-0.0,0.0112,0.03,0.0069,0.0146,0.0236,-0.0183,-0.006,-0.0059,0.0981,0.0517,-0.0376,-0.0191,0.0035,0.0084,0.0422,0.0574,-0.0401,-0.0246,-0.0484,-0.1007,-0.0776,-0.0182,0.0039,-0.0239,-0.0544,0.0175,0.0066,-0.0254,-0.0554,-0.0373,-0.0665,0.002,0.0149,-0.0289,0.0414,-0.0051,-0.0136,-0.0934,0.0625,0.018,-0.0241,-0.0142,-0.0652,-0.0029,0.0298,0.0186,-0.001,-0.0139,0.0125,-0.0254,-0.0164,0.0009,0.0635,-0.0165,-0.0135,-0.048,0.0183,0.0091,0.0023,0.0229,-0.0068,-0.0218,0.0102,0.0325,-0.0348,0.0187,0.0303,0.0233,-0.0275,-0.0006,-0.0045,0.001,0.0204,0.0512,0.0445,0.0698,-0.0057,0.0284,-0.0121,-0.0111,0.0495,-0.0215,0.0275,-0.0548,-0.0198,-0.059,0.0149,0.0381,-0.0371,0.007,0.0012,0.0196,-0.0333,-0.0754,-0.067,-0.0184,-0.0628,-0.065,0.0101,-0.0604,0.0131,0.0168,0.0341,0.0512,0.0087,0.002,0.0144,0.0121,-0.0027,0.0673,0.0157,0.0037,-0.0235,0.0436,-0.0287,-0.0253,-0.0516,-0.0006,-0.0196,-0.027,-0.0141,0.0031,-0.045,0.038,0.0146,0.058,0.0259,-0.0433,-0.0116,0.0437,-0.0028,0.0058,0.0316,-0.0425,0.0176,0.0008,-0.0048,-0.0103,-0.035,0.008,-0.0288,-0.0228,0.0129,0.0037,0.0198,-0.0012,0.0316,-0.0339,-0.006,-0.0228,-0.019,-0.0195,-0.0238,0.0148,-0.0322,-0.0584,-0.0514,-0.026,-0.0436,0.0384,0.0258,-0.0491,-0.0403,-0.0567,-0.0317,0.0071,0.0593,0.0005,-0.0176,0.0251,0.0013,-0.0095,-0.0467,-0.0347,0.0028,0.0044,-0.0121,0.0484,0.0505,-0.0637,0.0605,0.0352,-0.0161,0.0041,0.0472,0.0223,-0.0109,-0.0376,-0.017,0.1048,0.023,0.0509,0.0302,0.0261,0.0333,-0.0014,-0.012,0.0505,0.0028,-0.0332,-0.0042,-0.0059,0.0195,-0.0452,-0.0706,-0.0134,-0.0585,-0.0186,0.0021,-0.0049,0.0024,-0.0422,-0.0115,0.0356,-0.0197,0.0085,-0.0018,0.0261,-0.0803,0.0369,-0.0379,0.0254,-0.0635,0.0021,0.006,-0.0239,-0.0058,0.0042,0.0202,0.007,0.0062,0.0645,-0.0596,0.0347,-0.0575,-0.0247,0.0349,0.0971,0.0155,0.0676,-0.003,0.018,0.0332,0.0553,0.009,0.0267,0.0255,0.0323,0.021,0.0047,-0.0323,-0.0043,-0.0536,-0.046,-0.0568,0.0255,0.0567,-0.0141,-0.0217,0.0305,0.0073,-0.1114,-0.0985,-0.0696,-0.0086,-0.0111,-0.0409,0.0289,0.0354,-0.0496,-0.0434,-0.0302,0.0505,0.0367,0.024,0.0138,0.0002,-0.0123,0.0246,-0.0221,-0.0299,-0.0406,-0.0418,0.0422,-0.0455,-0.0135,0.0013,0.0018,0.0494,-0.0355,0.0086,0.0598,0.0382,0.0454,0.0203,0.0451,0.0028,0.0345,-0.0487,0.0071,0.0082,-0.0002,0.0044,-0.0428,-0.0467,-0.0034,-0.002,-0.0663,-0.0852,-0.1053,0.0456,0.0122,0.0029,0.01,0.0198,0.0702,-0.0231,-0.0351,-0.0325,-0.0087,-0.0568,-0.0057,0.0408,0.0577,0.0593,0.0479,0.0003,-0.0142,0.0264,0.0525,0.05,-0.008,-0.0296,-0.0254,-0.005,0.0255,0.018,0.0226,0.038,-0.05,-0.0191,-0.0391,0.0302,-0.0009,-0.0318,0.0238,0.0125,0.0315,0.0136,0.0218,0.0579,0.0386,-0.0072,-0.0363,-0.0018,0.0149,-0.0271,0.0372,-0.0595,-0.0472,0.026,-0.0047,-0.0101,0.0172,0.0161,0.0173,-0.0183,0.014,-0.1286,0.061,0.0542,-0.0406,-0.0551,-0.0033,0.0193,-0.0174,-0.0497,-0.0107,-0.0529,-0.0769,-0.0009,-0.0504,-0.0197,-0.0009,0.0062,0.0006,-0.0831,-0.0567,0.0292,0.0334,0.026,0.0696,0.0228,0.0534,0.0225,0.0338,0.0556,0.0236,0.0511,0.0233,0.0662,-0.0018,-0.0285,0.0007,0.0308,0.0029,-0.0569,0.0056,-0.0479,-0.0067,-0.0273,-0.0911,-0.0095,-0.0928,-0.0257,-0.0639,-0.0739,-0.0665,0.0144,-0.0618,-0.0299,0.0027,0.0135,0.0503,-0.0048,-0.0479,-0.0749,0.0372,-0.0051,-0.0192,-0.0467,-0.0551,-0.0136,-0.0296,0.027,-0.0164,-0.0083,0.0035,-0.0614,-0.0151,-0.02,0.0195,-0.035,0.0124,-0.0293,-0.1374,-0.0686,-0.1361,-0.0154,-0.0076,0.0492,-0.0607,0.0103,0.0295,0.0526,-0.0547,0.0225,0.0289,0.0054,0.0497,-0.0194,0.0151,0.0023,0.0011,-0.0406,-0.0137,0.0311,0.0108,0.0263,0.029,0.0422,-0.024,-0.0044,-0.0225,-0.0585,-0.0389,-0.0246,0.0454,0.027,-0.0053,-0.0018,0.059,0.0167,0.0353,0.0071,-0.016,0.0276,0.0301,-0.0491,-0.0503,-0.0374,0.0052,0.0097,0.0129,0.0671,0.0349,0.0203,0.0208,-0.0114,0.0266,-0.0116,0.0007,0.0215,-0.017,0.0071,0.0039,0.042,0.0136,0.0092,0.0586,0.0538,0.0428,0.0151,0.0512,0.0292,-0.0242,0.0076,0.0133,0.0152,0.0396,0.0405,0.069,0.0359,0.0147,0.0231,-0.0365,-0.0362,-0.0006,-0.0453,-0.0161,-0.0051,-0.0022,-0.0395,-0.0299,-0.0323,0.0294,-0.0499,-0.0398,0.0015,-0.0264,-0.0342,-0.0411,-0.0282,0.0303,0.0252,-0.0382,0.039,0.0299,0.0055,-0.0928,-0.0408,-0.0431,0.0348,0.0194,-0.0053,0.0199,0.02,-0.01,-0.0637,0.0641,-0.008,-0.0079,-0.0056,-0.0431,-0.0283,0.0364,-0.0054,-0.0351,0.0173,0.0352,0.0197,0.0712,-0.0155,-0.0293,-0.0231,0.0417,0.0616,0.0096,0.0318,0.0073,-0.0295,0.0101,-0.0316,0.006,0.0132,-0.0379,-0.0213,-0.0682,0.033,0.0108,0.0332,-0.0019,0.0285,0.0536,0.0322,-0.0783,0.0038,0.0214,0.0578,-0.0113,0.0563,0.0041,0.0026,-0.0469,-0.0882,-0.0619,-0.0568,-0.0626,-0.0249,-0.0401,-0.0417,-0.0127,0.0259,-0.0095,-0.0014,-0.0129,-0.0136,-0.0593,0.0236,0.0537,0.0275,0.0442,0.0346,0.0211,0.0131,-0.0731,-0.0318,-0.0043,0.0077,-0.0391,-0.0248,-0.014,0.0075,0.0087,-0.0099,-0.0045,-0.0125,-0.0056,0.0435,0.0068,-0.0234,0.0181,0.0185,0.031,0.0459,0.0458,0.0253,0.0428,0.0454,0.0321,0.0304,0.0099,0.0005,-0.0395,0.0185,-0.0411,0.0102,0.0188,-0.01,0.0424,-0.0317,-0.0094,-0.0939,-0.0582,-0.0872,-0.0002,-0.0649,-0.0093,0.058,-0.0088,0.0175,-0.0143,-0.0116,0.0001,0.0499,0.0384,0.0416,0.0065,-0.0186,-0.023,-0.032,-0.0026,0.0098,-0.0322,-0.0268,-0.0026,0.0226,-0.029,0.0135,-0.0381,-0.0217,0.0119,-0.0275,0.0414,-0.0637,0.0028,-0.0841,0.002,0.021,0.0348,0.0076,-0.0101,-0.0349,0.0065,0.0154,0.0195,0.0619,0.0317,0.042,0.0073,0.0505,-0.0396,-0.0619,0.011,0.0021,0.015,-0.004,-0.0549,-0.0061,-0.0378,-0.022,0.0049,-0.0626,-0.0617,0.0493,0.0263,0.0576,0.059,0.0119,0.0041,-0.0154,0.025,0.0252,0.0079,0.0338,0.0518,0.0203,0.0055,-0.0058,0.0008,0.0067,-0.0001,-0.0462,0.0266,-0.0363,0.0581,0.0561,0.021,0.0391,0.0475,0.0832,0.0303,0.0263,0.0068,-0.087,-0.088,-0.079,-0.0917,0.0029,0.0021,-0.052,-0.034,0.0104,-0.1189,0.0225,-0.1282,-0.1591,-0.0436,0.01,-0.1452,-0.0797,-0.002,0.0239,0.0139,0.0104,0.0133,0.0343,0.0186,-0.0612,0.0519,-0.0033,0.022,-0.0005,0.0152,0.0143,0.0133,-0.0177,-0.0117,-0.0597,-0.0612,-0.0228,0.0138,0.009,0.005,0.0065,-0.0225,-0.0206,-0.0085,0.0235,-0.0327,0.0607,0.0164,-0.0488,0.0395,0.0308,-0.0336,0.0152,0.0286,-0.0033,0.0098,-0.012,0.0496,0.0017,-0.0071,0.0249,0.0479,-0.0132,-0.0672,0.0028,-0.0054,-0.0054,0.0537,-0.0865,-0.0581,-0.0631,0.0101,-0.0055,0.0492,-0.0269,0.078,0.081,-0.0356,-0.0002,0.0914,0.1006,0.0971,0.0244,0.0366,0.0063,-0.0253,0.0009,-0.0531,0.0802,0.0363,-0.0297,0.001,0.0268,-0.0196,0.0034,0.0376,0.0197,-0.0297,0.0032,-0.0145,-0.0215,0.0447,0.004,-0.0308,-0.0079,0.008,-0.0242,-0.0177,-0.0428,0.0438,0.0471,-0.0306,0.0096,0.0672,0.0544,0.0522,-0.0201,-0.013,0.0483,0.0334,0.0262,0.0404,-0.0397,0.0366,-0.0106,0.0293,0.0413,0.0016,0.0176,0.0122,-0.0358,0.007,-0.0446,0.0479,0.0247,-0.0004,-0.0071,-0.0276,0.0006,0.0772,0.0756,0.0163,0.0154,-0.0323,0.007,0.0598,-0.0248,-0.0234,-0.0001,0.0625,0.0071,-0.0267,0.0008,0.0289,-0.0228,0.0485,-0.008,0.044,0.0495,0.0164,0.0254,0.0116,0.023,0.0513,0.0522,0.0171,0.0148,-0.0046,-0.011,0.0011,0.034,0.0302,-0.0367,0.0486,0.0232,-0.0107,-0.0222,0.0306,0.0254,-0.0434,-0.0323,-0.0146,-0.017,0.0449,0.0198,-0.0495,-0.0197,0.0268,0.0079,0.0538,-0.0093,-0.025,0.0414,-0.0411,0.026,-0.0098,0.0258,-0.0353,-0.0435,-0.0066,0.0066,0.0204,-0.0095,0.0087,0.0089,-0.0016,-0.0479,-0.0074,0.0048,-0.0131,-0.0066,0.0347,-0.0131,0.0296,0.0044,0.0155,-0.0236,0.0082,0.0155,0.0657,-0.0108,0.0215,-0.0047,-0.0057,0.0083,-0.014,-0.0161,0.028,-0.0346,-0.054,0.045,-0.021,-0.0052,-0.018,-0.0163,-0.0197,0.0306,-0.0245,0.0114,-0.009,-0.0171,-0.0052,-0.0184,0.0108,-0.0577,0.02,0.0214,0.0276,0.013,0.0429,0.0231,0.0595,0.0206,0.0301,0.0432,-0.0288,0.0212,-0.005,-0.0483,-0.0206,-0.0141,-0.0066,-0.0689,-0.0038,-0.0185,0.0027,-0.0053,-0.0097,-0.0029,-0.1196,-0.0471,0.013,-0.0328,-0.0009,-0.0508,0.0273,0.0129,0.0399,-0.0003,0.055,-0.0025,0.0138,-0.0019,-0.0002,-0.0293,-0.054,-0.0352,0.0403,0.0379,0.0083,0.0343,0.0258,-0.0302,-0.0334,-0.0324,-0.0367,0.0025,-0.008,0.0531,-0.0071,0.0244,0.0176,0.067,-0.0106,0.0093,-0.0125,0.0088,-0.0605,0.01,-0.0466,0.0226,-0.0511,-0.0141,-0.1128,-0.0013,-0.016,-0.025,-0.035,0.032,-0.0025,-0.0054,-0.0088,0.0301,-0.0181,-0.0256,0.0128,0.0572,0.0268,-0.0632,-0.1701,-0.1662,0.054,0.0242,-0.0539,0.0616,0.0866,0.0304,0.0484,-0.0042,0.0075,0.026,-0.0178,0.0211,-0.0542,-0.047,-0.043,-0.0004,-0.0038,-0.0636,-0.1687,0.0291,0.0457,-0.1188,-0.0247,0.0036,0.0029,0.0033,0.0215,-0.0169,-0.002,0.0118,-0.0313,-0.0335,-0.034,-0.0676,-0.036,-0.0499,-0.0728,-0.0416,0.0037,0.002,-0.0001,-0.0381,0.0242,0.0214,0.0125,0.04,0.0059,-0.0162,-0.0269,0.0299,0.0531,0.0213,-0.0033,0.034,-0.0223,0.0043,-0.0148,0.0162,0.0075,0.0293,-0.0349,0.0189,0.0244,-0.031,-0.044,-0.0103,-0.0321,0.0397,-0.0219,-0.0724,0.0546,0.0059,0.0293,-0.023,0.0061,-0.0136,-0.0095,0.0104,0.0052,-0.0182,0.0018,-0.0717,0.0032,-0.0101,0.0158,0.008,-0.0167,-0.0342,0.0197,0.0358,0.0194,-0.0568,0.0542,0.0185,-0.0118,0.0272,0.02,-0.0214,-0.0022,0.0328,0.0602,-0.024,0.0021,-0.0456,-0.002,0.0194,-0.0273,0.0097,-0.0017,-0.0009,-0.043,0.0212,-0.0024,0.0034,0.0051,0.0401,0.0289,0.0422,0.0041,-0.0081,-0.0462,-0.1533,0.0028,0.0111,-0.0067,-0.0198,-0.0506,-0.0292,0.0805,0.0063,0.0381,0.0297,-0.0212,-0.0714,-0.0667,0.006,-0.0331,-0.0263,-0.0258,0.0533,0.023,0.098,-0.0122,0.0191,0.0587,-0.0065,-0.0001,-0.0236,0.0432,0.0214,-0.0105,-0.0175,0.0028,0.0491,-0.0313,0.0299,0.0132,-0.0046,-0.0554,-0.1067,-0.0596,-0.0923,0.0724,0.0518,0.0475,0.0476,-0.0603,-0.0397,0.0126,0.0338,0.0467,0.0347,-0.077,-0.0413,-0.0827,-0.007,-0.0109,0.0061,0.0162,0.0148,0.0299,0.0393,0.0803,-0.0005,0.0029,0.0142,0.0139,0.049,-0.0,-0.0522,-0.0138,-0.0467,-0.0081,0.0625,0.0965,0.049,0.0976,0.0727,-0.0001,0.0274,0.0179,0.0176,0.0517,0.0315,0.0043,0.0308,0.0128,-0.0071,0.0187,0.0436,0.0168,0.0625,0.0287,0.025,-0.0161,0.0455,0.0025,0.0079,-0.0547,-0.0038,0.0293,0.0164,-0.0563,0.0055,0.0364,0.0172,-0.0207,-0.0212,-0.0128,0.0352,0.0824,0.0216,-0.1197,-0.0115,-0.1556,-0.0234,-0.0391,-0.0321,-0.0769,-0.0665,-0.1444,0.0294,0.0208,-0.075,-0.065,-0.0062,0.0153,0.0103,-0.005,0.004,0.0319,0.038,0.0274,0.0815,0.0056,-0.0102,-0.0524,0.0798,-0.0275,-0.025,0.0138,0.0522,0.0302,0.0151,0.0249,-0.0436,-0.0149,0.0161,0.0055,0.0466,0.0301,0.0165,0.0189,0.0026,-0.0131,-0.0066,-0.0068,0.0018,-0.0212,0.0148,0.0486,-0.0328,-0.0767,-0.0756,-0.0733,0.0345,0.053,0.0379,-0.0016,0.0648,0.0001,-0.035,-0.0082,-0.0388,0.0212,0.0223,0.0497,0.0026,0.0385,0.0012,-0.0308,0.001,0.0094,-0.0337,-0.0629,-0.0051,-0.0227,0.0684,0.0161,0.0141,0.049,0.046,0.1018,0.0695,-0.0367,-0.0264,-0.004,0.0506,0.0648,0.0608,-0.0242,0.0127,0.0004,-0.0519,0.0553,-0.0351,0.0027,0.068,0.0144,0.0467,0.0013,-0.0628,-0.0001,0.0324,-0.0199,-0.0472,0.0178,0.0117,0.0099,0.0079,0.0108,-0.0465,0.0027,-0.0116,0.0022,0.0419,0.0021,0.0047,-0.0211,0.0234,0.0323,0.1597,0.0334,0.0348,-0.0173,-0.0291,-0.0724,0.0138,0.0067,-0.0396,-0.0321,0.0148,0.0501,0.0508,0.0443,0.0278,0.0031,0.028,0.0328,0.0382,0.045,0.0026,0.0449,0.0356,-0.0842,0.0737,0.0464,-0.0594,-0.0471,-0.0462,-0.0129,0.0502,0.0382,0.0494,0.011,-0.025,0.0439,-0.0055,-0.0074,0.0648,-0.0343,-0.0414,0.0343,0.0098,0.0353,-0.0287,0.0047,0.0296,0.0234,0.0301,0.0292,-0.0046,-0.0107,-0.0182,0.0427,-0.0278,0.0266,-0.0213,0.0564,0.04,0.0583,-0.0023,0.0403,0.0397,0.026,-0.0083,0.0029,-0.0053,0.0607,0.0383,-0.0112,-0.0197,0.0296,-0.0055,-0.0018,-0.0012,-0.0947,-0.1215,-0.1216,0.0073,-0.0385,-0.0155,0.0132,0.0042,-0.0167,-0.0361,-0.015,-0.0324,0.0012,0.0096,0.0004,-0.0007,0.0164,0.0239,-0.0351,-0.0292,-0.0153,0.008,-0.0243,-0.0135,-0.0536,-0.0455,-0.0153,-0.0108,0.0265,0.0116,0.0269,-0.0041,-0.0164,0.0272,0.0618,0.0208,0.0095,0.0277,0.0161,-0.0365,-0.0207,-0.0307,0.0671,0.0135,-0.062,-0.1015,0.0459,0.023,0.0461,0.0136,0.0376,-0.0277,-0.0518,0.0778,-0.0077,0.1346,0.0245,0.0326,0.0311,-0.0163,0.0542,-0.0263,-0.0687,-0.0477,-0.104,-0.0285,-0.0274,0.005,0.0532,0.0164,-0.0034,0.0981,-0.0396,0.0152,-0.0398,-0.0205,-0.0208,0.1108,0.0366,0.0339,0.0382,0.0336,0.0193,0.0571,0.0287,0.0059,0.0202,-0.0449,-0.0054,0.0465,-0.0592,-0.0556,0.0368,-0.0092,0.0293,0.0363,0.0186,0.0239,0.008,0.01,-0.0591,-0.0031,-0.0741,-0.1555,-0.1654,-0.0863,-0.0971,-0.0256,-0.0503,-0.0547,-0.032,-0.0756,-0.1298,-0.0085,-0.0653,0.0376,-0.045,0.0139,0.0408,0.0435,0.044,0.023,0.0343,0.0161,0.0128,-0.047,-0.0391,0.0315,-0.0195,0.0503,-0.0106,0.0387,0.0043,-0.011,0.0001,0.0473,0.0376,-0.0059,0.0516,0.0012,0.0216,0.064,-0.0236,-0.0137,0.0079,0.0323,0.0533,0.041,0.0058,-0.0028,0.0152,0.0028,-0.0344,0.0199,-0.0731,-0.0752,-0.1192,-0.0576,-0.0166,-0.0481,0.0334,0.0168,-0.0251,0.0147,-0.0384,0.0014,0.0286,0.0197,-0.0257,-0.0018,0.0381,0.0401,0.0386,-0.0388,0.0716,-0.0545,-0.0081,-0.0026,-0.0177,0.0464,0.0355,0.0184,0.0395,0.0006,0.0277,0.0108,0.0341,0.0259,0.0552,0.0065,0.0478,0.0038,-0.0565,0.039,0.037,0.0348,-0.0126,0.0253,0.0112,0.0006,0.0338,0.0311,0.0007,0.0249,0.0359,-0.0012,-0.0066,-0.0509,-0.0212,0.0459,0.0072,0.0099,0.046,-0.0187,-0.0248,0.0548,0.0105,0.009,-0.0167,-0.0165,0.0531,0.0713,0.0268,0.018,-0.0014,0.0075,0.0523,0.0523,0.0234,0.007,-0.0611,0.0589,0.0234,0.0946,0.0958,-0.0055,0.0162,0.043,-0.0623,0.0792,-0.0449,0.0359,-0.0963,0.0052,0.0266,0.0605,0.0045,0.0411,0.0202,0.0052,-0.0663,0.0193,-0.0123,-0.0516,-0.0675,-0.0349,-0.029,0.0459,0.074,-0.0131,-0.0298,0.0014,-0.0014,0.029,-0.0008,-0.0426,-0.0294,-0.0048,-0.0085,0.0323,-0.0358,-0.0178,-0.0139,-0.017,-0.0348,-0.0997,0.0013,-0.0787,-0.0165,-0.0559,-0.1015,0.0133,-0.0065,0.0079,0.0329,-0.0526,-0.0635,0.0093,-0.0548,0.0334,-0.0913,-0.0224,-0.0142,0.0121,0.0197,-0.0199,-0.0339,-0.0123,0.0528,-0.0112,-0.0532,-0.0066,0.0167,0.097,0.0635,0.0859,0.052,0.0311,0.0436,0.0862,-0.0285,0.002,-0.0076,0.005,0.0107,-0.0044,0.0009,0.0013,-0.0156,-0.0242,0.0303,-0.062,-0.0107,-0.057,0.0324,-0.0016,-0.0663,-0.0403,-0.0674,-0.0058,-0.0069,0.04,0.0803,0.021,0.0764,0.1896,-0.0228,0.0136,-0.0085,0.0273,0.0381,0.0262,-0.0104,0.0107,0.003,0.098,0.012,-0.0148,-0.0579,-0.0625,-0.0063,-0.0223,0.0344,0.0509,0.0206,-0.0807,-0.0061,0.0412,0.031,0.013,0.0922,-0.002,0.0335,0.0078,0.0009,0.0184,0.0383,0.004,-0.0287,0.0337,0.0279,0.0306,-0.0156,-0.0169,0.0095,0.0086,0.0518,-0.0515,0.0262,0.0523,0.0333,-0.0092,0.0161,-0.0142,-0.0191,-0.0201,0.0403,-0.0118,0.0282,0.0092,-0.0309,-0.0293,-0.002,0.0076,0.0002,0.01,-0.0418,0.0414,0.034,0.0245,0.02,-0.01,-0.0228,-0.0925,-0.0689,-0.0857,0.0247,0.0249,0.018,-0.0304,0.0405,-0.0512,-0.0084,-0.0231,-0.0344,-0.0121,-0.0497,0.0142,0.0409,-0.0105,-0.0235,0.0391,0.0353,-0.027,-0.0212,-0.0164,-0.0199,0.0076,-0.017,-0.0007,0.0612,-0.0057,0.0175,0.0455,0.0016,-0.0881,-0.0222,-0.0307,0.0536,0.0105,0.0478,0.0226,0.0066,0.0392,-0.0038,0.0258,0.0045,0.0001,-0.0149,-0.0057,-0.0198,0.0327,-0.0407,0.0667,0.0512,0.0564,0.051,0.0166,0.0143,-0.0034,0.0582,-0.0029,0.0205,-0.0508,0.0523,-0.0034,0.0272,-0.0383,-0.0396,-0.0791,0.0168,0.0657,-0.0024,0.0034,-0.0203,-0.0058,-0.0058,0.0099,-0.0027,-0.0225,-0.0267,-0.0262,-0.0548,0.0037,0.0091,-0.0389,0.0162,-0.0404,-0.0324,-0.0179,0.0207,0.0333,0.0217,0.0015,-0.036,0.0822,0.0161,-0.0156,-0.0112,0.0239,0.047,0.0675,0.0036,0.0049,-0.0307,0.0053,-0.0095,-0.0176,-0.0601,-0.1133,-0.0849,-0.0853,-0.1088,0.0096,0.0066,-0.0268,0.0168,0.0575,-0.0096,-0.0203,-0.0033,-0.0107,-0.0145,-0.0221,0.0637,0.0266,-0.0426,0.0476,-0.1029,-0.0376,0.01,-0.0181,-0.0459,-0.0416,-0.0249,0.0107,-0.0329,-0.0707,-0.0834,-0.0812,-0.092,0.0398,-0.0063,-0.0064,0.0066,0.0616,0.0971,0.0862,0.0531,-0.004,-0.0552,0.0477,-0.0184,-0.0261,-0.009,0.002,0.0126,-0.0105,0.0199,0.0418,-0.0556,-0.0423,0.0222,0.0049,-0.0129,0.0187,-0.0122,0.0271,0.037,-0.0205,0.0306,-0.0041,-0.0088,0.0794,0.0252,-0.0078,-0.04,-0.036,-0.0154,-0.0812,0.0453,-0.0952,-0.0486,-0.0244,-0.0048,-0.0029,0.0615,-0.1037,-0.059,0.0524,-0.009,-0.0067,-0.0532,0.0154,0.0428,0.1433,0.0638,0.038,0.0066,0.0338,-0.0204,-0.0098,-0.0132,-0.0032,0.0757,-0.0091,-0.0003,0.0354,0.036,-0.0404,0.0432,0.0509,0.0369,-0.0582,0.0539,-0.0416,-0.0451,-0.0172,0.0418,0.057,0.0255,0.0584,0.0353,0.0232,0.0274,-0.0459,-0.0283,-0.0308,-0.0003,-0.0543,-0.0409,-0.0884,-0.0362,-0.0267,0.0451,0.0318,0.0618,0.0465,-0.0065,0.0317,0.0264,0.0262,-0.039,0.0132,0.0097,0.0408,0.011,0.0308,0.0942,0.0791,0.0284,-0.0353,-0.0524,0.0616,0.0098,0.014,0.0282,-0.0492,-0.0331,-0.045,0.008,0.0281,0.0086,-0.053,-0.0428,-0.031,0.0247,0.0301,-0.0501,0.0091,-0.0145,0.0091,-0.0006,-0.0277,-0.0318,-0.0327,-0.0129,-0.0058,0.0369,0.0748,0.0426,0.0079,0.0415,-0.0817,0.0152,-0.0387,-0.0564,-0.0246,0.028,0.0233,-0.042,0.0011,-0.1191,-0.106,-0.022,-0.0309,-0.0576,-0.0266,-0.0062,0.0396,0.0742,-0.0201,-0.0185,-0.0022,0.0173,-0.0113,0.0473,-0.0554,-0.0333,0.0047,0.0331,0.0129,0.0508,0.0975,0.0785,0.0006,-0.0002,0.0347,-0.0202,-0.0196,0.0609,0.0354,0.0241,0.0005,-0.0632,0.0416,0.0463,0.0046,0.0332,0.0343,-0.0257,-0.0347,-0.0102,-0.0458,-0.0332,0.0267,0.0176,0.0061,0.0447,0.0016,-0.0496,0.0165,0.0264,0.0258,0.0044,0.032,-0.0108,-0.0133,-0.0231,-0.0266,-0.0105,-0.0007,0.0345,-0.0966,0.1185,0.0981,0.081,-0.0356,0.0241,0.0287,0.0215,0.0375,-0.0504,-0.0116,0.1508,-0.1406,-0.1241,-0.0977,-0.0189,0.0083,0.0054,0.0462,0.0831,0.101,0.0171,-0.0106,-0.0191,0.034,-0.0173,-0.0193,-0.0185,0.032,-0.001,0.0224,-0.0108,0.1501,0.0819,0.2298,0.04,0.0208,0.0329,0.0452,-0.0609,0.0503,0.0407,0.0086,-0.035,-0.029,0.0094,-0.0064,0.0997,0.0729,0.0385,0.0488,-0.0476,0.0589,0.0371,0.0115,0.0624,0.0376,0.0617,-0.0146,-0.0606,-0.0575,-0.1101,-0.1017,-0.1012,-0.0439,-0.0591,-0.0296,0.02,-0.0455,-0.0544,-0.028,-0.0114,-0.0747,0.0276,0.0563,0.0354,0.0043,0.0129,-0.0264,0.0464,-0.0034,-0.0069,-0.0222,-0.0426,-0.0161,0.1393,0.0609,0.0561,0.0368,0.0551,0.0484,0.0028,0.0289,-0.0014,0.0422,0.0051,0.0492,0.0164,0.0291,0.0631,0.0251,-0.0065,0.0147,-0.0029,0.0153,0.0302,-0.0593,-0.0446,-0.0419,0.0168,0.0227,0.0126,0.0185,-0.0147,0.0057,-0.0074,-0.1059,-0.0269,0.0034,-0.0101,0.0235,0.0324,0.0293,-0.0224,-0.0281,-0.0254,0.0353,-0.0798,-0.1198,-0.1616,-0.0126,0.0296,-0.0265,-0.0023,-0.068,-0.0807,0.0048,-0.0894,0.0618,0.0013,0.0138,-0.0204,-0.0345,-0.0182,0.0188,0.0365,0.0023,-0.0074,0.021,-0.0285,0.0325,0.0168,-0.037,-0.0852,-0.0475,0.0727,0.0617,0.0319,-0.0309,0.1,0.0246,-0.0149,-0.0088,0.0009,0.0213,0.0691,0.0832,-0.0138,0.0265,-0.0062,-0.0065,-0.1012,-0.0205,0.0297,-0.0605,-0.1692,-0.042,-0.0672,-0.1183,-0.0097,-0.029,-0.103,-0.0861,-0.0112,-0.0857,-0.0427,-0.0707,-0.0173,-0.1345,-0.0468,0.0633,0.0939,0.0723,0.0634,0.0343,0.0323,0.0168,0.0372,0.0737,-0.0138,0.0366,0.0358,0.0007,-0.0223,0.047,0.0193,0.037,0.0181,-0.0057,-0.0073,0.0002,-0.0246,0.0057,-0.0147,0.057,0.0408,-0.0419,-0.061,0.0434,-0.0139,-0.0196,-0.0013,0.0027,0.0167,0.0326,0.0456,0.0023,-0.0143,0.0021,0.0063,0.0646,0.034,0.0985,0.0139,0.0195,0.0104,-0.0,0.017,-0.0018,-0.0039,0.028,-0.0118,0.0216,0.0538,-0.0775,0.021,-0.0364,-0.084,-0.0207,0.0519,-0.036,-0.0042,0.0687,0.0593,-0.0172,-0.0083,-0.0553,0.003,0.0251,0.0309,0.0545,0.0076,-0.0281,-0.0053,-0.0372,0.073,0.0423,0.0544,-0.0092,-0.0171,-0.0234,0.0248,0.0248,0.0273,0.0022,0.0014,-0.0181,-0.0432,-0.033,0.0,0.0173,0.0503,0.0249,0.0497,0.0939,0.0268,0.029,-0.0875,-0.0544,-0.1189,0.0187,-0.0647,-0.001,-0.0634,0.0241,-0.0425,-0.0574,-0.0129,0.0127,0.0182,-0.0021,-0.0632,-0.029,-0.051,-0.0098,0.0176,-0.0206,-0.0131,-0.0062,0.0071,-0.0023,-0.0057,0.0462,-0.0017,0.0061,-0.0335,0.059,0.035,0.0049,-0.0049,0.0278,0.0512,-0.0115,-0.0264,0.0223,0.0066,-0.0651,-0.0844,0.0344,0.0157,0.0296,0.0419,-0.0049,0.0173,0.0447,-0.0084,-0.0271,0.0474,0.0821,-0.0163,0.0255,0.0104,0.0394,-0.0476,-0.0403,0.0398,-0.0715,0.0538,-0.0142,0.0107,0.0335,0.0374,0.0584,-0.0229,0.0092,0.0293,-0.0172,0.0364,0.019,-0.0503,-0.0066,-0.0052,-0.0272,0.0203,-0.0328,0.0718,0.0046,0.0166,0.0206,-0.0206,0.0382,0.02,0.0228,-0.0202,-0.0778,-0.1084,0.029,0.0221,0.0289,-0.0234,0.0767,-0.019,0.0503,0.008,-0.0462,-0.0546,0.0139,-0.0453,-0.0419,-0.0082,-0.0034,0.0127,-0.0026,-0.0117,-0.1087,-0.0378,-0.0864,-0.0777,-0.0354,-0.0543,0.0053,-0.0289,-0.0332,-0.048,-0.042,0.0189,-0.0731,-0.0525,-0.0535,-0.0202,-0.0314,-0.035,0.0135,-0.0576,-0.037,-0.1347,0.0551,-0.0042,0.0097,0.1598,0.0432,0.1113,0.0589,0.0542,-0.0033,0.0053,0.1307,0.1006,0.0627,0.063,-0.0211,0.0327,-0.0223,0.0139,-0.0211,-0.0105,0.0118,0.0598,0.007,0.0246,0.0847,-0.0479,0.0806,0.0782,-0.006,0.0121,-0.0194,0.0151,0.0147,0.0645,-0.1164,-0.0926,0.0341,0.0257,-0.0131,0.0062,0.0088,0.072,0.0236,-0.1766,-0.1798,0.0007,-0.0129,0.0174,-0.0145,-0.0097,0.0678,0.0007,-0.0172,-0.0023,0.0093,-0.044,0.0006,-0.0176,0.0057,high energy density food recognition
trm_4a3fd79d0aa76,0.0483,-0.0262,0.0361,-0.0686,0.0149,-0.0223,0.0164,0.0093,0.0406,-0.001,0.0492,0.0655,0.007,-0.0241,-0.0435,-0.0286,-0.0496,-0.0978,-0.0102,-0.0695,-0.0097,0.0311,0.0083,-0.0192,0.0203,0.0447,0.0391,-0.0522,-0.0308,0.0444,-0.0535,-0.0526,-0.0642,0.0352,-0.1138,-0.0996,0.0852,-0.0167,-0.0699,-0.063,-0.053,-0.0536,-0.0202,-0.0041,-0.0593,-0.0959,0.1338,-0.0031,0.0401,-0.0175,-0.0267,0.0589,0.0353,0.0206,-0.0677,-0.0274,-0.05,0.0187,0.0272,-0.0012,0.0242,0.0566,-0.1175,0.0527,-0.0505,0.091,-0.1173,-0.1198,-0.0716,0.015,-0.0,0.0359,0.0462,-0.0353,-0.0511,-0.0359,-0.0506,0.0588,0.0144,-0.0127,0.008,0.0499,-0.1051,-0.0398,0.0061,0.0597,-0.0352,0.059,0.007,-0.1112,-0.0555,0.0615,-0.0444,0.1954,0.1695,0.1605,0.0986,0.0708,0.189,0.1118,0.0326,-0.0644,0.1063,0.1293,0.0668,-0.0916,-0.1098,0.063,-0.0215,-0.0297,-0.0189,-0.0392,0.0089,0.1175,-0.0111,-0.0393,-0.0172,0.0614,-0.0004,-0.0089,-0.1017,-0.1063,-0.1029,-0.0461,-0.0751,-0.1039,-0.1117,0.0522,0.0791,0.0327,-0.0784,-0.027,-0.0109,-0.136,-0.0899,-0.1143,0.054,-0.0638,-0.0718,-0.0021,-0.025,-0.0369,-0.0401,-0.0556,-0.0442,0.0103,0.0521,0.0188,-0.0707,-0.0042,-0.0342,-0.0813,-0.0559,-0.1071,0.0518,0.0275,0.0955,0.0156,0.025,-0.0169,-0.0423,-0.0583,-0.1034,-0.0783,-0.0136,-0.0502,0.0137,-0.1117,-0.1046,-0.0272,-0.0013,-0.0798,0.0801,-0.1042,-0.054,-0.0914,-0.064,-0.0435,-0.0458,0.0543,-0.1173,0.0131,-0.0714,0.0043,0.0439,0.0074,-0.0194,-0.0634,-0.0426,-0.0622,-0.0616,0.0136,-0.0094,-0.0445,-0.0405,-0.1117,-0.1018,-0.0404,-0.0793,-0.0445,0.0307,0.2284,-0.1201,-0.065,-0.0557,-0.0428,-0.1344,-0.0343,0.0033,-0.0014,-0.108,-0.034,-0.0404,0.0354,-0.0186,-0.0095,0.0395,-0.0328,0.0574,-0.0026,0.0785,-0.0554,-0.1149,-0.0707,0.0667,0.0327,-0.1005,0.028,-0.0527,0.0177,0.0906,-0.0483,0.0961,-0.0627,-0.0572,0.048,-0.0089,0.0122,0.0069,-0.0252,0.0422,-0.0609,-0.0283,0.0046,-0.0293,-0.0571,-0.0859,-0.099,-0.0467,-0.1029,0.0562,-0.0141,-0.0508,0.0018,0.0165,-0.0598,0.0012,-0.0616,0.0562,0.0868,0.0568,0.104,-0.0305,0.0455,0.0801,0.0951,0.0005,-0.0292,0.0168,-0.023,-0.0457,0.017,-0.0951,0.0104,-0.0309,0.0069,-0.0585,-0.0993,-0.0491,-0.0327,0.0021,-0.0451,-0.0165,-0.1723,-0.1614,-0.0526,-0.0058,0.0241,0.02,-0.0151,-0.0402,0.0173,0.008,-0.0465,-0.0155,0.0094,-0.0217,-0.0004,-0.0533,0.0657,0.0391,-0.0996,-0.0366,-0.0573,0.1164,0.1271,-0.0398,-0.001,0.0325,-0.0386,-0.0229,0.0127,-0.0783,-0.0004,0.0086,-0.0124,0.037,0.0286,0.0145,-0.0609,0.0083,0.0124,-0.1194,-0.1773,-0.0195,-0.0572,-0.0554,-0.0893,0.0148,-0.047,0.0116,0.0103,0.0082,-0.0059,-0.0105,0.1238,-0.0409,-0.048,-0.0358,-0.0927,-0.0778,-0.009,0.0802,0.0773,0.0355,0.0253,-0.0452,-0.0111,-0.0065,-0.0584,-0.0029,0.1152,0.0394,0.0412,-0.0159,0.0315,-0.0136,-0.0624,-0.0268,-0.084,0.033,0.005,-0.0324,0.06,0.0448,0.0871,-0.0501,0.065,-0.0354,-0.0127,-0.026,0.0595,-0.0346,0.1145,-0.0887,-0.0295,-0.0938,0.0611,-0.001,0.0075,0.0045,0.1472,-0.0295,0.0024,0.0108,0.0064,-0.0557,-0.0053,0.0044,-0.0239,0.0681,-0.0554,0.0654,-0.0778,0.2839,0.2779,0.105,-0.0113,-0.0101,-0.0695,-0.0698,0.0124,0.0334,0.026,0.0346,-0.0221,0.0141,0.0034,-0.0059,0.0202,0.0163,-0.097,-0.0268,0.0534,-0.0976,-0.0766,0.0231,-0.0605,-0.074,-0.02,0.0477,-0.0427,-0.0178,-0.164,-0.1666,-0.0206,-0.0738,0.1047,-0.0469,0.0192,-0.0137,0.0281,-0.0241,0.0446,-0.0486,0.0397,0.0206,-0.0067,-0.0858,-0.0533,0.0169,0.0229,0.0294,-0.0071,0.0715,0.0003,0.023,0.1003,-0.1236,-0.1165,-0.0472,0.0396,-0.0709,-0.0559,0.069,-0.1172,-0.0176,-0.0434,-0.1028,0.0282,0.0671,-0.0024,-0.0306,-0.0512,-0.0471,-0.1109,-0.0254,0.1107,-0.0514,-0.0177,0.0134,0.0636,0.0867,-0.0431,-0.0778,-0.033,0.0492,0.0475,-0.0157,0.0189,0.0959,0.0413,0.018,0.0599,-0.0206,0.0098,-0.0128,0.0012,-0.1268,-0.0058,0.0621,0.0443,-0.1583,-0.1703,0.0044,-0.0197,-0.1955,-0.0137,-0.0246,-0.0668,-0.0597,-0.0031,-0.0363,-0.0286,-0.0259,-0.0637,-0.0528,-0.0498,-0.0622,0.1186,-0.0486,0.0383,-0.0384,-0.0118,0.0849,0.0037,0.0139,0.0644,0.1037,0.0021,-0.0097,0.0075,0.0347,0.0275,0.0811,0.034,0.0383,0.1047,0.0316,0.0062,-0.0794,-0.0116,0.0195,-0.1255,-0.0149,-0.0264,-0.1028,-0.0724,-0.0127,-0.0676,-0.0501,0.0112,0.0467,-0.0071,-0.0477,0.0312,-0.0274,0.0131,-0.0095,-0.0353,0.0905,-0.0758,-0.0316,0.0502,-0.0169,-0.0681,0.1158,0.0046,0.0095,0.0075,-0.0533,-0.0622,-0.1083,0.072,-0.0781,-0.0123,0.0537,-0.1411,-0.0196,-0.07,-0.0676,-0.0706,-0.0276,0.0218,0.2286,0.233,0.0228,0.0087,0.0455,-0.002,0.0175,-0.0265,-0.0374,0.0043,0.0915,0.0296,0.0672,-0.0222,0.0564,-0.0192,-0.0591,-0.011,0.0091,0.0126,-0.0108,0.0783,-0.0874,-0.0111,0.1295,-0.0878,-0.0382,0.0502,0.0645,0.0028,0.0564,0.2297,-0.1077,-0.0155,-0.0127,0.0152,0.0015,0.0112,0.0246,-0.0448,-0.0773,-0.0368,-0.0083,-0.0382,-0.0349,-0.1259,-0.0035,-0.0781,0.0307,0.0366,-0.0264,0.0848,-0.0293,-0.0739,-0.0032,0.0028,0.054,0.17,-0.062,-0.0304,-0.0324,0.055,0.0407,0.0035,-0.0182,0.0009,-0.0181,0.0847,0.0561,0.1481,-0.0923,-0.0226,-0.14,-0.0698,0.0952,-0.1037,-0.0475,-0.11,0.1217,-0.1278,-0.0252,-0.0033,0.237,0.0015,0.0075,-0.0932,-0.0943,0.1467,0.1334,0.1029,0.1154,0.0719,0.0642,-0.1255,0.0629,0.0815,-0.0095,-0.0262,-0.0087,-0.0501,-0.0272,-0.0647,0.0864,-0.0288,0.01,-0.0204,0.0051,0.0294,-0.0189,0.0197,0.1061,-0.1112,-0.0381,-0.0268,-0.0013,0.0444,0.1966,0.0472,0.0917,0.0071,0.0219,-0.1305,-0.0009,-0.0223,-0.0183,-0.0336,0.0127,-0.0245,-0.0155,-0.0557,-0.0551,0.0097,-0.0833,-0.0944,-0.0635,-0.006,-0.0042,-0.0662,-0.0572,-0.0428,-0.0803,-0.0227,0.053,-0.0547,-0.093,0.0276,0.0468,0.0183,-0.2185,-0.2057,-0.1586,-0.0423,-0.0131,-0.0298,-0.0166,-0.0044,0.0211,-0.0045,0.037,0.078,0.05,-0.0162,0.0322,0.0432,0.0433,0.0399,-0.0923,-0.0262,-0.0228,-0.0051,-0.0419,0.0027,-0.003,0.0141,-0.0128,-0.0128,-0.0302,0.0522,-0.1013,-0.1632,-0.14,-0.1049,0.0035,0.0606,0.0067,-0.0581,-0.0427,0.1,0.0298,0.0066,0.0537,0.0427,-0.0317,-0.024,-0.0089,0.0129,0.0286,0.0747,0.0227,0.057,0.0723,-0.0206,0.039,-0.028,-0.0529,-0.1043,-0.0905,-0.0629,-0.0947,0.0902,-0.0086,-0.0235,-0.0266,0.0415,0.0003,0.0513,0.0669,-0.0808,0.0021,-0.0146,0.0018,0.0483,0.0252,-0.1166,0.0192,-0.0446,-0.0427,0.0687,-0.0185,0.1029,-0.0294,-0.0209,0.0234,0.0029,0.0191,0.1879,0.0753,0.073,0.0778,0.055,0.0725,-0.0031,0.1444,0.1122,-0.0561,0.0241,-0.0392,-0.0881,-0.1007,-0.0177,-0.0161,0.0017,-0.1599,-0.016,-0.099,-0.055,-0.0915,-0.0163,0.0249,0.0212,-0.0195,0.0495,-0.0449,0.0546,0.0321,-0.0216,-0.011,0.0585,0.0608,0.0154,0.0562,-0.0426,0.0689,0.1149,-0.0947,0.0965,0.0431,-0.0072,-0.0278,-0.0145,-0.0578,0.0488,-0.0331,-0.1938,-0.1323,-0.0189,0.0582,-0.0356,-0.0821,-0.0078,0.0002,0.1231,-0.0271,-0.0163,0.1053,-0.0759,0.0017,-0.0828,0.2463,-0.0377,0.0968,0.0033,-0.0541,0.0113,-0.1708,-0.1789,-0.0484,0.1328,-0.0388,-0.0403,-0.014,0.0423,-0.007,-0.0581,-0.0678,-0.0326,-0.0007,-0.0079,0.0059,0.0431,-0.0473,0.0524,-0.0721,-0.075,-0.0347,-0.004,-0.0254,0.0611,0.0452,0.0788,0.0343,0.0934,0.0715,-0.0318,0.01,-0.1141,-0.0768,-0.048,-0.0632,0.0181,0.0668,0.0466,-0.0,-0.0435,0.0278,0.0689,0.0585,-0.0039,-0.0451,0.0034,0.0724,0.0141,0.0387,0.1256,-0.035,-0.0574,0.0162,0.0619,0.0145,-0.048,-0.0015,-0.0064,-0.0767,0.0021,-0.0087,0.0126,0.012,-0.16,-0.117,-0.1518,-0.0271,-0.0039,-0.0581,-0.0845,-0.0426,-0.0896,-0.0884,-0.1543,-0.069,-0.0683,-0.037,-0.0084,0.0373,-0.0777,0.0081,-0.0371,-0.021,0.048,-0.032,0.0576,-0.0026,-0.0684,0.0316,-0.0015,-0.023,-0.039,0.0275,0.0368,-0.01,-0.0564,-0.0237,0.0624,-0.0348,-0.034,-0.0002,-0.006,-0.0647,-0.0061,-0.0681,-0.081,-0.0737,-0.1404,-0.1277,0.0915,0.0656,0.0796,-0.0133,0.0294,0.055,0.0153,0.0132,-0.0167,0.0379,0.0388,0.0048,0.0037,0.0286,-0.0468,-0.0037,0.0168,-0.0039,-0.0509,-0.0424,-0.0592,-0.1236,-0.0875,0.0855,0.0601,0.108,0.005,0.0025,-0.0582,-0.088,0.0104,-0.0569,-0.0286,-0.0209,-0.0068,0.0035,0.0796,0.0198,-0.0111,-0.0578,0.001,-0.0715,-0.0152,-0.0399,0.0997,0.1831,0.2501,-0.0316,-0.0226,-0.0205,-0.0195,-0.0272,0.003,-0.0718,-0.0394,0.0489,-0.0002,0.0588,-0.0173,0.019,0.0055,0.0068,-0.0566,0.1077,-0.1216,-0.0696,-0.1206,-0.0541,0.0821,0.0143,0.0592,-0.1006,0.1343,0.053,-0.0067,-0.0269,-0.0275,-0.0249,-0.0382,0.0539,-0.0396,-0.0962,-0.0814,-0.029,-0.1223,-0.065,-0.0719,0.0051,-0.0447,0.0121,-0.0757,0.0145,0.0291,0.1476,-0.0189,0.0166,0.0033,-0.0146,0.0587,-0.0191,0.0342,0.0122,-0.021,0.205,0.1786,0.1884,0.1384,0.1377,0.0628,0.1885,0.0856,-0.0442,0.0114,0.0289,0.0184,0.0132,-0.0063,-0.049,-0.0051,-0.0391,-0.0555,-0.0256,-0.0114,0.0173,0.0005,-0.0542,0.07,0.0872,-0.0197,0.0423,-0.0518,-0.1142,0.0402,-0.029,-0.0794,-0.0144,0.0154,0.074,0.0651,0.1097,-0.0546,-0.1195,-0.0501,-0.0481,-0.016,0.0076,-0.0109,0.1212,-0.0571,-0.1564,-0.0931,-0.0295,0.0272,0.0721,0.2308,0.1389,-0.0505,0.0405,0.0972,0.3194,0.2834,0.2673,0.0917,0.0745,-0.0005,0.0567,0.016,0.0252,-0.0851,-0.006,-0.0019,0.1118,0.0277,-0.0475,0.0156,-0.0364,-0.0336,0.0346,0.0191,0.0207,0.2265,0.0009,-0.008,-0.0201,-0.0583,0.0086,0.0882,0.057,-0.0476,-0.0443,-0.1195,-0.0751,0.0503,-0.0264,-0.0337,-0.0355,-0.037,-0.0209,0.018,0.0504,0.1507,-0.0442,-0.0889,-0.0636,0.0083,0.0103,0.0626,-0.1038,0.0608,0.1537,-0.0015,-0.1555,0.051,0.0542,-0.058,-0.0881,0.0127,-0.0695,-0.0324,-0.121,-0.0256,0.1265,-0.0717,-0.0622,0.0419,-0.045,0.0164,0.0004,-0.0501,-0.0685,-0.0849,0.0511,0.0309,-0.0009,0.0463,0.046,0.0805,0.0258,-0.0461,0.0132,-0.0395,-0.0511,-0.0875,-0.0348,0.1245,0.0615,-0.1004,-0.0639,-0.0034,0.0503,-0.0274,0.0401,0.0131,0.0202,0.0125,0.0932,-0.0986,-0.0676,-0.0844,0.0724,0.0174,-0.0651,0.0769,0.0769,-0.0754,0.0031,0.0061,0.02,0.0131,0.0103,-0.0835,0.2709,-0.136,-0.1357,-0.0296,-0.0647,-0.0527,-0.0628,-0.0774,0.0462,0.0208,-0.0647,0.0202,-0.0002,0.1963,-0.0496,-0.0764,-0.0376,-0.039,0.054,-0.0149,0.0123,-0.0122,-0.0921,-0.0696,-0.1107,-0.0753,-0.0797,-0.0388,0.0056,-0.0049,0.2782,0.2192,0.2182,-0.0247,0.2382,-0.072,-0.0128,0.0015,-0.0492,0.0227,-0.1076,-0.0467,-0.0418,-0.0509,-0.1171,0.0859,0.0518,-0.1001,0.0262,0.06,0.0199,-0.1222,-0.0452,-0.0029,-0.0075,-0.0385,0.0428,-0.0039,0.1048,0.1097,0.1726,0.0795,0.0139,0.0558,-0.0357,-0.0893,-0.0862,0.0057,-0.0648,-0.0652,-0.0649,0.0112,0.0252,0.0321,-0.0412,-0.0303,-0.0965,0.0287,0.0343,0.0402,-0.0002,-0.0441,0.0441,-0.0194,-0.0839,-0.0772,-0.1176,-0.0607,-0.0306,-0.0921,-0.0942,0.0031,0.0063,0.0972,0.1036,-0.0041,-0.0234,-0.028,0.0512,-0.0526,-0.032,0.0417,0.0458,0.0696,-0.1782,-0.028,0.0928,-0.0702,-0.0545,-0.0112,-0.0507,0.0003,-0.033,0.1147,0.0958,-0.1198,0.0693,-0.0201,0.1031,0.1495,0.1095,0.0004,0.04,0.0704,0.1456,-0.011,0.0409,-0.036,-0.0133,-0.1133,-0.0887,-0.0624,0.0443,-0.0258,-0.0252,-0.0715,-0.0207,-0.0669,-0.0264,-0.1086,-0.0237,-0.0046,-0.0392,0.01,0.0651,-0.0367,-0.0149,-0.0719,-0.0577,-0.0075,0.0007,-0.0445,0.0091,0.0464,-0.036,0.0386,-0.0226,-0.0443,-0.0273,0.0523,0.0423,-0.1341,-0.2046,0.0471,0.163,0.2648,0.0013,-0.03,-0.0052,0.0514,0.0409,-0.0508,-0.0766,-0.0813,0.0242,-0.1544,0.0281,0.0188,-0.0182,-0.0283,-0.0308,-0.012,-0.1106,-0.1182,0.0214,-0.0633,-0.0472,-0.0067,0.0983,-0.0341,0.066,0.0266,-0.0069,-0.0261,0.017,0.0641,-0.0202,-0.0154,-0.0467,-0.0541,-0.0517,-0.043,-0.0294,0.0907,0.07,0.1553,0.1371,-0.0246,-0.0283,-0.0376,0.0283,0.0255,-0.0018,-0.0613,-0.0247,0.0118,-0.0345,-0.0228,-0.0192,0.0872,0.0134,-0.0061,0.0209,-0.0306,-0.0446,-0.0344,-0.0421,-0.0193,-0.0392,-0.102,-0.0852,-0.1308,-0.0542,0.0482,-0.0308,-0.0491,-0.0455,-0.0086,0.0832,0.1112,0.0327,-0.0302,0.0821,-0.006,-0.0153,-0.0747,0.0262,0.001,-0.0398,0.0981,0.1551,0.0734,-0.034,-0.0195,0.0096,0.2271,0.2195,-0.1731,-0.1216,0.0278,-0.0414,0.0154,0.0247,-0.0852,-0.0112,-0.0224,-0.033,0.0805,-0.0141,0.1664,-0.0726,0.1134,0.026,0.026,0.0701,0.1848,0.2078,-0.0652,0.0834,0.038,0.0196,0.003,0.0041,-0.0501,-0.0214,-0.037,0.0755,0.0158,-0.0351,-0.0132,-0.0798,-0.0037,-0.1124,-0.1155,-0.1091,0.0488,-0.074,0.0275,-0.0049,-0.0754,-0.0965,0.0272,0.0138,-0.053,-0.0545,0.0674,0.0271,-0.0925,-0.1458,-0.0891,-0.0374,-0.0378,-0.0693,0.0095,-0.0072,-0.006,0.0405,0.0968,0.0619,-0.0205,0.0848,0.0175,-0.0163,0.1889,-0.0546,-0.1135,-0.0106,-0.1269,0.0204,-0.0235,0.0487,-0.0117,0.0216,0.0332,-0.0084,-0.0109,0.0921,-0.0048,0.0555,-0.0398,0.0554,0.0566,0.0554,0.038,0.0881,-0.0149,-0.0197,-0.0185,-0.0174,-0.0633,-0.0145,-0.0898,0.0307,-0.0223,0.0012,0.1587,0.1571,-0.1176,-0.0593,0.0421,0.0168,0.0545,0.0361,0.0526,0.0186,0.0071,-0.0854,-0.0354,-0.0539,0.0099,-0.0015,0.0187,-0.1024,-0.1133,-0.1322,-0.0005,0.0066,-0.0047,0.0889,-0.039,-0.0443,-0.0449,0.1982,0.0459,0.2551,-0.0381,-0.0182,0.0419,0.0543,0.1857,0.0923,0.0934,-0.0063,0.0087,-0.0622,0.043,0.0191,0.1011,-0.0976,-0.0448,-0.067,-0.0894,-0.023,-0.0033,0.0053,0.1815,-0.0595,0.1115,0.1067,0.0893,-0.0195,-0.0046,0.028,0.0369,0.0266,0.0191,0.0904,0.0319,0.0664,-0.1216,-0.0688,-0.1058,-0.006,-0.0324,-0.0746,-0.0748,-0.0596,-0.0559,-0.0625,-0.0151,-0.0421,0.1105,-0.0153,-0.0468,0.0885,0.0297,0.0063,0.0738,0.0001,-0.0959,0.0981,-0.0515,-0.0116,-0.0735,-0.0111,0.0244,0.0316,-0.0343,-0.013,-0.0166,-0.0151,-0.1159,-0.0741,-0.0913,-0.094,-0.017,0.0562,0.1106,-0.0917,-0.1034,-0.0242,-0.0314,-0.1168,-0.042,0.024,-0.0359,-0.007,0.0474,-0.0504,-0.0955,-0.061,0.0489,0.0333,-0.0026,-0.1948,-0.0626,-0.0723,-0.0669,-0.2348,-0.0089,-0.045,0.0518,-0.0559,-0.0021,0.0271,0.0298,-0.0926,-0.0411,-0.1232,-0.0618,-0.0007,0.0523,-0.0562,0.0564,-0.1498,-0.0732,0.0187,0.0604,-0.0227,-0.0054,-0.0807,0.0739,-0.1418,-0.1831,-0.1539,0.0393,-0.0254,-0.094,-0.049,-0.0416,-0.0569,-0.0401,-0.029,-0.0163,-0.11,-0.0117,-0.0815,-0.0342,-0.0367,-0.0046,-0.1618,-0.0747,-0.1018,-0.0241,0.0219,-0.0587,-0.1439,-0.1555,-0.0391,-0.1161,0.0092,-0.2123,-0.2004,-0.0201,0.1621,0.1064,-0.0604,0.0288,-0.0021,0.1009,0.079,0.0791,-0.1796,-0.1881,0.0063,0.0283,-0.0233,0.0208,-0.0054,-0.001,-0.0155,-0.0242,-0.0424,-0.0461,0.0492,-0.0304,-0.0283,0.0228,-0.0667,-0.0093,0.0384,0.0078,0.1717,0.1451,0.0091,-0.0766,-0.1443,-0.0814,-0.0711,-0.1155,-0.0873,0.1587,-0.0035,-0.033,0.2704,0.1862,0.2063,0.1717,0.1807,0.2107,0.1467,0.1086,0.1312,0.068,0.1093,0.2078,0.2573,0.2904,0.2106,-0.1497,0.1403,0.0828,0.2062,-0.0948,-0.0395,0.066,-0.0479,0.0201,0.148,0.0846,-0.0395,-0.0174,0.1033,-0.0266,-0.046,0.0911,-0.0066,-0.0197,0.0413,-0.0038,-0.0451,-0.026,-0.0308,-0.0026,0.0461,0.0228,-0.0424,0.0305,0.0163,-0.1826,-0.0936,-0.0922,-0.0998,-0.0616,-0.1127,-0.0827,-0.0557,-0.0332,-0.0457,0.0116,0.0541,-0.0307,-0.0846,-0.1898,0.0875,-0.0718,-0.0158,0.022,-0.0546,0.0442,-0.0793,-0.052,-0.0625,0.0157,-0.0503,0.0174,-0.0182,0.0935,0.1623,0.1241,0.0321,-0.0499,-0.0171,-0.09,-0.07,-0.023,-0.0357,-0.0578,0.0678,-0.0205,-0.011,0.0139,-0.0502,-0.0153,0.0162,0.0347,-0.0058,-0.0475,-0.0665,0.0996,0.0185,0.0125,-0.0959,-0.0241,0.0735,-0.0644,-0.0264,-0.0511,0.0197,-0.0097,0.1339,0.0185,-0.039,0.0833,0.1085,0.0861,0.0062,0.1839,0.0832,-0.0698,-0.0399,0.1625,0.1892,0.048,0.0822,0.0243,0.0994,-0.0705,-0.0683,-0.01,-0.0136,0.1459,0.1617,0.0467,-0.0208,0.0293,0.0806,0.1599,0.1528,0.1413,-0.0092,0.0048,0.006,0.0331,0.034,0.0096,-0.0846,-0.0754,-0.0236,-0.0838,-0.0641,-0.058,0.0282,-0.0319,0.0036,-0.0239,-0.0104,0.0741,0.0925,0.0622,0.0354,0.0508,0.0219,-0.0376,-0.011,-0.011,-0.0229,-0.0593,-0.003,-0.0596,-0.0962,-0.0857,0.0661,0.0062,-0.0296,0.1097,0.0272,0.062,0.0695,-0.0049,0.0711,0.0089,-0.0912,-0.1177,0.1149,-0.018,-0.0705,0.0676,0.0919,0.0968,0.0567,-0.0088,-0.0063,-0.0617,-0.0484,0.2135,-0.0117,0.0005,-0.0013,-0.037,-0.0105,0.0769,-0.0248,0.0085,-0.0057,-0.057,-0.0206,-0.067,-0.0488,-0.0707,0.0459,0.0389,0.045,0.0621,0.0155,0.0195,0.1689,0.1682,0.0568,0.1193,-0.1436,0.0611,0.0398,0.1218,0.1706,0.0917,0.0382,0.0335,-0.0159,0.0979,0.0369,0.0186,0.0033,0.0078,0.0354,-0.029,0.0288,-0.0387,0.0123,0.0644,-0.0121,0.0561,-0.0146,0.1611,0.0001,0.0513,0.0461,-0.1308,-0.0662,0.0165,-0.0409,-0.0947,0.0898,0.0481,-0.05,-0.0303,0.0851,0.0421,-0.1302,-0.0253,0.035,-0.1024,0.0278,0.0164,0.051,0.062,0.124,0.1743,0.1991,0.0827,-0.0139,0.0523,0.0973,-0.0357,-0.0395,0.023,0.0093,-0.0498,0.0561,-0.0593,-0.0146,-0.1149,-0.1436,-0.1363,-0.0782,-0.1086,-0.0352,-0.0021,-0.1168,-0.0268,0.0561,0.0405,-0.0274,-0.0107,-0.0374,0.0466,-0.0243,0.0341,0.0402,-0.0124,-0.0461,-0.0594,0.0246,-0.0671,-0.026,0.0992,-0.0452,-0.0457,0.0334,-0.0126,0.0191,0.0189,-0.0285,-0.0265,-0.0611,0.0069,-0.0334,-0.0519,0.066,0.0008,0.0529,-0.0252,-0.1524,-0.0849,-0.0265,-0.0635,-0.0329,-0.0036,-0.0941,-0.0368,0.0465,-0.0212,0.0407,-0.1828,-0.0585,-0.0851,-0.1559,-0.0866,-0.0742,0.0174,0.0174,-0.0521,0.005,0.0624,-0.1036,-0.0292,0.0322,0.0026,-0.0544,-0.0668,-0.2322,0.0622,-0.0468,-0.0094,-0.0652,0.1518,-0.046,-0.0764,-0.11,-0.0482,0.0106,0.0205,-0.0527,0.1243,0.0694,0.1237,0.1956,0.112,-0.0146,0.0359,0.1232,0.0518,0.0412,-0.1969,-0.142,0.0024,-0.0765,-0.0109,0.0333,0.0163,0.0507,0.0001,-0.0141,0.0745,0.01,-0.0604,0.0265,0.004,-0.1617,-0.0488,-0.1819,-0.0027,-0.0262,0.0484,-0.0545,0.2802,0.282,0.1093,0.1517,0.0709,0.0175,0.0178,0.0007,0.0781,0.0262,-0.0042,0.0949,-0.0157,0.046,-0.0427,0.0103,0.0073,-0.0813,0.0177,-0.0319,-0.037,0.1647,-0.0764,0.18,0.0616,0.19,0.025,0.084,0.1517,0.0869,-0.0055,-0.0382,0.0176,0.0575,-0.0156,-0.0482,-0.1063,-0.0472,0.0609,0.013,-0.0529,-0.0124,-0.0056,0.0206,-0.0313,0.01,-0.0449,-0.0011,0.0443,-0.0209,0.0582,-0.0139,-0.0567,0.0018,0.0438,-0.0461,0.0012,0.0001,0.0044,0.0153,0.0845,-0.0445,0.1154,0.0297,0.0602,0.0294,0.0121,0.0897,0.0371,-0.0373,0.0115,-0.0685,-0.0683,0.0256,0.0489,-0.0293,-0.0672,-0.007,0.0077,-0.0558,-0.0981,-0.0823,-0.095,-0.115,0.0236,0.0017,0.0063,-0.1266,-0.0732,-0.0683,0.0043,-0.0352,0.0188,0.0106,0.1219,0.0635,-0.0697,-0.0286,-0.0007,-0.006,-0.0789,-0.0767,0.117,0.0851,-0.0979,-0.0096,0.0318,-0.0328,0.0694,0.0396,0.0602,-0.0324,0.0519,-0.1011,0.0277,-0.072,-0.0814,0.1275,-0.0823,0.0867,0.1295,0.0841,0.0873,0.077,-0.0229,-0.0546,-0.1101,-0.0229,-0.0073,-0.0258,0.0261,-0.0472,-0.0554,-0.083,-0.0987,-0.1027,-0.0842,-0.0237,-0.0288,-0.0236,-0.0755,-0.0223,-0.0404,-0.0522,0.0265,-0.0099,-0.0454,-0.1447,-0.0216,0.0241,0.0965,0.0043,-0.0271,-0.0002,0.033,-0.0326,-0.0364,-0.0171,-0.0503,-0.0003,-0.0666,-0.1514,-0.0303,-0.0212,-0.0655,-0.0646,0.0234,0.0444,-0.0287,-0.0916,0.0409,-0.0657,0.0182,-0.0879,-0.0972,0.0395,-0.0557,-0.0458,-0.1692,-0.0681,0.0516,0.1587,-0.0949,-0.0009,-0.0569,0.0572,-0.0065,-0.0013,-0.0528,-0.1212,-0.0827,-0.0251,-0.0599,0.0151,-0.0136,-0.0303,-0.0118,0.0303,0.049,0.0064,0.0547,0.0062,-0.0455,-0.0122,0.0041,-0.0382,0.0046,-0.0676,-0.0377,0.1015,-0.0284,0.0813,0.0237,0.0428,0.0577,0.1398,-0.0472,-0.0357,-0.1303,-0.0224,0.014,0.1247,0.1319,0.0715,-0.0101,-0.0177,-0.0051,0.0959,0.1047,0.039,0.0586,-0.1757,-0.0308,-0.0072,0.0666,-0.0304,0.0217,0.1108,0.0486,-0.0054,0.0219,0.0098,-0.0132,0.0557,0.0286,-0.0184,0.0769,0.0391,-0.0042,-0.018,0.0405,0.0331,-0.0188,0.0419,0.0442,-0.0183,0.1467,0.0613,0.0747,-0.0304,-0.0191,0.0059,-0.009,-0.0259,-0.1884,-0.1961,0.1002,0.061,0.1068,-0.0127,-0.006,-0.1193,-0.1039,-0.1062,-0.1155,-0.0006,-0.0093,-0.0298,-0.0438,0.0654,-0.0212,-0.0569,0.0063,-0.0428,-0.0493,0.1472,-0.0883,0.0309,-0.1485,-0.0521,-0.0376,0.0605,-0.0254,0.0482,-0.0436,0.0971,-0.0308,0.1117,-0.0815,0.0665,0.0177,0.0149,0.0395,0.0738,0.1043,0.1287,0.1274,-0.1215,-0.1147,-0.0969,-0.0328,-0.0933,-0.0601,-0.0773,-0.1259,-0.0775,-0.0249,-0.096,0.0417,-0.0721,0.0153,-0.0265,-0.0482,0.0088,-0.0045,-0.1895,-0.093,0.1231,-0.0356,-0.1104,-0.0128,0.1074,-0.0457,0.0569,0.0125,0.0382,0.1151,0.0811,-0.1112,-0.112,-0.0372,-0.0315,0.0586,0.0836,0.0122,-0.0129,0.003,0.0873,0.0953,0.0973,0.0086,0.0909,-0.1361,-0.1474,-0.083,-0.1394,-0.0488,-0.0766,-0.1109,-0.0793,-0.0164,0.0172,-0.0212,-0.0339,0.0235,-0.1087,0.1892,0.19,0.1373,0.0879,0.0174,0.1143,-0.178,-0.1205,-0.1605,0.0497,0.0885,0.0893,0.0283,0.0262,0.2144,0.1359,0.2108,0.0551,-0.0256,-0.0277,0.0146,0.0713,0.0161,0.0031,0.0457,-0.0572,-0.0519,0.0326,0.056,-0.0023,-0.0184,-0.0768,-0.062,-0.0314,-0.056,0.1374,-0.0163,0.1018,0.0682,0.056,0.0598,0.058,0.0477,-0.0131,0.0272,0.0785,0.0157,0.071,0.0902,-0.0217,-0.0105,0.0287,0.0971,0.0804,0.0763,0.0645,0.0534,0.0728,0.021,-0.0649,0.0346,0.0274,-0.0482,-0.0261,0.0333,0.0748,-0.0062,-0.0726,0.0212,-0.002,0.1653,0.0324,-0.0564,-0.0255,0.0677,0.0299,0.114,0.0701,0.0827,0.0205,0.0106,0.1379,-0.1368,-0.1014,0.0329,0.0939,0.0718,0.0571,0.0257,0.0036,-0.0561,-0.0499,0.0432,0.2189,0.0348,0.008,-0.0424,-0.0664,-0.1915,-0.1146,-0.1417,-0.0958,-0.0834,-0.0413,-0.0415,-0.0138,0.099,0.1026,0.048,-0.0852,-0.0388,-0.0949,-0.0438,-0.0365,0.0405,-0.0217,-0.0236,0.1493,0.1486,0.0671,0.0131,-0.0116,0.0505,-0.1291,-0.0532,-0.0755,-0.0385,0.0766,0.0869,-0.0214,-0.0539,0.0355,0.0699,-0.0875,-0.0467,-0.0237,-0.0029,-0.1255,-0.0882,-0.0663,-0.1087,0.0526,-0.0731,0.0673,0.1449,-0.0685,-0.1323,-0.0945,0.0447,0.0707,-0.0409,-0.0364,-0.236,-0.1512,-0.0668,-0.1709,0.1655,-0.0357,-0.0959,0.0438,-0.0745,0.0958,0.0876,0.068,0.0791,0.0644,0.1637,0.0318,0.0949,-0.0686,-0.0555,0.0569,-0.0481,-0.034,0.0176,-0.0368,0.1192,0.0661,-0.0377,-0.0857,-0.058,0.0252,-0.0174,-0.0749,0.098,-0.0328,-0.0,-0.0012,0.0279,0.011,-0.0562,-0.0106,-0.0233,-0.0157,-0.1243,-0.0542,-0.0119,-0.0482,-0.001,-0.0688,-0.0059,0.0547,0.0024,-0.0334,0.0424,-0.0483,0.0177,-0.05,-0.0519,-0.0439,-0.0434,-0.0006,0.0065,0.019,-0.0537,-0.0131,-0.0581,0.0807,0.0271,0.0165,-0.0407,0.1108,-0.0671,-0.0948,0.0348,0.0551,0.0085,-0.0257,-0.0741,0.0217,-0.0512,-0.0171,0.0601,0.1102,0.1744,-0.0365,-0.0284,0.0434,-0.0063,-0.0281,0.1621,-0.0241,0.1903,-0.1131,0.2277,0.2104,0.0229,-0.0451,-0.0108,-0.0388,-0.0059,0.0636,0.066,0.0977,-0.0108,-0.0157,-0.0154,0.0804,0.0241,0.0265,-0.0907,-0.0903,-0.1105,0.0244,-0.0376,-0.1281,-0.0392,-0.0372,0.0228,0.0087,-0.0126,-0.0297,0.1778,0.0033,-0.0774,0.2627,0.1365,0.0299,-0.0324,0.1064,0.1398,0.1436,0.0514,0.04,-0.002,-0.0066,0.0728,0.0794,-0.0542,0.0921,0.0098,0.0049,0.0051,0.1638,0.0797,-0.0492,-0.0537,-0.0202,-0.1458,-0.0503,-0.098,-0.0735,-0.0314,-0.1329,-0.0161,-0.1185,-0.1043,0.041,-0.0905,-0.1431,-0.1203,-0.0457,-0.0843,-0.1067,-0.1421,-0.1398,-0.1433,-0.0225,-0.0815,-0.0543,-0.0306,0.0067,0.0358,-0.0566,0.0473,-0.0405,0.0459,-0.0316,-0.0454,-0.0161,0.0209,-0.0556,-0.0284,-0.2242,-0.2297,-0.0191,-0.0133,-0.0965,-0.1597,0.0348,-0.0744,-0.0729,-0.1563,-0.0601,-0.0692,0.0736,0.0316,0.0562,-0.0527,0.0811,-0.0223,0.0899,0.0826,0.1939,-0.0723,0.0962,-0.1987,0.0007,0.0048,-0.014,-0.0131,0.0036,0.0995,0.1189,0.0609,0.0276,0.1198,-0.1311,-0.0585,0.0855,0.0054,-0.0257,-0.0279,0.0187,0.0355,0.1083,0.0946,-0.1568,-0.1056,0.0714,0.0906,0.033,0.1515,0.0462,0.0075,-0.0363,-0.071,-0.0021,-0.0829,-0.1074,-0.0577,-0.0792,0.0043,-0.0082,0.0493,-0.0144,0.1032,-0.0569,0.0653,-0.0296,0.0208,0.0089,-0.0086,-0.0365,0.0073,0.0003,0.0059,-0.0403,-0.0513,-0.0145,-0.0206,-0.0384,-0.048,-0.0441,0.016,-0.0656,-0.0059,-0.0711,-0.0073,-0.0055,0.0313,0.0764,0.0175,-0.0096,-0.0086,-0.0464,0.029,-0.0384,-0.0178,-0.0357,-0.0908,0.1031,0.0225,0.1161,-0.0817,-0.0028,-0.1305,-0.0505,0.0867,-0.0193,0.0994,0.0918,-0.0955,-0.0886,0.0325,-0.0487,-0.0073,-0.0225,0.1308,0.2248,-0.1174,0.0024,-0.0451,-0.0249,0.017,-0.0898,-0.0677,-0.0395,0.0594,0.0099,-0.0363,-0.0017,-0.0808,-0.0742,0.0536,0.0748,0.074,-0.0068,0.0316,-0.0425,-0.0883,-0.0347,0.0771,-0.0887,0.0328,-0.117,0.2672,-0.0705,0.069,-0.0265,-0.0275,-0.1437,-0.1239,-0.017,0.0265,-0.0468,0.1164,-0.0437,0.2129,-0.0239,-0.0003,0.218,0.062,0.0445,-0.0071,-0.0104,0.0373,0.0648,-0.0523,-0.0088,0.114,0.2378,0.0847,0.052,0.1626,0.0919,0.0607,0.1593,0.1542,0.1788,0.1078,0.0815,0.106,0.0641,0.1201,0.0254,0.2386,0.0618,0.2048,0.226,0.1224,-0.0926,-0.0946,-0.1128,-0.0582,-0.1174,-0.07,-0.1096,-0.0208,0.1465,0.1143,-0.1316,-0.1175,-0.086,0.0206,-0.0747,-0.0898,0.0586,-0.0495,-0.0607,-0.0086,-0.0384,-0.0189,-0.0028,0.0134,0.0021,0.0502,-0.0716,-0.0593,0.057,-0.0038,0.0019,0.0012,0.0093,-0.1061,0.0357,-0.0101,-0.0616,-0.067,0.0213,-0.1127,-0.0229,-0.0991,-0.0746,0.0835,0.0863,-0.0775,-0.078,-0.0091,-0.0646,-0.0435,-0.0616,0.0051,0.0812,-0.0094,-0.0407,0.0735,-0.0577,-0.0662,0.0595,object detection
trm_4a3fd79d09849,0.0247,0.0004,0.0163,0.0772,0.0008,-0.0468,-0.0123,0.0022,-0.036,0.0288,-0.0332,-0.0134,0.0329,0.0048,0.0419,0.0066,0.0507,0.0817,-0.0159,0.0418,0.0526,-0.0016,-0.0134,-0.0118,0.01,-0.0128,-0.0103,0.1267,0.101,0.0416,0.0597,0.0284,0.0005,0.0093,0.085,0.0647,-0.0825,0.0005,0.0311,0.0544,0.0728,0.0513,-0.0068,-0.031,0.0636,0.0831,-0.1626,0.0483,-0.0142,0.1041,0.0502,0.0422,0.0332,0.0289,0.1162,0.0387,0.0634,-0.0187,-0.0571,0.0094,-0.0145,-0.0224,0.0872,-0.0201,0.0119,-0.0518,0.1194,0.17,0.1165,-0.0241,-0.072,-0.019,-0.0214,0.0325,0.0537,0.0438,0.0568,-0.0336,-0.0916,-0.0065,-0.0548,-0.0001,0.015,0.1043,0.0187,-0.0369,0.0138,-0.0027,-0.0189,0.2833,0.0248,0.0418,-0.0297,-0.2865,-0.2529,-0.2771,-0.1085,-0.0798,-0.1414,-0.127,-0.0315,0.0209,-0.0524,-0.1458,-0.114,0.0444,0.1153,-0.0786,0.053,-0.014,0.0162,0.0864,-0.0061,-0.0862,0.0015,0.0045,0.0434,-0.0678,0.0284,0.0419,0.0835,0.1002,0.0729,0.0217,0.1187,0.0825,0.108,-0.0558,-0.0711,0.0299,0.0439,0.0326,-0.0384,0.0826,0.0767,0.137,-0.005,0.0267,0.0104,-0.0234,0.0551,0.05,-0.0857,0.0895,0.0823,-0.0702,0.0253,0.0032,0.0143,-0.0247,0.0598,0.054,0.0331,0.1275,-0.0101,0.0015,-0.0913,-0.039,-0.0303,0.0253,0.0247,0.0924,0.1231,0.0713,-0.04,-0.0296,-0.003,0.1269,0.1189,0.0352,-0.003,0.0792,-0.0716,0.0831,0.0793,0.0906,0.0525,0.0684,0.0385,-0.0159,0.1133,-0.0824,0.0247,-0.0185,0.1045,0.0695,0.0103,0.0532,0.0185,0.0874,0.0884,0.082,0.038,0.1754,0.1577,0.1431,0.1357,0.0387,-0.0002,0.0083,0.006,-0.2408,0.0949,0.1053,0.0256,0.1097,0.1141,0.0632,0.0188,0.0214,0.0769,-0.0284,0.0025,0.0097,0.0172,0.0161,-0.095,-0.0086,-0.0533,-0.0283,-0.1213,0.0448,0.069,0.0527,-0.03,-0.0529,0.0942,-0.04,0.0579,-0.0049,-0.1,0.0053,-0.1201,0.0353,0.0354,0.0378,-0.0046,-0.0067,0.0078,0.0237,-0.0535,0.0635,-0.0247,0.0137,0.0639,0.0566,0.0272,0.1328,0.0454,0.1255,0.023,-0.0475,0.073,-0.0126,0.071,0.1174,0.001,0.0378,-0.1004,-0.131,-0.0301,-0.1402,0.049,-0.0572,-0.1007,-0.1511,-0.0304,0.019,-0.0901,-0.0302,-0.0246,0.0159,0.0244,-0.0177,0.1028,0.0537,0.2206,0.2162,0.1693,0.1336,0.071,-0.0009,0.0018,0.1603,0.1343,0.0221,-0.0628,-0.0384,-0.0123,0.0378,0.0154,0.013,0.0427,0.0376,0.029,-0.0075,0.0614,0.0082,0.0248,-0.0292,0.0397,0.1511,0.041,0.0264,-0.0422,-0.0517,0.0254,0.0776,-0.0495,0.017,0.0403,-0.0,0.0506,0.0346,-0.0203,0.0416,-0.0322,-0.0615,0.0047,0.1159,-0.0191,-0.001,0.0108,0.0435,-0.0284,0.0527,0.0284,0.0343,0.0081,0.03,0.0501,0.0414,0.0054,-0.0537,0.0138,-0.0392,0.0099,0.0934,-0.0238,0.1237,0.1215,-0.013,-0.0629,-0.0156,-0.0735,-0.015,0.0678,0.0429,0.0357,0.0258,-0.0405,-0.2729,-0.0376,-0.0225,-0.0241,-0.0283,0.0197,0.0672,0.0761,0.0436,-0.0249,0.0173,0.1567,0.0264,0.0183,-0.1084,0.0564,-0.0222,-0.0636,0.0911,0.0074,-0.0185,0.0238,-0.1243,0.1017,0.0248,0.0836,-0.0419,-0.0849,-0.0425,-0.0898,-0.0538,0.1087,0.0419,-0.0562,-0.0732,0.0329,-0.0578,-0.0499,0.0055,-0.0291,0.0625,-0.0685,0.0079,-0.0251,-0.0689,-0.0643,0.0476,0.0477,0.0597,0.0576,-0.0062,0.038,0.0643,-0.0412,0.0,-0.0534,-0.0472,0.03,-0.0053,-0.0141,0.0181,0.0367,-0.1208,0.0654,0.104,-0.103,0.0272,0.1063,0.0483,0.0056,0.0503,-0.0096,0.1605,0.1233,0.0215,0.1298,-0.0758,0.068,-0.0355,0.0129,-0.0228,0.0142,0.0443,0.0413,-0.0551,-0.0584,0.0054,0.0889,0.0802,-0.1404,-0.0924,-0.0185,-0.1163,0.0297,0.0222,-0.0034,-0.1313,0.0979,0.1417,0.0887,0.018,0.1034,0.0955,0.0234,0.1195,0.0262,0.0641,0.0618,0.014,0.0121,0.0273,0.0188,-0.0621,0.057,0.0965,-0.0704,-0.1848,0.0533,0.0668,0.0158,-0.0198,-0.0365,0.0486,0.0157,0.0518,-0.0663,-0.057,0.0246,0.0163,-0.1264,0.0286,0.0151,-0.0606,-0.0035,-0.0286,-0.0088,-0.0289,0.0644,-0.0049,-0.0938,0.0117,0.0538,0.066,-0.0246,-0.0047,0.2405,-0.0128,-0.0017,0.0922,0.0772,0.0344,0.0856,0.0447,0.0798,0.0308,0.0064,0.0503,0.0135,-0.1206,0.0909,-0.0449,0.0481,0.0017,-0.093,-0.0403,0.0875,0.056,-0.1019,0.0188,0.0634,0.0859,-0.0618,0.0315,-0.0163,-0.0351,0.0164,-0.0907,-0.0109,-0.0747,0.0155,0.0006,-0.0239,0.0579,0.0323,0.0012,0.0545,0.0068,0.0013,0.0273,-0.0118,-0.0784,0.0321,0.0294,0.0428,-0.0173,0.0429,-0.0013,0.0134,0.0119,-0.1094,0.0692,0.0246,-0.0493,-0.0159,0.0909,-0.0422,-0.0406,-0.0458,0.0172,0.0157,-0.0106,0.0656,-0.032,0.0992,-0.0168,0.0159,0.0954,0.0481,0.078,0.0893,0.0327,0.0899,-0.01,-0.2242,-0.172,-0.0706,-0.0411,0.0252,-0.0045,0.0224,0.0366,0.0367,0.0243,-0.0042,-0.0202,-0.0532,0.0108,-0.0274,0.0279,0.0686,-0.0062,-0.035,0.0468,0.0101,0.0288,0.1196,0.017,-0.0892,0.0813,-0.0339,0.0161,-0.0197,-0.0328,-0.0602,-0.1662,0.0563,0.0975,0.0911,0.0294,0.0836,0.0316,-0.0438,-0.0,0.1084,0.0608,0.0357,0.0262,0.0009,0.0768,0.033,0.0831,-0.0769,0.0041,0.0137,-0.0663,0.0459,0.0382,0.0148,0.0001,-0.0585,-0.0725,-0.002,0.0185,0.0584,-0.116,-0.0297,0.0021,0.0819,-0.0002,-0.0011,-0.1366,-0.039,-0.1477,0.0497,0.0313,0.115,0.1012,-0.1091,0.0791,0.0355,0.0595,-0.1062,0.0647,0.0053,0.0148,-0.1519,-0.0195,-0.0192,0.0612,0.0753,-0.1328,-0.1106,-0.1086,-0.1179,-0.0667,-0.0051,0.0763,-0.1149,0.0199,-0.042,-0.0137,-0.0004,-0.0479,0.0463,0.0735,-0.1058,0.0406,0.0068,0.0639,-0.0071,-0.1111,-0.0384,0.0639,-0.0361,0.1475,0.0404,-0.0194,0.0016,-0.0025,0.0233,-0.0738,-0.0822,-0.0202,-0.0082,0.0901,-0.0556,0.0609,0.0363,0.0287,-0.0074,0.0087,0.0639,0.0598,0.0667,0.0253,0.0469,0.0541,0.0302,0.0441,-0.0234,0.0773,0.0514,0.0242,0.0513,0.0594,0.0164,0.098,0.0257,-0.0001,-0.0285,0.0411,0.1243,0.119,0.0831,0.0135,0.046,0.0422,0.0504,-0.0144,-0.1048,0.0221,-0.0066,0.0116,-0.058,-0.0296,0.0085,-0.0186,-0.0729,0.0098,0.1102,-0.0414,0.0299,-0.074,-0.0072,0.0821,-0.0225,-0.0311,0.0059,0.0106,0.0211,-0.1383,0.0853,0.1462,0.132,0.1033,-0.0375,-0.1107,-0.0017,0.0254,0.0104,-0.0139,-0.0188,-0.0476,0.0119,-0.0471,0.0381,0.0138,-0.0277,-0.0154,-0.0901,-0.1023,0.0212,-0.0087,-0.0485,0.0445,-0.0667,0.0363,0.0525,0.0894,0.0919,0.0871,0.0512,-0.1067,-0.0725,-0.0212,-0.0,-0.0018,-0.0043,-0.0457,-0.0628,0.077,-0.0663,-0.0073,-0.0338,-0.0717,-0.0233,0.093,-0.0093,0.1619,0.1616,-0.0297,-0.0502,-0.1376,0.021,-0.002,-0.0353,0.032,-0.1291,-0.2046,-0.0558,-0.1122,-0.1063,-0.1337,-0.0706,-0.022,-0.1125,-0.0691,-0.0282,-0.0436,0.0347,0.1105,0.1006,-0.0442,0.0177,-0.1286,0.1613,0.0312,0.1066,0.0685,0.0936,-0.0256,-0.0347,-0.0805,0.0362,0.0346,0.0649,-0.0205,0.0243,-0.0238,-0.0183,-0.0051,0.0178,-0.0173,0.0046,0.0368,-0.0156,-0.0743,0.0656,-0.0768,-0.0189,0.0292,0.0096,0.0421,0.0645,-0.0272,0.0644,0.1198,0.11,-0.0197,-0.017,0.0581,0.0512,0.0676,-0.0083,-0.0839,0.0733,0.077,-0.1055,0.0497,-0.0708,0.0608,-0.1734,0.0514,-0.0421,0.0362,0.0535,0.0143,0.1355,0.1158,0.0451,-0.1455,0.0613,0.0583,0.0401,-0.0399,-0.0068,0.0585,0.0644,0.1429,0.0639,0.0103,-0.0853,-0.0674,0.011,-0.1075,0.0651,0.0309,0.0176,0.0371,0.0599,0.0001,-0.0673,-0.0024,-0.0166,-0.1856,-0.0622,0.0379,0.0893,0.0636,0.0695,0.0109,0.0665,-0.0919,-0.1303,-0.0363,0.0215,0.0401,-0.0916,-0.0916,0.0167,0.0288,0.0668,0.0195,-0.0613,-0.0136,0.0087,-0.0924,-0.0279,0.0314,0.0133,-0.0598,-0.0391,0.0427,0.0087,0.0001,0.0457,-0.0126,-0.009,0.0961,0.098,0.1285,0.0445,0.1002,0.0229,0.0207,0.0665,0.0743,0.019,0.1239,0.0379,0.0846,-0.021,-0.0794,0.0265,-0.0616,-0.0444,0.0233,-0.0892,-0.014,-0.0211,-0.0574,-0.0389,-0.0066,0.0122,0.0669,0.0147,-0.0094,0.064,-0.0186,0.0015,-0.0068,-0.003,0.0903,0.0052,-0.064,0.012,0.0485,-0.0316,-0.0206,0.1051,-0.0182,0.1336,0.0656,0.0922,0.102,0.0887,-0.079,-0.0035,-0.0492,-0.0273,-0.0786,-0.0589,0.0043,-0.0149,-0.0078,0.0143,-0.0413,0.0128,0.0052,0.0572,0.0382,0.0282,-0.0499,-0.0266,0.0223,0.0547,0.0787,0.1023,0.0792,-0.0697,-0.0675,-0.0724,-0.0253,-0.0404,0.0467,0.0303,-0.011,0.0133,0.0109,0.0564,-0.031,0.0057,-0.0639,-0.0305,0.0074,0.0724,-0.0154,0.1035,-0.0023,0.0432,-0.0315,-0.1584,-0.2578,0.0479,-0.0001,0.0653,0.0391,0.0472,0.0244,0.0442,0.0711,-0.0143,-0.0204,-0.0204,0.0296,-0.0049,0.0112,-0.0097,-0.0117,-0.0399,-0.0157,0.0405,0.0432,0.0383,-0.0721,-0.0331,-0.1008,0.0542,-0.1767,-0.0819,0.0355,0.0018,0.0067,0.0427,0.0253,-0.037,0.0498,0.0577,-0.0065,0.0651,0.0915,0.0116,0.0323,-0.0712,-0.0456,0.0621,0.0217,0.1043,-0.0317,-0.1465,0.0112,-0.0406,-0.029,0.0253,-0.0749,0.0385,0.0005,0.0326,0.0677,-0.3128,-0.1743,-0.1658,-0.074,-0.1281,-0.0278,-0.1564,-0.1073,0.159,-0.1873,-0.2074,-0.1546,-0.1048,-0.1398,-0.0424,-0.0963,-0.0465,0.0406,-0.0349,0.0316,-0.0531,-0.0396,0.0794,-0.0515,-0.0666,0.014,-0.0688,0.0129,0.0572,-0.1171,-0.0205,0.0491,-0.0016,0.1219,-0.0222,-0.031,-0.099,0.0469,0.0601,0.0293,0.0079,-0.0069,-0.0594,-0.0364,-0.0728,-0.025,0.0283,0.0242,-0.001,-0.1976,0.0953,-0.1309,-0.13,0.0699,-0.0297,-0.0698,-0.2551,-0.2359,-0.1513,-0.1148,-0.0302,0.0191,-0.0089,-0.044,-0.0309,0.0414,0.0727,0.0517,-0.1328,-0.0196,0.0872,0.0221,0.0148,0.0022,-0.0902,0.0023,-0.0591,-0.1745,-0.1086,0.06,-0.0035,0.0465,-0.0516,-0.0169,-0.009,0.1638,0.173,0.0667,0.104,-0.0132,0.0518,0.0415,0.0402,0.035,0.0723,0.0199,0.0106,-0.1085,0.0483,0.109,0.133,-0.015,0.0037,-0.0588,0.1275,-0.0393,-0.1836,0.0293,0.2012,-0.1188,-0.0879,0.0093,0.1294,0.0147,0.1109,0.0972,0.0608,-0.018,-0.1007,0.0194,0.0011,0.0172,0.0238,0.0585,0.0974,-0.0264,-0.006,0.1042,0.08,-0.015,-0.0495,-0.2127,-0.2123,-0.1445,-0.1661,0.0391,-0.0159,0.0687,0.0732,0.0787,0.0258,-0.0496,-0.1385,0.0691,0.0804,-0.0268,-0.0679,0.0003,-0.0761,-0.0002,-0.0269,-0.0272,-0.1103,0.0773,0.0638,0.1235,-0.149,0.0041,-0.0101,-0.0156,-0.0156,0.1639,-0.1159,-0.0823,-0.0554,0.0176,-0.004,-0.0148,-0.2967,0.1974,0.1861,0.046,0.0442,0.1332,0.148,0.093,-0.0002,-0.0392,0.0088,0.0235,-0.0138,-0.1832,0.0608,0.0912,0.0517,0.0145,-0.0089,0.0719,-0.0714,0.0191,0.0238,0.0321,0.1369,0.0514,0.0299,0.1554,0.0624,-0.0159,-0.2902,-0.1421,-0.1536,0.0269,-0.2651,0.0451,0.0195,-0.0092,0.07,-0.0562,0.0883,0.0284,0.0191,0.0029,0.093,-0.1083,-0.0207,0.0884,0.0014,-0.0596,0.0089,0.2668,0.1258,0.0358,-0.0177,-0.0012,-0.0164,0.0261,-0.1425,-0.0534,-0.0584,0.0036,-0.0394,-0.0046,-0.0136,0.2179,0.211,0.0245,0.0768,0.1057,0.1008,-0.0143,-0.0196,-0.0065,0.0423,0.1118,0.0997,0.0062,0.0399,0.0026,0.0195,0.0595,-0.0417,-0.0337,0.0657,0.1044,0.1495,0.0651,-0.029,0.0759,0.0835,-0.02,-0.0241,-0.1043,-0.0643,-0.0414,0.0197,0.0431,0.0226,0.0605,-0.0001,-0.0196,-0.007,-0.0808,0.0673,0.002,-0.0778,0.0106,-0.0496,0.0105,0.0311,-0.0956,0.09,-0.0303,0.0233,0.1395,-0.1154,0.0653,-0.0602,-0.1579,-0.1467,-0.004,-0.0485,-0.0443,-0.2034,0.0204,-0.022,0.0444,-0.0236,0.0924,0.0832,0.0245,-0.006,0.0152,0.0418,0.0939,0.0141,0.0052,0.0094,0.0553,0.0658,-0.021,-0.0148,0.0083,-0.0471,0.0197,0.0247,0.0435,0.0577,0.0727,0.0676,0.0258,0.0395,-0.0157,0.0019,0.0006,-0.023,0.0371,0.0614,0.0356,-0.0306,0.005,0.0809,-0.0845,-0.1209,-0.2181,-0.0063,-0.0773,-0.0273,-0.0601,-0.0558,0.0735,0.0496,-0.0027,-0.0025,0.1013,0.0004,-0.0701,-0.0256,-0.0638,0.0095,0.0258,0.0457,0.0609,-0.0126,0.0926,0.0849,-0.1866,-0.1766,0.0328,-0.0478,-0.0435,-0.0119,0.0294,-0.038,-0.0346,0.0089,-0.0154,0.0143,0.0059,0.0131,0.0626,-0.0268,-0.0346,0.0011,-0.0988,-0.1439,-0.008,0.0382,-0.0097,-0.0254,0.0282,-0.025,0.0071,-0.0363,-0.0207,-0.0044,-0.0341,-0.0858,-0.049,0.003,-0.0147,-0.0334,-0.0406,0.1304,0.0503,-0.0273,-0.0291,0.0297,0.0109,-0.0083,-0.0229,-0.0016,-0.1091,0.0059,0.0264,-0.0192,0.0039,-0.1321,-0.0528,0.0223,-0.01,-0.02,-0.029,-0.0321,-0.0051,-0.0683,0.0093,0.0136,-0.1001,-0.0457,-0.0053,0.0149,0.0422,-0.021,-0.2441,-0.2291,0.0693,0.04,-0.0759,0.0374,0.0085,0.0112,0.0701,0.006,0.0596,0.0351,-0.0402,-0.0168,-0.1027,0.0917,0.0052,-0.0684,-0.0082,-0.1135,-0.1531,-0.1939,0.0706,-0.1161,-0.0341,-0.0282,0.0244,-0.0509,0.0381,-0.0372,0.0205,0.0275,-0.0712,-0.0582,-0.0235,0.0303,0.0377,0.063,0.0065,-0.0027,-0.0816,0.0566,-0.0263,-0.0464,-0.002,0.0509,-0.0142,0.013,0.0541,0.0068,-0.1107,0.0258,0.1658,0.2034,0.1157,0.0493,-0.0039,0.0015,-0.005,-0.0273,-0.0198,-0.0525,-0.0027,-0.0446,0.008,-0.1856,0.0199,-0.0527,-0.3342,0.0689,0.0305,0.0187,0.1341,0.0035,0.0744,-0.0287,0.0299,0.0178,-0.0054,0.0661,0.0182,0.0407,0.0489,-0.0477,0.0358,-0.0452,-0.062,-0.1136,-0.0653,-0.0878,0.0606,-0.0104,0.0629,0.0624,0.0943,0.0053,0.0635,-0.0434,-0.0208,0.0153,-0.0694,-0.1266,0.1001,0.093,-0.024,-0.0335,-0.0101,-0.0877,-0.0547,-0.0232,-0.0092,0.1866,0.0123,0.0857,0.0235,-0.0386,0.0114,0.2566,0.2213,0.2931,-0.0749,0.0266,0.0215,0.0039,0.1356,0.0743,0.0718,-0.1655,-0.0853,-0.0833,-0.0521,-0.0348,-0.0353,-0.0137,-0.0871,-0.128,-0.0892,0.0272,0.0377,0.0533,-0.0117,0.0671,-0.0261,0.1368,0.0716,0.1141,0.0475,0.0073,0.0224,0.0437,-0.1861,0.0062,-0.0558,-0.0495,-0.0766,0.0126,0.0082,-0.0293,-0.0385,-0.0116,0.0183,-0.0637,0.0118,0.0182,0.1482,0.0554,0.1201,0.0101,0.0071,0.0715,0.0404,-0.0079,0.0272,0.0343,-0.0268,0.0642,-0.1062,-0.0356,-0.0297,-0.1125,-0.0448,-0.0241,-0.0591,0.0113,0.0886,0.0191,0.0873,0.0513,0.0704,-0.0545,-0.0579,-0.1614,-0.0859,0.017,-0.0488,-0.0537,0.2354,0.1492,0.1422,0.0934,-0.0107,-0.0448,-0.0338,0.0958,0.115,0.076,0.0125,0.1133,-0.0203,-0.0466,-0.0013,-0.044,-0.0124,0.0699,0.0526,-0.0023,-0.0231,0.0559,0.0086,0.1445,0.0647,0.0173,0.0738,0.1662,-0.0203,0.0669,-0.0421,0.0381,0.0092,0.0475,-0.0036,0.0793,-0.0062,0.1117,0.118,-0.0109,-0.0183,0.0065,0.0183,0.0872,0.077,0.0777,-0.0122,0.0152,0.0291,0.0592,-0.0612,0.1118,0.1106,0.031,0.0112,0.0641,0.1189,0.1002,0.0831,0.0336,0.0618,-0.0413,-0.019,0.1502,0.0186,0.0427,0.0579,0.0512,0.08,0.1563,0.0104,0.0863,0.0521,-0.0961,0.1218,0.1475,0.0957,0.0925,0.1134,-0.0112,0.1113,0.079,0.0004,-0.1864,-0.1623,-0.0551,0.0382,-0.0238,-0.0356,-0.0732,-0.0245,0.1023,0.127,0.0535,-0.0456,0.0183,-0.0034,-0.046,-0.0258,-0.0248,0.0113,0.0256,0.0387,0.0272,0.0465,0.084,0.0293,0.0839,0.0092,0.0425,-0.0465,-0.1213,-0.1274,0.0415,0.1251,0.0484,0.1338,0.1245,0.1633,0.1118,-0.2627,0.075,0.0226,-0.2312,-0.1621,-0.1763,-0.1904,-0.1142,-0.1361,-0.0998,-0.087,-0.0669,-0.0673,-0.1235,-0.1926,-0.1853,-0.2628,-0.2761,0.1237,0.0146,-0.0784,-0.2425,0.1041,0.0798,-0.0577,0.0644,0.0078,-0.0438,-0.0853,-0.0199,0.0345,-0.101,0.235,0.2083,0.0515,-0.0066,0.0416,-0.0816,-0.0165,0.0526,0.0194,0.0168,-0.0227,-0.0927,-0.0809,-0.0038,0.017,-0.008,0.1488,0.0681,0.0549,0.076,-0.0209,0.1074,0.0751,0.0333,0.0041,0.0894,-0.0159,-0.0751,-0.0384,0.0255,0.1261,-0.0851,-0.0008,-0.0335,-0.0499,0.1044,0.0112,0.0764,0.0699,0.0518,0.0685,0.0469,0.0101,0.0022,-0.1515,-0.0932,-0.0834,-0.0507,0.0554,0.0235,0.0374,0.0249,-0.0158,-0.002,0.0753,-0.0544,0.0276,0.0658,-0.02,0.0497,-0.0475,-0.0768,0.1469,-0.0292,0.0663,0.0962,0.0657,0.0229,-0.0495,0.0918,0.0311,-0.0185,0.044,0.1157,0.0095,-0.0503,-0.0395,0.0385,0.1042,0.1016,-0.0235,-0.0963,-0.054,0.0797,-0.3525,-0.2095,0.0675,0.0888,-0.3363,-0.302,-0.0318,-0.2056,-0.1619,-0.2081,0.0877,0.0837,0.0535,0.0684,-0.3225,-0.2632,-0.1831,-0.0596,-0.039,-0.14,-0.3138,-0.322,-0.2735,-0.0083,0.0054,0.0226,-0.025,0.0067,0.0291,0.1003,0.0605,0.0008,0.0642,0.0951,0.0638,-0.0407,-0.0186,0.013,0.0271,-0.068,-0.0678,-0.0477,-0.0478,0.0296,-0.049,0.0176,-0.0439,-0.0483,0.0757,0.0738,0.0436,0.0196,0.1105,0.1199,0.1111,-0.002,0.004,-0.0368,-0.1366,-0.0814,-0.0693,-0.0956,0.0301,-0.0694,-0.0379,0.0931,0.1272,-0.0519,-0.0259,0.0435,-0.034,-0.0569,-0.0549,-0.0596,0.0377,0.0341,0.0249,0.0143,-0.1221,-0.0795,-0.1112,0.0296,0.0187,0.0255,-0.0156,0.0014,0.0151,0.0023,0.0812,0.0347,0.0799,0.0929,0.0835,-0.0657,-0.011,-0.012,0.024,0.0325,-0.0161,-0.2415,-0.1932,-0.0817,-0.1046,0.0392,-0.0606,-0.0297,-0.1831,-0.1783,-0.0907,-0.0469,-0.0647,-0.0118,-0.0841,-0.0827,-0.0245,-0.022,0.0655,0.0296,0.0017,-0.0241,-0.02,-0.0276,0.0351,-0.0425,-0.0323,-0.0666,-0.1472,-0.0229,-0.1692,-0.1014,0.1103,0.1137,0.1062,0.0676,0.1085,-0.0663,-0.0156,-0.0004,-0.0165,-0.1011,-0.057,0.0923,-0.0245,-0.0431,0.0137,0.0138,-0.0423,-0.0733,-0.0414,-0.1798,-0.2184,-0.139,-0.0127,0.0355,0.0443,-0.067,0.0335,0.0584,0.0246,-0.0206,0.0243,-0.0453,0.1003,0.0297,0.0074,0.1085,0.1095,0.0914,0.0618,-0.0249,0.0974,0.052,0.0521,-0.0355,0.001,-0.0487,-0.0209,0.1712,0.0814,-0.07,-0.1183,0.0155,-0.0653,-0.0806,0.1738,-0.0521,0.0438,0.0207,-0.1377,0.1777,0.1877,-0.0027,-0.053,-0.0759,-0.0657,0.0351,0.0542,-0.0109,-0.0026,0.0193,0.0995,-0.0258,-0.0538,-0.0731,-0.0297,0.1668,0.109,-0.0134,0.1095,0.0144,0.0015,0.0601,-0.01,-0.036,-0.0617,-0.0195,0.1621,0.0722,0.1061,0.1174,0.1034,0.0871,0.0932,0.0932,0.0515,-0.0209,-0.0215,0.0949,-0.0285,-0.1117,-0.0685,0.0303,0.0768,0.1675,-0.0277,-0.0263,0.0259,0.0854,-0.1852,0.0465,0.0478,0.0599,0.0642,-0.0581,-0.1257,-0.0354,-0.1034,-0.0637,-0.0732,-0.1184,-0.0774,-0.0012,-0.0772,-0.0772,-0.0183,-0.0049,0.0602,0.0264,0.0256,0.0862,0.0565,0.0171,0.0276,-0.0189,0.0115,0.088,-0.0372,-0.0027,0.0574,-0.0585,-0.0556,0.122,0.0273,0.1535,0.0512,-0.0226,-0.0675,0.0797,-0.2458,-0.211,-0.0878,-0.176,-0.1644,-0.0314,0.0027,-0.0255,-0.0901,-0.0436,-0.0106,-0.0866,-0.0213,-0.06,0.0328,-0.0403,-0.027,0.0363,0.0052,0.0259,0.0327,-0.1774,0.2003,-0.1793,-0.1176,-0.1649,-0.0285,-0.2026,-0.1216,-0.0397,-0.05,0.0011,-0.036,-0.0114,0.0417,0.0624,0.1034,0.0593,-0.0839,0.0116,0.0628,0.0557,0.0258,0.0009,0.0039,0.0527,0.026,-0.0011,-0.0182,-0.0029,-0.0379,0.0153,-0.027,0.0825,0.034,0.0889,0.0277,0.0431,0.0242,-0.0402,0.0023,0.0547,-0.0734,-0.0384,-0.0941,-0.0036,-0.0122,-0.0938,0.0076,0.03,0.03,0.0328,0.0481,-0.0,-0.0731,-0.0156,0.0003,-0.0131,0.0393,0.0321,0.0627,0.0689,0.0625,0.0933,-0.0626,-0.0537,-0.0575,0.096,0.0181,0.0794,0.0288,0.0883,0.0429,0.0235,-0.0653,-0.0936,0.0483,0.0383,-0.0069,0.0537,0.0602,0.0189,-0.0575,-0.0176,0.0954,-0.06,-0.0415,0.0081,-0.0229,-0.0473,-0.0346,-0.0165,-0.002,0.0726,0.0126,0.0844,0.0375,0.0654,0.0605,-0.0455,-0.0977,-0.0554,-0.043,-0.066,0.0572,0.0679,0.0868,-0.0132,-0.014,-0.0782,-0.04,0.0157,0.0162,0.0676,0.0273,0.169,0.0759,0.0091,-0.0024,0.0175,0.0895,-0.0793,0.0038,0.0041,-0.1086,-0.0288,0.0003,0.1091,-0.0046,-0.0366,-0.0259,-0.0153,-0.0021,-0.0134,-0.0094,0.0146,0.01,-0.0207,0.0138,0.0358,0.0346,0.1029,-0.0144,-0.0076,-0.0053,0.0424,0.0579,0.0228,0.014,0.0329,-0.0437,0.1071,0.0169,0.0917,0.0859,0.0318,0.0841,0.0579,0.1198,0.0972,-0.0576,-0.0067,0.0858,0.0284,0.0996,-0.0618,0.0337,0.008,0.0902,0.1424,0.0874,0.0071,0.0345,-0.0824,0.0287,0.0027,0.037,-0.037,-0.0286,0.0313,-0.0276,-0.0013,0.0534,-0.0016,-0.022,0.0561,0.0197,0.044,0.0253,-0.048,-0.0016,-0.0949,0.0205,-0.032,-0.0918,-0.0643,0.0207,0.0298,0.1161,0.0055,-0.029,-0.1754,-0.1703,-0.0813,-0.0139,-0.0153,0.0487,-0.065,-0.1068,-0.0517,-0.018,0.1007,-0.0162,0.0858,-0.0992,0.086,0.0222,-0.0564,-0.0674,-0.0055,-0.0789,0.0193,0.0307,-0.1019,-0.0089,0.0734,-0.032,-0.0056,-0.023,0.0227,-0.0951,-0.0196,-0.0017,-0.0234,-0.052,0.0138,-0.0684,-0.0886,-0.086,-0.0274,-0.0148,-0.0802,0.0243,-0.0051,0.1346,0.141,-0.0506,-0.0765,-0.0581,0.0164,-0.0071,0.1018,0.0965,0.0721,0.0966,-0.015,0.0824,0.0081,0.0432,-0.0294,0.0685,0.1106,0.0358,0.0781,0.0897,-0.0108,0.0876,-0.0436,0.1856,0.046,-0.0374,-0.0281,0.0292,-0.0231,0.0628,-0.022,0.081,-0.1398,0.0547,-0.0665,0.019,0.0043,-0.0458,-0.1034,-0.1935,-0.0796,-0.0551,0.0876,-0.0066,-0.0105,-0.0099,0.0889,0.0538,0.0514,0.1055,0.0402,0.0069,0.0563,-0.0379,0.0621,0.0585,0.1054,0.1012,-0.034,-0.0704,0.1715,0.0775,-0.0035,0.0553,0.1103,-0.1244,-0.1118,0.0403,-0.0383,-0.0225,-0.033,-0.184,-0.192,0.1475,0.0677,0.0466,0.0591,-0.1051,-0.0073,-0.0034,-0.0373,0.0357,-0.003,-0.1996,-0.052,-0.0784,-0.182,0.0612,0.1001,0.0631,0.1478,0.0628,0.0461,0.1319,0.0981,0.06,-0.0421,-0.0336,-0.0542,-0.0734,0.0751,-0.2013,-0.1819,-0.1446,-0.0751,-0.0629,-0.1075,0.2411,0.1613,0.2292,-0.0481,-0.0695,-0.0908,-0.081,-0.0022,-0.0821,-0.0019,-0.125,0.036,0.0504,0.0536,-0.0322,0.0039,-0.0144,-0.0056,-0.0558,-0.0064,0.0385,-0.0017,-0.0843,0.064,0.0222,0.1088,0.0805,0.0088,-0.0065,-0.2278,-0.0011,-0.2045,-0.0065,-0.0057,0.0192,0.009,-0.0097,0.029,-0.0483,-0.1157,-0.0189,-0.0262,-0.0453,0.0419,0.0434,0.0163,-0.1326,-0.0281,-0.0969,-0.0841,0.0272,-0.0222,-0.0519,-0.0221,0.0041,-0.061,0.0356,0.0588,-0.0094,-0.124,0.0303,0.0237,-0.072,-0.0849,-0.1312,-0.0519,-0.0644,-0.0533,-0.0139,-0.0045,-0.0901,-0.0679,-0.0333,-0.0491,0.0359,-0.0896,0.0322,0.0265,-0.0185,-0.0701,-0.0615,-0.0216,-0.0358,0.0171,0.0752,0.0479,0.001,-0.1756,0.0172,0.0359,0.0003,0.0096,0.0849,0.0608,0.0852,0.0787,0.0298,0.0212,0.0605,-0.0238,-0.2302,-0.2183,-0.1759,0.0244,0.136,0.2592,0.0775,0.0311,-0.0648,0.0592,0.0579,-0.1542,-0.1566,-0.0359,-0.0264,-0.0666,-0.0174,0.2042,0.0655,0.1527,0.0269,-0.0922,-0.1557,0.0039,0.0267,-0.0059,0.0071,0.1775,0.0351,0.0037,0.019,0.2693,0.2203,0.0875,0.2299,-0.0847,0.0607,-0.0185,-0.116,0.2102,0.0649,-0.0175,0.0001,-0.0526,0.0332,0.0139,0.1712,0.1245,0.0504,0.0934,-0.2178,0.0917,0.051,0.0068,0.2083,-0.1165,-0.1194,-0.0383,-0.1438,-0.0696,-0.1767,-0.0661,-0.0634,0.0282,-0.02,0.0107,0.0278,0.0331,0.0057,0.046,-0.1058,-0.0027,0.0531,0.1212,0.081,0.0543,0.0718,0.0115,-0.0417,-0.0174,0.0488,-0.0672,0.0181,0.012,0.1348,0.02,0.12,0.0589,0.1481,0.0732,0.0006,0.1175,-0.0174,-0.0152,0.0254,0.0401,0.0663,0.0711,-0.014,0.0141,0.0292,0.0297,0.0354,0.0559,0.0665,-0.0559,0.0056,-0.0204,0.0539,0.0675,0.0259,-0.0697,-0.081,0.029,0.0262,-0.0374,0.046,0.0993,-0.026,-0.005,-0.1381,0.0338,0.0521,-0.0195,0.0549,-0.0279,-0.0358,-0.1031,-0.157,0.0053,0.0695,-0.0591,0.134,0.02,-0.1371,0.0732,-0.1947,0.226,-0.1886,-0.1885,-0.0111,0.0472,0.0673,-0.0517,-0.0228,-0.0582,-0.0827,-0.1161,-0.0408,0.0102,0.0807,-0.086,-0.0473,0.0146,0.1229,0.0778,0.106,0.0033,0.0239,0.1982,0.0323,-0.0101,-0.0016,0.0344,0.086,0.0883,-0.2812,-0.0019,0.0916,-0.1216,-0.1371,-0.0451,0.0324,-0.0854,-0.0897,-0.0672,0.0355,-0.0752,0.0426,-0.0218,-0.1117,-0.0604,0.0271,-0.0951,-0.0323,-0.0429,-0.0152,-0.107,-0.0729,0.0723,0.0469,0.0337,0.1984,0.0328,0.0739,0.0568,0.1358,0.2251,0.0894,0.1924,0.1215,-0.0887,0.0829,0.1506,0.1315,0.1877,0.0564,0.0174,0.0601,0.04,0.0245,0.0434,0.089,0.1736,0.1262,0.0295,-0.0265,0.0184,0.0148,0.038,-0.0267,0.0179,0.1011,0.0332,0.0434,-0.0143,-0.0031,0.0842,0.0999,0.0173,-0.0718,0.0906,0.1146,-0.0196,0.0281,0.0688,0.0905,0.0524,0.0075,-0.0113,-0.0099,-0.0796,-0.0448,-0.0783,0.0459,-0.0406,-0.0701,-0.0055,0.1343,-0.0478,0.079,0.0916,0.0581,0.1274,0.1598,-0.0116,-0.1083,-0.1779,-0.0244,0.0849,-0.2698,-0.0058,0.0354,-0.0854,0.1024,0.0876,0.1348,-0.0683,-0.0342,-0.1042,-0.0464,0.1316,0.0991,-0.0595,-0.0731,-0.0448,-0.0639,-0.0579,0.0382,0.0638,0.0577,0.0335,0.0594,0.0946,0.0168,0.0363,-0.021,-0.0519,-0.013,-0.0568,-0.1738,0.0556,-0.0313,-0.0132,-0.0385,-0.049,-0.0446,-0.0017,-0.0044,0.0665,0.0028,0.0262,-0.0002,0.0227,0.025,0.0463,0.035,0.0703,-0.0004,0.0463,-0.0038,0.0169,-0.0218,0.0178,-0.109,-0.0648,-0.0138,0.0231,-0.0083,0.0166,-0.0431,0.0436,0.0197,0.0761,0.0604,-0.116,0.047,-0.0764,0.019,-0.0028,0.0997,0.0829,-0.0242,0.0359,-0.0704,-0.0869,0.085,0.0985,-0.0287,0.0575,0.0081,0.0578,-0.204,-0.2689,0.1201,0.0002,0.0574,0.0496,0.0003,0.0771,0.1268,0.138,-0.0731,-0.0011,0.0087,0.012,0.1315,0.0682,-0.0601,0.0095,-0.0031,-0.0066,0.0404,0.0469,0.1237,0.0046,-0.096,0.0766,-0.0332,0.06,-0.2216,0.1102,-0.2259,0.0098,0.0199,0.1259,0.0989,0.0591,0.149,0.0733,0.0593,0.0511,0.0012,0.093,-0.0321,-0.0059,-0.1367,-0.1534,-0.1333,-0.058,-0.1937,-0.2628,0.0326,-0.0231,-0.1862,-0.3472,-0.1339,-0.0289,-0.2267,-0.143,-0.1045,-0.2039,-0.1462,-0.2369,-0.2268,-0.0978,-0.1447,-0.0639,-0.1802,-0.0921,-0.2848,-0.1047,-0.1746,-0.2027,-0.0976,0.0952,0.0935,0.0802,0.157,0.2367,0.1583,0.1397,0.0705,-0.1109,-0.0709,0.1787,0.154,0.0878,-0.0673,0.0346,0.108,-0.1251,0.037,0.0465,0.0212,0.0453,0.002,-0.0054,0.0061,0.0839,-0.0789,0.1779,0.1794,-0.0514,-0.0098,0.0087,-0.0219,-0.0206,0.0947,0.043,-0.0155,0.0606,0.0604,-0.0747,0.0345,0.0011,0.1181,0.1013,0.0337,0.0353,0.0558,0.0852,-0.015,0.0623,0.0509,0.0841,0.0168,-0.1526,0.0921,0.0549,0.034,0.0022,0.0165,-0.0236,anticipation
trm_557b47abe9a34,0.0003,0.0368,-0.0034,0.0333,-0.0299,0.0075,0.0003,-0.0138,-0.009,0.0124,-0.0064,-0.0005,0.0107,-0.0047,0.0232,0.0122,0.0353,0.0768,-0.0016,0.0352,0.0091,-0.001,0.022,0.0313,0.0028,0.0033,-0.0001,0.0129,0.0394,-0.0031,0.0116,0.0621,0.0193,0.0431,0.0314,0.0457,-0.0328,-0.0137,0.0667,-0.0142,0.0365,0.0155,0.0008,0.0097,0.031,0.0311,-0.0224,0.0055,-0.0204,0.0417,0.0174,-0.0622,-0.0189,-0.0427,0.005,0.015,-0.0026,0.0249,0.014,0.0172,-0.0109,-0.0273,0.0744,-0.04,-0.0007,-0.0873,0.1208,0.1023,0.0443,0.0008,-0.0202,-0.0298,-0.0228,0.0534,0.0674,0.0213,0.023,0.003,-0.0441,-0.0238,-0.0009,-0.0315,0.0287,0.0576,-0.0054,0.0031,0.0059,0.0103,0.0127,-0.0144,0.031,-0.0342,0.0229,-0.0798,-0.0761,-0.062,-0.0584,-0.0348,-0.1289,-0.0686,-0.0172,0.0027,-0.0619,-0.0798,-0.0412,0.0403,0.0761,-0.0598,-0.003,0.0028,-0.0021,0.0423,-0.0382,-0.07,-0.0342,0.0003,0.0569,-0.0645,0.0051,-0.0052,0.0859,0.0805,0.0722,0.0028,0.0468,0.0656,0.067,-0.0213,-0.0626,-0.0101,0.0266,0.0167,-0.0397,0.0466,0.0176,0.0827,-0.037,0.0544,0.03,-0.0109,0.0284,0.0134,-0.0262,0.0167,0.062,0.0045,-0.0146,0.0171,0.0258,-0.0058,0.0199,0.0709,0.0551,0.0463,-0.0234,-0.0317,-0.0166,-0.0077,-0.0055,0.0248,0.0252,0.063,0.1035,0.0831,-0.0181,0.0021,0.0609,0.0712,0.07,0.0051,0.0093,0.086,-0.021,0.0718,0.0589,0.0669,0.0552,0.0428,0.0019,-0.0087,0.0504,-0.0581,0.0258,-0.0151,0.0048,0.0686,0.0189,0.0372,0.0062,0.116,0.1108,0.0136,0.0008,0.0433,0.039,0.0635,0.0864,0.0237,0.0413,-0.0624,-0.0411,-0.0713,0.0913,0.0726,0.0085,-0.0079,0.0429,-0.0019,0.0202,0.0014,0.0753,0.0353,-0.0309,-0.0322,-0.0055,-0.0011,-0.0007,0.0221,-0.0121,0.038,-0.0174,0.0425,0.0812,0.0124,-0.0231,-0.0102,0.0375,-0.0391,0.0304,-0.0188,-0.02,0.0465,-0.0497,0.0424,0.0373,-0.0924,0.0176,0.0307,-0.0146,0.0151,-0.0021,0.0508,0.002,-0.0182,0.0188,0.0447,0.0483,0.0279,-0.0203,0.0727,-0.0209,-0.0061,0.0267,-0.0172,-0.0224,0.0412,-0.0111,0.0288,-0.0286,-0.0513,0.0006,-0.0614,0.0577,0.0153,-0.0678,-0.0903,-0.0078,0.008,0.01,0.0275,0.0108,0.001,0.0473,0.0166,-0.024,-0.0815,-0.0495,-0.008,-0.0204,-0.0679,-0.0765,0.0484,0.034,0.1259,0.1096,0.0224,-0.0116,-0.0471,0.0291,0.0392,0.0356,0.0053,0.0067,0.0765,0.0096,0.0128,0.0103,-0.0443,0.0208,-0.0583,-0.062,0.1002,0.0349,0.051,-0.0429,-0.0453,0.0585,0.0077,0.013,0.015,-0.0246,-0.02,0.0546,-0.0254,0.0089,0.0016,-0.0532,-0.0057,0.0072,0.065,0.0223,0.0034,0.057,0.0558,0.0409,0.035,0.0059,0.0308,0.0297,0.0379,-0.002,0.0157,0.0139,0.0187,-0.0011,-0.0607,-0.0918,-0.0084,0.0023,0.0523,0.0413,-0.001,-0.0473,-0.0407,-0.0313,-0.0343,0.0588,0.0438,0.0347,0.0327,0.0086,-0.0451,-0.0055,-0.0347,0.0156,0.0257,0.0134,0.0773,0.0116,0.0062,0.0041,0.0143,-0.045,-0.0051,-0.0413,-0.0299,0.0102,-0.059,0.0308,0.0251,0.0279,-0.0158,-0.0096,-0.031,0.057,-0.0009,0.0358,-0.0405,-0.0505,-0.0683,-0.073,-0.0502,0.01,-0.0112,-0.0004,-0.0297,0.0466,0.0005,-0.0087,-0.0025,-0.0227,0.0426,0.0069,0.0428,-0.0944,-0.1019,-0.0306,0.053,0.0098,0.0226,0.0223,-0.0353,0.0084,0.0306,-0.0113,-0.0395,0.0005,0.0109,0.0216,0.0167,-0.0054,0.0661,0.0487,-0.0527,0.0616,0.0176,-0.0577,0.0381,0.0654,0.039,0.0003,0.0528,0.0072,0.1562,0.1451,0.043,0.075,0.0423,0.0449,0.024,0.0632,-0.0315,-0.0006,-0.0089,0.0298,0.0029,-0.0091,-0.0099,0.091,0.0331,-0.0313,-0.0324,0.0132,-0.0173,0.0175,0.0159,-0.0212,-0.0432,0.0878,0.0531,0.0055,-0.0366,0.0304,0.0258,-0.008,0.0603,-0.0164,0.0332,0.0579,0.0044,0.0189,0.0456,0.0585,0.0439,0.0399,0.0755,0.0173,-0.0705,0.0449,0.003,-0.0353,-0.0213,-0.0532,0.0414,0.0322,0.0144,-0.0043,-0.0248,-0.0236,0.0144,-0.0611,-0.0241,-0.0353,-0.0623,-0.0299,-0.0543,0.0086,0.0142,0.0215,0.0093,0.0159,-0.0713,0.1124,0.1335,0.0374,-0.0126,0.0238,-0.0125,-0.0171,0.0621,0.0636,0.0283,0.0492,0.063,0.0017,0.0599,0.0129,0.024,0.0513,-0.0545,0.0746,-0.0184,0.0514,0.0213,-0.0175,0.0005,0.0235,-0.0062,-0.044,0.015,-0.0073,0.0185,-0.0318,-0.0368,-0.0691,0.0079,-0.0499,-0.087,-0.0792,-0.0168,0.007,0.0014,0.016,0.1455,0.0414,0.0068,0.1045,0.082,0.062,0.0713,0.0351,0.0092,-0.0202,0.015,0.0261,0.0182,0.01,-0.023,-0.0153,0.0216,-0.0572,0.0528,0.027,-0.0481,-0.0347,0.0605,-0.0533,-0.0321,0.0009,0.0195,0.0644,0.0256,0.0826,-0.0209,0.0163,-0.0346,-0.0209,0.0422,-0.023,0.0458,0.0508,0.0309,0.0257,0.003,-0.0809,-0.0858,-0.044,-0.0211,-0.0195,-0.0304,0.0071,0.0554,0.0519,0.008,-0.063,0.0422,-0.0521,-0.0156,-0.0259,0.0267,0.0351,-0.0024,-0.052,-0.0475,-0.0098,-0.0198,0.069,0.0104,-0.0681,0.0414,0.0287,-0.0581,-0.005,-0.0257,-0.0207,-0.0559,0.0125,0.0252,0.0251,-0.0104,0.0279,0.0074,-0.0243,0.0251,0.0873,0.0228,-0.0066,0.0004,0.0481,0.1199,-0.0042,0.1132,-0.022,0.0204,0.0129,-0.0415,0.0605,0.0448,0.0038,0.0006,-0.0193,-0.0923,0.043,0.0121,0.0023,-0.0276,-0.0227,-0.0111,0.0097,0.0018,0.0003,-0.0411,-0.0036,-0.0342,0.09,-0.007,0.1408,0.0382,-0.0453,0.1558,-0.004,0.1215,-0.0504,0.0814,0.0096,0.0199,-0.0693,0.0045,0.0126,0.0215,0.1677,-0.0769,-0.0753,-0.059,-0.0559,-0.0218,-0.0455,0.0494,-0.0368,-0.0443,-0.0146,0.0131,0.0293,0.0492,0.0346,0.0068,-0.1149,0.0604,-0.008,0.0058,-0.0028,-0.0075,-0.0177,-0.0094,-0.0781,0.0797,0.0048,0.0203,-0.0071,-0.0213,-0.0583,-0.0792,-0.0383,-0.017,-0.0325,0.0551,0.02,0.0204,0.0154,0.0058,-0.0253,-0.0146,-0.0019,0.0497,0.0376,0.003,0.0857,0.1183,0.0734,-0.0234,-0.036,0.0485,0.0829,-0.0215,0.0359,0.0197,0.0054,-0.0348,0.0782,-0.024,-0.0691,0.0061,0.233,0.2334,0.138,-0.0039,0.0203,0.0523,-0.0215,0.0305,0.0065,0.0267,0.0182,-0.0241,-0.0258,0.0192,0.0207,-0.0062,-0.0177,-0.0727,0.0668,0.0316,0.0183,0.0015,0.0369,0.0522,-0.0168,-0.0216,0.0452,-0.0139,0.0117,-0.0547,0.0658,0.1183,0.0903,0.0636,-0.0127,-0.0358,0.0416,0.0419,0.0517,-0.0396,-0.0015,-0.0097,0.0122,0.0109,0.0432,0.0163,-0.0169,-0.0461,-0.0514,-0.0501,-0.0208,-0.0191,-0.0316,0.0195,0.0034,0.0265,0.0626,0.013,0.0505,0.0408,0.0472,-0.0307,-0.0262,0.0011,-0.0171,0.004,-0.0297,-0.0315,-0.0121,0.035,-0.0213,0.0178,-0.0151,-0.0106,-0.0084,0.0633,-0.0355,0.0402,0.038,0.0033,0.0016,-0.0203,0.0177,0.0066,-0.0152,-0.0061,0.0732,-0.1064,-0.0296,-0.0507,-0.0201,-0.0387,0.0068,0.0327,-0.0735,-0.077,0.021,-0.0095,-0.0301,0.0865,0.0795,-0.0181,0.0386,0.0195,0.1036,0.0463,0.0563,0.0649,0.1158,-0.0249,0.0084,-0.0082,0.0285,-0.0127,0.0391,-0.0313,-0.0686,0.0131,-0.0051,0.0028,-0.0075,0.0345,-0.0132,0.0072,-0.0252,-0.0642,0.0272,-0.042,-0.0157,-0.0043,0.0131,0.0277,0.0023,-0.0511,0.0106,0.2269,0.1065,0.006,-0.0253,-0.0425,0.0043,-0.0118,-0.036,-0.0561,0.0225,0.0415,-0.0086,0.0122,0.0586,0.0795,-0.0686,0.0593,-0.0092,-0.0213,0.0019,-0.0236,0.0976,0.0864,0.0205,-0.0622,0.0228,0.0211,0.0555,-0.0021,0.0066,0.0447,0.0626,0.0317,-0.0129,0.0057,0.0038,-0.0325,0.0151,-0.0046,0.1036,0.0529,0.017,-0.059,0.0363,-0.035,-0.0209,-0.0321,-0.0364,-0.0637,-0.0365,0.0279,-0.0054,0.0736,0.0343,0.0359,0.0186,-0.0165,-0.0433,0.0019,-0.0123,0.0198,-0.0244,-0.0719,-0.0501,-0.0112,0.0035,0.0417,-0.0208,-0.0032,0.0129,-0.0176,0.0186,0.0415,-0.0132,-0.0472,0.0106,0.0051,-0.0147,-0.0127,0.0362,0.0267,0.0093,0.066,0.0611,0.0955,0.0661,0.0909,0.0095,-0.0091,0.0129,0.0741,0.0347,0.0503,0.0418,0.0657,0.0212,-0.0033,-0.0218,-0.0136,-0.0524,0.0126,-0.0183,-0.0436,-0.025,-0.0595,0.0106,-0.0593,-0.0234,0.0398,0.002,-0.0258,0.0024,-0.0117,0.0113,-0.0315,-0.011,-0.0432,0.013,-0.0159,0.0049,0.0199,0.008,-0.0088,0.0014,0.0006,0.0521,0.0309,0.0214,0.0796,0.0612,-0.0706,-0.0583,-0.0466,-0.0317,-0.0353,-0.0162,-0.0241,-0.028,-0.0029,-0.0107,-0.0262,-0.0083,0.0152,0.0261,0.0433,0.038,-0.0227,-0.0043,0.0607,0.0335,0.068,0.0762,0.0733,-0.0308,-0.0172,-0.0467,-0.0432,0.0098,0.0694,0.0549,0.0174,0.0234,0.0073,-0.0081,-0.0008,0.0028,-0.0292,-0.0093,0.0135,0.0497,-0.001,0.0447,-0.0355,-0.0019,-0.0302,-0.054,-0.1345,-0.0069,-0.0269,0.0074,-0.0102,0.0027,0.0591,0.0372,0.0825,0.0007,-0.0307,-0.0511,0.0145,0.0071,-0.0366,-0.0026,0.0281,-0.0075,0.0493,0.0399,0.0922,0.0242,-0.0861,0.0306,0.0025,0.0532,-0.0552,-0.056,-0.0225,0.0125,0.0213,0.004,-0.0115,-0.0491,0.0526,0.0518,0.0294,0.0045,0.0228,0.0394,0.0084,0.0186,0.0009,0.024,0.0363,0.0328,0.0038,-0.0191,-0.0056,-0.006,-0.0168,0.0663,-0.0284,0.0369,-0.0215,0.0239,0.0623,-0.0893,-0.0698,-0.1272,-0.1017,-0.0837,-0.0474,-0.1108,-0.0524,0.037,-0.0639,-0.0414,-0.0364,-0.0272,-0.0356,-0.0034,-0.005,-0.0063,0.0287,0.0109,0.0153,-0.0488,-0.0291,0.0454,-0.0412,-0.0434,-0.0266,-0.0467,0.0239,0.0365,0.0094,0.0369,0.0425,0.001,0.0042,-0.0401,-0.02,-0.0642,0.0527,0.1062,0.0546,0.0226,0.0057,-0.0223,-0.0196,-0.0211,0.055,0.0744,0.054,0.0212,-0.0453,0.0008,-0.0796,-0.0783,0.0638,0.0044,-0.0127,-0.0923,-0.092,-0.0854,-0.0434,-0.0499,0.0055,-0.0428,-0.0447,0.0203,0.1074,-0.0491,0.0193,-0.0305,0.0316,0.0231,0.0038,0.048,0.0269,-0.0098,0.0361,0.0029,-0.0503,-0.0107,0.0087,-0.0022,0.0239,-0.0099,-0.0417,-0.0177,0.0525,0.0427,0.0675,-0.0011,-0.0128,0.0392,0.046,-0.0056,0.0225,-0.0732,-0.0351,-0.0783,-0.1086,-0.0051,-0.0354,0.0442,-0.0302,-0.0785,-0.0306,0.0005,-0.0294,-0.0636,-0.0335,0.0252,-0.0485,-0.0541,0.038,0.0265,-0.0014,0.0745,0.0472,0.1511,0.0233,-0.0956,0.0335,0.0581,-0.0552,0.0448,-0.0106,0.0121,0.0418,0.0238,0.0593,-0.0029,-0.0199,-0.0069,-0.0737,-0.0451,-0.0624,-0.0602,0.0928,0.0279,0.0539,0.0975,0.0624,0.0268,-0.043,-0.0548,0.0474,0.0255,-0.0437,-0.0185,0.04,-0.0287,0.0001,-0.0299,-0.0099,-0.0941,0.0462,0.0283,-0.012,-0.0381,-0.0232,0.0261,-0.0271,-0.0271,0.0615,0.0595,0.069,-0.0084,-0.0032,0.0023,0.0489,-0.0875,0.0749,0.0777,-0.0102,-0.0025,0.0613,0.0683,0.0414,0.0105,0.0142,0.0195,-0.003,-0.0037,-0.0611,-0.01,-0.0474,0.0338,-0.0356,-0.016,-0.0573,-0.0174,-0.0062,0.0606,0.0068,0.023,0.0342,0.0525,-0.0653,-0.0312,0.0134,-0.0875,-0.06,-0.1201,-0.0316,-0.0608,0.0293,0.0222,-0.0279,0.0585,-0.0326,0.0738,0.0581,-0.004,0.0074,0.0775,-0.0356,-0.0081,0.0874,-0.0244,-0.0082,0.0029,0.0162,-0.0013,0.0283,-0.0129,0.0418,-0.0093,0.0383,-0.037,-0.0906,-0.1006,-0.0935,-0.0223,-0.0155,-0.0071,-0.0078,-0.0035,-0.0018,0.0504,0.0107,0.0751,0.0204,0.0099,0.0258,0.0193,0.0537,0.0522,0.0019,-0.0432,-0.0257,0.0151,0.0275,-0.0254,0.0124,0.0642,0.0508,0.0813,0.0417,-0.0202,0.0941,0.0983,0.0068,0.003,0.0092,-0.0377,-0.0205,0.0465,0.0499,-0.0627,0.0448,0.0243,-0.0139,-0.0401,-0.0132,0.1312,-0.0103,-0.0487,0.0597,0.0208,0.017,0.0193,-0.0423,-0.0523,-0.0409,-0.0246,0.0824,-0.0544,-0.0108,-0.0234,-0.08,-0.0228,-0.0535,-0.0092,0.0156,-0.0581,0.0274,-0.0003,0.0528,0.0089,0.0437,0.0283,0.0141,-0.0324,0.0079,0.0513,0.0813,-0.0019,0.001,0.013,0.0175,0.0206,0.0183,0.0031,0.0173,-0.0369,0.0083,-0.0046,0.0255,0.0495,0.0245,0.0184,0.0274,-0.0012,-0.0366,0.003,-0.0694,0.0362,0.0255,0.0218,-0.0029,0.0017,0.0984,0.1453,-0.0368,-0.0016,-0.0491,0.0026,-0.01,0.0074,-0.0402,-0.0243,-0.0216,0.0035,0.0457,-0.0092,0.094,-0.0186,-0.0057,-0.0243,0.0197,0.0086,0.0208,0.0578,0.0476,-0.0781,-0.0657,-0.0106,-0.0636,-0.0306,0.001,-0.0267,-0.0216,-0.0174,0.0336,0.0093,-0.0747,0.011,-0.0172,-0.0306,-0.0155,0.0086,0.0159,-0.0087,-0.0205,-0.0527,-0.0775,-0.0633,0.0426,0.0208,0.0393,-0.0564,-0.0445,-0.0127,-0.0057,-0.0139,-0.0449,-0.0099,-0.0192,-0.0038,-0.0424,-0.0414,-0.0093,-0.0513,0.0033,0.0624,0.0253,0.0019,0.0037,0.014,0.0703,0.0008,0.065,0.0653,-0.0265,0.0242,0.0189,0.0366,-0.0133,-0.0352,-0.0715,0.0222,-0.0005,-0.0042,0.0298,0.0358,0.0412,-0.0298,-0.0034,-0.0089,-0.0593,-0.0495,-0.051,0.003,0.0384,0.0194,-0.0913,-0.0927,0.1067,0.1108,-0.0597,-0.0031,0.0076,0.0218,0.0725,-0.0396,0.0272,0.0221,0.0135,-0.0081,-0.1403,0.0444,-0.0917,0.003,0.0204,-0.0216,-0.0793,-0.052,0.0042,-0.0519,-0.0105,-0.0125,-0.0276,0.0156,0.0599,0.0005,0.0355,-0.0221,0.0319,0.0194,0.0129,0.0221,-0.0002,0.0792,0.0343,0.0461,-0.0364,0.0623,0.0108,-0.0081,0.0345,0.0511,0.0027,-0.0299,0.0296,0.0488,-0.0208,-0.0109,-0.0721,0.0029,-0.0361,-0.0477,0.0843,0.0754,0.0106,0.0233,0.0294,-0.0417,-0.0935,-0.0423,0.0037,-0.0144,-0.0217,-0.0201,-0.0749,0.044,0.1183,0.014,0.0423,-0.062,-0.065,-0.0775,0.0074,-0.029,0.004,0.0009,-0.015,-0.0219,0.049,-0.0149,-0.0197,-0.0495,-0.0397,-0.0846,-0.0821,-0.0743,0.004,0.0242,0.0568,0.0261,-0.0437,-0.0108,0.0385,-0.0363,-0.0285,-0.0088,-0.0743,-0.0188,0.106,0.077,0.0479,-0.0097,-0.0101,-0.0275,-0.0317,-0.0401,-0.0345,-0.0477,0.0212,0.052,-0.0126,-0.0017,-0.0289,-0.0097,0.0228,-0.0087,-0.0227,0.037,0.0303,-0.0542,0.0437,0.035,-0.0139,-0.0738,-0.0079,-0.0824,0.004,0.001,-0.0348,-0.0328,-0.0458,-0.0462,-0.0344,-0.0006,-0.0094,-0.0054,-0.0438,0.021,-0.0574,0.0852,0.0615,0.0312,0.0704,0.0137,-0.0002,-0.019,-0.0531,0.0191,-0.0659,-0.0621,-0.0494,0.025,0.0507,0.001,-0.01,-0.0439,-0.0294,-0.0368,-0.0309,-0.0637,0.0961,0.0796,0.0658,0.014,0.0121,0.0883,0.0146,0.0399,0.0373,0.0215,-0.0066,-0.001,-0.0449,-0.013,0.018,-0.0495,0.0404,0.003,-0.0047,-0.0157,0.089,-0.0155,0.079,0.0238,0.0274,0.0105,-0.0357,-0.0772,-0.0229,-0.0017,-0.0326,-0.0157,0.0843,0.0538,0.0646,0.041,0.011,0.0101,-0.0172,0.0314,0.0631,0.0184,0.0026,-0.001,0.0073,-0.022,0.0291,0.0109,0.0369,0.0488,0.0426,0.0426,-0.0127,-0.0205,0.0033,0.1816,0.0517,0.07,0.0971,0.2102,-0.0168,0.0341,0.0021,0.0673,0.0047,0.0021,-0.0089,0.0552,0.0361,0.1029,0.0114,-0.004,-0.0235,-0.0049,-0.0335,0.08,-0.0078,-0.0343,-0.0546,0.009,0.0024,0.0693,-0.0388,0.0932,0.1072,0.0797,0.0338,0.0105,0.0568,0.0662,0.0451,0.0406,0.0319,0.0263,0.0261,0.1011,-0.048,0.0203,-0.0094,0.0137,-0.0144,0.0223,0.0698,-0.0116,-0.0022,-0.0116,-0.0023,0.0288,0.1458,0.0139,0.0558,0.0033,0.123,0.0872,0.0392,-0.0673,-0.0473,0.0368,-0.0023,0.0105,-0.0768,-0.0817,-0.0851,0.2248,0.227,-0.0099,-0.0531,0.0133,-0.0074,-0.0029,0.032,0.0473,-0.0041,0.0402,0.0226,0.0244,0.0036,0.0533,-0.0093,0.0861,-0.0491,0.0412,-0.005,-0.0601,-0.0636,0.0016,0.0611,0.1024,0.0323,0.0212,0.0734,0.0502,-0.0604,0.0302,0.0581,-0.1198,-0.0761,-0.0646,-0.0966,-0.0495,-0.0744,-0.0831,-0.0524,-0.0451,-0.0559,-0.0761,-0.0591,-0.0887,-0.1182,-0.0759,0.1375,-0.0406,-0.0307,-0.062,-0.0144,0.0326,-0.0274,-0.0081,0.0141,-0.0456,-0.0719,0.0277,-0.0107,-0.0248,-0.0414,-0.0272,-0.0686,0.0148,-0.007,-0.1099,-0.0719,-0.0025,-0.0073,-0.0297,-0.0177,-0.0457,-0.0105,0.0296,0.0068,-0.0255,0.1385,0.0495,0.0775,0.0662,0.0244,0.054,0.0816,0.0414,0.0048,0.0447,0.0253,0.0126,0.0356,0.106,0.2228,-0.0391,0.0777,-0.0094,0.0031,0.04,-0.0299,0.057,0.0496,0.0378,0.014,0.0343,0.002,0.0164,-0.0431,-0.0516,-0.0731,-0.0386,0.0555,0.0102,0.0204,0.0548,-0.0011,0.0107,0.0041,-0.0162,0.024,0.0119,-0.0097,0.0517,0.0603,0.0047,-0.025,0.01,0.0594,0.0529,-0.0018,0.0242,0.0076,0.0708,0.0184,-0.0363,-0.0108,-0.0153,-0.0036,-0.0069,0.0028,-0.0246,0.0182,0.0572,-0.0308,-0.0477,-0.0379,-0.0074,-0.0785,-0.0287,0.0344,0.012,-0.0652,-0.0814,-0.0341,-0.0144,-0.0343,-0.0449,0.0641,0.0619,0.0253,0.0217,-0.0941,-0.0914,-0.0658,0.018,-0.0166,-0.0396,-0.0871,-0.0802,-0.0999,-0.0133,-0.0238,0.0108,-0.0049,-0.0297,-0.0069,0.0548,0.0174,0.0109,0.0624,0.0648,0.0673,-0.0481,0.0145,0.0096,0.005,0.0061,-0.032,-0.0509,-0.0445,-0.0427,-0.0738,0.0224,0.0295,0.0306,0.0268,0.0122,0.0661,-0.0453,0.0563,0.0794,0.0641,-0.0581,0.0115,0.025,-0.008,0.008,-0.0614,-0.0447,-0.018,-0.0844,0.0259,0.0971,0.1183,-0.0738,-0.0131,0.0395,-0.0528,-0.0185,-0.084,-0.0882,0.038,0.0329,0.0329,0.0285,-0.0788,0.0127,-0.0201,0.0029,0.0144,-0.0269,-0.0271,0.027,-0.0575,0.006,0.0458,-0.0099,0.0621,0.0609,0.0692,0.0189,-0.0054,0.0084,-0.0314,-0.0327,-0.0154,-0.0704,-0.0622,0.0223,-0.0684,0.0507,0.0022,-0.0416,-0.0488,-0.1092,-0.0394,0.0322,-0.0166,0.0157,-0.0497,-0.0232,-0.015,-0.0155,-0.0492,-0.0427,0.0529,-0.0024,0.041,-0.0371,-0.0393,0.0086,-0.0044,-0.0243,-0.0578,-0.0253,-0.0567,-0.0397,0.0834,0.0808,0.0061,0.0339,0.0764,-0.0498,-0.0153,0.0058,-0.0144,-0.0597,-0.0218,0.1775,-0.0078,-0.0211,0.0608,-0.0449,-0.0138,-0.0224,-0.0555,-0.1101,-0.1132,-0.1012,-0.0535,0.0277,-0.0288,-0.0557,0.0521,-0.0067,-0.0031,-0.0018,0.0332,-0.0307,0.0042,0.0224,0.1005,0.124,0.1115,0.0855,0.0329,0.0443,0.0234,0.0359,0.0149,-0.0439,-0.0526,0.0258,-0.0044,-0.0283,-0.1111,0.0549,-0.0086,0.0284,-0.0408,0.0068,-0.0383,-0.0423,0.0227,-0.0027,-0.0742,-0.0423,-0.0373,0.0235,0.022,-0.0257,-0.0103,0.0187,0.0008,0.0221,-0.0042,-0.0078,0.0358,-0.0488,-0.0175,-0.0099,-0.0021,0.0673,0.0342,0.0167,0.0215,0.0388,0.0383,0.0463,0.0516,-0.0583,0.0345,0.0025,0.15,0.0581,0.0585,0.1154,0.075,0.0541,0.0592,0.0592,0.0241,-0.0079,-0.0417,0.0571,-0.0187,0.0023,0.0161,0.063,0.0509,0.2255,-0.0418,0.002,0.0066,-0.0151,-0.0632,-0.0567,0.0086,0.0934,0.0449,-0.0106,0.0274,0.0109,-0.0517,-0.06,-0.0822,-0.1272,-0.1009,0.0158,-0.0195,-0.0864,-0.0531,-0.0094,0.1234,0.1017,0.0158,0.0317,0.0132,0.0228,-0.018,-0.0469,-0.022,0.0359,-0.0267,-0.0054,0.0912,-0.0486,0.0456,0.1164,0.0552,0.14,0.0346,0.0274,-0.0512,0.037,-0.1386,-0.1411,-0.0245,-0.1062,-0.0505,0.0373,-0.075,0.0173,-0.0818,-0.0092,0.0283,-0.0617,0.0003,-0.0324,-0.0236,-0.0113,0.0059,0.0431,0.011,-0.0035,0.0139,-0.0576,0.0025,-0.0605,-0.0494,-0.0637,-0.0312,-0.013,-0.038,-0.0022,0.0193,-0.0061,0.036,-0.0013,-0.0049,0.0408,0.0549,0.0111,-0.0364,-0.0285,0.0102,0.0101,0.0419,-0.0332,-0.0068,-0.0092,-0.007,0.0052,-0.017,-0.0243,-0.0787,0.0257,-0.031,-0.1004,-0.0044,0.0172,0.0227,0.0001,0.0155,-0.0132,-0.0251,0.0482,-0.0682,-0.024,-0.0171,-0.0201,-0.0139,-0.0156,0.0078,0.0424,0.0361,0.0498,0.0433,-0.0239,-0.03,-0.0025,0.0389,0.0303,-0.0751,-0.0226,0.0632,0.0573,0.0623,0.044,-0.0012,0.0083,-0.0148,0.0514,0.0449,0.0783,0.0104,0.0505,-0.03,0.0006,-0.0374,-0.0559,0.0418,0.0273,0.0085,-0.0241,0.0116,0.0335,-0.0407,-0.045,0.0311,0.0232,0.018,0.0526,-0.0325,-0.0513,-0.0146,-0.0163,-0.0057,0.0588,0.0146,0.0668,0.0682,-0.0221,0.0297,0.0014,-0.0161,-0.0621,-0.0621,-0.0482,0.037,0.0582,-0.0196,-0.0305,-0.1056,0.0411,0.0173,0.0404,0.0025,0.0408,0.0557,0.0449,0.0224,0.0206,-0.041,0.0316,0.0383,0.0005,0.0313,0.0129,-0.0318,0.01,-0.0021,0.0839,-0.0208,0.0236,-0.0124,0.012,-0.0397,-0.0467,-0.0727,0.0039,0.0226,0.0057,0.0199,-0.0221,0.0668,0.1551,0.0195,-0.0019,0.0188,-0.0041,-0.0232,-0.0049,-0.0119,0.0319,-0.0133,0.0724,0.0467,0.0329,0.1011,-0.0188,0.0637,0.0478,0.0991,0.0123,-0.0106,-0.1011,0.0984,0.0245,0.025,-0.0217,-0.034,0.0237,0.0551,0.0887,0.0411,0.037,-0.0119,-0.0022,0.0321,-0.0031,0.025,-0.019,0.0009,-0.007,-0.0045,0.0402,0.0274,-0.0026,-0.0305,0.0377,0.0227,0.04,0.0092,-0.0406,-0.0243,-0.0276,-0.0028,-0.0484,-0.004,-0.0658,-0.0161,0.033,0.0801,0.0215,0.0081,-0.0597,-0.0588,-0.0447,0.0059,-0.0076,-0.007,-0.0956,-0.0678,-0.0181,-0.0154,0.1056,0.0057,0.0002,0.0039,0.032,-0.0461,-0.0633,-0.0251,-0.06,-0.0079,-0.0207,0.022,-0.0131,-0.0233,0.0685,-0.0616,-0.0275,0.0273,-0.0097,-0.0441,-0.0033,0.0052,-0.011,-0.0319,-0.0523,-0.0746,-0.0051,-0.0632,-0.0155,-0.0481,-0.0052,0.0006,0.1126,0.2121,0.2059,-0.0366,-0.0333,-0.0392,0.0135,0.0029,0.0465,0.0841,0.1031,0.1157,0.0052,-0.003,-0.0052,0.0563,0.0017,0.0117,0.0862,0.0166,0.0671,0.0958,-0.0689,0.0371,0.0024,0.1123,0.0745,0.0234,-0.007,0.0001,-0.0166,0.0276,0.0189,0.0523,-0.0589,0.0854,-0.0256,-0.0097,-0.0288,0.0243,0.0026,-0.0366,-0.0917,-0.0825,0.0431,0.0573,0.0406,0.0072,0.0832,0.0391,0.0252,0.1275,0.0343,0.0107,0.0225,-0.0213,0.0446,0.0028,0.0172,0.0738,0.0388,0.0229,0.0774,0.0443,-0.0344,0.0423,0.0763,-0.0164,-0.043,0.0017,-0.0032,-0.0379,-0.0598,-0.0523,-0.0335,0.0797,0.1233,0.0347,0.0188,-0.0272,-0.0352,0.0063,0.0089,0.001,-0.043,-0.0966,-0.0534,-0.0092,-0.0591,0.1418,0.1555,0.0454,0.013,0.0322,0.0367,0.07,0.0298,-0.0292,-0.0045,-0.0014,0.0435,-0.0217,0.0569,-0.0681,-0.0571,-0.072,-0.0505,-0.0356,-0.0404,0.024,0.0215,0.0161,-0.0405,-0.0511,-0.091,-0.0235,-0.036,-0.0643,-0.076,-0.1064,-0.0556,0.0049,0.0313,-0.0083,-0.0114,-0.0232,-0.0184,0.007,-0.0269,-0.0077,-0.0265,-0.0071,0.026,0.0055,0.0784,0.0397,0.038,0.0437,-0.0413,0.0563,-0.0523,-0.0904,-0.0298,-0.0176,-0.0168,-0.0446,-0.0093,-0.0622,-0.0688,-0.0608,-0.0819,-0.0151,-0.0325,0.033,0.0116,-0.0172,-0.0635,-0.0353,-0.0502,0.0075,0.0002,-0.068,-0.0365,-0.0305,0.0,0.0393,0.0501,-0.0243,-0.0203,-0.0463,0.0705,-0.0202,-0.0081,-0.0644,-0.0322,0.0135,-0.0302,-0.0305,0.0134,-0.0799,-0.0863,-0.0207,-0.0089,-0.0217,-0.053,0.004,0.0572,0.0043,0.0354,-0.0455,-0.0338,-0.0018,0.0141,0.0314,0.0242,-0.0368,-0.1254,0.0314,0.0059,0.0951,0.1216,0.1061,0.073,0.0828,0.0533,0.0755,0.0107,0.0371,0.0208,-0.0266,-0.0286,-0.0253,0.0269,-0.05,-0.0142,0.0546,-0.0088,-0.0018,-0.0205,0.0185,-0.0432,-0.0679,-0.0471,0.0335,-0.0007,0.0181,-0.0116,-0.0524,-0.0342,0.0076,-0.0626,-0.0221,0.0192,-0.0049,-0.0274,-0.0557,0.0369,0.0456,0.0276,0.0308,-0.0561,-0.0475,-0.0575,-0.0036,-0.0523,0.0434,-0.012,-0.0565,-0.0494,0.1118,0.0324,-0.0386,-0.0348,0.0028,0.0504,0.2075,0.1603,0.1014,0.1172,-0.071,0.0477,0.0642,0.007,-0.0502,-0.0344,-0.0547,-0.0206,-0.0998,-0.0951,-0.104,-0.056,-0.0392,-0.0341,-0.0413,-0.0625,0.0153,-0.0291,-0.0285,-0.012,-0.0595,-0.0431,0.0546,0.1011,0.0845,-0.0034,0.0645,0.0724,-0.0327,-0.009,-0.0014,-0.0037,-0.0291,-0.0254,0.0506,0.0286,0.0644,-0.0136,0.05,0.0452,-0.0231,-0.0448,0.0108,0.0474,0.0065,-0.0372,0.0062,0.0871,-0.0346,0.0703,0.015,0.0257,-0.0014,0.0059,0.0253,-0.025,-0.0122,0.0054,0.0326,0.0162,0.0364,-0.031,-0.025,-0.0149,0.016,-0.0972,0.0136,0.0249,-0.0162,-0.0362,-0.0058,0.0187,0.0216,-0.0157,-0.0086,0.0179,-0.013,-0.0976,-0.0819,-0.0267,-0.0466,0.0182,-0.0903,-0.0036,-0.1072,0.0097,-0.0949,-0.0357,-0.1207,-0.1245,-0.0119,0.0043,0.0082,0.0402,0.0169,-0.0193,-0.0198,-0.0455,0.0184,0.0117,0.0344,-0.0526,-0.0688,-0.052,0.0746,0.0678,0.0723,0.002,0.0464,0.002,0.0431,-0.0097,-0.0097,-0.0144,0.0299,0.0405,-0.0563,-0.0142,0.0642,-0.0825,-0.0809,-0.0192,0.0235,-0.0392,-0.095,-0.072,-0.0405,-0.0246,0.0266,0.0136,-0.0533,-0.024,0.0934,-0.0564,-0.0209,-0.037,-0.0029,-0.1211,-0.0241,0.058,0.0567,0.0174,-0.0029,-0.0062,0.0376,-0.0093,-0.0065,-0.0108,0.0118,0.0434,0.0178,-0.0276,0.0388,0.0493,-0.0285,-0.0373,0.0596,0.0136,0.0327,0.0538,0.0503,0.0087,0.033,0.0403,0.0342,-0.0593,-0.0767,0.0204,-0.0049,0.0239,-0.0187,0.0035,-0.0004,0.0257,-0.0052,0.0458,0.0004,0.1018,0.1081,0.0206,0.0161,0.0461,0.0852,-0.0064,0.0367,0.0737,0.1156,0.021,0.0091,-0.0189,0.006,-0.006,0.0573,-0.0286,0.0452,-0.0572,-0.0738,-0.0811,0.0355,-0.0461,0.0882,0.0768,0.0076,-0.032,-0.0273,0.0352,-0.0187,-0.0211,0.0153,0.0374,-0.0308,0.0538,0.0001,-0.047,-0.0044,0.0017,0.0197,-0.0267,0.002,-0.0845,-0.0672,0.0875,0.0947,-0.0443,-0.0495,-0.0169,-0.0515,-0.0197,0.0066,0.0424,0.0832,0.0044,0.0863,0.0898,0.0236,0.062,-0.0353,0.0025,-0.0395,-0.0133,-0.0919,0.0147,-0.0674,-0.0071,-0.027,-0.0324,-0.0036,-0.0078,-0.0235,0.0351,-0.0143,0.0365,0.0253,0.0091,-0.0071,0.0396,0.029,0.0489,0.0247,0.043,0.0686,0.0826,0.0322,-0.0236,0.0044,-0.0116,-0.0559,-0.0025,-0.0181,0.0121,0.0034,-0.0177,0.0235,0.0395,0.042,-0.1017,-0.0369,-0.0463,0.0119,0.0034,0.0509,0.0488,-0.0035,0.0178,-0.0345,-0.0639,0.1061,0.0475,-0.0006,0.0657,-0.0129,0.0129,-0.063,-0.0734,0.0944,0.0052,0.0527,0.0191,0.025,0.1136,0.0904,0.0608,-0.0408,0.0202,0.0056,-0.0387,0.0681,0.0076,-0.0476,0.0152,-0.0361,-0.002,-0.0049,0.0115,0.0526,0.0026,0.0279,0.0798,0.0187,0.1604,-0.129,0.0905,-0.0425,-0.051,-0.0343,0.1853,0.1779,-0.0603,-0.0829,-0.0255,-0.0816,-0.0317,-0.0529,-0.0165,0.0365,-0.0574,-0.0305,-0.0296,-0.024,-0.0095,-0.0081,-0.0493,0.0206,-0.0021,-0.0552,-0.1292,-0.0329,-0.1137,-0.0992,-0.0348,-0.0389,-0.0529,-0.0652,-0.0653,-0.0189,-0.0515,-0.0701,-0.0268,-0.039,-0.0477,-0.1127,-0.0683,-0.0621,-0.0626,-0.0343,0.0582,0.0023,0.1779,-0.0502,-0.0243,0.0593,0.0566,0.0315,-0.0398,-0.0249,0.0834,0.0685,0.032,-0.0083,0.0064,0.0779,-0.0438,0.0194,0.0271,0.0281,0.0714,0.0148,-0.0061,0.0451,0.0312,-0.029,0.0508,0.0602,-0.0227,0.02,-0.0206,0.0057,-0.0018,0.0248,-0.0302,0.0054,0.0536,-0.0712,-0.0547,0.0044,-0.0271,-0.0499,0.0268,-0.0814,-0.0802,0.0591,0.0577,-0.0323,0.042,0.0135,0.0292,0.0246,-0.0539,0.0391,0.0391,-0.0028,0.0342,0.0549,0.0033,decision certainty
trm_557b48a224b95,0.022,0.033,0.0369,0.0989,0.0178,-0.0143,0.0061,0.0239,-0.0285,0.0254,-0.0396,-0.0285,0.0544,0.0121,0.0174,0.0013,0.063,0.0844,0.0072,0.0022,0.0361,-0.0181,-0.0118,-0.0443,-0.0092,-0.0515,-0.048,0.1307,0.1077,0.0144,0.0599,0.042,0.0269,0.0296,0.1169,0.093,-0.0512,0.0385,0.0444,0.067,0.0704,0.0597,-0.0017,-0.0342,0.0645,0.0996,-0.2136,0.0217,-0.035,0.1412,0.0576,0.0078,0.0073,0.0093,0.1222,0.0541,0.0906,-0.0374,-0.0545,-0.0193,-0.0426,-0.0583,0.1168,-0.043,0.0273,-0.0449,0.1241,0.163,0.1006,-0.0174,-0.0522,-0.0094,-0.0564,0.0413,0.0913,0.0212,0.0914,-0.0425,-0.0838,0.0261,-0.034,-0.0194,0.0247,0.1105,0.01,-0.0427,0.0352,-0.0257,-0.0247,0.3737,0.0517,0.0425,-0.0107,-0.3319,-0.3161,-0.3057,-0.137,-0.0833,-0.1664,-0.1089,-0.0668,0.0244,-0.0695,-0.1386,-0.1467,0.0981,0.1139,-0.11,0.054,0.0299,0.001,0.0792,-0.0291,-0.1301,-0.0099,0.0242,0.0589,-0.0844,0.018,0.0423,0.0983,0.1389,0.113,0.0544,0.1263,0.1071,0.1221,-0.0747,-0.0736,0.0472,0.0566,0.0399,-0.0322,0.1715,0.1004,0.1372,-0.0446,0.0593,0.0308,-0.022,0.0451,0.0911,-0.0457,0.0987,0.0463,-0.0681,0.0342,-0.0211,0.0322,-0.0324,0.0536,0.0581,0.0666,0.1333,-0.079,-0.0016,-0.1089,-0.0628,-0.0098,0.0209,0.0336,0.0785,0.1264,0.1065,-0.0004,-0.0092,0.0073,0.1143,0.1039,0.039,0.0132,0.073,-0.0609,0.1176,0.0997,0.12,0.0666,0.0669,0.0435,-0.0085,0.1619,-0.0517,0.0821,-0.0064,0.0682,0.0719,0.0446,0.0837,0.0219,0.0607,0.0659,0.0526,0.0067,0.1308,0.1122,0.2013,0.1822,0.0131,-0.0095,0.0945,0.0251,-0.2839,0.1229,0.1294,0.0241,0.1738,0.1755,0.0833,0.0301,0.0023,0.1157,-0.0082,0.0301,0.0335,-0.0204,-0.0019,-0.0997,0.0472,-0.0041,-0.0434,-0.1482,0.0526,0.0923,0.0602,-0.0417,-0.0625,0.0657,-0.0625,0.1018,-0.0526,-0.1068,0.0655,-0.1696,0.0789,0.0793,0.0349,-0.0015,-0.0173,0.0227,0.0557,-0.0619,0.0686,-0.0287,0.0132,0.0666,0.0559,0.0751,0.1483,0.0822,0.1042,-0.0068,-0.0383,0.0513,-0.0462,0.0542,0.1081,0.0226,0.0439,-0.141,-0.2039,-0.0489,-0.2286,0.0584,-0.0998,-0.1319,-0.214,-0.0507,0.0173,-0.0923,-0.0131,-0.0024,0.0082,0.0538,-0.0423,0.1307,0.0979,0.3291,0.332,0.2436,0.1914,0.1071,0.0209,0.008,0.1942,0.161,0.0111,-0.0422,-0.0408,0.0149,0.0674,0.0334,0.0187,0.046,0.036,0.0479,-0.0161,0.0221,-0.0218,0.0167,-0.0637,-0.013,0.1369,0.0741,0.0662,-0.0093,-0.0217,0.0753,0.0872,-0.0088,0.0287,0.0459,0.0073,0.0786,-0.0039,-0.027,0.0316,-0.087,-0.0668,-0.0019,0.1221,-0.0035,-0.0201,0.0835,0.1386,0.0086,0.0225,0.0102,0.0367,-0.016,0.044,0.0422,0.0656,-0.0207,-0.0556,-0.0052,-0.0842,0.0376,0.0565,-0.0413,0.1262,0.1213,-0.0295,-0.0487,-0.0055,-0.1035,-0.0179,0.1113,0.0724,0.069,0.0473,-0.0097,-0.3059,-0.0014,-0.01,0.0148,-0.0086,0.0156,0.0781,0.0929,0.0698,-0.0373,0.0004,0.1515,-0.0008,0.0017,-0.1041,0.0998,-0.1018,-0.0423,0.0562,-0.0104,-0.0782,0.0308,-0.1147,0.0903,0.0111,0.0794,-0.0903,-0.1072,-0.0209,-0.1055,-0.0942,0.0947,0.0277,-0.0672,-0.0654,0.0538,-0.0158,-0.0454,0.0348,-0.0056,0.0435,-0.054,-0.0034,-0.1189,-0.0995,-0.0477,0.0644,0.0795,0.113,0.0752,-0.0032,0.0201,0.0531,-0.0533,0.0332,-0.0752,-0.0527,0.0434,0.0063,-0.0235,0.0573,0.0191,-0.2028,0.0896,0.1256,-0.1347,0.0587,0.1058,0.0373,-0.0026,0.086,0.0222,0.2276,0.2078,0.0484,0.1412,-0.0749,0.0763,0.0342,-0.0189,-0.0172,0.0331,0.0227,0.0427,-0.0453,-0.046,0.0609,0.1243,0.0698,-0.126,-0.0939,-0.033,-0.0896,-0.002,0.0345,0.0195,-0.139,0.1006,0.1194,0.0759,-0.0273,0.1089,0.1018,-0.0104,0.1131,0.0316,0.0438,0.0992,-0.0209,-0.0353,0.0338,0.0459,-0.0369,0.0249,0.1212,-0.0774,-0.2632,0.0812,0.0871,0.0126,-0.0025,-0.0579,0.0414,0.085,0.0596,-0.057,-0.0488,0.0515,-0.0086,-0.1252,-0.0017,-0.0089,-0.0891,0.0174,-0.0353,0.0043,-0.0345,0.119,-0.0032,-0.0852,0.0356,0.1149,0.1451,-0.0237,-0.0268,0.313,0.0436,0.0085,0.0758,0.0622,0.0105,0.0822,0.0467,0.0727,0.0436,-0.0058,0.0247,0.0248,-0.1847,0.1101,-0.0287,0.05,0.0148,-0.1041,-0.0427,0.0692,0.0537,-0.0607,0.0237,0.0839,0.1045,-0.1095,-0.018,-0.0608,-0.0658,-0.0082,-0.0946,0.0111,-0.0713,0.0756,0.0115,-0.0038,0.1014,0.0376,-0.0001,0.0629,0.053,0.0373,0.0604,0.02,-0.0761,0.0324,0.0523,0.0579,-0.0124,0.0155,-0.0159,0.0085,-0.0078,-0.1068,0.0794,0.0314,-0.0081,0.0029,0.0844,-0.0625,-0.0336,-0.0184,0.0069,0.0147,0.021,0.0586,-0.05,0.0885,0.0105,-0.009,0.1293,0.0688,0.123,0.086,0.0372,0.1179,-0.0081,-0.1875,-0.1281,-0.0548,-0.0396,-0.0247,-0.043,0.038,0.0209,0.0317,-0.0027,-0.0214,-0.044,-0.0435,0.0089,-0.0389,0.0382,0.1115,0.0019,-0.0299,0.0187,0.0612,0.012,0.124,0.0269,-0.149,0.1378,-0.0451,-0.0196,-0.0462,-0.0181,-0.1191,-0.1647,0.0807,0.0679,0.0562,0.0103,0.1151,0.0322,-0.0569,0.0292,0.1093,0.0076,0.0126,0.0347,0.0059,0.1059,0.0421,0.107,-0.0881,-0.0319,0.0358,-0.08,0.0736,0.0664,0.0216,-0.0088,-0.0643,-0.0982,0.0247,0.0274,0.0335,-0.0876,-0.0452,0.0134,0.0742,0.0273,0.0383,-0.1326,-0.0386,-0.1195,0.0706,0.0542,0.1693,0.1058,-0.1162,0.0925,0.0386,0.0855,-0.1782,0.0608,0.0256,0.0295,-0.1737,0.0449,-0.005,0.0737,0.1171,-0.1462,-0.1649,-0.0932,-0.1274,-0.0915,0.0136,0.07,-0.0487,-0.0132,0.0257,0.0128,0.0099,0.0367,0.0304,0.0429,-0.1275,0.0282,-0.0099,0.0379,-0.0095,-0.1031,-0.0857,0.0262,-0.0462,0.1323,0.05,-0.035,-0.0081,0.0057,-0.0604,-0.1134,-0.1209,-0.0444,-0.0127,0.1091,-0.019,0.0569,0.0444,0.0439,0.0078,0.0228,0.027,0.0587,0.0803,0.0457,0.0529,0.0623,0.0622,0.0153,-0.0504,0.0779,0.0619,0.0197,0.0451,0.0521,-0.0019,0.1354,0.0477,-0.0336,-0.0364,0.0389,0.1854,0.1872,0.1085,0.0321,0.0292,0.0557,0.0138,-0.0142,-0.0507,0.0183,0.0094,-0.0384,-0.0782,-0.0113,0.0613,-0.0639,-0.1162,-0.0617,0.1111,-0.0249,0.0349,-0.0641,-0.0293,0.0581,-0.0481,-0.0368,-0.0149,0.0142,0.034,-0.1188,0.1024,0.1694,0.146,0.1113,-0.0656,-0.1769,0.0074,0.0907,0.0381,-0.0117,-0.0349,-0.0164,-0.0179,-0.0671,0.0286,0.0117,0.0007,-0.0232,-0.0655,-0.1363,0.0461,-0.0121,-0.058,0.0787,-0.0804,0.0508,0.0521,0.092,0.0987,0.0977,0.0763,-0.129,-0.0537,0.0223,0.0508,-0.001,-0.0082,-0.094,-0.0268,0.0968,-0.0736,-0.0005,-0.0098,-0.0699,-0.0557,0.0883,-0.0438,0.1269,0.1282,-0.0627,-0.0999,-0.2145,-0.0007,0.0171,-0.0744,0.0316,-0.1289,-0.2203,-0.1051,-0.1072,-0.0981,-0.1265,-0.0944,-0.0075,-0.1233,-0.0887,0.0389,-0.0298,0.04,0.1043,0.0928,-0.0096,0.054,-0.0602,0.1755,0.0427,0.1204,0.0598,0.1252,-0.0487,-0.029,-0.1068,0.0516,0.0198,0.06,-0.0236,-0.0297,-0.0363,-0.0378,-0.0723,0.0097,-0.0224,-0.0153,0.0131,-0.0977,-0.1218,0.0793,-0.0795,-0.0453,0.0164,0.0427,0.0403,0.0694,-0.0696,0.0403,0.1574,0.1261,-0.0092,-0.029,0.0366,0.0933,0.0455,0.0019,-0.0708,0.0679,0.0827,-0.1353,0.1005,-0.06,0.09,-0.2033,0.0673,-0.1101,-0.002,0.0363,-0.0152,0.1702,0.1533,0.0285,-0.2078,0.0435,0.0479,0.0422,-0.0551,-0.0295,0.0636,0.0447,0.1218,0.0498,0.0129,-0.0654,-0.0895,0.0188,-0.094,0.0823,0.0593,0.04,0.0492,0.0746,-0.0025,-0.0759,-0.0423,-0.0559,-0.2107,-0.0706,0.0279,0.0641,0.097,0.0233,0.0555,0.05,-0.0903,-0.149,-0.0466,0.0103,0.0777,-0.1228,-0.1277,0.0122,0.082,0.102,0.0031,0.0125,0.0387,0.0458,-0.105,-0.0469,0.0457,0.0442,-0.0686,-0.0564,0.0743,0.0277,0.0149,0.0558,-0.0223,-0.0207,0.0734,0.0775,0.1911,0.0968,0.1634,0.0159,0.0325,0.0909,0.136,0.0564,0.1615,0.0733,0.1673,0.0272,-0.0036,0.0784,-0.0778,-0.0666,0.0443,-0.0789,0.0455,0.0105,-0.1041,-0.063,-0.102,-0.0085,0.0977,0.0251,-0.0513,0.0625,-0.0051,-0.027,-0.0494,0.0083,0.1012,-0.0029,-0.098,0.0335,0.0272,-0.0085,-0.0444,0.1517,-0.0179,0.1343,0.0602,0.0411,0.0766,0.062,-0.0487,-0.0038,-0.0505,-0.0515,-0.0866,-0.0996,0.0251,0.0041,-0.0294,0.0158,-0.0494,-0.0249,0.003,0.0381,0.0657,0.0459,-0.0593,-0.0345,0.0605,0.0778,0.0634,0.1663,0.0754,-0.1142,-0.0539,-0.1151,-0.0189,-0.0854,0.0743,0.0444,-0.0172,0.006,0.0051,0.0461,-0.0178,0.0338,-0.004,-0.0319,-0.0415,0.0895,-0.024,0.1024,-0.0144,0.0782,-0.0271,-0.173,-0.2656,0.0216,-0.0187,0.0317,0.047,0.0099,0.0165,0.0653,0.0687,-0.0284,0.0038,-0.0022,0.0532,0.0162,0.0306,0.0002,0.0342,-0.0162,0.0153,0.099,0.0648,0.0698,-0.0835,-0.0105,-0.0608,0.1171,-0.2276,-0.1307,0.0432,-0.0015,-0.0067,0.0385,0.034,-0.0511,0.047,0.0679,0.055,0.0895,0.1178,0.0108,0.0798,-0.0766,-0.0178,0.0668,0.0467,0.0833,-0.0401,-0.1126,0.0188,-0.0452,-0.0542,0.0506,-0.0589,0.0802,-0.0404,0.0385,0.053,-0.4057,-0.2804,-0.2735,-0.1654,-0.204,-0.062,-0.2548,-0.1501,0.118,-0.2273,-0.2598,-0.188,-0.1289,-0.1784,-0.0285,-0.0907,-0.0334,0.0486,-0.0356,0.0322,-0.0418,-0.0289,0.0728,-0.0553,-0.0991,0.0135,-0.0682,0.0003,0.1223,-0.1744,-0.0474,0.0741,-0.0037,0.0768,-0.0261,-0.0175,-0.1365,0.0343,0.0724,0.0636,-0.0103,-0.0367,-0.0734,-0.0474,-0.0231,0.0307,0.1076,0.0749,0.0427,-0.2495,0.0357,-0.237,-0.2051,0.0758,-0.0493,-0.0492,-0.2373,-0.2533,-0.1437,-0.1788,-0.0078,-0.0023,-0.0462,-0.0066,-0.0228,0.0522,0.0304,0.0351,-0.1188,-0.0168,0.1131,0.0278,0.0404,0.0227,-0.0822,-0.0071,-0.0241,-0.1331,-0.1339,0.0167,-0.0008,0.0528,-0.05,-0.0353,-0.0138,0.1239,0.1283,0.0924,0.1122,0.0413,0.0798,0.0278,0.0227,0.0338,0.0338,-0.0139,-0.0131,-0.2028,0.0645,0.1387,0.1093,-0.015,0.0233,-0.1016,0.1395,-0.0625,-0.2207,0.0381,0.2699,-0.1392,-0.1187,0.0429,0.1572,0.0096,0.1045,0.1055,0.0986,-0.0057,-0.0874,0.0612,0.0876,0.01,0.0575,0.0701,0.1014,0.0457,0.0573,0.0965,0.0526,-0.0511,-0.0106,-0.3029,-0.2709,-0.2131,-0.2497,0.0528,0.0069,0.098,0.089,0.0931,0.007,-0.019,-0.1917,0.1126,0.0712,-0.0263,-0.0484,-0.0335,-0.0906,-0.0075,-0.0076,-0.0287,-0.1003,0.0657,0.0738,0.1373,-0.1676,-0.001,-0.0063,-0.0111,-0.0111,0.1421,-0.1177,-0.0782,-0.0714,0.0207,-0.0411,0.008,-0.358,0.1966,0.1851,0.0166,0.065,0.1162,0.1287,0.1357,-0.0043,0.0068,0.0408,0.0217,-0.0008,-0.2314,0.0802,0.11,0.0639,-0.0035,-0.0056,0.0733,-0.0597,0.0306,0.0347,0.055,0.1573,0.0542,0.0331,0.238,0.0562,-0.0294,-0.2926,-0.1557,-0.1688,0.0051,-0.2928,0.0672,0.0338,-0.0357,0.0749,-0.0147,0.1233,0.0866,0.0357,0.0261,0.1316,-0.0794,-0.0248,0.1074,-0.0015,-0.0257,0.0059,0.3431,0.1516,0.046,0.0382,0.0248,-0.03,0.0225,-0.2174,-0.0861,-0.1051,-0.0408,0.0209,0.0329,0.0327,0.3072,0.2982,-0.0035,0.0606,0.147,0.0603,0.0003,-0.0168,-0.0367,0.019,0.0774,0.1033,0.0152,0.0634,0.0303,0.0486,0.0908,-0.0573,-0.0111,0.0649,0.0596,0.1411,0.0829,0.0133,0.0913,0.0956,-0.0351,-0.0383,-0.112,-0.131,-0.014,0.0414,0.0565,0.0321,0.0739,0.0073,-0.012,-0.0039,-0.016,0.1596,-0.0154,-0.0769,0.004,-0.0055,0.0132,0.035,-0.125,0.0874,-0.0476,0.012,0.1516,-0.1458,0.064,-0.1164,-0.1797,-0.2183,-0.0009,-0.0138,-0.0681,-0.2615,0.0459,-0.0678,0.0478,-0.0156,0.0696,0.0776,0.0414,-0.0404,0.0312,0.0491,0.0884,0.0498,0.014,0.022,0.0914,0.1075,-0.0302,-0.0014,0.0121,-0.1022,0.0556,0.0316,0.0587,0.0701,0.0672,0.0752,0.0139,0.0322,-0.009,0.05,-0.0163,-0.02,0.0388,0.0316,0.0261,-0.0056,0.0341,0.1723,-0.051,-0.087,-0.1696,-0.008,-0.0565,-0.0798,-0.0863,-0.0584,0.0872,0.0837,0.0139,0.0123,0.1264,0.0037,-0.0031,-0.003,-0.0132,0.0297,0.066,0.0841,0.1074,-0.0234,0.1007,0.0958,-0.1918,-0.1561,0.0389,-0.0986,-0.1091,-0.0039,0.0413,-0.0512,-0.0748,0.0142,-0.0097,0.0419,0.0507,0.0193,0.056,-0.0349,-0.0516,0.0194,-0.0978,-0.17,0.0149,0.0347,-0.0052,0.0084,0.0095,-0.0176,0.1347,0.0425,0.0286,0.1069,0.0858,-0.0975,-0.1029,0.0298,-0.01,0.0365,-0.0283,0.1125,0.0289,0.0188,0.0012,0.1023,0.0416,0.0381,0.0282,0.03,-0.0927,0.0086,0.0464,0.0113,0.0367,-0.1658,-0.1252,-0.011,0.01,-0.0482,-0.0106,0.0148,0.0464,-0.0459,0.0348,0.0541,-0.1202,-0.0818,-0.0257,0.0375,0.0555,-0.0288,-0.3671,-0.3446,0.1275,0.0773,-0.0575,0.0414,0.0209,-0.0032,0.1048,0.016,0.0168,0.0398,-0.0474,-0.0135,-0.1259,0.1156,-0.0442,-0.0558,0.0267,-0.1109,-0.2699,-0.1453,0.0683,-0.1932,-0.0433,-0.0488,-0.0079,-0.0509,0.0294,-0.0618,-0.0306,0.0002,-0.0344,-0.036,-0.0331,0.0283,-0.0137,0.0568,0.0361,0.0398,-0.0923,0.0537,-0.0347,-0.0801,0.0311,0.0636,-0.0392,-0.0023,0.0991,0.0381,-0.106,0.0186,0.1907,0.2602,0.1376,0.0411,-0.0032,0.0405,-0.0218,-0.0507,-0.0427,-0.0813,-0.0412,-0.0949,-0.0115,-0.2281,-0.007,-0.0437,-0.4545,0.085,0.0797,-0.0189,0.1575,-0.0084,0.0478,-0.0283,0.0112,0.0155,-0.035,0.0714,0.0105,-0.0065,0.0426,-0.0266,0.0504,-0.0718,-0.0624,-0.1349,-0.1273,-0.1829,0.1038,0.0327,0.0443,0.0537,0.0824,-0.0009,0.0653,-0.0648,-0.0265,0.0083,-0.0925,-0.1298,0.1499,0.089,-0.0709,-0.0496,-0.0254,-0.0545,-0.0868,-0.0468,-0.0141,0.2162,-0.0228,0.0688,0.0115,-0.0388,0.0076,0.3221,0.2991,0.4082,-0.0508,0.0205,0.0159,-0.085,0.1077,0.0302,0.063,-0.2126,-0.094,-0.1648,-0.0229,-0.0401,-0.0331,-0.0491,-0.1482,-0.1922,-0.1969,0.0056,-0.0044,0.036,-0.0428,0.0343,-0.0284,0.1773,0.0796,0.1009,0.0572,0.0091,0.0332,0.0414,-0.1507,0.0318,-0.0566,-0.0464,-0.0835,0.053,0.0196,-0.0328,-0.0376,0.0109,0.0038,-0.1259,-0.0341,-0.0461,0.1352,0.0663,0.1205,0.0156,0.0043,0.0822,0.0598,0.0391,0.0725,0.0477,-0.0192,0.0861,-0.1529,-0.0208,-0.0408,-0.1153,-0.0434,-0.0383,-0.0793,0.0072,0.1281,-0.0078,0.0908,0.0483,0.0809,-0.0429,-0.0824,-0.1801,-0.1322,-0.0123,-0.0497,0.0135,0.2095,0.1324,0.1414,0.0991,0.0037,-0.0262,-0.0507,0.0848,0.125,0.1013,0.0453,0.1521,-0.0058,-0.0053,-0.0002,-0.0076,0.0016,0.0703,0.1004,-0.0344,-0.0596,0.027,0.0055,0.1817,0.0519,0.0564,0.0904,0.2438,-0.0409,0.0394,0.0085,0.0577,0.0095,0.0372,0.0001,0.1072,0.0522,0.1137,0.0274,-0.0406,-0.0743,-0.0085,-0.0085,0.0971,0.066,0.0335,-0.104,0.0576,0.0332,0.059,-0.0995,0.151,0.191,0.0971,-0.0072,0.0775,0.1256,0.0813,0.084,0.0823,0.0589,-0.0243,-0.0102,0.1573,0.0048,0.0658,0.0626,0.0853,0.0805,0.1953,0.0678,0.121,0.0215,-0.1547,0.135,0.2008,0.1468,0.0996,0.1089,0.0241,0.1907,0.1388,0.003,-0.2347,-0.1963,0.0194,0.0195,-0.0434,-0.0475,-0.0766,-0.0302,0.1674,0.1794,0.047,-0.052,0.0337,0.0289,-0.015,-0.0021,-0.0185,0.013,0.0622,0.0534,0.0114,0.0331,0.1093,0.029,0.0939,0.0589,0.0126,0.0006,-0.2037,-0.1888,0.0476,0.1449,0.1285,0.1226,0.1126,0.1525,0.101,-0.3503,0.0654,0.0357,-0.2153,-0.1381,-0.1365,-0.1972,-0.1096,-0.1384,-0.1236,-0.0853,-0.0683,-0.0567,-0.0838,-0.1842,-0.1834,-0.2929,-0.3327,0.1736,-0.0185,-0.0887,-0.3257,0.1618,0.0306,-0.0578,0.095,-0.0225,-0.076,-0.1004,0.0143,0.0517,-0.0551,0.3016,0.2788,0.0691,-0.0267,0.0307,-0.1317,-0.012,0.084,0.0419,0.026,-0.0897,-0.147,-0.074,0.0115,-0.0144,-0.0341,0.2009,0.1016,0.0767,0.0796,0.0088,0.1235,0.0731,0.0512,0.0337,0.0833,0.0553,-0.0546,0.0063,0.0596,0.1693,-0.0892,0.0447,-0.0051,-0.0554,0.0992,0.0048,0.1075,0.0889,0.0768,0.0644,0.0406,-0.0301,0.0242,-0.1905,-0.1172,-0.1416,-0.0337,0.0718,-0.0199,0.053,0.0523,-0.0311,0.0307,0.1058,-0.0655,0.005,0.0626,0.0323,0.0554,-0.0397,-0.0355,0.1697,-0.0103,0.0878,0.0698,0.0148,0.0218,-0.06,0.1084,0.0401,-0.0224,0.0385,0.0927,0.0061,-0.038,0.0394,0.0007,0.0847,0.1085,-0.113,-0.1533,-0.1182,0.0551,-0.4582,-0.2851,0.0742,0.1072,-0.4552,-0.3407,-0.0432,-0.2315,-0.1961,-0.2309,0.0768,0.0721,0.063,0.0607,-0.4299,-0.3288,-0.2264,-0.0176,-0.1289,-0.1855,-0.4029,-0.4064,-0.3584,-0.0341,0.0112,0.0406,-0.0331,0.0034,0.0592,0.1119,0.0762,0.0146,0.0729,0.0905,0.063,-0.0402,0.0235,0.0207,0.0295,-0.0275,-0.1035,-0.0903,0.0072,0.0273,0.0097,0.0151,-0.0237,-0.0522,0.0848,0.0735,0.0821,0.035,0.1265,0.1453,0.1386,0.0036,0.0488,-0.025,-0.2122,-0.0963,-0.109,-0.1199,0.0141,-0.1314,-0.0397,0.1307,0.1547,-0.0424,-0.0526,0.0496,-0.083,-0.1155,-0.1111,-0.0399,0.072,0.0682,0.0477,0.0335,-0.1157,0.019,-0.0133,0.002,0.0574,-0.0071,-0.0111,0.0142,0.0161,0.0263,0.018,-0.0104,0.0432,0.1198,0.1202,-0.0616,-0.0253,0.0145,-0.0001,0.0265,-0.0298,-0.3082,-0.2641,-0.1065,-0.1812,0.0988,-0.0937,-0.0652,-0.2048,-0.1998,-0.1402,-0.0913,-0.0752,-0.0357,-0.1432,-0.1447,-0.0219,-0.0154,0.082,0.0273,-0.0062,-0.0175,-0.001,-0.0147,0.0154,-0.0257,-0.0449,-0.0677,-0.183,0.0418,-0.1818,-0.1223,0.1264,0.1156,0.0984,0.0562,0.1179,-0.0975,-0.0305,0.0119,-0.0023,-0.1377,-0.0255,0.117,-0.003,-0.0021,0.0314,-0.0198,-0.0203,-0.0828,-0.0712,-0.1621,-0.2831,-0.1742,-0.0823,0.0265,0.0345,-0.0905,0.0639,0.0757,0.0195,-0.0359,0.0699,-0.0609,0.0864,0.0701,0.0157,0.1289,0.1432,0.1364,0.1087,-0.0158,0.1056,0.0647,0.046,-0.0262,0.0161,-0.0294,0.019,0.2179,0.054,-0.0783,-0.0958,0.0339,-0.0939,-0.0889,0.2466,-0.1178,0.0819,0.0347,-0.1619,0.2492,0.2576,-0.0342,-0.0219,-0.0447,-0.0643,0.0603,0.0512,-0.0288,-0.002,-0.0113,0.1499,-0.0645,-0.0672,-0.102,-0.0084,0.2137,0.0848,-0.0247,0.109,0.0434,0.0144,0.0649,-0.016,-0.0083,-0.0227,-0.076,0.222,0.0815,0.1188,0.1671,0.097,0.0806,0.0701,0.0701,0.0432,-0.028,-0.0248,0.1108,0.0127,-0.0689,-0.0278,0.024,0.0798,0.2148,-0.0861,0.0829,-0.0042,0.1089,-0.2551,0.0661,0.0857,0.1001,0.0581,-0.0562,-0.0945,0.033,-0.1771,-0.0628,-0.0888,-0.1582,-0.0937,-0.0074,-0.0196,-0.0827,-0.0215,-0.0059,0.064,0.0445,0.0326,0.0742,0.0595,0.0078,0.0413,-0.0115,0.0056,0.08,-0.0463,-0.038,0.0753,-0.0986,-0.0646,0.1374,0.0254,0.1825,0.0282,-0.0062,-0.088,0.0461,-0.2743,-0.2386,-0.1062,-0.2021,-0.1633,-0.0138,-0.002,-0.0481,-0.1554,-0.0697,-0.0011,-0.1101,0.0463,-0.0481,0.0255,-0.0834,-0.0224,0.0715,-0.0054,0.0325,0.0163,-0.0991,0.2888,-0.1286,-0.0421,-0.1373,0.0082,-0.1266,-0.2,-0.0912,-0.0648,-0.0374,-0.0055,-0.0463,0.0408,0.0786,0.1284,0.0773,-0.1021,-0.0159,0.0982,0.0441,0.016,-0.0181,-0.0226,0.0192,0.0299,0.0147,-0.0262,0.031,-0.0171,0.0485,0.0088,0.1163,0.0083,0.1019,-0.0011,0.034,0.0168,-0.0249,-0.0362,0.0682,-0.0989,-0.0072,-0.0798,-0.0228,-0.0638,-0.1039,-0.0264,0.0289,0.0828,0.0348,0.0218,0.0045,-0.0849,-0.0009,0.0394,-0.0032,0.0048,0.0564,0.0956,0.1073,0.0929,0.1376,-0.0424,-0.0326,-0.0374,0.1215,0.0588,0.0746,0.0438,0.0987,0.0557,0.005,-0.0129,-0.1657,0.0717,0.0481,0.035,0.0351,0.0794,0.0581,-0.1144,-0.0316,0.1386,-0.0305,-0.03,0.0182,-0.0506,-0.0357,-0.0507,-0.0381,0.0046,0.1051,0.0304,0.1354,0.0941,0.0244,0.0654,-0.0965,-0.125,-0.1315,-0.0965,-0.1351,0.0832,0.0604,0.0895,-0.0422,-0.0335,-0.0363,0.0109,0.0633,0.0234,0.1201,0.016,0.1677,0.1254,0.023,0.0683,0.0373,0.1081,-0.1309,-0.0245,0.0136,-0.1616,-0.0368,0.0072,0.0947,0.0343,-0.012,-0.0394,-0.0109,0.0217,-0.0136,-0.0066,0.0662,0.0019,-0.0046,0.0285,-0.0135,0.0631,0.1604,0.0164,0.0398,0.0144,0.0508,0.0595,0.0224,0.0327,0.0901,-0.0637,0.0999,0.0332,0.1116,0.0963,0.0219,0.1046,0.0666,0.1739,0.101,-0.0137,-0.0598,0.0962,0.0349,0.0961,-0.0703,-0.0077,-0.0252,0.0587,0.1567,0.0989,0.0147,0.039,-0.1219,0.0434,0.0055,0.0584,-0.0336,-0.0412,0.0184,-0.0605,0.0336,0.0829,-0.0277,-0.0264,0.0109,-0.0336,0.0308,0.0423,-0.0671,-0.0046,-0.1368,-0.0021,-0.0695,-0.1319,-0.0503,0.032,0.0043,0.1344,0.0335,-0.0172,-0.2028,-0.2233,-0.0833,-0.0156,-0.0156,0.06,-0.1044,-0.1349,-0.0466,-0.0665,0.1454,0.0037,0.0841,-0.136,0.0553,-0.0132,-0.0537,-0.0608,0.0003,-0.0515,0.0175,0.0172,-0.0967,0.006,0.09,-0.0809,-0.0352,-0.0027,0.0151,-0.0763,-0.0412,0.0311,-0.0297,-0.0344,0.0191,-0.1192,-0.099,-0.1202,0.0387,0.0265,-0.1069,0.0016,0.0187,0.1919,0.1947,-0.1081,-0.0758,-0.071,0.0512,-0.0376,0.0604,0.0999,0.0625,0.0958,-0.0604,0.0828,0.0339,0.0577,-0.0883,0.051,0.133,0.0354,0.0952,0.122,-0.0198,0.1033,-0.0461,0.189,0.0679,-0.0231,-0.0183,0.0027,-0.0713,0.0848,-0.0219,0.0832,-0.2046,0.0691,-0.114,-0.0007,-0.0134,-0.0488,-0.1064,-0.113,-0.1811,-0.1443,0.1246,0.0613,0.0556,0.0164,0.0556,0.0606,0.1307,0.1339,0.0777,-0.0261,0.071,-0.0577,0.0339,0.066,0.0982,0.1131,-0.1083,-0.131,0.2011,0.1089,-0.0369,0.0656,0.1396,-0.1674,-0.1483,0.0699,-0.0304,-0.0491,-0.003,-0.0722,-0.0843,0.1323,0.1015,0.059,0.0672,-0.1161,-0.0417,-0.0301,-0.0449,0.0264,-0.0695,-0.2606,-0.1209,-0.1057,-0.2438,0.1372,0.1585,0.107,0.1538,0.0675,0.0573,0.143,0.0975,0.0361,0.0174,0.0316,-0.0217,-0.1051,0.1161,-0.1592,-0.1405,-0.085,-0.0865,-0.0632,-0.0837,0.2996,0.1985,0.3077,-0.044,-0.1242,-0.1155,-0.073,-0.0011,-0.1074,-0.0215,-0.1632,-0.0091,0.0424,0.0568,-0.0096,-0.0074,-0.0119,-0.0024,-0.0577,0.0007,0.0187,-0.0362,-0.092,0.0639,-0.0133,0.1223,0.0901,0.0301,0.0341,-0.3117,0.0196,-0.2325,-0.0486,-0.0131,-0.0012,-0.0088,-0.0303,0.0383,-0.0497,-0.1356,-0.0151,-0.0471,-0.053,0.0317,0.0436,0.0408,-0.0776,-0.0385,-0.1498,-0.1206,0.0646,-0.0046,-0.0206,0.0405,0.0156,-0.0549,0.0656,0.0732,-0.0176,-0.0291,0.0561,0.0652,-0.0998,-0.0839,-0.1348,-0.0698,-0.0463,-0.0342,0.02,0.0225,-0.096,-0.0817,-0.0218,-0.0196,0.0217,-0.1352,0.0822,0.0808,-0.0459,-0.1607,-0.0856,-0.0274,0.0078,0.022,0.0772,0.0645,-0.03,-0.1629,0.0084,0.0347,-0.0059,0.0193,0.1473,0.1043,0.1411,0.1249,0.0462,0.0508,0.0526,-0.0218,-0.1318,-0.1221,-0.0758,0.0593,0.2183,0.3513,0.069,0.0342,-0.1418,0.0537,0.1241,-0.2893,-0.2603,-0.1215,-0.022,-0.053,-0.021,0.3047,0.1091,0.2077,-0.0143,-0.1027,-0.2097,-0.0109,0.024,-0.0166,0.0011,0.2538,0.0432,0.0124,0.0223,0.3636,0.289,0.1587,0.2878,-0.0765,0.1019,0.0112,-0.1984,0.2767,0.1042,0.0048,-0.0196,-0.056,0.0935,0.0372,0.2496,0.1603,0.0648,0.1645,-0.2425,0.0865,0.0291,-0.0548,0.3015,-0.0434,-0.0461,-0.0379,-0.1177,-0.0708,-0.1792,-0.0789,-0.1014,0.0848,0.0377,-0.0585,0.0452,0.0337,-0.014,0.0738,-0.1528,-0.0274,0.067,0.1396,0.0711,0.0706,0.1118,0.029,-0.0361,-0.0146,0.012,-0.0908,-0.0287,-0.0228,0.1234,0.0257,0.0755,0.0646,0.1639,0.0951,0.0199,0.1702,-0.0296,0.0251,0.0445,0.0364,0.0516,0.0888,0.0223,0.0322,0.03,0.018,-0.0052,-0.008,0.0688,-0.0319,-0.0174,-0.0227,0.0671,0.0475,0.0603,-0.0932,-0.1105,0.049,0.0255,-0.0724,0.0486,0.0694,-0.0545,0.0128,-0.0994,0.034,0.0437,-0.0071,0.0441,-0.0074,-0.103,-0.1509,-0.2624,0.0257,0.1068,-0.039,0.1368,-0.0133,-0.1955,0.1104,-0.2993,0.3098,-0.1696,-0.1517,-0.0624,0.0469,0.0662,-0.0125,-0.0308,0.0149,-0.0109,-0.1233,-0.0433,0.0316,0.0981,-0.0809,-0.0758,-0.0299,0.1095,0.0817,0.1316,0.0052,0.036,0.2431,0.0249,0.0021,0.0309,0.0343,0.0716,0.0671,-0.2438,-0.005,0.1121,-0.1245,-0.1806,-0.0047,0.0482,-0.1325,-0.1616,-0.093,-0.0083,-0.1231,0.0578,0.0016,-0.1596,-0.0924,0.0585,-0.1475,-0.0367,-0.0678,-0.0129,-0.1767,-0.083,0.0737,0.0842,0.0579,0.2588,0.041,0.1143,0.0839,0.1478,0.3156,0.0827,0.1966,0.1569,-0.1294,0.0867,0.2069,0.2027,0.2576,0.1025,0.0716,0.1234,0.0826,0.0746,0.0431,0.0822,0.1468,0.1111,-0.02,-0.0963,0.0473,-0.0138,-0.0253,-0.0493,0.0244,0.1098,0.0707,0.0812,-0.0351,-0.0232,0.1501,0.1859,0.0548,-0.0431,0.0786,0.162,0.0022,0.0684,0.044,0.1441,0.0502,0.0197,0.011,0.0033,-0.0452,0.0279,-0.127,0.0659,-0.0492,-0.131,-0.0058,0.1369,-0.0323,0.1373,0.0713,0.0399,0.1785,0.2218,-0.0437,-0.1271,-0.1931,-0.0222,0.0565,-0.2329,0.047,0.05,-0.116,0.0913,0.0701,0.1235,-0.0698,-0.0357,-0.1464,-0.0546,0.1695,0.147,-0.0659,-0.0808,-0.0605,-0.088,-0.0685,0.0122,0.0657,0.0667,0.036,0.0818,0.1352,0.0563,0.0626,-0.0166,-0.0295,-0.064,-0.0212,-0.1724,0.0947,-0.0356,-0.0051,-0.0496,-0.0625,-0.0321,-0.0015,0.0136,0.0457,0.0019,0.0648,-0.0032,0.0261,0.0195,0.0362,0.0351,0.0912,-0.0072,0.0467,-0.0128,0.0707,0.0273,0.0549,-0.1412,-0.0423,-0.0058,0.0034,0.017,0.0209,-0.0516,0.0475,0.0131,0.119,0.0934,-0.1274,0.0034,-0.0871,0.0457,0.0184,0.131,0.0692,-0.0286,0.0566,-0.1093,-0.0826,0.1269,0.108,-0.0509,0.0589,0.0462,0.0725,-0.2433,-0.3291,0.1565,-0.0187,0.0791,0.0088,0.0093,0.1274,0.1276,0.1529,-0.0666,0.0228,0.0333,-0.0121,0.1434,0.0842,-0.0486,-0.0141,-0.0327,-0.0268,0.0024,0.073,0.1084,0.0038,-0.1333,0.1232,-0.0964,0.1083,-0.265,0.143,-0.2861,0.0131,0.0239,0.1691,0.1463,0.0577,0.0824,0.0464,-0.0163,0.0429,-0.055,0.0674,-0.0586,-0.092,-0.144,-0.1589,-0.1554,-0.0777,-0.2215,-0.2922,0.0871,-0.0625,-0.2323,-0.4607,-0.2034,-0.0036,-0.2944,-0.1884,-0.1103,-0.2678,-0.1929,-0.2801,-0.2647,-0.161,-0.1985,-0.0695,-0.2307,-0.1571,-0.3424,-0.1343,-0.2787,-0.237,-0.1991,0.1105,0.1017,0.1188,0.225,0.3035,0.1614,0.1496,0.0436,-0.0899,-0.037,0.1603,0.1454,0.0965,-0.0718,0.0363,0.1326,-0.1734,0.031,0.0814,0.0326,0.0879,0.0301,0.0043,0.0037,0.0572,-0.0879,0.1581,0.1512,-0.0811,-0.0014,0.0366,-0.0371,-0.0359,0.1135,-0.0557,-0.0674,0.0796,0.0331,-0.1426,0.0833,-0.0072,0.1076,0.1316,-0.0626,-0.0637,0.0908,0.0644,-0.0281,0.0611,0.0436,0.1067,0.0062,-0.1417,0.0611,0.0447,0.0284,0.0194,0.0295,-0.0296,loss anticipation
trm_4a3fd79d0a908,-0.1062,-0.1271,-0.1318,-0.1211,0.0112,-0.0502,-0.1111,-0.0682,-0.0592,-0.1045,-0.0034,-0.0033,-0.1315,-0.0906,-0.1389,-0.0769,-0.0887,-0.1035,-0.0731,-0.0369,-0.0737,0.0304,-0.0579,0.034,-0.0187,0.0245,0.0199,-0.1238,-0.1709,-0.088,-0.1231,-0.1179,-0.158,-0.0874,-0.1781,-0.1249,-0.0753,-0.0866,-0.1593,-0.0181,-0.1303,-0.1422,-0.0722,0.0971,-0.0957,-0.0828,0.1845,-0.079,0.0623,-0.1009,-0.0522,0.1004,0.0953,0.0758,-0.0099,-0.0803,-0.1271,-0.0525,0.0058,-0.0542,0.0108,0.0465,-0.1667,0.1176,0.049,0.0781,-0.2173,-0.2552,-0.1329,-0.0181,0.0726,0.0217,0.2113,-0.1131,-0.1504,0.0908,-0.1589,0.0593,0.0613,-0.0639,-0.0051,0.1079,-0.0622,-0.1649,0.083,0.0707,0.0026,-0.004,0.0008,-0.2372,-0.1089,-0.0439,-0.0241,0.1876,0.1735,0.1618,0.1611,0.0259,0.2702,0.1,0.0908,0.0445,0.1288,0.0634,0.1199,-0.1779,-0.1899,0.1578,-0.0294,-0.0581,0.0153,-0.1264,0.1269,0.2,0.0588,0.0208,-0.0927,0.0417,-0.0279,-0.0933,-0.0948,-0.1856,-0.1339,-0.0141,-0.0901,-0.1465,-0.0645,0.0659,0.0939,0.0268,-0.1133,-0.0966,-0.0479,-0.3127,0.0103,-0.2031,0.001,-0.1583,-0.0464,-0.0556,-0.1148,-0.13,0.039,0.0065,-0.0219,0.0907,-0.083,0.0503,-0.1071,0.0985,-0.0906,-0.0957,-0.185,-0.172,0.1855,-0.0032,0.0712,0.0388,0.0325,-0.0652,-0.0658,-0.0959,-0.232,-0.2491,-0.0377,-0.0112,-0.0306,-0.2038,-0.1896,0.0206,-0.0689,-0.1225,0.0605,-0.2733,-0.1792,-0.2399,-0.1744,-0.1439,-0.0958,-0.0342,-0.1969,0.0602,-0.06,0.0237,-0.0727,-0.0722,-0.1116,-0.1097,-0.0911,-0.0194,-0.0082,-0.0675,-0.0235,-0.1867,-0.1702,-0.2716,-0.2334,-0.0383,-0.0003,-0.1559,-0.0549,0.2456,-0.1752,-0.1726,0.0943,-0.1173,-0.1668,-0.0275,-0.0825,0.0035,-0.2166,-0.1007,0.002,0.0187,0.066,0.034,0.1026,-0.1737,-0.1639,0.0568,0.1022,-0.1315,-0.1821,-0.0724,0.0904,0.0099,-0.0509,0.1434,-0.0334,0.2605,-0.0888,-0.201,0.1892,-0.1628,-0.1551,0.0954,-0.0564,0.0985,0.0454,-0.0937,0.0046,-0.2247,-0.078,0.0115,-0.0804,-0.0987,-0.0925,-0.1361,-0.0778,-0.0915,0.0453,0.0178,0.0025,0.0627,0.0324,-0.2032,0.0071,-0.082,0.1372,0.2918,0.0902,0.3188,-0.1102,0.1413,0.2275,0.3755,0.1624,-0.02,0.0054,-0.0302,-0.0692,-0.0239,-0.1582,0.0086,-0.0896,0.0192,-0.1283,-0.2075,-0.1599,0.01,0.0561,-0.09,-0.0618,-0.2246,-0.1708,-0.1017,0.0511,0.0601,-0.1538,-0.1395,-0.1238,-0.1321,-0.0275,-0.0799,-0.1215,0.0139,-0.0082,0.156,-0.0329,0.199,0.1395,-0.1701,-0.1456,-0.1117,-0.0505,-0.0323,-0.1499,-0.0253,-0.0477,0.0015,0.0051,-0.0156,-0.1293,0.0997,0.0833,-0.0665,0.1803,0.0214,0.0851,-0.1449,-0.0077,0.0491,-0.1464,-0.1559,-0.1315,-0.052,-0.0,-0.0741,-0.0978,-0.1349,0.0523,-0.1012,-0.0045,0.0173,0.0572,0.1424,0.1057,0.0325,-0.0222,-0.1441,-0.1219,0.0433,0.0163,-0.0227,0.0955,0.0514,-0.3096,-0.2266,-0.2082,-0.1439,-0.1415,0.0272,-0.1167,-0.0561,-0.0948,-0.1015,-0.0563,-0.148,-0.1528,-0.1384,0.0097,-0.0322,0.0504,0.0077,-0.0008,0.0768,-0.1472,0.2957,0.0303,-0.1702,0.0311,0.1143,-0.0057,0.1306,-0.1658,-0.0333,-0.0969,0.1237,0.151,0.1503,0.2058,0.0353,-0.0664,0.0747,0.0314,0.0735,-0.1089,-0.0477,0.0496,-0.0433,-0.0597,-0.0246,-0.0543,-0.0322,0.1551,0.0647,-0.1002,-0.2148,-0.1084,-0.0632,-0.0737,0.0436,0.0059,-0.0473,0.0702,0.0984,0.096,0.0139,-0.1362,-0.0499,-0.0051,-0.2111,-0.0255,0.2725,-0.1406,-0.0133,0.3006,0.0131,-0.0907,-0.0241,0.0181,-0.2723,-0.1758,-0.3841,-0.3491,-0.144,-0.1916,-0.1074,-0.173,-0.1215,-0.032,0.0749,-0.0267,-0.025,-0.0148,0.0937,-0.0122,0.0186,-0.3025,-0.1778,0.0214,0.0476,0.0113,0.0597,-0.0434,-0.1081,0.0317,0.1198,-0.111,0.0277,0.0947,0.1042,-0.1282,-0.0447,0.0457,-0.1542,0.0276,-0.0533,-0.0086,0.0209,0.0833,-0.0659,-0.0685,0.0647,-0.1425,-0.1159,0.0426,0.4302,-0.1504,-0.0701,0.0222,0.0277,0.1243,-0.0542,-0.1166,-0.0512,0.0383,0.0455,-0.0459,-0.0452,0.0717,0.0441,-0.0088,0.079,0.1637,0.1698,-0.0217,0.0036,-0.0881,-0.0413,0.06,0.145,-0.1064,-0.1596,0.1362,0.0392,-0.0795,-0.0221,0.0649,-0.0951,-0.0809,0.0403,-0.0571,-0.1231,-0.1121,-0.1466,0.0578,0.0289,-0.0424,0.1355,-0.1814,0.0193,-0.0008,0.0093,0.1113,0.0963,-0.1353,-0.1181,0.1207,-0.1098,-0.0894,-0.0587,0.0998,0.1605,0.2164,0.0405,0.1948,0.1302,0.0481,0.0684,-0.0968,-0.0373,-0.1146,-0.2682,-0.1121,-0.0012,-0.1695,-0.1033,-0.042,-0.158,-0.0494,0.0289,0.0126,-0.0473,-0.1043,-0.0489,0.0364,0.039,0.0121,-0.0238,0.0865,-0.0119,-0.0197,-0.0223,-0.0281,-0.1719,0.1263,0.0565,0.0803,-0.0545,-0.0592,0.0253,-0.0866,0.0477,-0.087,0.0479,0.1101,-0.0286,0.0137,-0.0567,-0.0771,0.0081,-0.1267,0.0226,-0.0361,-0.0454,0.043,0.0329,0.108,0.1175,0.0172,-0.1068,-0.0073,-0.0525,0.1765,0.0711,0.0737,0.0609,0.0806,-0.0455,-0.1287,0.0466,0.1551,0.1357,-0.0235,-0.0238,-0.2393,-0.0731,0.1961,-0.0525,0.0203,0.0881,0.0691,0.0554,0.0735,0.0215,-0.0378,-0.1772,-0.1702,0.1312,-0.1912,-0.0639,0.093,-0.0829,-0.3055,-0.0565,-0.0772,0.0507,0.0246,-0.2423,-0.0791,-0.228,0.0446,0.0198,-0.0553,0.0387,-0.121,-0.1853,-0.1062,0.0543,0.0884,0.0733,-0.0981,-0.0007,0.0643,0.04,0.0882,-0.0553,-0.0706,-0.0433,-0.1233,0.0817,-0.0063,-0.0844,-0.1011,-0.0369,-0.2563,-0.1899,0.1484,-0.2099,0.0711,-0.1842,0.2054,-0.1209,-0.0492,-0.0696,0.0314,-0.1022,-0.0617,-0.0925,-0.2033,0.0161,0.188,-0.0559,0.0486,0.1385,-0.1393,-0.1322,-0.055,0.0008,-0.0766,-0.1043,-0.0919,-0.0615,-0.0494,-0.1043,0.2055,-0.1073,0.0287,-0.0399,0.0761,0.0517,0.0991,0.0531,0.1681,-0.1695,-0.1161,0.0401,0.0284,0.0022,0.1287,0.2108,0.1857,0.1186,0.1837,-0.0341,0.0465,-0.0783,-0.1073,-0.002,0.0661,0.0416,-0.0151,-0.1307,-0.0927,-0.0799,-0.1501,-0.1413,-0.1233,0.0757,0.1379,0.0655,-0.0227,0.0914,0.0492,0.0006,-0.0129,0.0299,-0.1342,0.0423,0.1082,-0.0827,-0.3066,-0.304,-0.2213,-0.0028,-0.0199,-0.1159,0.0401,-0.0695,0.0257,-0.0379,-0.0686,0.135,0.1272,-0.007,-0.1757,0.1466,0.1534,0.329,-0.179,-0.0393,-0.1021,-0.0369,0.0391,-0.1304,0.1427,0.0453,-0.0405,0.0225,-0.0153,0.0525,-0.2006,-0.2875,-0.2411,-0.174,0.0695,0.2208,0.0271,-0.1502,-0.0258,0.036,0.0872,0.0756,0.067,0.0186,-0.0877,-0.1094,-0.0614,0.1401,0.0979,0.1653,-0.0702,-0.0299,0.0314,-0.0955,0.0781,-0.0825,-0.1457,0.0061,-0.1771,-0.1802,-0.1029,0.0667,0.1066,0.0287,-0.0284,-0.0466,0.0237,0.1791,-0.023,-0.1322,0.0664,0.0073,0.0274,0.0124,0.1394,-0.0774,0.1753,-0.1928,-0.2005,0.1333,0.1346,0.1833,-0.0231,-0.0504,0.0701,-0.0001,0.0165,0.2308,0.0178,0.0844,0.1019,0.1628,0.0374,0.0067,0.1918,0.1997,-0.1602,0.0189,0.0792,-0.2236,-0.1635,-0.0466,-0.1477,-0.0449,-0.2662,-0.0809,-0.182,-0.1203,-0.2427,0.0175,-0.0202,0.0617,-0.0777,-0.0322,0.0446,0.0579,0.1423,0.0605,0.1046,0.1768,0.0291,0.0748,0.0479,-0.0005,0.1555,0.1715,-0.1268,0.1804,0.0751,-0.0403,-0.0655,-0.1184,-0.0578,0.1387,0.0692,-0.3147,-0.1675,-0.0604,0.0995,0.2189,0.085,0.0586,0.0287,0.0007,-0.0426,-0.0982,0.1272,-0.0677,0.0601,-0.2111,0.0703,-0.0781,0.1617,0.1785,0.0584,0.1718,-0.2269,-0.21,-0.0955,0.2516,-0.0803,-0.1042,-0.1155,0.0949,-0.0009,-0.1778,-0.0573,-0.1578,0.0909,-0.0927,-0.0136,0.0809,0.0048,0.1157,-0.1966,-0.11,-0.0664,0.1086,-0.145,0.0436,0.1188,0.0871,0.1338,0.3602,0.1504,-0.1193,-0.0791,-0.12,-0.0626,-0.127,-0.0524,0.0357,0.1624,0.0905,-0.0021,-0.1326,0.134,0.2434,0.0955,-0.003,-0.0265,-0.0419,-0.2052,-0.083,-0.0766,-0.0022,0.0599,-0.1516,-0.0567,0.1257,0.0127,-0.1095,-0.0291,0.0966,-0.069,-0.0387,-0.0856,-0.1509,-0.1482,-0.3099,-0.1726,-0.3178,-0.0187,-0.0372,-0.1108,-0.1599,-0.138,-0.2085,-0.1375,-0.2652,-0.1527,-0.15,0.0163,0.0754,0.1359,-0.0445,0.0458,-0.0103,0.0605,0.1016,0.1462,0.1935,0.1263,-0.0588,-0.0159,0.0211,-0.0012,0.1398,0.1282,0.1427,-0.0257,0.1429,-0.0618,0.1103,-0.0608,-0.0618,-0.0402,0.0964,-0.0511,0.0964,-0.1833,-0.0638,-0.0441,-0.044,-0.0189,0.0179,0.1241,0.0581,0.0987,0.1542,0.1096,0.0502,0.0467,-0.0183,-0.0054,0.0514,0.0077,-0.0254,-0.0739,-0.1329,-0.0686,0.1192,0.1012,-0.1542,-0.1036,-0.086,-0.2348,-0.1204,0.2123,0.0979,0.1786,0.0958,0.065,-0.087,-0.0131,0.0803,-0.0041,-0.0481,-0.0292,0.0313,-0.0806,-0.1064,-0.0049,0.0955,-0.1071,-0.019,-0.1079,0.0713,-0.1669,0.0557,0.1037,0.197,0.1628,0.1227,0.0648,0.057,-0.0174,-0.0183,-0.0564,-0.0937,0.0059,0.0052,0.0802,-0.0117,-0.043,0.0412,-0.0187,-0.0807,-0.0406,-0.1732,-0.2222,-0.1919,-0.14,0.2138,0.0161,0.0807,-0.1684,0.2171,0.1263,-0.0094,-0.0385,0.0246,0.0654,-0.0194,0.0981,-0.1332,-0.1207,-0.0429,-0.033,-0.1473,-0.0421,-0.1111,-0.0324,-0.069,-0.062,-0.0895,-0.0715,0.0025,-0.0625,0.0034,0.0097,0.0546,-0.122,0.0116,-0.1083,0.0751,-0.0495,-0.0833,0.4089,0.3017,0.3414,0.2339,0.2521,0.0749,0.3196,0.191,-0.1716,0.2001,0.207,0.1263,0.1071,0.1297,-0.0863,-0.017,-0.0762,-0.0018,0.0339,0.0275,0.0487,0.0439,-0.1386,0.0302,0.0453,0.0178,0.0903,-0.0277,-0.0911,0.1156,0.0693,-0.0793,-0.0028,-0.0728,0.0823,0.022,0.1791,-0.0168,-0.1847,-0.1799,-0.1054,-0.0425,0.1313,0.1105,-0.0866,-0.1139,-0.2759,-0.196,-0.1063,0.2151,-0.0839,0.2727,0.2366,-0.0724,0.0037,-0.0505,0.0521,0.1218,0.0559,0.2187,0.1047,0.0456,0.1026,0.0689,-0.1222,-0.1682,0.1107,-0.0877,0.057,-0.006,-0.0996,-0.0317,-0.1524,-0.0822,-0.0412,-0.0826,-0.2091,-0.0263,0.1874,-0.0439,0.0068,-0.0009,0.17,0.0329,0.0289,-0.1804,-0.1852,-0.0717,-0.0667,-0.0826,-0.1617,-0.0467,-0.0546,-0.0176,0.2308,0.1007,0.098,0.273,0.0117,0.0522,-0.0091,0.159,0.0017,0.2533,-0.0845,0.2477,0.3605,0.0708,-0.1161,0.3059,0.2571,-0.0172,-0.1792,0.0336,-0.1909,-0.0747,-0.2738,-0.0545,0.0895,-0.0609,-0.0851,0.0401,-0.078,-0.0139,-0.0963,-0.0724,-0.0535,-0.078,0.0261,0.1113,-0.0356,0.339,0.195,0.267,0.2932,-0.1215,-0.0353,-0.0942,-0.1177,-0.0783,-0.0523,-0.0342,0.1636,-0.1566,-0.0956,0.1222,0.0165,-0.0067,0.1043,0.1014,-0.0038,-0.0114,0.1475,-0.0555,-0.0891,0.0172,0.1146,0.0408,0.0075,-0.0306,-0.0306,-0.193,0.0878,0.0166,0.052,-0.0434,0.0935,-0.0483,0.2378,-0.3078,-0.2762,0.1101,-0.0701,-0.2442,-0.2429,-0.2043,-0.0386,-0.0834,-0.0543,-0.0026,-0.0274,0.1684,-0.0064,0.1074,-0.0924,0.1273,-0.0054,0.0869,0.0539,-0.0747,-0.0653,-0.0027,-0.0647,-0.0245,-0.0314,-0.0669,0.0622,0.0134,0.0687,0.0199,0.1228,0.0301,0.1254,-0.1789,-0.1036,0.0498,-0.1583,-0.0155,-0.1966,-0.3167,-0.0265,-0.1007,-0.2219,-0.0121,-0.0915,-0.2112,-0.0207,-0.1015,0.0394,-0.2247,-0.0721,-0.1207,-0.2238,-0.0713,0.0857,-0.0856,0.2585,0.142,0.1112,0.1652,-0.0558,0.0606,-0.083,-0.2126,-0.209,0.0285,-0.1025,-0.0239,-0.0854,-0.0416,0.0602,0.0728,0.0173,-0.1627,-0.1002,-0.0131,0.025,-0.0358,-0.0364,-0.0402,0.0829,-0.077,-0.1345,-0.0786,-0.1843,-0.1166,-0.0686,-0.1651,-0.1825,0.0216,0.0219,-0.0398,0.0157,0.0157,-0.1429,-0.1069,0.0583,-0.2099,0.0375,0.0048,-0.0111,-0.1633,-0.1559,0.013,0.1549,-0.0162,-0.0019,0.0154,-0.0521,0.1957,0.0994,0.0209,-0.0039,-0.2187,0.0648,-0.0033,0.0806,0.1291,0.0952,0.017,-0.1023,-0.0088,0.173,-0.0971,0.0181,-0.1222,-0.0167,-0.1146,-0.1017,0.0042,0.1494,-0.0384,-0.0734,-0.1372,-0.0107,-0.0172,0.0004,-0.0595,-0.1783,-0.0076,-0.0056,-0.0969,0.081,-0.0734,-0.054,-0.0627,-0.0718,-0.0922,-0.0784,-0.0575,-0.0467,0.0097,-0.0325,0.1077,-0.0536,-0.0168,-0.0248,0.0366,0.0027,-0.0344,-0.1868,0.0575,-0.1162,-0.0183,0.0119,0.0492,0.0875,0.0572,0.0682,-0.0995,-0.0582,-0.1173,-0.062,-0.2549,-0.0027,-0.2332,-0.037,-0.0796,-0.0944,-0.0441,-0.1154,-0.101,0.2266,0.1311,0.0154,0.2751,0.1341,0.1065,0.0711,0.2038,-0.0176,-0.0678,0.0261,0.2767,0.0147,0.0446,-0.0417,-0.118,-0.0636,-0.0866,0.0378,0.0164,-0.0287,0.0545,0.0992,-0.0688,-0.0732,-0.051,0.0761,0.147,0.1019,-0.3295,-0.1542,-0.0647,-0.2696,-0.2194,0.0425,0.1301,0.0354,0.0426,0.0076,0.0153,-0.1926,-0.0267,-0.0479,-0.1137,-0.28,-0.0687,-0.0211,-0.1362,-0.0919,0.1416,-0.0485,-0.0602,-0.0578,0.0157,0.1148,0.2722,-0.0554,0.0829,0.0051,-0.0299,-0.1365,-0.0662,0.0337,0.0154,-0.0164,0.1796,0.1319,0.0728,-0.0652,-0.1222,0.0526,0.4704,0.4681,-0.1946,-0.1449,0.0747,-0.0925,-0.0926,-0.0455,-0.2162,0.0636,-0.0283,-0.094,0.0083,0.0269,0.2529,-0.0338,0.1975,0.046,0.0081,0.1246,0.4266,-0.111,-0.0593,0.3064,0.0249,0.0863,0.0754,0.0652,-0.0669,0.2025,0.1535,-0.0193,-0.0798,0.0282,0.0185,0.1555,0.1324,0.0015,-0.0303,-0.0463,0.1303,-0.1447,0.0387,0.1801,-0.0697,-0.0027,0.0129,0.0082,-0.1607,-0.0358,0.0596,-0.0711,0.0832,-0.1072,0.0961,0.1574,-0.0341,-0.03,0.0397,0.0141,0.0124,0.1515,0.1116,0.1343,0.0351,0.2011,0.0968,0.0699,0.4042,-0.1523,-0.1264,0.1289,-0.165,0.0544,0.0843,0.1341,-0.0838,0.0013,0.0124,-0.0245,0.0369,0.0598,-0.0211,-0.0018,0.0264,0.0785,0.0628,0.1099,0.323,0.3005,-0.0976,-0.1898,-0.1234,-0.0178,0.1178,0.0516,-0.0118,0.0365,0.0676,0.0195,0.1009,-0.0979,-0.329,-0.1133,-0.0217,0.132,-0.0147,0.0273,0.0383,0.2863,0.225,0.0471,-0.0233,-0.0917,0.015,0.0561,0.1376,-0.1525,-0.1953,-0.2357,0.0351,0.0011,0.043,0.2999,-0.0713,-0.0492,0.0629,0.1937,0.1166,0.2256,-0.0591,-0.0266,-0.0319,0.0186,0.1348,0.1962,0.2352,-0.0351,0.0605,0.0764,0.0683,-0.1094,0.1161,-0.2759,-0.0711,-0.0303,-0.1229,-0.0154,0.064,-0.045,-0.0783,-0.0716,-0.0219,-0.0201,-0.0237,-0.1064,-0.0669,-0.0187,-0.0244,-0.0781,0.099,0.2271,0.1681,0.269,-0.2307,-0.1385,-0.1885,-0.0621,0.0949,-0.0553,-0.1571,-0.1098,-0.1686,-0.0438,0.1561,0.0571,0.2062,0.1,0.0304,0.0305,-0.0352,0.0219,0.0135,0.0013,-0.2344,-0.0059,-0.1228,-0.0259,-0.114,-0.0001,0.0994,0.3026,0.1945,0.1471,0.1033,-0.1398,-0.3166,-0.1794,-0.2495,-0.1771,0.0358,-0.0525,0.0348,-0.1231,-0.2004,-0.1711,-0.0918,0.0346,0.0117,-0.0572,-0.0809,-0.0292,-0.06,-0.2248,-0.1455,-0.1122,0.0943,0.034,-0.0331,-0.2853,-0.0486,-0.1325,-0.1736,-0.3945,0.0453,-0.0139,-0.117,-0.0938,-0.0509,-0.0226,-0.0316,-0.1459,-0.1153,-0.1211,0.2347,0.0877,0.196,0.0558,0.136,-0.0577,0.095,0.1439,0.282,-0.1069,-0.0406,-0.0046,0.1749,-0.183,-0.2342,-0.1786,-0.0912,-0.0848,-0.1548,-0.1093,-0.0861,-0.1097,-0.0247,0.0068,0.0157,-0.2811,0.0179,-0.0209,-0.1045,-0.119,-0.0963,-0.0054,-0.193,0.0823,0.0363,0.1945,-0.0371,-0.0572,-0.2652,-0.1195,-0.1467,-0.1174,-0.2506,-0.1801,0.0331,0.0669,0.053,-0.0368,-0.0798,0.0325,0.1738,0.2252,0.203,-0.2898,-0.3119,-0.0197,0.0818,-0.0035,-0.1072,0.0465,-0.1038,-0.002,-0.0422,-0.0896,-0.1477,-0.0319,-0.1171,-0.1023,0.0151,-0.1195,0.0191,-0.0187,0.0583,0.1329,0.115,-0.1039,-0.1758,-0.2265,-0.161,-0.1243,-0.2834,-0.1498,0.2713,-0.0714,-0.1275,0.0488,0.0294,-0.0911,0.0453,-0.0266,0.0005,0.1814,-0.0275,0.083,0.0327,-0.077,-0.0126,-0.0079,0.1187,0.2267,-0.2483,0.0111,0.0476,0.298,-0.0508,-0.0313,0.0453,-0.0491,0.0344,0.0478,0.0658,-0.0359,-0.0238,-0.1868,-0.1613,-0.1898,-0.0066,-0.0825,0.111,0.1938,0.2417,-0.009,-0.0044,0.0999,0.2144,0.0824,0.0655,0.0378,0.039,0.0338,-0.3482,-0.1609,-0.1793,-0.1781,-0.1053,-0.1741,-0.1809,-0.1268,-0.0173,-0.0731,-0.2563,-0.1544,0.0388,-0.0985,-0.3251,0.0839,-0.0852,-0.0115,0.0562,-0.0985,0.0115,-0.1868,-0.1051,0.0029,-0.1115,-0.049,0.0593,-0.1512,0.0585,0.0947,0.1013,-0.0182,-0.147,0.0758,-0.0352,-0.1978,-0.0403,-0.112,-0.1086,0.1277,0.0297,-0.0007,-0.1939,-0.1169,-0.0365,0.0133,-0.0696,-0.1014,-0.1509,-0.0774,0.0047,-0.0816,0.0921,-0.1441,-0.0625,0.0742,0.065,0.0464,0.0541,0.0308,-0.2443,0.0152,-0.0853,-0.1625,0.2161,0.3285,0.2888,-0.0551,0.4357,0.2263,-0.1893,-0.1174,0.3987,0.1536,0.077,0.1117,0.113,0.0811,-0.1039,-0.0957,-0.0855,-0.0989,0.4979,0.3974,0.2936,0.0822,0.2216,0.2154,0.433,0.4166,0.3633,-0.012,-0.0157,-0.0503,-0.0248,-0.0512,-0.0015,-0.2058,-0.1024,0.0164,-0.0124,-0.0953,-0.0819,0.1237,-0.0243,0.0213,-0.1008,0.0679,0.2148,0.2987,-0.0431,-0.0436,-0.1235,-0.0061,0.0034,-0.0399,-0.0369,-0.102,-0.0353,-0.0379,-0.1738,-0.2777,-0.2547,0.0414,-0.0737,-0.0184,0.2078,0.0651,0.2323,0.0688,0.1359,0.3168,-0.0435,-0.2004,-0.2025,-0.0455,0.1094,-0.076,0.1904,0.0996,0.18,0.0631,-0.2103,-0.2078,-0.1475,-0.1298,0.0766,-0.3242,-0.2148,0.063,-0.0538,0.1837,-0.0306,-0.0053,0.1248,0.0245,-0.0349,0.0373,-0.0785,-0.1808,-0.2284,0.029,0.0128,-0.0835,0.0178,-0.0562,0.0733,0.3651,0.3155,0.1442,0.2598,-0.0945,0.0558,0.1155,0.1932,0.2475,0.3331,0.0672,0.0849,0.0074,0.1867,0.1792,-0.0094,-0.0155,-0.0493,-0.0436,-0.1,0.0062,-0.041,0.0035,0.018,0.0224,0.0677,0.0065,0.1394,-0.1111,0.0926,0.0819,-0.1326,-0.1979,-0.0954,-0.137,-0.1831,0.1155,-0.0571,-0.111,-0.058,0.2012,0.0145,-0.2489,-0.0577,-0.0298,-0.1512,0.0116,-0.0426,0.0433,0.1176,0.0965,0.3898,0.2541,0.2452,-0.0065,0.0547,0.1321,-0.1521,-0.17,-0.0295,0.0207,-0.0618,-0.0211,-0.0422,-0.1118,-0.1211,-0.1929,-0.2402,-0.1966,-0.098,-0.053,-0.1438,-0.0012,-0.0935,-0.0152,-0.0105,-0.0854,-0.1062,-0.0774,0.2466,0.0046,-0.0389,-0.1441,0.1072,-0.0202,-0.1268,0.109,-0.2119,-0.1109,0.2074,-0.1551,-0.1591,-0.0499,0.0248,-0.0023,0.0442,-0.0677,-0.0725,-0.0398,0.0176,0.0246,-0.2348,0.0601,-0.0072,0.1416,0.0227,-0.2485,-0.1018,0.0055,-0.0625,-0.0667,-0.0417,-0.1605,-0.0319,0.025,-0.0199,0.0724,-0.3761,-0.1549,-0.1701,-0.296,-0.2145,-0.1633,-0.1412,-0.1412,-0.0743,-0.0524,0.09,-0.2491,-0.0665,-0.1432,-0.1378,-0.0196,-0.0625,-0.3525,0.1734,-0.255,0.077,0.0269,0.2797,-0.0183,-0.0202,-0.1763,-0.0844,-0.0237,0.0236,-0.0456,0.2123,0.0217,0.0882,0.2507,0.2133,-0.0037,0.0432,0.0114,-0.0182,-0.0176,-0.1001,-0.115,-0.0787,-0.1209,-0.0272,-0.0027,0.0118,0.0673,-0.0318,-0.0431,0.0829,0.0923,-0.0752,0.1302,-0.0184,-0.0877,0.0094,-0.1438,0.0149,-0.039,0.1412,-0.0963,0.1342,0.1217,0.0005,0.1721,0.1681,-0.0431,0.1561,0.0265,0.3189,0.1259,-0.0113,0.1432,-0.1721,0.0642,0.1375,0.0838,-0.0336,-0.0462,0.0522,-0.027,0.0132,-0.1532,-0.1988,-0.1118,-0.1394,-0.0312,-0.0599,-0.1934,0.2899,-0.0002,0.0555,0.078,-0.0162,-0.0106,0.0336,-0.0615,-0.149,-0.0527,0.109,0.1592,-0.0002,0.0536,-0.1208,0.0247,0.125,0.0976,0.1794,0.0689,0.0232,-0.0902,0.0647,-0.1233,-0.0455,0.0198,-0.0157,-0.0415,-0.0951,-0.0899,-0.116,-0.0304,0.0613,-0.1212,0.082,-0.0247,0.0615,0.0685,0.1061,0.1279,0.0782,-0.0727,-0.0763,-0.0948,-0.0523,0.0555,0.0661,-0.0614,-0.0614,-0.0202,0.0815,-0.0987,-0.1591,-0.1235,-0.1844,-0.156,-0.0482,-0.0499,0.0189,-0.1228,-0.1339,-0.1486,-0.0502,-0.106,0.0136,0.0596,-0.1028,0.1675,-0.153,-0.1395,-0.0684,0.0721,-0.0908,-0.0637,0.1186,0.0612,-0.2265,0.0343,-0.0054,-0.0677,0.0518,0.0768,0.0136,0.0842,-0.086,-0.2048,-0.0838,-0.2104,-0.266,0.0193,-0.1328,0.0644,0.0747,0.1588,0.1608,0.1545,-0.1571,-0.1979,0.0582,0.2226,0.2956,0.0317,-0.0867,0.0007,0.0185,-0.0832,0.08,-0.0796,-0.1597,-0.0509,-0.0283,-0.1029,-0.1693,0.1705,0.0413,0.0362,0.1527,-0.0093,0.0453,-0.0703,-0.0641,-0.0661,0.0052,-0.1045,0.0112,0.1326,0.0789,-0.0167,-0.0826,-0.0571,-0.1347,-0.0319,-0.0261,-0.2596,-0.0633,-0.0419,-0.0155,-0.0346,0.0499,0.0283,0.0512,-0.0704,0.0989,-0.2275,-0.1462,-0.1711,-0.1812,0.0073,-0.1702,-0.1485,-0.32,-0.1432,-0.1007,0.2009,-0.1811,-0.0478,-0.0582,0.0591,0.1547,0.1305,-0.1132,-0.1763,-0.0755,-0.0537,0.027,0.1382,-0.0775,-0.0776,-0.0767,0.1085,0.079,0.094,0.1911,-0.0116,-0.0307,0.1078,-0.0272,0.0672,0.0563,-0.0013,-0.0987,-0.0186,0.0256,0.1238,0.0149,0.1262,0.1358,0.0053,0.0235,-0.0181,-0.198,-0.1286,-0.0388,0.1452,0.2819,0.0929,-0.0152,-0.006,0.0181,0.3405,0.2115,0.1714,0.2121,-0.229,-0.0202,-0.048,0.0524,-0.0847,0.1085,-0.0177,-0.015,0.0334,0.0417,0.0714,-0.0735,0.0731,0.0773,-0.1619,0.2392,0.1202,0.0303,0.0434,0.0459,0.0533,-0.0145,-0.0333,-0.0062,0.0196,0.1356,0.219,0.2443,-0.1271,0.0303,0.0027,-0.0809,-0.1754,-0.3846,-0.3595,0.0244,0.0774,0.1024,-0.0682,0.0531,0.0979,-0.0471,-0.0688,-0.1151,0.064,-0.0689,-0.0165,0.0053,0.0786,-0.0188,-0.1813,-0.0518,-0.1792,-0.1164,-0.0036,-0.1311,0.0196,-0.2067,-0.0967,-0.0448,-0.0515,0.0243,0.1483,0.0173,-0.0868,-0.1255,0.2644,-0.1143,0.1486,0.1822,0.1622,-0.0133,0.0382,-0.1574,0.2585,0.234,-0.2069,-0.1241,-0.0611,-0.0301,-0.1156,-0.1347,-0.2177,-0.2548,-0.1067,-0.0141,-0.0843,0.0609,-0.0279,-0.0458,-0.1327,-0.2145,0.0996,0.0642,-0.1595,-0.1039,0.0003,-0.1161,-0.2296,0.1068,0.1883,-0.1348,0.0604,0.1488,0.1148,-0.2147,-0.2288,-0.1695,-0.2525,-0.0975,-0.0926,0.0045,0.0972,0.0401,0.1383,0.0016,0.2322,0.3237,0.238,0.1417,0.2605,-0.3289,-0.2539,-0.1698,0.0628,-0.0065,-0.0323,-0.0885,0.0221,0.0972,-0.1871,-0.1928,-0.0528,0.1814,-0.1663,-0.078,-0.0832,-0.0181,0.0904,0.1228,-0.0298,-0.0522,-0.0093,-0.0721,0.0348,0.16,0.1475,0.0658,0.0098,0.1036,0.1506,0.114,0.1098,-0.005,-0.1231,0.0096,-0.0362,0.0141,-0.0216,0.0253,0.1747,0.0809,0.0437,0.0522,-0.0199,-0.0159,-0.2211,-0.1832,-0.133,-0.1513,0.4001,0.0027,0.2484,0.1802,0.1189,0.0015,0.001,0.1707,-0.0515,0.281,0.2039,0.0641,0.1481,0.0767,0.0236,-0.0927,-0.0767,-0.1536,0.0543,0.2266,0.138,-0.1298,-0.0378,-0.0035,-0.0209,0.014,-0.0474,-0.107,-0.1269,-0.0123,-0.2223,0.0058,-0.096,0.1094,0.0968,0.1157,0.088,-0.0427,-0.0307,-0.0528,-0.0675,0.0938,0.1877,-0.0601,0.029,-0.067,0.0556,-0.0411,-0.0862,-0.0055,0.144,0.1076,-0.0195,-0.1976,-0.1071,-0.1591,-0.1229,0.037,0.089,-0.0799,-0.0189,-0.1037,-0.1589,-0.2675,-0.1816,-0.1614,-0.1643,-0.1257,-0.0965,-0.0987,0.1321,-0.2369,-0.2371,-0.2002,-0.0631,-0.0526,-0.2092,-0.097,0.0301,0.1541,0.077,-0.1157,0.3597,0.3298,0.2091,0.0053,0.0463,-0.0211,-0.1739,0.04,-0.0464,0.0399,0.1786,0.2041,-0.0463,0.03,0.0902,0.1286,-0.2124,-0.1217,-0.0549,-0.063,-0.1674,-0.1266,-0.0901,-0.1357,0.0349,-0.1845,-0.1645,0.1908,-0.0405,-0.255,0.0094,0.1409,0.1294,-0.0962,-0.1157,-0.4216,-0.3214,-0.1415,-0.3177,0.1147,-0.1116,-0.0991,0.0683,-0.1119,-0.089,-0.1931,-0.083,0.1233,0.1214,0.2531,0.183,0.2283,-0.0502,-0.021,0.1958,0.0299,0.1361,0.0982,0.0577,0.2481,0.157,-0.173,-0.279,-0.1396,-0.0688,-0.1479,-0.0375,-0.0918,0.0521,0.0367,0.0273,0.148,0.1006,-0.2236,-0.0358,-0.1629,-0.0317,-0.1913,-0.2694,0.0004,-0.0617,-0.0097,-0.0951,-0.0192,-0.1598,-0.0973,-0.2344,-0.1046,-0.1782,-0.055,-0.0449,-0.0286,-0.0385,-0.0675,0.0649,0.1097,0.041,-0.0848,-0.0882,-0.1426,-0.0288,0.1145,0.1149,-0.0993,0.2763,-0.0092,-0.0489,0.0784,0.0587,-0.0577,-0.0104,0.0082,0.049,-0.0022,-0.0109,0.1746,0.2974,0.4183,-0.0799,-0.0411,-0.0001,0.049,-0.0329,0.2114,-0.0414,0.3298,-0.1571,0.0674,0.042,0.1237,0.0211,-0.0032,-0.0148,0.0257,-0.0186,-0.0144,0.0709,0.0258,-0.059,-0.1387,0.0973,0.1952,0.2197,-0.2241,-0.1865,-0.203,0.0068,-0.1992,-0.0513,-0.0215,0.0454,0.0157,-0.047,-0.1604,-0.1747,-0.0157,0.0042,-0.1181,0.0344,0.299,0.0344,-0.0714,0.1815,0.4298,0.171,0.1259,0.2059,-0.0947,0.0341,0.2563,0.2098,-0.1231,0.2877,0.1178,0.0833,0.0856,0.4158,0.1041,-0.1795,-0.1579,-0.0996,-0.1047,0.0601,-0.1149,0.0064,-0.1182,-0.1223,-0.0233,-0.17,-0.0877,0.1295,-0.086,-0.2314,-0.1071,-0.1591,-0.065,-0.0598,-0.1033,-0.1095,-0.1129,-0.0601,-0.0598,-0.2161,-0.1554,0.1697,0.2895,-0.0312,-0.0406,0.0784,0.0289,-0.057,-0.08,-0.1269,-0.1863,0.0609,0.0875,-0.1968,-0.2545,-0.1136,-0.0691,-0.1192,-0.1529,-0.0025,-0.1298,-0.047,-0.128,-0.1059,-0.071,-0.124,-0.0443,-0.04,-0.0647,0.1703,-0.1157,0.0439,0.198,0.0792,-0.1842,-0.0593,-0.1819,-0.1731,-0.1,-0.0872,-0.0947,0.0788,0.1121,0.1489,-0.0212,-0.0766,-0.0171,-0.0739,0.0053,0.138,-0.1793,-0.0967,-0.1685,0.0349,0.0478,0.1443,-0.0282,-0.2746,-0.2296,-0.0392,-0.0284,0.0099,0.1429,0.1137,0.0003,-0.1245,-0.1435,-0.0784,-0.1678,-0.3331,-0.1411,-0.0962,0.1117,-0.0078,0.2094,-0.0413,0.1372,0.014,0.0382,0.03,0.0989,0.1804,0.058,-0.0212,0.0114,-0.0837,0.0305,-0.0221,0.0075,-0.0518,-0.0307,-0.0227,0.0106,-0.1034,-0.0649,-0.0829,-0.0737,-0.1838,-0.0399,0.0136,0.1014,-0.0793,0.0707,0.0094,0.0682,-0.0443,-0.0263,0.0353,-0.0559,-0.2342,-0.0903,0.1917,0.1868,-0.0102,-0.0736,-0.0952,-0.1565,-0.0818,-0.0185,-0.0944,0.1341,0.0828,-0.2171,-0.1996,0.007,-0.1639,-0.0556,-0.0481,0.4059,0.2567,-0.266,0.0852,-0.0934,-0.0146,-0.1006,-0.203,-0.2251,-0.1956,0.0475,-0.0073,-0.1212,-0.0036,-0.1125,-0.0654,0.1707,0.0055,0.0689,0.0044,0.0026,0.0259,-0.173,-0.0503,0.0767,-0.1488,0.1048,-0.24,0.1448,-0.1987,0.3046,0.1429,0.146,-0.2807,-0.2452,0.1095,0.2617,0.053,0.2453,0.0439,0.081,0.1212,0.0553,0.1179,0.0603,0.0539,0.0709,0.1031,0.0781,0.1147,-0.0779,0.1465,0.3072,0.566,0.251,0.1952,0.3973,0.2104,0.2449,0.2999,0.2126,0.2541,0.1622,0.2709,0.2797,0.1744,0.2245,0.3082,0.3507,0.2946,0.3188,0.1753,0.2719,-0.2392,-0.0619,-0.223,-0.1944,-0.1145,-0.2772,-0.2481,-0.1147,-0.0143,-0.0881,-0.3133,-0.2683,-0.1968,-0.0512,-0.0002,-0.1892,0.1191,-0.0303,-0.0799,0.0377,-0.1182,-0.0947,-0.0542,-0.0835,-0.1696,0.0933,-0.2169,-0.2287,0.0731,-0.0191,-0.0689,0.0142,0.0207,-0.1852,0.2002,0.1654,-0.1687,0.2528,0.2983,0.0602,0.0941,0.1589,-0.1015,0.3825,0.3856,-0.0444,-0.0459,0.1306,-0.0494,0.0176,-0.149,-0.0517,0.1242,-0.0279,-0.0772,0.0512,0.0168,-0.033,-0.0361,mental representation
trm_557b4817db34d,0.0225,0.0251,0.0276,0.0112,-0.0118,0.0042,0.0055,0.0212,0.0061,0.031,-0.0052,0.0027,-0.0022,0.0054,0.0276,0.023,0.0086,-0.0016,-0.0212,-0.0027,0.015,-0.0054,-0.0139,-0.0213,0.0049,0.0012,0.0012,0.0147,0.0222,0.014,0.0077,0.0014,0.0087,0.0116,0.005,-0.0086,-0.0197,-0.0121,0.0318,0.0088,0.0007,0.0191,0.0069,-0.0185,0.0102,0.0276,-0.0113,0.022,-0.0161,0.0021,0.0209,0.0115,0.0062,0.0078,-0.0034,-0.0119,-0.0032,0.0185,-0.0096,0.0209,0.0043,-0.0002,0.007,0.0082,0.0074,0.0141,0.0303,0.0241,0.0169,-0.0105,-0.0222,-0.0257,-0.0191,-0.013,0.0277,-0.0078,0.0242,-0.0229,0.0207,-0.0007,-0.0247,-0.0062,-0.0031,0.0066,0.0042,0.0057,-0.002,-0.0019,-0.0138,0.0112,0.016,0.0239,-0.0587,0.0123,0.0074,0.0148,-0.0096,0.0185,-0.0002,0.0002,0.0132,-0.0125,-0.0107,-0.0002,0.0062,-0.0024,0.0235,-0.016,0.0203,0.0282,-0.0128,0.0162,-0.0113,0.0022,0.0115,-0.0119,0.0078,0.0013,0.013,0.0049,0.0012,0.0108,0.0046,-0.0064,0.0001,0.0068,-0.0014,-0.0145,-0.0123,-0.0211,0.0006,0.004,0.0032,-0.017,0.005,0.0218,0.0087,0.0031,-0.001,0.0213,0.0187,0.0019,-0.0236,0.0018,0.0009,0.0016,0.0204,0.0053,0.0116,-0.029,0.0139,-0.0005,-0.017,0.0052,-0.0073,-0.0149,-0.0115,0.0105,-0.0188,-0.0114,0.024,0.0118,0.0131,0.027,-0.0012,-0.0003,-0.0083,0.0209,0.0201,0.0063,-0.0323,0.0033,-0.0131,-0.0014,0.0153,0.0017,0.0023,0.0016,-0.0007,-0.0077,0.0114,-0.0308,0.006,-0.0168,0.0287,0.0033,0.0158,-0.0026,0.0194,0.0119,0.0151,0.0066,0.0015,0.0236,0.0208,0.029,0.026,0.009,0.0104,0.0169,0.0041,0.0128,-0.0007,0.023,-0.0028,-0.0065,-0.0076,0.02,-0.0035,-0.0179,0.0021,-0.007,-0.0079,-0.016,-0.0041,0.0007,-0.0373,0.0141,0.0254,0.0026,-0.0096,0.0148,-0.0065,0.0084,0.0093,-0.0231,0.021,-0.0039,-0.0096,-0.0301,-0.003,-0.0043,-0.0194,-0.0038,-0.0069,0.0022,-0.0108,-0.0127,0.0026,0.0161,-0.0229,0.0143,-0.0017,0.0021,-0.002,0.0108,-0.0123,0.0072,0.0167,-0.0046,0.0126,-0.0006,-0.0018,-0.0124,-0.0008,0.0148,0.0075,0.0088,0.0019,-0.0079,0.0025,-0.0068,0.0141,-0.0059,0.0119,-0.0234,-0.0096,0.0125,-0.0344,0.0138,0.0037,0.0287,0.0074,0.0005,0.0136,-0.0127,0.0004,0.0074,0.0135,-0.0239,-0.0198,-0.0032,-0.0144,0.0065,0.0073,0.0173,-0.0256,0.0092,0.0277,-0.002,0.0016,0.0246,0.0056,0.002,-0.0061,0.0009,0.011,0.0051,0.0031,0.0098,0.0079,-0.0105,-0.0141,-0.0112,0.008,0.0083,0.0075,0.0066,0.0234,0.0156,-0.0148,-0.0021,0.019,-0.0128,-0.0183,0.0114,0.0025,-0.0061,0.0083,0.0188,-0.0117,0.0087,-0.0073,-0.0135,-0.001,0.0267,-0.0095,0.0001,0.001,-0.005,-0.0045,-0.0004,-0.0003,-0.0234,-0.0029,-0.0103,-0.009,-0.0107,0.0028,-0.0015,-0.0038,0.0013,0.0125,0.0018,0.0165,0.0119,0.012,0.0051,0.0098,0.0024,0.0204,0.002,0.0116,-0.0029,0.0085,0.0134,0.0053,0.0069,0.0224,0.0004,-0.0111,0.0182,0.0104,0.0054,-0.0122,-0.0081,0.0183,0.0119,0.0131,0.0205,0.0008,-0.0034,0.0027,-0.0056,0.0116,0.0017,0.0204,0.0054,-0.0468,-0.0192,-0.0443,0.012,0.0196,-0.0013,0.0175,0.0013,0.0171,-0.001,0.013,0.0006,0.0041,0.0176,0.006,0.0093,0.0061,0.0029,0.0121,0.0013,0.0259,0.0002,0.0131,-0.006,0.0239,0.0173,0.0027,0.0027,0.007,0.0247,-0.0134,-0.014,0.0192,-0.0023,0.0187,0.009,0.0009,0.0105,-0.0109,0.0057,0.0202,0.0218,-0.0068,0.0207,0.015,0.0331,0.0271,0.0198,0.0256,0.0006,0.0194,-0.005,0.0186,-0.0153,0.0159,0.0017,-0.0445,-0.0043,0.0021,-0.0123,0.0228,0.0172,-0.0082,-0.0119,0.0128,-0.009,0.021,0.0134,-0.0214,-0.0093,0.0145,0.012,0.0125,0.0121,0.0099,0.0162,-0.011,0.007,0.0045,0.0122,0.0146,-0.0222,-0.0037,0.0102,0.0152,-0.0312,0.0104,0.0041,-0.0165,-0.0287,0.0213,-0.0035,0.0137,-0.0009,0.0235,-0.0137,-0.0141,0.0041,-0.0001,-0.01,-0.0134,0.0217,0.006,0.0122,0.0185,0.0069,-0.0185,-0.0294,0.0084,-0.0065,0.0068,0.0017,-0.0368,-0.0364,0.0087,0.001,-0.0204,0.0092,0.0094,0.0088,-0.0223,0.0204,0.0181,0.0125,0.0106,0.0228,0.018,0.0053,0.0147,-0.0105,-0.0052,-0.0,0.0165,-0.0263,-0.0002,-0.0038,-0.0145,-0.0072,0.0121,0.0092,-0.0049,0.018,-0.0033,0.007,0.0106,0.0083,0.0039,-0.0154,-0.0114,-0.0308,-0.0259,0.0005,-0.0051,0.0269,0.0023,0.0169,-0.0006,0.0098,0.0118,0.0107,-0.0013,0.001,-0.006,-0.0103,0.0063,0.0129,-0.0217,-0.0089,0.0035,-0.0056,-0.0083,-0.02,-0.0298,-0.0094,0.0051,0.0018,0.0211,0.0084,-0.0169,0.0015,-0.0317,0.029,0.0066,0.0081,0.0225,0.0111,-0.0014,-0.01,-0.025,-0.0107,-0.0031,0.0078,0.0002,0.0017,-0.0251,0.0024,-0.0145,-0.0083,-0.0087,0.0126,-0.0003,-0.0183,-0.0083,0.0249,0.0035,0.0193,0.0066,-0.0031,0.0199,-0.0066,-0.0158,0.0062,-0.0049,0.0136,-0.002,0.0137,0.0109,0.0182,0.0212,-0.0105,0.0126,0.0042,-0.0017,-0.0167,-0.0051,-0.0191,0.0108,-0.0179,0.0166,0.0177,0.0205,0.0119,0.0206,0.0181,-0.0085,0.0151,0.0316,0.0145,0.0224,-0.0043,0.0036,0.0384,0.0123,0.0225,-0.0361,0.0091,0.0128,-0.0199,0.0192,0.0118,0.0109,0.0054,-0.0021,0.0036,0.0058,0.0112,0.0284,0.004,0.014,-0.0078,0.0088,0.019,0.0134,-0.0013,0.007,0.0045,-0.0116,0.0152,0.0116,0.0077,-0.0121,0.0111,-0.0224,-0.0045,0.0132,0.017,-0.0054,-0.0003,0.0158,-0.0182,-0.0029,0.0109,-0.0132,-0.0008,-0.0243,0.0058,0.01,0.004,0.0162,0.0097,0.0015,0.0026,-0.0155,-0.0075,-0.0056,0.0027,0.0129,0.0077,-0.0364,0.0231,-0.0053,-0.0072,-0.0054,-0.0094,0.0131,0.0136,-0.0204,0.0158,0.0135,0.011,-0.001,0.0181,0.0102,0.0073,0.0144,0.0151,-0.0377,0.0135,0.0004,0.0271,0.0052,0.017,-0.0024,-0.0045,0.0075,-0.0314,0.0215,0.0045,0.0239,0.0108,0.0094,-0.0163,0.0077,-0.0046,0.0002,-0.0366,-0.0219,0.0064,-0.0141,-0.0113,-0.0221,0.002,-0.0249,0.0103,0.0115,0.0105,0.0049,0.0158,0.0175,0.0102,0.0087,0.0155,-0.0293,0.012,-0.0166,-0.0012,-0.0014,0.0174,0.0201,-0.0169,0.0133,-0.0058,0.0116,0.0006,0.0149,-0.0016,-0.0082,0.012,0.0124,0.0029,0.0094,-0.0056,-0.0189,-0.018,0.0091,0.0212,0.0038,-0.0013,0.0079,-0.0122,-0.0227,0.0138,-0.0058,0.0057,-0.0012,-0.0091,-0.0183,-0.0002,-0.0151,0.0321,0.0076,-0.0045,0.002,-0.0159,0.0008,0.0117,0.0067,0.0187,-0.0142,0.0031,0.0257,0.0171,0.019,0.0187,-0.0183,0.0004,-0.0142,-0.0067,-0.0101,-0.0018,-0.0081,0.0186,0.008,0.002,-0.0183,-0.0066,-0.0006,0.0053,0.0017,0.0217,0.0071,0.0186,0.0163,-0.0192,-0.019,-0.0236,0.0001,-0.0046,0.0153,0.0141,0.0235,-0.0149,-0.0104,-0.0118,-0.0371,-0.036,0.001,-0.0367,-0.0146,-0.012,-0.0012,-0.006,0.0018,0.013,0.022,-0.0157,0.011,-0.038,0.0109,0.0101,-0.0079,0.008,0.0045,0.0016,-0.0036,-0.0009,-0.0065,0.0075,0.0018,-0.0033,0.012,-0.0218,-0.0107,0.01,0.0098,0.0206,-0.0017,0.02,0.0073,-0.0218,0.0011,-0.0028,-0.0077,0.0222,-0.023,0.0044,0.0108,0.006,0.0298,0.0119,0.0189,0.0043,-0.0143,-0.0295,0.0004,-0.0136,0.0031,-0.0075,0.0067,0.015,0.0037,0.0096,-0.011,0.0166,0.0125,0.0131,-0.011,0.0148,-0.0093,0.014,0.0148,0.0134,0.0102,-0.0174,-0.0027,0.0166,0.0185,0.0028,0.0017,0.0202,-0.0092,0.005,0.0056,0.0032,0.0019,0.0091,-0.0047,-0.0168,0.0257,0.0106,-0.009,0.0039,-0.006,-0.0098,-0.0478,-0.011,-0.0197,-0.0732,-0.0095,0.0032,-0.0078,0.0124,0.0222,-0.0282,0.0147,0.0153,-0.0012,-0.0482,-0.0272,-0.0177,-0.0132,-0.0021,-0.0016,-0.0001,0.0115,0.005,0.019,0.0021,0.0215,-0.0019,-0.0242,0.0053,-0.02,-0.0279,0.0123,-0.0012,0.0141,-0.0389,0.0115,-0.0269,0.0077,0.0194,0.0197,0.003,0.0055,-0.0064,-0.0122,-0.0041,-0.0134,-0.0099,-0.0177,0.0085,-0.0099,-0.0125,0.0052,0.0116,-0.0187,0.025,-0.0072,-0.0008,0.0123,-0.0109,-0.0309,0.0091,-0.0227,-0.0154,-0.0326,-0.0029,0.0207,0.0068,-0.0026,-0.0166,-0.0038,0.0142,0.0094,-0.0119,-0.0173,0.0067,0.0146,0.0082,0.0152,-0.0017,-0.0011,0.0017,0.0248,0.0244,-0.023,0.0125,0.0094,-0.0181,-0.0002,-0.0052,-0.0066,-0.0649,-0.0238,0.0243,0.0063,0.0119,0.0204,0.0022,-0.0056,-0.0055,0.0174,0.0136,-0.01,-0.0342,-0.0292,0.0213,0.0034,0.0061,-0.0087,-0.0031,-0.0049,0.0072,-0.0059,-0.0492,0.0156,0.0107,-0.0109,-0.0015,0.032,0.0019,-0.0033,-0.0285,-0.0127,0.0014,0.0014,-0.0009,0.003,-0.0011,0.0156,-0.0119,0.0045,-0.0068,0.0011,-0.0005,-0.0041,-0.0064,-0.0148,0.0044,0.02,-0.019,0.008,0.0194,0.0212,-0.0252,-0.0021,0.0032,0.0106,-0.0101,-0.0062,-0.0085,0.0033,0.0006,0.0078,0.0009,0.0032,-0.0351,-0.0048,-0.0391,0.005,-0.0236,-0.0077,-0.0011,0.0118,0.0135,-0.031,-0.0034,-0.02,0.0009,0.0147,-0.0478,0.0127,0.0161,0.006,0.0089,0.0143,-0.0227,-0.0156,0.0249,0.0079,-0.008,0.0071,0.0004,-0.0049,0.0112,0.0144,-0.0053,-0.0052,-0.0149,-0.0017,0.0071,-0.0414,-0.0295,-0.0275,0.0041,-0.0198,-0.0138,-0.0249,0.0011,0.019,-0.0342,-0.0056,-0.0037,-0.0268,-0.03,-0.0104,0.0029,-0.0254,0.0177,-0.0076,-0.018,-0.0017,-0.0146,0.0146,0.0132,0.0162,0.0057,0.0035,0.0184,-0.011,0.0023,-0.0087,0.0131,-0.0002,0.0128,-0.004,-0.0161,0.0087,0.0139,0.0138,-0.0042,0.0053,-0.0057,-0.0331,-0.0077,-0.0013,-0.0001,0.0094,-0.0099,-0.0166,-0.0004,0.0187,-0.0227,-0.0147,-0.0127,0.0189,-0.0128,0.0007,0.0011,0.0048,-0.0123,-0.0247,-0.0012,0.0009,0.0021,0.0038,0.0125,0.0009,0.0133,-0.0232,-0.0157,0.018,0.02,0.0319,0.013,-0.0082,0.0005,0.0204,0.0016,-0.005,-0.0046,0.003,0.0028,0.0028,0.0155,0.0012,0.0202,0.0232,0.0008,0.0223,-0.0134,0.0017,-0.0136,0.0187,0.0012,0.0167,0.0065,0.0108,-0.0056,-0.0044,0.007,0.0274,-0.0011,-0.0098,0.0123,0.0185,0.0054,-0.0127,-0.0031,0.0237,-0.0068,-0.0087,0.004,0.0167,-0.0011,-0.0064,0.006,0.0126,-0.0052,-0.0092,0.0089,0.0101,0.0121,0.0091,-0.0047,0.0071,-0.011,-0.008,0.0083,0.0127,-0.0348,0.0032,-0.0337,-0.0249,-0.0114,-0.0267,0.0273,-0.0003,0.0102,0.0028,0.0303,-0.0308,0.0086,-0.0084,-0.0003,0.0062,-0.0059,0.0025,0.0057,-0.03,-0.0051,-0.0291,-0.0148,-0.0092,0.0112,-0.0048,0.0063,0.0083,0.0081,-0.008,-0.0108,-0.0108,0.0048,0.0214,0.0176,0.0031,-0.0138,-0.0426,0.013,-0.0232,0.0223,0.0201,0.0112,-0.0041,0.0244,0.0244,0.0152,0.0016,0.0072,-0.0031,-0.0036,-0.0076,0.0138,-0.0136,-0.0054,0.0253,-0.0084,0.0058,0.0012,-0.0036,0.0009,0.0026,0.0127,0.0216,-0.0013,-0.0102,-0.0128,-0.0051,-0.0076,0.0009,0.0115,-0.0097,0.0151,-0.0158,-0.0144,-0.0141,-0.0236,0.0023,-0.0069,0.0052,0.0045,0.0132,-0.016,0.014,0.003,-0.023,0.018,-0.0036,-0.0036,-0.0225,0.0139,0.0137,0.0147,0.0231,-0.0054,0.002,-0.001,-0.0089,0.0016,0.0181,0.0125,-0.0023,0.0031,-0.003,0.0005,-0.001,-0.009,-0.0257,0.0208,0.0107,-0.0198,0.0116,-0.0092,0.0091,0.0209,-0.0013,0.0007,-0.0074,0.0185,-0.0127,-0.0056,0.0097,-0.0188,0.008,0.0003,0.0027,0.0023,-0.007,0.0124,0.0091,0.0021,0.0008,-0.0001,0.0239,-0.0045,0.0117,0.0098,-0.0137,-0.0004,-0.0158,-0.0021,0.0205,-0.0048,-0.0005,-0.0017,-0.0297,0.0029,-0.0034,0.0062,0.0286,-0.005,-0.002,-0.0088,0.0127,0.008,-0.0004,-0.003,-0.0062,-0.0104,-0.0143,0.0122,0.0127,0.0168,0.0082,0.0075,0.0138,-0.0087,-0.0103,0.0136,0.0113,-0.0057,0.0116,0.0009,0.0164,0.0034,-0.0079,-0.0153,0.013,-0.0031,-0.0066,-0.0231,0.0073,-0.0091,0.0023,-0.0019,0.0136,-0.0238,0.0035,0.0033,-0.0108,0.005,-0.0166,0.0052,-0.0035,-0.0043,0.0021,0.0214,-0.0074,-0.0166,-0.0086,-0.0039,0.0023,-0.0415,0.0147,0.0128,0.012,-0.0234,0.0112,0.0057,-0.0117,0.0079,-0.0115,0.0165,0.0122,0.0177,-0.0062,-0.0031,-0.025,-0.0309,-0.0019,0.0134,0.0094,0.0189,0.0099,0.0125,0.0028,-0.0304,0.0071,-0.0112,-0.0049,-0.0189,0.0008,0.0188,0.0115,-0.0192,0.0217,0.0184,-0.0004,0.0146,0.0208,-0.0072,-0.0062,0.0315,0.0082,0.0022,-0.0034,0.0262,-0.0,0.0113,-0.0094,0.0058,0.0002,0.0176,0.0191,-0.0061,0.0179,0.0077,0.0049,0.0083,-0.0178,0.0128,-0.0251,-0.0094,0.0167,0.0176,-0.0017,0.0089,0.0335,0.01,-0.0049,0.0042,0.0076,-0.0213,0.0172,0.015,-0.0103,0.0007,-0.0204,0.0128,0.014,-0.0507,0.0068,0.0059,-0.0021,-0.0053,-0.007,0.0058,-0.0359,0.0036,0.0073,-0.0145,-0.0044,-0.0028,0.0035,0.0014,0.0065,0.0065,0.0057,-0.0066,0.009,0.0058,-0.0028,0.0214,0.005,0.0189,0.0199,0.0212,0.0133,-0.0127,0.0057,-0.0107,0.0155,-0.0161,0.0061,-0.0065,0.0063,0.0155,0.0032,0.0085,-0.0163,0.0158,0.0082,0.0087,-0.0131,-0.0121,0.0024,-0.005,-0.0196,-0.0077,-0.0178,0.0052,0.0004,0.0082,-0.0217,-0.0575,0.0181,0.0064,-0.0277,-0.0102,0.0027,0.0058,0.0042,0.0002,0.0002,-0.0184,0.0109,0.0015,0.0115,0.0133,0.0121,0.0251,-0.0016,0.0193,0.0053,-0.019,-0.0269,0.0024,-0.0232,-0.0301,-0.0015,0.0187,0.0042,-0.0282,0.0027,0.0172,-0.0117,0.0209,0.006,0.0216,0.0032,0.0141,-0.0046,0.0097,0.0168,0.0014,0.0215,0.0205,0.0026,0.0154,-0.0126,-0.0073,-0.0099,-0.0056,0.0012,-0.007,-0.0,0.0342,-0.0088,0.0025,-0.0052,-0.0069,0.0058,-0.0041,0.0079,0.0034,0.0081,0.0278,0.0074,0.0271,0.0114,0.0091,-0.0097,0.0176,-0.0621,-0.0676,0.0069,0.0104,0.0175,-0.016,0.004,-0.0175,0.0095,0.0143,0.0108,-0.0234,-0.0021,-0.0101,0.0047,0.0186,0.0089,0.0052,0.002,0.0079,-0.0066,0.0036,0.0133,0.0124,0.0054,0.0114,0.0029,0.0032,0.0023,-0.0097,-0.0153,0.0195,0.0142,-0.0063,0.0111,0.0071,-0.015,0.0017,-0.0299,-0.0167,-0.0023,0.0063,-0.0041,0.0044,0.0029,0.014,-0.02,0.0158,0.0151,0.0107,0.0075,-0.0011,-0.0041,-0.0009,-0.0256,0.0045,0.0204,-0.0001,0.0003,0.0059,0.0053,0.0226,-0.0001,-0.0064,0.0111,-0.0272,-0.0025,0.002,-0.0031,0.0054,0.0131,0.0147,0.0008,0.0035,0.0217,0.0353,0.0068,0.0057,0.001,0.0015,-0.0257,-0.0163,-0.0443,-0.0202,-0.0123,-0.0214,0.0133,0.0222,0.0014,0.0156,0.0158,0.0047,0.0027,0.0014,0.0131,-0.0048,-0.0042,-0.0121,0.0106,-0.0107,0.0046,0.0186,-0.0555,-0.0033,0.024,0.0031,0.0159,0.0073,0.0026,-0.0185,0.0243,0.0284,-0.0032,-0.0005,0.0258,-0.0073,0.0019,0.0074,0.0153,-0.006,0.0102,0.0182,0.0045,-0.0219,0.0024,-0.003,-0.0034,0.0089,-0.023,-0.0149,0.0152,-0.0109,-0.0031,-0.0018,-0.0087,-0.0175,0.0154,-0.0113,0.0025,0.0123,-0.0098,0.0117,0.0159,0.0236,-0.0059,-0.0161,-0.0025,0.0247,-0.0202,-0.0142,0.0052,-0.0097,0.0151,0.0143,0.001,0.0131,0.01,0.0097,0.0045,0.0083,-0.0065,0.0026,0.0111,0.0201,0.0232,0.0111,0.0093,0.0169,0.0115,-0.0211,0.0127,0.0119,-0.0058,0.0238,-0.003,-0.014,-0.0461,-0.0287,0.0103,0.0175,0.0276,0.0074,0.0126,-0.0001,-0.0141,0.0145,-0.0027,0.012,0.0216,0.0191,0.0035,0.0183,0.0112,0.0112,0.0207,-0.0062,0.0223,0.012,0.0108,0.0073,0.0121,-0.005,-0.012,0.0059,0.0143,0.008,0.0022,-0.0347,0.0189,0.0141,0.0071,0.0069,0.0081,0.0168,0.0173,0.0067,0.0211,0.0002,0.0097,-0.0169,0.0208,0.0103,0.0111,0.0034,-0.0245,0.0072,0.0119,-0.0291,-0.0216,0.0163,0.0066,0.0144,-0.0111,-0.0026,0.0224,0.0042,-0.0347,-0.0352,0.0209,0.0033,0.0071,0.0003,0.0022,-0.0217,-0.0081,-0.0212,-0.0055,-0.0091,-0.0012,0.0075,-0.0071,-0.0246,-0.0072,0.0194,0.0153,0.0126,0.0152,0.0194,0.0198,0.0053,0.0161,0.0033,-0.0051,-0.0439,0.0064,0.0208,0.0255,0.0181,0.0163,0.0132,-0.0074,0.0168,0.0077,-0.0104,0.0123,0.017,0.0084,-0.0051,-0.0182,0.0103,-0.0039,0.0145,0.0063,0.0142,-0.0083,-0.0019,-0.0029,0.0141,0.0046,-0.0012,-0.0054,-0.0254,-0.0016,0.004,-0.0065,-0.0024,-0.0042,0.0098,0.0155,0.0052,-0.0252,-0.0104,0.0073,0.0211,0.0179,0.0126,0.0185,-0.0449,0.015,0.009,0.0114,-0.0016,0.0121,-0.0032,0.001,0.022,0.0038,0.016,0.0064,0.0066,-0.0265,-0.0044,0.0231,-0.0478,-0.0369,0.026,0.0158,-0.0361,0.0107,0.0091,0.0027,0.0083,0.0006,0.0198,0.0194,0.0153,0.0029,-0.0506,-0.0636,-0.0189,-0.0618,-0.0045,-0.0253,-0.0561,-0.0548,-0.0334,0.0145,0.0051,-0.0174,0.012,0.0196,0.0108,0.0038,0.0125,0.0169,-0.0004,-0.0108,-0.016,-0.0083,0.0021,0.0081,-0.0246,-0.0441,-0.0243,-0.0193,0.0261,0.0009,0.0118,0.0,0.0139,0.0126,0.0009,0.0038,-0.0076,-0.0055,0.009,0.0173,0.0154,0.0034,0.0184,0.0111,-0.0028,0.0072,-0.0126,-0.0117,-0.0059,-0.0235,-0.0091,0.0187,-0.0115,0.0121,-0.0036,0.0162,0.0143,0.0016,0.0134,-0.0107,0.0071,0.0095,0.0027,-0.0005,0.0084,0.0218,0.0074,-0.0191,-0.011,-0.0078,-0.0108,-0.0014,-0.0222,0.0206,0.0005,0.0046,0.0148,-0.0132,0.0196,-0.0074,0.017,-0.0075,0.0046,0.0034,-0.0063,0.0037,0.0147,0.0066,-0.0068,-0.0124,0.0164,-0.0091,-0.0,-0.022,0.0002,-0.0127,-0.0027,0.014,-0.0148,-0.0189,-0.0149,-0.0166,0.0039,0.0009,0.0224,0.001,-0.0034,0.0163,-0.0128,0.0038,0.006,-0.0187,-0.0031,-0.0158,-0.0184,-0.0079,0.0116,0.0051,-0.005,0.0234,0.0208,-0.0073,-0.0041,-0.0102,0.0093,-0.0055,-0.0087,0.0165,-0.0183,-0.0316,0.0228,0.001,0.0102,-0.0185,0.0069,-0.0251,-0.0354,0.0091,-0.0011,0.0152,0.0013,0.0004,0.0007,0.0127,0.0087,0.0,0.0053,0.0157,0.0107,0.0108,0.0174,0.0251,0.0104,-0.0033,0.0012,0.0148,0.016,-0.0137,0.0187,-0.0147,-0.0188,0.0174,0.0147,-0.0078,-0.0079,-0.0078,0.0079,0.0146,-0.0446,-0.0287,0.0067,-0.0037,0.0075,0.022,-0.0017,0.0034,0.0058,-0.0133,-0.0019,-0.0323,0.0167,0.0208,0.0003,0.0142,-0.0048,0.0076,-0.0204,0.0208,0.0144,0.0061,-0.0019,0.0152,0.0107,0.0001,0.0022,-0.006,0.006,0.0119,-0.0047,-0.0111,-0.003,-0.0012,0.0213,0.0201,0.0155,-0.0015,0.0252,0.0162,0.0184,0.0184,-0.0042,0.0187,0.0054,0.0264,-0.0074,0.0127,0.0031,0.0158,-0.004,0.0203,-0.0018,0.013,0.012,-0.0233,0.0038,0.0046,0.0145,-0.0129,0.0197,0.0126,-0.036,0.0073,0.0139,0.012,0.0161,0.0151,0.0187,-0.0062,-0.032,0.0116,0.0142,-0.0127,0.0114,0.015,0.0033,0.0143,-0.0029,0.0016,0.0099,0.0001,0.0008,0.004,0.0206,0.0119,0.0227,-0.0025,0.0044,0.0084,0.0129,0.0088,-0.0079,0.0096,0.0004,0.0075,0.0102,0.0152,0.0019,-0.0024,-0.0082,0.0044,-0.0192,-0.0021,-0.0116,0.0004,-0.0373,-0.0022,0.0263,0.0028,-0.0199,0.0136,-0.014,-0.0082,0.0016,-0.0109,-0.0176,0.0065,0.0066,0.0119,0.0128,-0.017,0.017,0.0048,-0.0146,0.0214,-0.0079,-0.0202,-0.0243,0.0135,-0.0225,0.0204,0.0305,0.016,-0.0319,0.0058,0.009,0.0098,-0.0012,-0.0263,-0.0095,0.0068,0.0088,-0.0237,0.0076,-0.0072,-0.0042,0.015,0.0005,-0.0015,0.0135,0.0121,0.0298,0.0272,0.0243,0.0037,0.002,0.0004,-0.0237,0.0189,-0.0038,-0.0054,0.0043,-0.0105,0.0223,0.0259,-0.0144,0.0301,0.0299,0.0033,-0.0013,-0.0092,-0.0163,-0.0033,0.0115,-0.0038,0.0182,0.0127,-0.0021,0.0053,0.0022,0.0071,-0.0077,0.0075,0.0114,0.0102,0.0073,0.0052,0.0228,-0.0054,0.0125,0.011,0.0152,0.0056,-0.005,-0.01,0.0189,-0.017,0.0148,0.0074,0.0212,0.0047,-0.0032,0.0131,-0.0141,0.0006,0.0099,-0.0224,0.01,0.0065,-0.001,0.0239,0.0067,0.0007,0.0105,0.002,0.0049,0.0176,0.0147,0.0059,0.015,0.025,0.0121,0.0041,-0.02,-0.0157,0.0073,-0.0203,-0.0037,-0.0003,0.002,0.0265,0.011,0.0168,0.0017,0.0141,0.0112,-0.0192,0.0044,0.0097,-0.0454,0.0074,-0.0038,-0.0087,-0.0208,0.0151,0.0086,0.0101,0.0,-0.0037,-0.0024,-0.0023,0.0233,0.0075,0.0092,0.0058,-0.0026,0.0131,0.0143,-0.0146,-0.0167,-0.0006,0.0175,-0.0041,0.0124,-0.0141,0.0014,0.0167,-0.0042,0.0121,0.0117,0.0058,0.0085,0.024,0.0112,0.0165,0.018,0.0038,0.0093,0.0061,0.0055,-0.0074,-0.0219,-0.005,0.0161,0.0318,0.0072,0.0064,-0.011,0.0078,0.0108,0.0155,0.0147,-0.0051,-0.0073,0.0083,0.0225,-0.0286,-0.0041,0.0043,-0.0078,-0.0089,-0.015,0.0005,0.0057,0.0171,0.0018,0.0004,0.0041,-0.0183,-0.0127,-0.0126,0.0093,-0.0071,0.0052,-0.0057,-0.0026,-0.008,-0.024,-0.0148,-0.0146,-0.0145,0.008,-0.0151,-0.0213,-0.0236,0.0027,0.0038,-0.051,0.0175,-0.0032,0.018,0.0179,0.0024,0.0158,-0.0023,-0.0301,-0.0083,0.0083,0.0002,-0.0239,0.0097,0.0061,0.0163,-0.0047,-0.0449,-0.0071,-0.0037,0.003,0.0018,-0.0014,0.0109,0.0079,0.0,-0.0054,-0.0367,-0.005,0.0104,-0.0053,0.0128,0.025,0.0224,-0.0009,-0.0084,-0.0027,0.0024,0.0036,0.0081,0.0186,0.0054,0.0098,-0.0038,-0.0037,-0.0052,-0.0106,0.0186,0.0071,0.0131,-0.0076,0.0036,0.0155,0.0133,0.0081,0.0021,0.0187,0.0115,-0.011,0.0107,0.0127,0.008,0.0242,0.0037,-0.0041,-0.0183,0.0012,0.0257,-0.0103,0.0102,-0.0172,-0.0037,0.0168,-0.011,-0.0143,-0.0255,0.0015,-0.0098,-0.0159,0.004,-0.0031,0.0169,0.0248,0.0036,0.0126,0.0058,-0.0061,0.0116,0.0083,0.0266,0.017,0.0023,-0.0005,-0.0014,-0.0082,0.0283,0.0191,0.0279,-0.0105,-0.0096,0.013,-0.0243,-0.0191,0.0082,0.0103,0.0155,0.0158,0.0177,0.0139,0.0005,0.0159,-0.0277,0.0103,-0.0316,0.0056,0.0066,-0.03,0.0082,0.0021,-0.024,0.019,0.0154,-0.0015,-0.0082,0.0003,-0.0065,0.0146,0.0026,0.0126,0.0192,0.0121,0.0136,-0.0193,-0.0047,0.0035,-0.01,-0.0066,0.0029,-0.0219,0.0255,0.0055,-0.0013,0.0041,0.0044,-0.0025,-0.0118,0.0028,0.017,-0.0071,-0.0034,0.0181,-0.0193,0.001,0.003,-0.0125,-0.0022,-0.0016,0.0124,0.0062,-0.0261,-0.0015,0.0074,-0.0135,0.0055,0.0079,0.0158,0.0138,0.0059,0.0107,-0.0273,-0.0156,-0.0254,0.0201,-0.0154,0.006,0.0042,-0.0106,0.0242,-0.0247,-0.0178,-0.0216,-0.0115,0.0214,0.0042,-0.0026,0.0143,0.0091,0.0272,-0.0198,0.0193,0.0242,0.0093,-0.0011,0.0054,0.0165,0.0099,-0.0142,0.008,0.0201,0.0147,0.0035,0.0076,-0.0104,-0.0021,0.0043,-0.0068,-0.0043,-0.0022,0.001,-0.0222,0.0049,-0.0269,0.013,0.0035,0.0265,0.022,0.0085,0.0127,-0.0083,0.0037,0.0173,0.0135,0.0273,0.0179,0.0007,0.0039,0.0229,0.0204,0.0025,-0.0074,0.0084,0.0058,0.0102,0.019,0.0057,-0.0048,0.0046,-0.0034,0.0193,0.002,0.0169,0.0112,0.018,-0.008,-0.0037,0.006,-0.0022,-0.0005,-0.0096,-0.0053,0.014,0.0111,-0.0033,-0.0006,0.0091,-0.0003,0.0096,0.01,-0.0151,-0.0031,-0.0081,-0.0211,-0.014,0.0052,0.0166,-0.0381,-0.0061,0.0121,-0.0182,-0.0038,-0.015,0.0056,-0.0021,-0.0037,0.0123,-0.0084,-0.0041,0.0194,0.0135,0.0014,0.0043,0.0083,-0.0335,-0.0279,-0.0025,0.0074,0.0218,0.027,0.0107,0.0339,0.0033,0.0087,0.019,0.0188,-0.0039,-0.0081,0.0101,0.0199,-0.0561,-0.0101,-0.026,-0.0023,0.018,0.0174,0.0168,0.0088,-0.0148,-0.0037,0.0162,0.0082,-0.0253,-0.0268,0.0101,0.0245,0.0101,0.0108,0.0093,0.0118,0.0095,-0.007,-0.0162,0.0215,0.002,0.0103,-0.0045,-0.0176,0.0151,-0.0088,0.018,0.0327,-0.0261,0.0058,-0.0049,-0.0012,0.021,0.0183,0.0279,0.0047,0.0176,0.0076,0.0003,0.012,0.0062,0.0165,0.01,-0.0413,-0.0051,-0.0089,0.008,0.0181,0.0128,0.0228,0.0011,-0.0136,0.0163,-0.0408,0.0045,0.0192,0.0095,0.004,-0.0099,-0.0132,-0.0229,-0.0099,0.0265,-0.012,-0.0071,0.0014,-0.0025,-0.0067,0.0103,-0.0126,-0.0037,-0.0198,-0.0219,0.0239,-0.0123,-0.0019,0.0102,0.0087,0.0019,-0.0015,0.0114,-0.0045,-0.0004,0.0047,0.0093,-0.0013,-0.0178,-0.0051,-0.0168,-0.0079,-0.0245,0.0177,0.0136,0.0042,0.0098,-0.0109,0.0271,0.0076,-0.0024,0.0157,-0.0212,0.0026,0.012,0.0071,-0.0005,0.006,0.0222,0.0117,-0.0168,-0.0064,-0.0087,-0.0189,-0.0073,0.004,0.0184,-0.0057,0.0016,-0.0074,0.0091,-0.024,0.0134,0.0005,0.0029,-0.0068,-0.0186,-0.0072,0.0144,0.0147,-0.0115,-0.0138,-0.0024,-0.0239,0.0065,0.0104,0.0096,-0.0028,0.0181,0.0129,0.0015,-0.016,0.0015,0.0104,0.0012,0.0058,-0.0053,-0.0018,-0.0001,0.0239,0.0176,0.0099,0.0084,0.0192,0.0037,-0.0163,-0.0269,0.003,0.0127,0.0234,-0.0054,-0.0048,-0.0029,0.0153,0.0076,0.0002,0.0043,0.0167,0.0084,-0.0003,-0.0164,0.0096,-0.0049,0.0222,-0.0019,0.0109,0.0148,0.0112,0.0189,0.0246,0.0277,-0.0032,0.0073,0.0198,0.0179,0.0171,0.0019,0.0056,0.0052,0.0122,0.0119,0.02,0.0168,0.0109,0.0091,-0.0125,-0.0029,-0.0205,-0.0054,0.0036,-0.0105,-0.0189,0.0081,0.0144,0.0185,0.0254,0.0101,-0.0162,0.0021,0.0004,0.0127,0.005,0.0006,0.0158,0.0168,-0.004,0.0041,-0.0487,0.0194,0.0097,0.0082,-0.0029,0.0012,0.0203,-0.0108,0.0163,0.0158,0.0165,0.0136,0.0138,-0.0059,-0.0113,0.0166,-0.004,0.0086,0.0104,-0.0149,-0.0016,-0.0143,0.0171,-0.0162,0.0106,-0.008,0.0133,0.0149,-0.0036,-0.0093,-0.0046,0.0015,0.0185,0.0108,0.0033,-0.0192,-0.0341,0.0065,0.0072,-0.0329,0.0055,-0.0135,-0.0002,-0.0138,0.0101,0.0068,-0.0047,0.0107,-0.0008,-0.0052,-0.0019,0.0079,0.0086,0.012,0.0181,0.0035,-0.0144,-0.0055,-0.0188,0.0178,0.0147,0.0054,0.0193,0.0026,0.0112,-0.0728,-0.0471,0.0032,-0.0041,-0.0175,0.0191,0.004,-0.0121,0.0132,0.026,-0.0026,-0.0154,-0.001,-0.0026,0.0026,0.0169,-0.0137,0.0187,0.009,0.0037,0.0268,-0.0057,0.0077,-0.0129,-0.0067,0.0014,0.0092,0.0149,0.0016,0.0148,-0.0495,-0.0115,-0.0118,-0.013,-0.017,-0.0086,0.0053,0.0033,0.0133,0.0117,-0.0039,0.0157,-0.0135,0.005,0.0075,0.0051,-0.0122,-0.0134,-0.0114,-0.045,0.0197,-0.0112,-0.0481,-0.0526,-0.0322,-0.0493,-0.0663,-0.0284,-0.0279,-0.0143,-0.0099,-0.0383,-0.0376,-0.0241,-0.0564,-0.0259,-0.0189,-0.0117,-0.0198,-0.0142,-0.0079,-0.0045,0.0038,0.0155,0.0027,-0.014,0.0181,-0.0071,0.0123,0.0178,0.0177,0.0183,-0.0069,0.0216,0.0071,0.0209,0.0196,0.0175,0.01,0.0071,0.0171,0.0059,0.0109,0.0223,0.0225,0.02,-0.0084,0.0159,-0.0302,0.002,0.0161,-0.0023,0.0203,0.0069,0.0018,0.0,0.0241,0.0006,0.0036,-0.0029,-0.0113,-0.0124,-0.0119,-0.0192,-0.004,0.0093,-0.0025,-0.0032,-0.0133,0.0154,0.0022,0.0045,-0.0108,0.0006,0.0038,-0.0156,-0.0135,-0.0133,-0.0235,-0.0075,-0.0063,0.0134,economic value processing
trm_4a3fd79d0a33b,0.0373,-0.011,0.012,-0.0894,-0.0016,-0.0302,-0.0082,0.0077,0.0414,0.0051,0.0272,0.0365,0.0256,-0.0011,-0.0471,-0.0148,-0.0545,-0.1203,-0.0151,-0.0585,-0.0315,-0.0248,0.0379,-0.0222,0.0021,0.0137,0.0153,-0.0382,-0.0161,0.0475,-0.0495,-0.0498,-0.0454,0.013,-0.0671,-0.097,0.0575,-0.0265,-0.0732,-0.0864,-0.0253,-0.0343,0.0019,-0.0152,-0.0739,-0.0623,0.1072,0.0083,0.018,-0.0406,-0.0105,0.0534,0.0368,-0.0271,-0.0893,-0.0181,-0.0327,-0.0028,-0.0222,-0.0249,0.0658,-0.0219,-0.1145,-0.0326,-0.0468,0.1083,-0.1208,-0.0908,-0.0503,0.038,-0.0122,0.0407,0.0072,-0.0128,-0.0566,-0.0232,0.0328,0.0153,-0.019,0.0636,0.0343,0.009,-0.0759,0.0006,-0.0346,0.0604,-0.0445,0.0553,0.0025,0.0673,-0.0446,0.085,-0.0491,0.1775,0.1896,0.1674,0.1302,0.0884,0.123,0.0801,0.0442,-0.1021,0.0557,0.0917,0.0727,-0.0694,-0.0758,0.0975,0.0139,-0.029,-0.0262,-0.0292,0.0061,0.059,-0.0318,-0.0187,-0.0434,0.0679,-0.0164,-0.0037,-0.0944,-0.0822,-0.105,-0.033,-0.0753,-0.0664,-0.1234,0.0298,0.0595,0.0476,-0.0242,-0.0333,0.0287,-0.0246,-0.0841,-0.1272,0.0135,-0.0702,-0.0532,0.0097,-0.0369,-0.0405,-0.0088,-0.0626,-0.0977,-0.0263,0.0397,-0.0145,-0.0271,-0.0553,-0.024,-0.0765,-0.0383,-0.0734,0.0099,0.0278,0.0433,-0.0105,-0.0304,-0.0185,-0.0318,-0.0682,-0.1099,-0.0509,0.0184,-0.0455,0.0014,-0.0714,-0.0716,0.0057,-0.0041,-0.0845,0.0434,-0.0045,-0.0063,-0.0216,0.0119,-0.0189,-0.0051,0.0413,-0.0395,-0.0104,-0.0825,-0.0392,0.0767,0.0085,0.0492,0.0093,0.0006,-0.071,-0.0718,0.0109,0.0425,0.0057,0.006,-0.0648,-0.0937,-0.03,-0.0786,0.0252,0.0312,0.1772,-0.0988,-0.0347,-0.1667,0.0703,-0.0241,-0.0445,-0.0052,-0.0364,-0.0663,0.0011,0.0279,-0.0041,-0.0158,-0.0232,0.0126,-0.029,0.0558,-0.023,0.0681,-0.0342,-0.0789,-0.0555,0.0285,0.0497,-0.0977,0.0638,0.01,-0.06,0.1167,-0.0042,0.0702,-0.0411,-0.0386,0.0967,0.0064,-0.0282,0.0072,0.0032,0.0165,-0.0499,-0.0585,0.0328,-0.0247,-0.0431,-0.0542,-0.0926,-0.0162,-0.1281,0.0389,0.0022,-0.0235,-0.0026,0.0585,-0.0402,-0.0052,-0.0566,0.0721,0.0421,0.0508,0.0491,-0.0383,-0.0255,0.0098,0.0258,-0.0491,-0.0288,0.011,-0.0066,-0.0381,0.0227,-0.0304,0.0074,0.0731,0.1116,0.0924,0.0508,0.0492,0.023,0.0693,-0.0105,0.0046,-0.1302,-0.1436,-0.0231,0.0194,0.056,0.016,0.0125,-0.0454,0.0452,0.0072,-0.0326,0.0279,0.0128,-0.0376,-0.0438,-0.0716,0.009,0.0321,-0.1079,-0.0156,-0.0331,0.1093,0.1117,-0.0246,0.0032,0.0582,-0.0279,-0.0187,0.0105,-0.096,-0.0632,-0.0422,-0.0036,-0.0173,0.0175,-0.0124,-0.0756,0.0091,0.0191,-0.0691,-0.1608,0.0119,-0.0648,-0.0472,-0.0402,0.0132,-0.0247,-0.0303,-0.0102,-0.0056,-0.0217,-0.0407,0.1201,-0.0495,-0.0815,0.0436,-0.0821,-0.0761,-0.0109,0.0821,0.0723,0.0272,0.0244,-0.0075,0.0259,0.0125,-0.041,0.0682,0.1766,0.0522,0.074,0.0113,0.0148,-0.0509,-0.0274,0.0001,-0.0306,0.0073,0.0123,0.0155,0.0223,0.0617,0.0463,-0.0286,-0.0317,-0.0149,0.0345,-0.0514,0.0012,-0.0247,0.1234,-0.064,0.0446,-0.0805,0.0067,0.0207,-0.0429,-0.003,0.0861,-0.0526,-0.0438,0.001,-0.0181,-0.0643,-0.0282,-0.0261,-0.0224,0.0777,-0.0694,0.0052,-0.0689,0.1314,0.1661,0.101,0.0179,0.0028,-0.0532,-0.0725,0.0159,0.0364,0.0259,0.0049,-0.0533,0.0065,-0.0104,0.0146,0.0273,0.0081,-0.089,-0.0392,0.0322,-0.0429,-0.0679,-0.0508,-0.12,-0.1032,-0.0432,0.0027,-0.0332,-0.0266,-0.1458,-0.1462,-0.0306,-0.033,0.0847,-0.0274,-0.0034,-0.0323,0.0328,0.0066,0.0231,-0.0347,0.008,0.0331,0.0404,-0.0453,-0.0345,0.0882,0.0498,0.0287,-0.018,0.0697,0.0329,0.0494,0.1132,-0.0927,-0.2026,-0.1349,0.0125,-0.0404,-0.0412,-0.015,-0.1104,-0.0112,-0.0854,-0.1107,-0.04,-0.0224,0.018,0.0074,-0.0561,-0.0071,-0.0875,-0.0405,0.0038,-0.006,0.018,0.0216,0.0469,0.0381,-0.0242,0.0268,-0.0509,0.0521,0.0012,0.0003,-0.0225,0.0879,0.019,0.0081,0.0002,-0.0871,-0.0239,-0.0231,-0.0177,-0.1026,-0.0041,0.109,0.0276,-0.1854,-0.2052,-0.0392,0.0136,-0.0733,-0.044,-0.0355,-0.0643,-0.0563,0.0089,-0.0004,-0.0409,-0.004,-0.0489,-0.0497,-0.0157,-0.0779,0.0806,-0.0302,-0.0094,-0.0283,-0.0344,0.0527,-0.0491,-0.0104,0.0207,0.1024,0.0152,0.0034,0.0638,0.0088,-0.0501,0.0218,-0.0035,0.0096,0.1145,0.0606,0.0028,-0.0441,-0.0105,0.0074,-0.1538,0.0333,0.0065,-0.11,-0.1066,-0.0506,-0.0625,-0.0255,-0.0047,0.0609,-0.0201,-0.0694,0.0848,-0.0653,-0.0161,-0.0154,-0.05,0.0515,-0.0522,-0.0316,0.0923,0.0136,-0.0226,0.0748,0.0008,-0.0346,0.0236,-0.0587,-0.0952,-0.0767,0.0835,-0.0206,0.0546,0.0309,-0.1028,-0.0229,-0.041,-0.0416,-0.1079,0.0103,0.0358,0.1865,0.1774,0.0353,-0.0051,0.044,-0.0533,0.0423,-0.0344,-0.011,-0.0026,0.0036,-0.0354,-0.0149,-0.0668,0.0376,-0.0186,-0.0256,-0.0593,-0.0445,-0.0246,-0.0209,0.0184,-0.0974,-0.0361,0.0816,-0.0614,0.0135,0.0592,0.0645,0.055,0.038,0.1788,-0.0589,0.0322,0.0345,-0.0889,-0.0302,-0.0241,-0.0299,-0.0466,-0.0585,-0.035,0.0073,-0.0624,-0.0392,-0.1253,-0.0243,-0.0528,0.0248,0.0116,-0.0115,0.0432,-0.0359,-0.0093,0.0265,-0.0275,0.0461,0.0931,-0.0325,-0.0575,-0.1092,0.0368,-0.0345,-0.0049,-0.0252,0.0228,0.0126,0.0114,0.052,0.1184,-0.1138,-0.0159,-0.1204,-0.0038,0.0611,-0.0982,-0.1034,-0.0886,0.0686,-0.1269,0.0061,0.0438,0.1693,0.0161,-0.0091,-0.0563,-0.0767,0.1496,0.1011,0.0848,0.1303,0.0215,0.1033,-0.0659,0.0565,0.0073,-0.0068,0.0068,-0.0114,-0.0396,-0.0357,-0.0744,0.1275,-0.0291,0.0069,-0.033,-0.0387,0.0031,-0.0289,0.0312,0.1154,-0.0579,-0.0058,-0.0131,-0.0027,0.0604,0.0658,-0.0132,0.0258,0.0252,-0.0321,-0.1311,-0.0164,-0.0089,0.0134,-0.0575,-0.0643,-0.061,0.008,-0.0139,-0.0282,0.0464,-0.0457,-0.0763,-0.0359,-0.0192,0.0003,-0.1445,-0.1356,-0.0432,-0.1566,-0.0389,-0.0003,0.0125,-0.083,0.0287,0.0594,0.0182,-0.2188,-0.2063,-0.1394,-0.0308,-0.0077,-0.0405,-0.03,0.0085,0.0196,-0.0047,0.0595,0.0151,0.0147,0.0117,0.0499,-0.0253,-0.0243,-0.0558,-0.0397,-0.0126,-0.019,0.0051,-0.0498,0.0213,-0.0215,0.0404,-0.0386,0.0009,-0.018,0.1092,-0.0933,-0.1304,-0.1123,-0.0827,0.0224,0.0012,-0.0194,-0.0205,-0.0066,0.1108,0.015,0.0138,0.0342,0.0272,-0.0265,-0.0111,0.0251,-0.0228,0.0282,0.0565,0.0595,0.0225,0.0631,-0.0072,-0.0054,-0.0257,-0.0106,-0.0841,-0.0583,-0.039,-0.0939,0.0692,-0.0489,-0.0422,-0.0098,0.0011,0.0196,-0.0086,0.058,-0.0542,-0.0005,-0.0128,0.0566,0.0325,0.0142,-0.0946,-0.0448,0.0047,0.0121,0.0077,-0.0346,0.072,-0.0223,0.0032,-0.0005,0.0262,0.0103,0.1958,0.0888,0.0485,0.0564,0.0103,0.0952,-0.0195,0.1311,0.0815,-0.0486,-0.0024,-0.02,-0.0733,-0.0816,-0.0284,-0.0054,0.0387,-0.1449,-0.0423,-0.0667,-0.0381,-0.0389,-0.0029,-0.0001,0.0619,-0.06,0.0076,-0.0737,0.0485,0.0201,-0.0473,-0.0429,0.0088,0.07,-0.0185,0.034,-0.0372,0.0257,0.0548,-0.0446,0.052,0.0255,0.0384,-0.0397,-0.0141,-0.0208,-0.0162,-0.1238,-0.1728,-0.1507,0.0065,0.0293,-0.0753,-0.1034,-0.0561,0.0526,0.1212,-0.0555,-0.0262,0.0089,-0.108,-0.0704,-0.0492,0.1921,-0.0135,0.0617,-0.1344,-0.1031,-0.1156,-0.1395,-0.1352,-0.0563,0.0949,-0.0474,-0.0263,-0.0015,0.0123,-0.0187,-0.0487,-0.0627,0.0162,-0.0245,0.0081,0.0809,0.0298,-0.029,0.0321,-0.0911,-0.0498,-0.0165,0.0376,0.0096,0.0291,0.0004,0.0323,-0.0248,0.0229,0.048,-0.0034,-0.0141,-0.0995,-0.0772,-0.0504,-0.0475,0.0063,0.0435,0.0002,0.0019,0.0007,0.0091,0.0422,0.035,0.0513,-0.0508,-0.0364,0.0843,0.003,0.0234,0.1311,-0.063,-0.0127,0.0321,0.0979,0.0491,-0.0229,0.0107,-0.0041,-0.0032,0.0264,0.0274,0.027,0.0258,-0.0567,-0.0849,-0.0517,-0.003,0.0144,-0.0037,-0.0409,-0.0082,-0.0145,-0.0234,-0.0687,0.0242,0.0247,-0.0093,0.0113,-0.0175,-0.0674,-0.0031,-0.0217,-0.0386,0.0567,-0.0915,-0.0251,-0.0793,-0.0414,0.0286,-0.0008,-0.0096,-0.0551,0.0083,0.0279,0.0485,-0.03,0.0221,0.0531,0.0142,0.0053,-0.0007,0.0047,-0.021,-0.0186,-0.0302,-0.0832,-0.0935,-0.189,-0.1764,0.0673,0.055,0.0339,-0.0132,0.0021,0.0605,-0.0708,-0.0255,-0.0113,0.0599,0.0425,-0.0129,-0.0013,0.0201,-0.0329,0.0145,-0.0437,-0.0559,-0.0295,-0.0255,-0.0511,-0.0987,-0.0859,0.0102,0.0491,0.0289,-0.0323,0.0039,-0.0682,-0.0378,0.0226,-0.0256,0.0101,0.0159,-0.0191,0.0563,0.1236,0.0163,-0.072,-0.0861,0.0162,-0.066,-0.027,-0.0286,0.0453,0.1217,0.1747,-0.1644,-0.1127,-0.0856,-0.0675,-0.0345,-0.0341,-0.0871,-0.0234,0.0513,-0.013,0.059,-0.029,-0.0131,-0.0032,0.0158,-0.0047,0.0797,-0.0316,-0.0164,-0.0509,-0.025,0.0434,-0.0187,0.0333,-0.0654,0.1265,0.0391,-0.0198,-0.0088,-0.0593,-0.0097,-0.054,0.05,-0.0146,-0.1036,-0.056,-0.0303,-0.066,-0.0792,-0.0336,0.0248,0.0432,-0.0066,-0.0286,0.0331,0.0422,0.1024,0.0182,0.0195,-0.0017,-0.007,0.004,-0.0138,0.0422,0.0047,-0.0258,0.1625,0.1035,0.1733,0.1045,0.1142,0.0975,0.1948,0.0822,-0.0026,0.0298,0.0248,0.0076,0.0332,0.0059,0.0412,0.0464,0.0496,-0.061,-0.0424,-0.0246,0.0132,0.0045,-0.0038,0.1048,0.1152,-0.0116,0.074,-0.0596,-0.0655,0.0328,-0.0455,-0.0818,-0.0115,0.0481,0.0565,0.0614,0.073,-0.0566,-0.1215,0.0032,-0.0015,0.0014,0.0068,0.005,0.1176,-0.0204,-0.0549,-0.0363,-0.0192,0.019,0.0531,0.149,0.1292,-0.0367,0.0637,0.0919,0.2331,0.1959,0.1939,0.0862,0.0558,-0.0453,0.0153,0.0028,0.0493,-0.1078,0.0034,-0.0128,0.0952,0.0254,-0.0426,0.0145,-0.0446,-0.0195,0.0117,0.0424,0.0546,0.1667,0.0219,0.019,-0.0142,-0.1005,-0.0002,0.1049,0.0666,-0.0099,0.0046,-0.0879,-0.0565,0.0769,0.0065,-0.0543,0.0034,-0.0453,-0.0587,-0.027,0.0404,0.1087,-0.0385,-0.0569,-0.0838,-0.0264,0.0235,-0.0528,-0.0394,-0.017,0.0425,-0.0316,-0.0643,-0.0793,-0.0452,-0.1116,-0.0038,0.0304,-0.0713,-0.0097,-0.168,0.0214,0.0854,-0.1121,-0.0589,0.0861,-0.0302,0.0536,0.0227,-0.0223,-0.0539,-0.0674,-0.0328,-0.007,0.018,0.0249,0.0371,0.0388,0.02,-0.0652,-0.0217,-0.0309,-0.0494,-0.1025,-0.0137,0.1094,0.0912,-0.0958,-0.0476,-0.0352,0.0221,-0.0762,0.0073,-0.0142,0.0103,0.0113,0.0783,-0.1026,-0.0798,-0.0452,0.1458,0.0028,-0.089,0.028,0.028,-0.0319,-0.0491,-0.0239,-0.0085,0.0047,-0.0458,-0.0884,0.2092,-0.0595,-0.0738,-0.0285,-0.0336,-0.0213,-0.0394,-0.0656,0.0114,0.021,-0.0879,0.0086,0.0206,0.1558,0.005,-0.0036,0.0041,-0.0175,0.017,0.0202,0.0304,0.0224,-0.0863,-0.0713,-0.0811,-0.0743,-0.085,0.0898,0.0336,0.0041,0.2141,0.1971,0.1716,-0.0259,0.1831,0.0108,0.032,-0.0195,-0.0612,0.0486,-0.0753,-0.055,-0.047,-0.0404,-0.1226,0.0866,0.0234,-0.0435,0.0127,0.0643,-0.0036,0.0118,0.0622,-0.0035,0.0142,-0.0192,0.0045,0.0119,0.0619,0.1401,0.1289,0.101,0.0458,0.0554,-0.0114,0.0432,0.0401,-0.0072,-0.0319,-0.0211,-0.0755,0.0189,0.0084,-0.0017,-0.0282,-0.0137,-0.0765,-0.01,0.0297,0.0854,-0.0005,-0.0416,0.0133,-0.0275,-0.0397,-0.0766,-0.0799,-0.0502,-0.0066,-0.1001,-0.1002,-0.0363,-0.027,0.1365,0.1026,-0.0078,-0.0248,-0.042,0.042,-0.0043,-0.0552,0.0552,0.0304,0.0999,-0.224,0.0088,0.0611,0.0013,-0.0524,0.0051,-0.0108,-0.0011,-0.006,0.0649,0.0954,-0.0667,0.0904,0.0257,0.1027,0.1231,0.0667,0.0009,0.0718,0.0484,0.105,0.0018,0.0508,-0.0375,-0.046,-0.1189,-0.0712,-0.1062,-0.0006,-0.027,-0.0106,-0.0463,0.0018,-0.0482,-0.013,-0.0745,0.0067,-0.0088,-0.0377,0.0315,-0.0093,-0.0019,-0.0238,-0.0523,-0.071,0.0113,0.0103,-0.0543,-0.0204,0.033,0.0036,0.0625,-0.0306,-0.0464,-0.0518,0.0317,0.0427,-0.1742,-0.2381,0.0526,0.1301,0.1951,0.0176,-0.0442,-0.0327,0.043,0.032,-0.0011,-0.0326,-0.0772,0.0233,-0.0895,0.0153,0.05,-0.0255,0.0426,-0.0309,-0.0145,-0.0908,-0.1189,0.03,-0.0035,-0.0261,-0.017,0.0477,-0.064,0.0099,0.0486,-0.0142,0.021,0.0274,0.0393,-0.0251,-0.0283,-0.0499,-0.0156,-0.0502,0.0035,-0.0205,0.0584,0.0582,0.2097,0.1611,-0.0358,-0.046,-0.0232,0.0214,-0.0044,-0.0263,0.035,0.0069,0.0585,0.018,0.0128,-0.0123,0.0574,0.0394,-0.0385,0.0942,-0.0304,-0.0085,-0.0493,-0.0019,0.0074,0.0312,-0.0687,-0.0955,-0.0505,-0.0656,0.0298,0.0029,0.0024,-0.0053,0.0043,0.0933,0.0375,0.0131,-0.0686,0.0671,-0.0486,0.0063,-0.0431,0.0374,0.0149,-0.0319,0.0797,0.0948,0.0679,-0.0137,-0.0041,-0.0509,0.1224,0.1099,-0.1496,-0.1327,-0.0064,-0.02,0.0521,0.0113,-0.034,-0.0011,-0.0228,-0.0151,0.0494,-0.0103,0.1103,-0.1115,0.0529,0.0453,-0.0167,0.0572,0.0869,0.1598,-0.0598,0.0323,0.0807,-0.0152,0.0198,-0.0054,-0.025,-0.1224,-0.1217,0.0212,0.0065,-0.068,0.0128,-0.1193,-0.0246,-0.1306,-0.0565,-0.0816,0.0627,-0.0755,-0.0139,-0.0718,-0.0504,-0.0816,-0.0021,0.0431,-0.0329,-0.0378,0.0426,0.0418,0.0162,-0.0438,-0.0259,-0.0039,-0.022,-0.0784,0.0052,-0.0194,-0.0122,0.0062,0.1035,0.0283,-0.0496,-0.0054,-0.0269,-0.0622,0.1452,-0.0349,-0.1525,-0.1403,-0.024,0.0379,0.0291,0.0559,-0.0043,0.0172,0.0221,0.0023,-0.0166,0.0126,-0.017,0.0403,-0.0074,0.0276,0.0357,0.0595,-0.016,0.0334,-0.0057,-0.0125,0.0027,-0.0331,-0.014,0.009,-0.0747,0.039,-0.0037,-0.0009,0.0794,0.1484,-0.0179,-0.0669,0.046,0.0011,-0.0051,0.0084,-0.0162,-0.044,-0.0474,0.0099,-0.0463,-0.0411,0.0131,0.0145,-0.0115,0.0324,0.0347,0.0433,-0.0,-0.0047,-0.0241,-0.0199,-0.0266,-0.0487,-0.0326,0.0829,0.0274,0.1064,-0.0348,0.0179,0.0982,0.0572,0.1556,0.0602,0.0352,-0.0187,-0.0004,-0.0667,0.0301,0.0201,0.0118,-0.0176,-0.0682,-0.0767,-0.0938,-0.0347,0.0405,-0.036,0.1457,-0.0597,0.0799,0.0777,0.072,0.0173,-0.0165,-0.0014,0.0273,0.0086,-0.041,0.0424,-0.0466,-0.0217,-0.1154,-0.0691,-0.0827,0.0002,-0.1223,-0.1348,-0.0425,-0.012,-0.0225,-0.0524,0.006,-0.0516,0.0282,-0.0257,-0.0325,0.0924,0.0502,-0.027,0.0334,-0.0025,-0.0529,0.0683,-0.0508,-0.0368,-0.0419,-0.0235,-0.0403,-0.0261,-0.0778,-0.0402,-0.0557,0.0284,-0.0552,-0.0317,-0.0453,-0.0454,-0.0327,0.0289,0.0509,-0.0685,-0.0711,-0.0394,-0.0345,-0.0575,0.011,0.0319,-0.0499,-0.0205,0.0333,-0.0316,-0.0105,-0.0287,0.0133,0.0161,0.0212,-0.1973,-0.105,-0.0914,-0.0339,-0.1741,-0.0076,-0.0714,0.0596,-0.0315,-0.0313,-0.0066,0.0207,-0.0993,0.0067,-0.113,-0.1948,-0.0373,-0.0265,-0.0883,-0.0187,-0.2031,-0.153,-0.0447,-0.0377,0.0164,-0.0072,-0.0547,0.0634,-0.0683,-0.0835,-0.0939,0.0259,-0.0092,-0.0607,-0.0562,-0.041,-0.0596,-0.0328,-0.0883,-0.0681,-0.0911,-0.0206,-0.0975,-0.0253,0.0022,0.0038,-0.0817,-0.023,-0.1459,-0.0349,0.0097,0.0093,-0.0048,-0.1064,-0.0405,-0.0967,0.0035,-0.1251,-0.1208,-0.0331,0.1915,0.1578,-0.0561,-0.0089,-0.0294,0.1017,0.0582,0.0903,-0.19,-0.1779,-0.0186,0.0002,0.0027,0.0008,-0.0301,0.0349,0.0056,-0.0358,-0.0385,-0.0297,0.0589,-0.0103,-0.0204,-0.001,-0.0485,-0.0145,0.0327,-0.0913,0.1913,0.147,0.0221,-0.0528,-0.0685,-0.028,-0.0349,-0.0605,-0.0484,0.2264,-0.0041,-0.0294,0.2154,0.1395,0.1797,0.1575,0.1332,0.16,0.0959,0.0804,0.0588,0.0473,0.1183,0.1442,0.2271,0.2577,0.2242,-0.1371,0.0817,0.0749,0.2192,0.0264,-0.0538,0.0458,0.0014,-0.0097,0.1253,0.1627,-0.0329,0.0533,0.1098,0.066,0.036,0.0786,-0.0069,-0.0559,0.0576,0.0312,0.0405,0.0382,-0.0675,-0.0781,0.0438,-0.0162,-0.0811,0.0155,0.0286,-0.1309,-0.042,-0.1183,-0.0579,-0.0368,-0.071,-0.0697,-0.0501,-0.0532,-0.0622,0.0177,0.0414,-0.0561,-0.1277,-0.1598,0.0702,-0.141,-0.0141,-0.0131,-0.047,0.0991,-0.0421,-0.0437,-0.0916,0.0219,-0.0843,0.0377,0.0136,0.137,0.1123,0.1055,0.0646,-0.0361,-0.0337,-0.074,0.0221,0.003,0.0168,-0.0197,-0.0037,-0.0342,-0.0797,0.0204,-0.0079,-0.0194,0.0016,0.0798,0.0367,-0.0265,-0.079,0.0393,0.0143,0.0067,-0.0563,-0.0081,0.0225,-0.0325,-0.0007,-0.0566,0.0446,0.0021,0.0385,-0.0069,0.0012,0.0275,0.0317,0.0398,0.0283,0.1316,0.067,-0.0572,-0.0566,0.1047,0.2169,0.0215,0.1391,0.0658,0.1496,-0.0652,-0.0654,-0.0159,-0.0372,0.0765,0.0859,0.0217,-0.0272,-0.0202,0.0471,0.1244,0.1193,0.1401,0.0004,0.001,-0.0015,0.055,0.0633,0.0271,-0.0273,-0.0529,-0.0403,-0.1266,-0.0765,-0.0704,-0.0244,-0.0359,-0.0059,0.0289,-0.0151,0.0126,-0.0235,0.1182,0.0979,0.0931,0.0191,-0.0232,-0.0035,-0.022,-0.0062,-0.1006,0.0469,-0.023,-0.0401,-0.0265,0.0369,0.0416,-0.0342,0.0594,0.0041,0.0282,0.0348,-0.012,0.0687,-0.0332,-0.0791,-0.1224,0.1164,-0.0622,-0.0471,0.0416,0.0827,0.1018,0.1041,0.0038,0.012,-0.0442,-0.0372,0.1713,0.0311,0.0164,0.0061,-0.061,-0.0517,0.028,-0.0144,-0.0308,-0.0167,-0.0732,-0.0404,-0.0785,-0.0164,-0.0093,0.0347,0.0082,0.0239,0.0075,-0.0041,0.0257,0.0472,0.0373,0.0084,0.0713,-0.1003,0.0326,-0.0132,0.0472,0.1165,-0.0211,0.0185,-0.0008,-0.0126,0.0686,0.0015,-0.0204,-0.032,0.0773,0.0979,-0.0393,0.037,-0.0305,-0.0119,0.0218,0.011,0.0396,-0.0074,0.1423,0.1085,0.0814,0.1041,-0.1351,-0.0641,-0.0243,-0.0466,-0.1065,0.1037,0.0434,-0.0252,-0.0239,0.0473,0.0235,-0.1103,-0.0349,0.0564,-0.0512,0.0608,0.0645,0.0725,0.0947,0.225,0.1032,0.1054,-0.05,-0.0481,-0.0328,0.0751,-0.0172,0.0047,0.0115,-0.0247,-0.0101,0.0549,0.0297,-0.0181,-0.0516,-0.0954,-0.0881,-0.0348,-0.0751,-0.0358,0.0206,-0.1659,-0.0357,0.0225,0.0269,-0.007,0.0424,0.0598,0.072,0.0026,0.0795,0.0341,0.0051,-0.0175,0.0471,-0.0119,-0.0479,-0.0287,0.0184,0.1323,0.1328,0.0246,-0.0482,0.0108,-0.0145,-0.0067,0.0212,-0.0362,0.0132,-0.0208,0.0301,0.0639,0.0203,0.016,-0.05,-0.0634,-0.0732,-0.0702,-0.0687,-0.0522,-0.0256,-0.0573,-0.0216,0.1096,0.0091,0.0653,-0.1083,-0.0387,-0.048,-0.1128,-0.0618,-0.0472,0.0285,0.0285,-0.0275,0.0098,0.0466,-0.0497,-0.0012,0.0353,0.0004,-0.0142,-0.0039,-0.2115,0.049,0.025,-0.0663,0.0206,0.0546,0.1228,0.0382,-0.1075,-0.0477,0.0078,-0.0255,-0.0616,0.0658,0.042,0.0965,0.1233,0.0697,-0.0164,0.0236,0.1304,0.0707,0.0301,-0.1997,-0.1435,0.0039,-0.0703,0.0021,0.0261,-0.0137,0.0522,0.0072,0.0132,0.0457,0.0054,-0.0485,0.0234,0.0301,-0.2469,-0.1023,-0.2535,-0.0674,-0.0648,-0.0628,-0.0474,0.2557,0.2657,0.1421,0.1102,0.0373,0.0707,0.0299,-0.0106,0.0718,0.0497,-0.0177,0.0426,0.0058,0.0244,-0.0727,0.0131,0.0538,-0.0587,-0.002,-0.029,-0.0169,0.1636,0.049,0.1512,0.0779,0.1212,0.0625,0.0969,0.0933,0.0856,-0.0327,-0.0419,-0.032,0.0851,-0.0407,-0.0378,-0.0625,-0.0315,0.0242,-0.0343,-0.0474,-0.0502,-0.0065,-0.0408,-0.0431,0.0435,-0.0986,-0.0396,0.0419,0.0049,0.0848,0.0222,-0.0035,0.0903,0.0477,0.0054,-0.0085,-0.0054,0.0324,0.015,0.0345,-0.0289,0.0874,0.081,0.0894,0.0065,-0.0389,0.0635,-0.0041,-0.0317,-0.0022,-0.039,-0.0606,0.0206,-0.0217,0.0014,-0.082,-0.0128,0.0905,0.0895,-0.0845,-0.0766,-0.1099,-0.0971,0.064,0.014,-0.0116,-0.1264,-0.0452,-0.0456,0.0267,-0.0423,0.051,-0.0167,0.1212,0.0407,-0.0258,-0.011,-0.0029,-0.0225,-0.0853,-0.0538,0.0735,0.0807,-0.0293,-0.0228,0.0378,-0.0318,0.0659,0.0361,0.0378,-0.0499,0.0405,-0.0264,0.0263,-0.0424,-0.0198,0.0619,-0.052,0.0704,0.109,0.0164,0.0195,0.0265,-0.0133,-0.0151,-0.0818,-0.0175,0.0223,-0.0061,0.0736,-0.0597,-0.077,-0.06,-0.1705,-0.0951,-0.0172,-0.0387,-0.0161,-0.05,-0.0619,-0.0732,-0.1278,-0.0665,0.027,-0.0133,-0.0075,-0.1787,-0.0152,0.0272,0.0943,0.0019,-0.0171,0.0042,0.0291,-0.0187,-0.0343,-0.0337,-0.0392,-0.0198,-0.0688,-0.1171,-0.0051,0.0002,-0.0921,-0.0547,0.0187,0.0201,-0.0383,-0.0741,0.0517,-0.048,0.0436,-0.0577,-0.1018,0.0721,-0.0363,-0.0056,-0.1084,-0.0167,0.0452,0.103,-0.1007,-0.0095,-0.061,0.0458,-0.0714,-0.0582,-0.0888,-0.0908,-0.0484,-0.0282,-0.0381,-0.0273,-0.0027,0.0193,0.0221,0.0452,0.0196,0.0075,0.0315,-0.0006,-0.0401,-0.0351,0.0219,-0.0879,-0.0472,-0.107,-0.0438,0.0892,-0.0272,0.0617,0.0095,0.061,0.0625,0.1196,-0.0453,-0.0347,-0.1241,0.0387,-0.0208,0.1123,0.1084,0.0504,0.0086,-0.0132,0.009,-0.0047,0.0502,0.0251,-0.0407,-0.1059,-0.0256,0.0003,0.0684,-0.0236,-0.056,0.0815,0.0416,0.0183,-0.0078,0.0347,-0.0089,0.0206,-0.0165,-0.0058,0.0331,0.0358,-0.0139,-0.0863,0.0553,0.0676,-0.0183,0.0957,0.0651,-0.0318,0.0895,-0.0069,-0.0084,0.0374,-0.0046,0.0628,0.0117,-0.0532,-0.2052,-0.2251,0.0812,0.0435,0.0798,0.0164,-0.0223,-0.2041,-0.1191,-0.1171,-0.1119,0.0002,0.0271,0.0162,-0.0643,0.027,0.0226,-0.0278,0.0268,0.0026,-0.0624,0.1238,-0.0337,0.0126,-0.1452,-0.0685,-0.0353,0.0502,-0.0425,-0.0067,-0.0386,0.0298,-0.0276,0.0711,-0.1161,0.0225,-0.0764,-0.065,0.0587,0.0997,0.1082,0.0934,0.102,-0.06,-0.1211,-0.1316,0.0035,-0.1034,-0.0367,0.018,-0.0942,-0.0519,-0.0371,-0.0703,0.0413,-0.0591,0.0064,0.0012,-0.0486,0.0164,0.0142,-0.1644,-0.0484,0.0951,-0.0315,-0.08,0.0457,0.0509,-0.0024,0.0221,-0.0099,0.0262,0.1303,0.1059,-0.0579,-0.1298,-0.0471,-0.0282,0.0529,0.0386,0.0127,-0.0756,-0.0263,-0.0359,0.0904,0.0477,-0.0012,0.083,-0.0886,-0.1184,-0.0676,-0.1043,-0.0541,-0.0766,-0.0832,-0.0824,-0.0045,0.0527,0.0053,-0.0142,0.0581,-0.0345,0.1685,0.1471,0.1481,0.0684,0.0309,0.0955,-0.0715,-0.0661,-0.0205,0.0563,0.0638,0.0207,0.0063,0.0354,0.1482,0.1001,0.1496,0.0391,-0.0092,-0.0374,-0.0298,0.0832,0.0021,-0.0102,0.0068,-0.0893,-0.0911,0.012,0.0204,-0.0136,-0.0246,-0.0499,-0.0229,0.0006,-0.0353,0.0502,-0.0053,0.065,0.035,0.045,0.0428,0.0364,0.0085,0.0541,-0.0838,0.0711,0.0625,0.0613,0.0404,0.0336,-0.0005,0.0303,0.1185,0.0657,0.0555,0.0977,0.0412,0.0372,0.0283,-0.0589,0.0331,0.0792,-0.0065,-0.0357,0.065,0.1322,0.0828,-0.0886,0.0302,-0.0265,0.1236,0.0065,-0.0885,0.0127,0.08,0.0149,0.064,0.0662,0.1038,0.0105,0.0238,0.1521,-0.1145,-0.0921,0.0115,0.064,0.0431,0.0761,0.0394,0.0156,-0.0297,-0.0106,0.0379,0.1867,0.0353,0.003,-0.0582,-0.0365,-0.0821,-0.0241,-0.064,-0.0089,-0.0362,0.0107,-0.0136,-0.1112,0.1219,0.1209,0.085,-0.096,0.0738,0.0782,-0.0287,-0.0084,0.028,-0.0147,0.0442,0.0385,0.1226,0.0249,-0.0097,-0.0018,0.0036,0.039,-0.0048,0.0375,-0.0257,0.0908,0.0789,0.0131,-0.045,0.0385,0.0321,0.032,-0.0115,-0.0216,0.0264,0.0714,0.0592,0.0697,-0.0066,0.0021,-0.0497,0.0737,0.103,0.0743,-0.1363,-0.1355,-0.0032,0.0484,-0.0189,0.005,-0.2046,-0.1873,-0.1104,-0.0647,0.2352,0.0117,-0.089,0.0376,0.0753,0.1157,0.112,0.0548,0.1406,0.0893,0.1604,0.0119,0.0092,-0.0413,-0.0462,-0.0085,-0.0434,-0.1129,-0.0411,-0.0582,0.1368,0.0816,-0.0151,-0.047,-0.0339,0.0071,-0.004,-0.0607,0.0888,0.014,0.0194,0.037,-0.0274,-0.0156,-0.0117,0.0112,0.0115,0.0385,-0.046,0.0129,0.0058,0.1451,-0.038,-0.0523,-0.015,0.0921,0.031,-0.0064,0.0756,-0.0382,0.0297,-0.0468,-0.0452,-0.0415,-0.0134,-0.0177,-0.055,0.0116,-0.0684,-0.0007,-0.0088,0.0999,0.0155,-0.0255,0.0035,0.0147,-0.1091,-0.0934,0.0297,0.0776,0.0523,-0.0271,-0.0743,-0.0068,-0.0522,-0.0176,0.0791,0.1693,0.0864,0.0985,0.1505,-0.0263,0.1241,-0.0629,0.1108,0.0441,0.0761,0.1176,0.182,0.1701,0.0146,-0.0218,0.0219,-0.0218,0.0135,0.1343,0.1302,0.0718,0.0075,0.0131,-0.0131,0.0409,-0.0141,-0.0359,-0.0495,-0.0494,-0.0848,0.0076,0.0136,-0.0369,-0.0408,-0.052,0.0245,0.0071,0.009,-0.0022,0.1741,0.0086,-0.0785,0.2072,0.0747,0.0505,-0.0116,0.0471,-0.0273,0.0613,0.0227,-0.0246,0.0058,-0.0276,0.0505,-0.0183,-0.0429,0.0446,-0.0541,-0.0418,-0.0174,0.0607,0.04,0.0193,-0.0255,0.0194,0.049,0.0623,-0.0239,0.0153,0.0893,0.0381,0.0502,-0.0452,-0.027,0.0345,-0.0587,-0.036,0.0997,0.1328,-0.0811,-0.0167,-0.0633,-0.0571,-0.0729,-0.0331,-0.0787,0.0037,0.0155,-0.0126,-0.0141,-0.0268,0.0241,-0.1056,0.0291,-0.031,-0.0196,-0.0127,0.0379,-0.0939,-0.0394,-0.134,-0.1212,-0.0247,-0.0075,-0.0539,-0.1238,0.032,-0.0592,-0.0583,-0.1524,-0.0017,-0.0213,0.0637,0.0107,0.0593,-0.0425,0.0169,-0.0145,0.066,0.0093,0.1814,-0.0229,0.104,-0.1204,0.0226,0.0249,0.034,0.0452,-0.0417,0.0728,0.0945,0.0104,-0.0048,0.123,-0.0787,-0.0409,0.0946,0.0418,0.0136,0.0222,0.0144,0.0253,0.0652,0.0944,-0.1166,-0.0611,0.0522,0.0765,0.0166,0.1311,0.0247,-0.0006,-0.0217,-0.0445,0.0179,-0.0532,-0.0784,-0.0361,-0.0658,-0.0163,-0.0224,-0.0453,0.0414,0.112,-0.0668,0.0527,-0.0385,0.0061,0.0127,-0.0215,-0.0212,0.0013,-0.022,-0.0145,-0.0827,-0.0748,-0.0204,-0.0284,-0.0598,-0.0364,-0.0136,-0.0115,-0.0474,0.0155,-0.0107,-0.0275,0.0129,0.053,0.0682,0.0645,0.0035,-0.0365,-0.0397,0.0363,-0.0306,-0.0089,0.0283,-0.0493,0.0885,-0.0387,0.116,-0.0516,0.0297,-0.0881,-0.0457,0.0745,-0.0063,0.0292,0.089,-0.1054,-0.0391,0.0278,-0.0234,-0.0061,-0.0054,0.0777,0.2693,-0.0313,0.0055,0.0018,0.018,0.0536,-0.0719,-0.0609,-0.0128,0.0214,-0.04,-0.0441,-0.0098,-0.0657,-0.0687,0.0269,0.0559,0.0298,-0.0134,0.0453,-0.0119,-0.047,-0.0255,0.0883,-0.0496,-0.0065,-0.0671,0.2719,-0.0348,0.0323,-0.081,-0.0871,-0.101,-0.0921,0.013,-0.0194,-0.0303,0.0338,0.0332,0.1148,-0.0667,-0.0479,0.0852,0.1267,0.1054,0.0844,-0.0009,0.0948,0.1237,-0.0062,-0.0614,0.0928,0.1746,0.0496,0.0626,0.1009,0.0755,0.0134,0.1053,0.1334,0.2089,0.1299,0.0278,0.0862,0.0452,0.1036,0.0247,0.1877,0.0295,0.1378,0.1411,0.0793,-0.0574,-0.0749,-0.0866,0.0746,-0.0046,-0.0454,-0.0607,-0.0391,0.1154,0.1162,-0.0787,-0.0658,-0.0528,0.0569,-0.0534,-0.081,0.1081,-0.0061,-0.0537,-0.0322,-0.0252,0.0005,-0.0293,0.0082,0.0271,0.0149,-0.0158,-0.0046,0.0209,0.0146,0.0045,-0.0273,-0.0247,-0.0522,-0.0401,-0.0567,0.0091,-0.0552,0.014,-0.142,0.0115,-0.0659,-0.0495,-0.0542,-0.0538,-0.0665,-0.0992,0.0201,-0.0294,-0.0329,-0.0606,-0.0012,0.0887,-0.0847,-0.0635,-0.0223,-0.0804,-0.0823,0.0359,feedback processing
trm_4a3fd79d0a7bb,0.0227,0.0785,-0.0041,0.0633,-0.0507,-0.012,0.003,0.0298,0.0264,0.0401,-0.0141,-0.0525,0.05,0.0168,0.0555,0.0811,0.044,0.0241,0.0132,0.0014,0.0039,-0.0502,0.0001,-0.0108,0.005,-0.0213,-0.019,0.0478,0.0689,0.0398,0.0431,0.0183,0.0734,0.0143,0.076,0.0411,-0.0122,-0.0024,0.0702,0.0114,0.0673,0.1225,0.0489,-0.0588,0.0493,0.0363,-0.1308,0.0656,-0.0246,0.0389,0.0292,0.0004,-0.0481,-0.0199,0.013,0.0151,0.0539,-0.0136,-0.0388,0.0285,-0.0279,-0.062,0.0847,-0.0438,-0.004,-0.0071,0.0783,0.0827,0.0741,-0.0307,-0.0395,-0.0604,-0.0693,0.0364,0.0739,-0.0013,0.0918,-0.0733,-0.0138,0.0285,-0.0283,-0.0714,0.0394,0.1005,-0.0173,-0.0213,0.0311,-0.0002,-0.0226,0.1664,0.0585,0.0134,-0.0021,-0.0341,-0.0462,-0.0348,-0.0447,0.0002,-0.1057,-0.0014,-0.0099,-0.0369,-0.0406,-0.0029,-0.0163,0.0501,0.1152,-0.0441,0.0349,0.0501,-0.0147,0.0544,-0.0597,-0.0543,-0.0077,0.0109,0.007,0.0046,-0.0092,0.0183,0.0186,0.0909,0.0218,-0.0083,0.0691,0.0507,0.0563,-0.0183,-0.0652,-0.0404,0.0162,0.03,0.0192,0.0845,0.0077,0.0666,-0.0,0.0333,0.034,0.0092,0.0456,0.0438,-0.0265,-0.0333,0.0345,0.0125,-0.0028,-0.0388,0.0562,-0.0466,0.0503,0.0135,0.0578,0.0836,-0.0639,0.0019,-0.0537,-0.0279,-0.0517,-0.0396,0.0712,0.0175,0.0567,0.0965,-0.0074,0.0176,-0.0331,0.1142,0.1074,-0.0057,-0.0347,0.0292,-0.0757,0.0548,0.0372,0.0939,0.0553,0.0148,0.0175,-0.0093,0.121,-0.0724,-0.0039,-0.0034,0.0152,-0.0264,0.0506,-0.0071,-0.0045,0.0585,0.0655,0.0137,0.038,0.0498,0.0397,0.1447,0.0977,0.0234,0.0144,0.1046,0.009,-0.0918,0.0513,0.0982,-0.0264,0.0753,0.056,0.0077,0.0467,-0.011,0.0509,0.0278,0.0392,-0.0673,-0.0204,-0.0308,-0.0856,0.0512,0.057,-0.0278,-0.0511,0.0374,0.0465,0.018,-0.0132,-0.0422,0.0825,-0.0412,-0.0063,-0.0557,0.0421,0.0453,-0.1106,0.0458,0.0443,0.0248,0.0091,-0.0198,-0.007,0.0489,-0.0161,0.0783,0.0436,0.0155,0.0173,0.0574,0.0448,0.0913,0.0715,0.0322,-0.0076,-0.015,0.0518,-0.0027,-0.0082,0.0848,0.0185,0.0808,-0.0384,-0.1706,-0.0339,-0.1196,0.0277,-0.0484,-0.0998,-0.1381,-0.0414,-0.004,-0.0134,0.0165,0.0555,0.0177,0.0769,-0.0373,0.0809,-0.0068,0.1064,0.0982,0.1174,0.0186,0.003,0.0067,-0.0023,0.0804,0.0829,0.0545,0.0178,-0.0178,0.0613,0.0264,0.0285,0.022,-0.0305,0.0468,0.052,-0.0046,-0.0269,-0.0172,0.0036,-0.0352,-0.019,0.0172,0.0704,-0.0031,0.0349,0.0325,0.0411,-0.0045,0.0275,0.0077,0.0078,0.0183,0.0897,-0.0207,-0.0232,0.0826,-0.0338,-0.0098,-0.0394,0.0809,0.0016,-0.0611,0.0548,0.0604,0.0385,0.0565,0.0238,0.0915,0.0306,0.0477,0.0078,0.0029,-0.0528,-0.0492,-0.0455,-0.0259,-0.0227,-0.0005,0.0022,0.0428,0.0323,-0.094,-0.0085,-0.0167,-0.0169,-0.0141,0.0947,0.0754,0.0541,0.0582,0.0508,-0.0205,0.0413,0.0288,0.0445,0.0353,-0.0043,0.0681,0.0454,0.071,-0.0274,0.031,0.0313,-0.0473,-0.0095,-0.0408,0.048,-0.0349,-0.0113,0.0465,-0.0049,-0.0596,0.0315,-0.085,0.092,0.0775,0.0789,-0.0564,-0.077,-0.0515,-0.1157,-0.0151,0.066,0.0176,0.0008,0.0008,0.0379,-0.0164,-0.0435,-0.0162,0.001,0.0247,0.0106,0.0283,-0.1061,-0.0698,0.0397,0.066,0.0505,0.0267,0.022,-0.0223,0.0122,0.0035,-0.0518,-0.0363,-0.0138,0.0035,-0.0011,0.0195,0.0225,0.0831,0.0108,-0.0517,0.0166,0.0142,-0.0915,-0.0011,0.0695,0.0087,-0.0106,0.0903,0.0607,0.19,0.1587,0.0849,0.086,0.0277,0.0802,0.0811,0.0013,-0.0029,-0.0031,0.0317,-0.0377,-0.0736,0.0598,0.004,0.1046,0.0815,0.0017,-0.0014,-0.013,-0.0076,-0.0364,-0.0052,0.01,-0.023,0.0524,0.0397,0.0123,-0.0028,0.0735,0.0438,-0.0223,0.0728,-0.0022,0.0586,0.0531,-0.015,-0.063,0.0669,-0.0039,-0.0261,0.0682,0.1056,0.0032,-0.1811,0.0774,0.0361,-0.0038,-0.0774,-0.0083,0.0337,0.0596,0.0449,-0.0006,0.0045,-0.0147,0.0119,0.0074,0.0064,0.0656,0.0023,-0.0691,-0.067,0.0131,-0.0193,0.0403,0.0328,-0.0269,-0.0459,0.0553,0.0673,-0.0555,-0.0165,0.1022,-0.025,-0.0305,0.0441,0.0465,0.0375,0.0315,0.069,0.0599,0.0581,0.0281,0.0281,0.0105,-0.0459,0.0734,0.0064,0.0103,-0.0207,-0.0828,-0.0098,0.0249,-0.0043,-0.0393,0.0215,0.0221,0.0364,-0.0604,-0.0347,-0.0794,-0.0502,-0.0481,-0.0245,-0.0225,-0.007,0.0406,0.0189,0.0258,0.105,-0.0122,0.0367,0.0803,0.0698,0.0145,0.0241,0.0189,-0.0385,0.0131,0.0245,0.0128,-0.0023,0.0042,-0.0054,-0.0021,-0.0334,-0.057,0.0203,0.0372,0.0487,0.0113,0.0947,-0.0766,-0.0198,-0.0565,0.0383,0.038,0.0045,0.0709,-0.0221,0.0794,0.0083,-0.0579,0.0021,-0.0045,0.0188,0.0256,-0.0066,0.0182,-0.0347,-0.0414,-0.0411,-0.0245,0.0292,-0.0372,-0.027,0.0302,0.0541,0.0236,0.0318,-0.0596,-0.0203,0.007,-0.0141,-0.0213,-0.0064,0.0339,0.0253,-0.0182,-0.0195,0.0413,0.0145,0.0777,-0.0218,-0.0626,0.0156,0.044,-0.0511,-0.0661,-0.0423,-0.0334,-0.0338,0.0305,0.0386,0.0465,-0.0252,0.0244,0.0442,-0.0254,0.0389,0.116,0.0254,0.0341,-0.0262,0.0014,0.0937,0.0315,0.1074,-0.0025,-0.0151,-0.0203,-0.0306,0.044,0.0505,0.0649,-0.0084,-0.0206,-0.0386,0.0828,-0.0141,0.0123,-0.0005,-0.0376,0.0458,-0.0103,0.07,0.0591,-0.074,0.0132,0.031,0.0365,0.0149,0.0443,0.0559,-0.0542,0.0697,-0.0264,0.0753,-0.0409,0.0752,-0.0142,0.0431,-0.0302,0.0364,0.0152,0.0767,0.0724,-0.0293,-0.1171,0.0187,-0.0069,-0.0109,0.0713,0.0354,0.0467,-0.0044,0.0095,0.0149,0.0338,0.0751,0.0482,0.0323,-0.0723,0.0351,-0.029,0.0128,-0.0104,-0.0136,-0.0007,-0.0151,-0.0883,0.0929,0.0355,0.0262,-0.0002,0.0113,-0.0879,-0.0479,-0.0505,-0.01,-0.1295,0.0158,-0.0331,0.0239,0.0539,-0.0099,-0.0171,-0.0082,0.0185,0.0322,0.0377,0.0461,0.0921,0.0893,0.0523,-0.0323,-0.045,-0.024,-0.013,-0.0113,-0.0377,-0.0016,0.0034,-0.0151,0.0069,-0.0213,-0.0807,0.004,0.1226,0.1231,0.0859,0.0266,0.0387,0.0274,0.0084,0.0589,-0.1043,-0.0289,0.0292,-0.0521,-0.039,0.0224,0.0447,-0.0968,-0.0421,-0.0692,0.0697,0.0204,0.0575,0.0187,-0.0212,0.0355,-0.0426,0.0235,-0.0087,-0.0253,-0.0195,-0.0809,0.0368,0.0707,0.0675,0.037,-0.0127,-0.129,-0.0352,0.0745,0.0371,-0.0355,-0.0101,-0.061,-0.0074,-0.0193,0.0219,0.0483,0.023,-0.0411,-0.048,-0.0777,0.0067,-0.0172,-0.0331,0.0387,-0.0351,0.0115,0.0404,0.0341,0.0743,0.0531,0.0231,-0.0056,-0.0379,0.0009,0.0046,-0.0289,0.0037,-0.0611,0.0112,0.0608,-0.0692,0.0073,0.0005,-0.0316,-0.0242,0.0804,-0.0277,0.0488,0.0476,-0.07,-0.0637,-0.13,0.0287,-0.0234,-0.0045,0.0353,0.0165,-0.1748,-0.0369,-0.0324,-0.0813,-0.1328,-0.0028,-0.0032,-0.1115,-0.1371,0.0581,-0.005,-0.0045,0.1282,0.1019,0.0507,0.0219,-0.0535,0.0798,-0.0038,0.0489,0.035,0.0716,-0.0177,-0.031,-0.0835,0.013,-0.0041,0.0194,0.0153,-0.0165,0.0036,0.0034,-0.0381,-0.0265,0.0326,-0.0017,0.0545,-0.0596,-0.1091,0.0854,-0.0887,-0.0359,0.0125,0.0013,0.0279,0.0618,-0.0678,0.006,0.1383,0.031,0.0232,-0.0655,-0.0453,0.0311,-0.0156,0.0352,-0.0081,0.049,0.0599,-0.0341,0.0092,-0.0635,0.0583,-0.0179,0.059,-0.0522,-0.0511,0.0066,-0.0542,0.0737,0.083,0.0386,-0.1462,0.0505,0.0353,0.059,-0.0555,0.0082,0.0654,0.0462,0.0363,0.0119,0.0515,-0.0164,-0.0053,0.0064,-0.0836,0.0788,0.0562,0.0152,-0.0195,0.025,-0.0544,-0.1514,-0.0614,-0.0746,-0.2924,-0.1294,0.0132,-0.0129,0.0672,0.0719,-0.0167,0.0354,0.0008,-0.0641,-0.0888,-0.0215,0.0419,-0.038,-0.085,-0.0493,0.0182,0.0012,0.0106,0.0669,-0.0116,-0.0044,-0.0306,-0.0156,0.0474,0.0211,-0.081,0.0145,0.0759,-0.0303,-0.0114,0.0401,0.0112,0.0183,0.0435,0.0421,0.0693,0.0595,0.0544,-0.0528,-0.0216,0.041,0.0351,-0.0289,0.0583,-0.0152,0.0403,0.0702,0.0538,-0.024,0.0035,-0.05,0.0102,-0.0019,-0.0028,-0.0638,-0.0203,-0.075,-0.0938,-0.0598,0.0315,0.0116,0.0276,0.0407,0.0002,-0.0223,-0.0446,0.0406,0.0013,0.0109,-0.0901,0.0425,0.075,0.0446,-0.0099,0.0419,-0.0429,0.0789,0.0235,0.0191,0.0387,0.0193,-0.0666,-0.0283,-0.0394,-0.0352,-0.1202,-0.1068,0.0035,-0.0076,0.0369,0.0237,-0.0273,-0.0056,-0.0156,0.0136,0.0841,-0.0149,-0.0596,-0.047,0.0817,0.0204,0.0112,0.0783,0.0316,-0.0399,-0.0289,-0.0372,-0.0852,-0.0614,0.0651,0.0526,-0.0134,0.055,0.0024,0.0361,-0.0347,0.0361,-0.0009,0.0101,-0.0174,0.0307,0.0151,0.0722,-0.047,0.0655,-0.0468,-0.0643,-0.0766,-0.0148,-0.0228,-0.0292,0.0226,0.0061,-0.0144,0.0669,0.0623,0.0381,-0.0213,-0.0288,0.0155,-0.0065,-0.0188,-0.0276,0.0419,-0.0058,0.1013,0.1027,0.0809,0.0611,-0.0675,-0.0458,-0.0914,0.0495,-0.0952,-0.0469,-0.0224,0.0127,-0.0189,-0.0352,0.0154,-0.0874,0.0532,0.0571,-0.0116,0.031,0.0847,0.0185,0.0191,-0.0148,-0.0417,0.0013,0.0353,0.0407,-0.0144,-0.0403,0.0251,0.015,0.0153,0.0534,-0.0219,-0.0167,-0.0536,-0.0153,0.0061,-0.2656,-0.1949,-0.1404,-0.0681,-0.0655,-0.049,-0.1508,-0.1174,0.0347,-0.1297,-0.1045,-0.0936,-0.0804,-0.1215,-0.0077,-0.0148,-0.0132,-0.0092,0.0134,-0.0076,0.0142,0.0099,0.0394,-0.0261,-0.0294,0.0019,-0.0175,0.0617,0.0478,-0.0214,-0.0074,0.0051,0.0275,0.0014,-0.0257,-0.0512,-0.0883,0.0168,0.0849,0.0194,-0.0132,-0.0175,-0.0937,-0.0409,0.033,0.0392,0.1258,0.0778,0.0081,-0.1092,0.0185,-0.2012,-0.0986,0.0223,0.0023,0.0343,-0.0637,-0.0725,-0.052,-0.1002,-0.117,0.0148,-0.007,-0.0177,0.017,0.0295,0.0005,0.0118,-0.0324,-0.0185,0.0437,0.0448,0.0635,0.0342,0.0077,-0.0025,0.1048,-0.0231,-0.0359,0.0081,0.0004,0.0021,-0.0549,-0.0364,-0.0182,0.0409,0.0498,0.0443,0.0419,-0.0103,0.0489,-0.0102,0.0418,-0.0036,-0.0178,-0.0295,-0.0107,-0.07,0.0397,0.0492,0.0109,-0.0367,0.0226,-0.0713,0.0697,-0.044,-0.1059,-0.0305,0.0888,-0.0869,-0.0671,-0.0061,0.0791,0.0149,0.0543,0.0182,0.1056,-0.0016,-0.0499,0.0634,0.0607,0.0229,0.0722,0.0151,0.0218,0.0537,0.0537,0.0545,-0.0029,-0.0876,0.0162,-0.1632,-0.1066,-0.1322,-0.1359,0.0179,-0.0085,0.0542,0.0418,0.0597,-0.0189,0.0353,-0.0967,0.0153,0.0236,-0.0128,-0.0209,0.0065,-0.0222,-0.0366,-0.0144,-0.0058,-0.0177,0.0133,0.0231,0.0623,-0.0038,0.0245,-0.0169,-0.0103,-0.0103,0.0564,-0.0026,0.0211,-0.0078,0.0085,-0.0979,0.0499,-0.1067,0.1147,0.1017,0.0083,0.0254,0.0747,0.0704,0.0727,-0.0175,-0.0068,-0.0352,-0.0424,0.0464,-0.053,0.0274,0.004,0.1037,-0.0338,-0.022,-0.0075,0.0201,0.0432,0.0234,0.0243,0.0625,0.0415,0.0211,0.0652,-0.018,-0.0308,-0.0441,-0.0147,-0.0611,-0.0022,-0.059,0.0082,-0.0398,-0.0364,0.0267,-0.0265,0.0733,0.0914,0.0326,0.0036,0.0663,0.0097,0.0266,0.1014,-0.0209,0.029,-0.0646,0.1429,0.0585,0.0231,0.0979,0.0241,-0.0046,0.0099,-0.1924,-0.0266,-0.0523,-0.0135,-0.0047,-0.0338,0.014,0.0916,0.0911,-0.0424,0.0459,0.0273,-0.0138,-0.0214,-0.0417,-0.046,-0.0036,0.0265,0.03,-0.0104,0.0065,0.039,0.0125,-0.0214,-0.0723,-0.0152,0.0971,0.0329,0.0713,0.0308,0.0171,0.049,0.0618,-0.0232,-0.0244,-0.0168,-0.0155,0.0496,0.0303,0.0221,-0.0053,0.0756,-0.0262,0.0157,-0.0348,0.0429,0.0547,0.0221,-0.1136,0.0247,0.0412,-0.01,0.0151,-0.0929,0.0003,-0.0339,0.0048,0.0846,-0.0239,0.0027,-0.0897,-0.0406,-0.1076,-0.0079,0.0515,0.0224,-0.087,0.008,0.006,-0.013,-0.001,0.0744,0.0605,0.0167,-0.0674,0.0316,-0.0127,0.0719,-0.0,0.012,0.0108,-0.0053,0.0611,0.029,0.0325,0.0331,-0.0283,-0.019,0.0007,0.0493,0.038,0.0699,0.0525,0.0134,0.0247,-0.0172,-0.0101,0.0115,0.0461,0.0228,-0.029,-0.0203,-0.0046,0.0363,0.0837,-0.0386,0.0187,-0.0446,-0.0042,-0.0382,-0.0272,-0.0245,-0.0209,0.0565,0.0271,0.0223,0.0046,0.0988,-0.0296,0.0654,-0.0052,-0.0194,0.0217,0.0075,0.0758,0.0278,0.0026,0.032,0.05,-0.1244,0.0187,-0.0204,-0.0151,-0.0668,0.005,0.0389,-0.0528,-0.1102,0.0582,-0.0068,0.0443,0.0533,0.0488,0.0305,-0.0036,-0.0141,-0.0001,-0.0347,-0.0712,0.029,0.015,0.0559,-0.0213,-0.0118,-0.0578,0.1353,0.0835,0.054,0.0939,0.0789,0.007,-0.0582,-0.0229,-0.0235,0.0071,-0.0128,0.0781,-0.0116,0.0746,0.0543,0.0854,0.0198,-0.0098,0.0837,0.0545,-0.0556,-0.0059,0.0308,0.0239,-0.0189,-0.0523,-0.0717,-0.0028,-0.0567,0.0057,-0.0013,0.032,0.008,-0.0133,-0.011,-0.0022,-0.0393,-0.0853,-0.0487,0.0137,0.0244,0.0205,-0.1361,-0.1408,0.0942,0.0832,-0.0445,0.0647,0.0366,-0.0074,0.0999,-0.0218,0.0144,0.0213,-0.0215,0.0482,-0.069,0.0108,-0.0369,-0.0135,0.0108,0.0065,-0.1472,-0.0056,0.02,-0.1012,0.0163,-0.0189,-0.0242,-0.0149,0.0248,-0.0494,-0.0157,0.0024,0.0034,-0.0046,-0.026,-0.0498,-0.0374,0.0278,0.057,0.0436,-0.0524,0.0575,-0.05,-0.0925,0.0459,0.0584,-0.0374,0.034,0.0274,0.0273,-0.0064,-0.0028,0.054,0.1124,0.0238,0.0119,0.0434,0.0075,-0.0045,-0.0298,0.0052,-0.1625,-0.0575,-0.1149,-0.0508,-0.0646,-0.0071,0.0234,-0.2013,-0.0007,0.0898,-0.0271,0.0964,0.0286,-0.0149,-0.0232,0.0192,-0.0379,-0.028,0.0207,0.0208,-0.015,0.0178,-0.0166,0.0433,-0.023,-0.0493,-0.0449,-0.0845,-0.0979,-0.0057,0.0508,0.0591,0.0147,0.0529,0.0209,-0.0061,-0.0738,-0.0299,0.0186,-0.0935,0.0122,0.1355,0.0156,0.0005,-0.0153,-0.0339,-0.0391,-0.0378,-0.1866,-0.1746,0.0525,0.0021,0.0482,-0.0023,0.0003,-0.0463,0.1014,0.1245,0.1542,-0.0455,-0.0309,-0.0561,-0.0711,0.044,0.0048,-0.0302,-0.0408,0.012,-0.1117,-0.0633,0.0098,0.0179,-0.0449,-0.0572,-0.0575,-0.1074,-0.0075,-0.0229,-0.0067,0.0152,0.0013,-0.0417,0.1263,0.0265,-0.0198,0.053,-0.0193,-0.0318,0.0133,0.004,0.0261,-0.017,-0.0186,0.0146,-0.0251,0.0314,-0.0036,0.0061,0.0221,0.0003,-0.0711,-0.018,-0.0506,0.0416,0.0381,0.0419,-0.0084,-0.0162,0.0023,0.065,0.0537,0.0373,0.0354,-0.0309,0.0049,-0.0557,-0.0371,0.0215,0.0016,0.0423,-0.0244,-0.019,0.0241,0.1155,0.0005,0.0327,0.0141,0.0197,-0.0286,-0.0475,-0.1763,-0.0842,-0.0657,-0.0331,0.0715,0.0998,0.0524,0.0812,0.0376,-0.0721,0.006,-0.0796,0.0724,0.0528,0.0572,0.0343,0.0498,0.0231,0.0088,0.0015,-0.039,-0.0495,0.0745,0.0911,0.0481,-0.0187,0.0155,-0.0252,0.0907,0.0403,0.0518,0.0636,0.1324,0.0074,-0.0181,0.0549,0.0817,0.0141,0.0263,0.001,0.0495,0.0098,0.0423,-0.0388,-0.0573,-0.0244,-0.0299,-0.0624,0.0703,-0.0186,-0.0141,-0.0531,-0.0,-0.0153,0.044,-0.0875,0.0955,0.0785,0.0808,0.0193,0.0386,0.0842,0.0252,-0.0038,0.0013,0.066,-0.0056,0.0104,0.0733,-0.0156,0.0313,0.0422,0.0843,0.0186,0.0899,0.1092,0.0342,0.0268,-0.1147,0.0471,0.0803,0.1461,0.0712,0.0874,0.0413,0.1019,0.0798,0.034,-0.0251,-0.0334,0.0222,0.001,0.0042,-0.0894,-0.1197,-0.045,0.1207,0.1197,0.0286,-0.0222,0.0235,0.036,-0.0135,0.0465,0.0188,0.0287,0.0409,0.041,0.0154,0.0507,0.0524,0.0001,0.0759,0.0348,0.0118,0.0038,-0.0324,-0.06,0.0392,0.0107,0.0691,0.0975,0.0578,0.0721,0.0473,-0.1528,0.0396,0.0837,-0.0132,-0.0162,0.0242,0.0277,0.0002,-0.0259,-0.0428,0.0089,-0.0292,-0.0178,0.0643,-0.0233,-0.0087,-0.063,-0.1395,0.0436,-0.0527,-0.0825,-0.2031,0.0835,-0.0094,-0.0209,0.0175,-0.0048,-0.021,0.0097,0.0176,0.0009,0.0708,0.0804,0.107,0.0156,-0.0147,-0.0839,-0.0483,-0.0433,0.0167,-0.0157,-0.0462,-0.0632,-0.0465,-0.0447,-0.0026,-0.021,0.0135,0.0847,0.0525,0.059,0.0441,0.0043,0.0653,0.0315,0.0143,-0.0828,0.0385,0.0889,0.0618,0.0805,0.0657,0.1357,-0.0158,0.0991,0.033,-0.0315,0.0463,0.0341,0.0929,0.0256,-0.0261,0.0457,-0.0069,0.0206,0.0571,-0.034,-0.0766,-0.0533,0.0119,0.0601,-0.006,0.0282,0.0107,-0.0398,-0.0186,0.0165,-0.0673,-0.0073,-0.0537,0.0732,0.0751,0.0201,0.0102,-0.0203,0.0555,0.0605,0.0365,-0.0279,0.0304,-0.053,0.1008,-0.0073,-0.0015,0.0721,0.0251,0.0059,0.0062,0.1054,-0.0386,0.0641,0.1005,-0.0423,-0.1049,-0.0726,0.0233,-0.1877,-0.1,0.0771,0.0244,-0.1888,-0.0563,-0.0244,-0.0386,-0.0562,-0.0121,0.0541,0.0518,-0.0034,0.038,-0.3038,-0.3035,-0.1646,-0.1005,-0.1137,-0.1354,-0.2209,-0.2074,-0.158,-0.0193,-0.0114,0.0022,0.0271,0.0331,0.0317,0.0671,0.0377,-0.029,0.0219,0.0561,0.0353,-0.0727,-0.0153,-0.0106,0.0358,-0.0592,-0.0402,-0.0971,0.0572,0.0551,0.0611,-0.0153,0.027,0.0446,0.0142,0.029,-0.0124,0.0101,0.0348,0.0852,0.0811,-0.0186,0.0797,0.0276,-0.1373,-0.0512,-0.0422,-0.0803,-0.048,-0.0781,-0.04,0.0788,0.0858,0.0384,-0.0279,0.0457,-0.076,-0.0311,-0.0283,0.0227,0.0506,0.0544,0.0586,0.056,-0.0295,0.1278,0.0808,-0.0009,0.0226,0.0163,-0.0103,-0.0235,-0.0024,0.023,-0.0113,-0.0272,0.0331,0.0609,0.0973,0.0001,-0.0637,-0.0192,0.0048,0.0237,-0.0113,-0.077,-0.0795,-0.0171,-0.0785,0.0489,0.0421,-0.0544,-0.0209,-0.0752,-0.0731,-0.0387,-0.0273,0.0203,-0.0658,-0.0773,0.0218,0.0269,0.0602,0.0551,0.0326,-0.0128,-0.0115,0.0061,-0.0389,0.0403,-0.038,0.0096,-0.055,0.073,-0.0491,-0.0449,0.0533,0.0768,-0.0015,0.0706,0.0425,-0.054,-0.0369,0.0316,0.033,-0.0782,0.0074,0.1108,0.0421,-0.0349,0.0556,-0.0332,0.0161,-0.0221,-0.0323,-0.0791,-0.2061,-0.0853,-0.049,0.0196,-0.0333,-0.0222,0.0244,0.0644,0.0439,-0.0241,0.0481,-0.0212,0.071,0.0192,0.0453,0.0932,0.0689,0.031,0.0334,-0.0331,0.0311,0.0191,0.0562,0.0166,-0.0095,0.0594,0.0883,0.0638,-0.0074,-0.0491,0.0437,-0.0105,-0.0538,-0.0371,0.0789,-0.0395,0.0621,0.0397,-0.0582,0.1197,0.1251,-0.0052,-0.0189,-0.0153,-0.0038,0.0439,0.0283,0.05,0.0133,-0.0221,0.0303,-0.0172,-0.0072,-0.0593,-0.0389,0.0757,0.0398,-0.0103,0.0078,-0.0074,-0.0194,0.05,-0.007,0.0081,0.0564,-0.0028,0.1079,0.0368,0.073,0.0865,0.0768,0.0622,0.0371,0.0371,0.0291,0.0108,-0.0251,0.1234,0.0148,0.047,0.0346,0.1024,0.0435,0.1958,-0.0065,0.0816,-0.0004,0.0631,-0.0733,0.0998,0.0899,0.0452,0.0761,-0.0404,-0.0656,0.0104,-0.0431,-0.0378,0.016,-0.0672,-0.0548,0.0245,-0.0529,0.0376,0.0336,0.0067,0.1206,0.1021,0.0205,0.0581,0.0262,0.0049,-0.0079,-0.0215,-0.0007,0.0429,-0.0265,-0.0351,0.0374,-0.0458,0.0185,0.042,0.0192,0.0583,-0.0367,0.0554,-0.0289,0.0279,-0.0144,-0.0062,0.0532,-0.0526,-0.0134,0.0055,-0.0758,-0.0118,-0.1302,-0.0424,0.0155,-0.0618,0.0512,-0.0268,-0.0183,-0.0116,-0.0106,0.0259,-0.0291,0.0077,0.0454,0.0237,0.089,0.0371,0.0427,-0.0369,0.046,0.0748,-0.2686,0.0345,-0.0158,-0.0035,0.0228,0.0081,-0.0107,-0.0127,0.0781,0.052,-0.0927,-0.0555,0.0422,-0.0082,0.0193,-0.0297,-0.0321,-0.0809,0.0167,-0.0228,0.0275,0.0372,-0.0306,0.0617,0.0634,0.0551,0.0336,0.0416,0.0304,0.036,0.0402,0.0076,-0.0262,0.0503,-0.0519,0.0479,-0.0299,-0.0212,-0.0103,-0.0484,-0.002,0.0538,-0.0308,0.0789,0.0686,-0.0187,-0.0474,0.0312,0.0269,-0.0104,0.0392,0.1051,0.0468,0.0388,0.0545,0.072,-0.0068,0.0254,-0.0071,0.0404,0.052,0.0442,0.062,0.049,0.0252,-0.0463,0.0391,-0.0609,0.0708,0.0187,-0.0037,-0.0167,0.0646,0.0199,-0.0752,-0.0356,0.114,-0.0135,-0.0362,0.0423,-0.0309,-0.0562,0.0119,-0.0317,-0.0142,0.0792,0.0332,0.0532,0.0618,-0.0525,0.0627,-0.0266,-0.0096,-0.0313,-0.0576,-0.0422,0.0465,0.0466,0.0232,-0.0542,-0.0592,0.0065,0.0051,-0.0101,-0.0061,0.0406,-0.0451,0.0733,0.0522,0.0216,0.0014,0.0317,0.0692,-0.0421,0.0021,0.0061,-0.0803,0.0283,0.0271,0.0699,0.0025,0.0079,-0.0466,0.0462,0.0393,0.0045,0.009,0.0462,0.0339,-0.0007,0.0658,0.0034,0.0082,0.1013,0.0193,0.0142,-0.0213,0.0119,-0.0186,-0.0032,-0.0346,0.0194,-0.0425,0.0554,0.0413,0.0411,0.0575,0.0317,0.0533,0.0436,0.1239,0.0565,0.0331,-0.0526,0.0626,0.0121,0.0567,-0.0738,-0.0613,-0.0505,0.0256,0.0684,0.0691,-0.0117,-0.0008,-0.048,0.0656,0.0489,0.0351,-0.0283,-0.0465,-0.0086,-0.024,-0.0517,0.006,0.0058,0.0053,-0.0114,-0.0574,-0.0083,0.0253,0.0204,0.0284,-0.0404,0.0142,-0.0088,0.0039,-0.0323,0.0192,-0.005,0.0677,0.0319,-0.0325,-0.0486,-0.0566,-0.0604,0.0047,-0.0036,0.0259,-0.0918,-0.094,-0.0453,-0.0603,0.1124,0.0116,0.0056,-0.0605,-0.0072,-0.0206,-0.0177,0.0228,-0.0097,-0.062,-0.0276,0.0393,-0.064,-0.036,0.0419,-0.0616,-0.0307,-0.0419,-0.0481,-0.0134,-0.0289,-0.002,0.0143,-0.0103,0.0229,-0.037,-0.0711,-0.0726,0.0268,-0.0023,0.0082,0.0517,0.0414,0.1318,0.1248,-0.0164,-0.0467,-0.058,-0.018,-0.0053,0.0354,0.0854,0.035,0.0438,0.005,0.0275,0.05,0.0125,-0.0119,0.0595,0.0849,0.0304,0.0824,0.0669,-0.0168,0.0427,-0.0472,0.0781,0.0517,-0.0041,0.0099,0.004,-0.0375,0.0118,0.0073,0.018,-0.0942,0.0501,-0.0198,-0.0514,-0.0289,0.003,-0.0511,0.049,-0.0906,-0.0754,0.0478,0.0347,0.035,-0.0251,0.0098,0.0356,0.1241,0.1021,0.0252,-0.0111,0.0091,-0.0207,0.014,-0.0039,0.0787,0.0718,-0.0764,-0.0334,0.0601,0.0315,-0.0046,0.0074,0.0689,-0.0604,-0.0958,0.0671,-0.0183,-0.0943,-0.0448,0.0561,0.0799,0.0929,0.1047,0.0118,0.0338,-0.0153,-0.0463,0.0134,-0.0619,0.011,-0.0652,-0.1688,-0.1152,-0.0186,-0.1074,0.1216,0.0971,0.0333,0.0359,0.0249,0.0212,0.0684,0.0286,-0.002,0.0917,0.0732,0.0468,-0.082,0.0996,0.0281,-0.0136,-0.0299,-0.0822,-0.064,0.0305,0.1028,0.0783,0.1039,-0.0159,-0.028,-0.0583,-0.0525,0.0176,-0.0369,-0.0529,-0.0325,-0.0269,0.0377,0.0159,-0.0473,0.0135,0.003,-0.0172,-0.0337,-0.0086,0.0131,-0.0275,-0.0494,-0.0311,0.0157,0.1011,0.0774,0.0356,0.0679,-0.2188,-0.0292,-0.1398,-0.0596,-0.0357,-0.0496,-0.0616,-0.0286,0.073,-0.117,-0.0806,-0.0022,-0.0056,-0.0255,0.0157,0.0243,0.0019,0.0611,-0.013,-0.185,-0.0236,0.0256,-0.0136,-0.0336,0.0379,-0.0493,0.0229,0.0787,0.0655,0.0434,0.0899,0.0256,0.0151,0.0093,-0.0299,-0.077,-0.0012,-0.0163,0.025,0.0361,0.0043,-0.063,-0.084,0.0256,-0.0474,0.0639,-0.0408,0.0601,0.0159,0.0202,-0.0841,-0.027,0.0211,0.0697,0.0207,0.0568,0.0445,0.0042,-0.0061,0.0195,-0.0234,0.0484,0.0731,0.0773,0.0746,0.0467,0.0637,0.0656,0.0056,0.0462,-0.0303,0.0867,0.0706,0.0799,0.0076,0.0733,0.1398,0.0597,-0.0386,-0.0648,-0.0167,0.072,-0.1541,-0.1236,-0.0588,-0.0056,-0.0064,-0.0528,0.1069,0.0312,0.0684,-0.009,-0.0986,-0.088,0.0279,0.0076,-0.0486,-0.0283,0.104,0.0262,-0.0004,0.002,0.143,0.1007,0.1053,0.116,-0.0292,0.0554,0.0537,-0.05,0.0761,0.0766,0.0046,-0.0571,-0.0367,0.0223,0.0466,0.1633,0.1146,0.045,0.1346,-0.0569,0.0098,0.054,-0.0153,0.0876,0.0324,0.0345,0.0286,-0.1176,-0.0581,-0.1396,-0.072,-0.0592,0.0752,0.05,-0.0324,0.0666,-0.0314,-0.0327,-0.0113,-0.08,-0.062,0.0753,0.1006,0.0414,0.0568,0.0782,0.0344,0.0367,0.0115,-0.0231,0.0434,-0.0196,-0.0171,0.0376,-0.0365,0.034,0.0001,0.0784,0.1232,-0.0147,0.0626,0.027,0.0338,0.042,0.0763,0.0445,0.0809,0.0515,0.0416,0.03,0.0352,0.0199,0.0262,0.0381,-0.0386,-0.0182,0.0023,0.0332,0.0338,0.0986,0.007,-0.0225,-0.036,0.0648,-0.0919,0.0318,0.085,-0.0439,-0.0203,0.0019,-0.0018,-0.0029,-0.0063,0.0607,-0.0224,-0.035,-0.0341,-0.1365,0.0954,0.044,-0.0185,0.0713,0.0093,-0.0838,0.0756,-0.0855,0.132,-0.0078,-0.003,-0.0034,0.037,0.0527,0.0125,0.0201,0.0937,0.0905,-0.0715,0.004,0.0053,0.0332,-0.0356,-0.0494,-0.053,0.0945,0.0904,0.0833,-0.0306,0.0814,0.1264,0.0096,0.0255,-0.0248,0.0062,0.0556,0.0489,-0.0225,-0.0265,0.0301,-0.0048,-0.1128,0.0029,0.0067,-0.0554,-0.1186,-0.0751,-0.0128,-0.0621,0.0511,0.0141,-0.0889,-0.0762,0.0258,-0.0727,-0.0439,-0.0017,-0.0477,-0.0945,-0.0507,0.0476,0.0509,0.0176,0.0746,0.0037,0.0729,0.005,0.0888,0.107,0.0529,0.0804,0.031,-0.1068,0.064,0.0591,0.1083,0.1251,0.0616,0.0548,0.0786,0.1124,0.0805,0.0161,0.032,0.0482,0.0222,-0.0352,-0.0873,0.0282,0.0193,0.0086,-0.0347,0.0111,0.0434,0.0495,0.0683,-0.0196,-0.021,0.1183,0.1053,0.004,0.0239,0.0235,0.0691,-0.014,0.0409,0.0358,0.0625,0.025,-0.0048,0.022,0.0102,0.0044,0.1043,-0.0393,0.047,-0.0228,-0.0484,-0.0635,0.0972,0.0145,0.0775,0.0467,0.0349,0.0513,0.0538,-0.0629,-0.0633,-0.1007,-0.0153,-0.005,-0.0287,0.0585,0.0106,-0.0483,0.0421,0.0113,0.038,-0.0313,-0.0604,-0.0378,0.0262,0.09,0.041,0.0223,0.0203,-0.0168,-0.0889,-0.0688,-0.0008,0.0304,0.0523,0.0191,0.0775,0.0945,0.0402,0.0725,-0.0173,0.0002,-0.0345,0.0451,-0.0519,-0.0291,-0.0219,-0.0367,-0.0232,-0.0297,-0.0298,0.0457,-0.0296,0.0333,0.0007,-0.0103,0.0413,-0.0085,-0.0151,0.0298,-0.0047,0.0463,0.0501,0.0558,0.0334,0.036,-0.042,0.0169,-0.029,-0.0218,-0.0128,0.0138,-0.0379,0.0262,-0.0149,0.0032,0.001,0.0609,0.0523,-0.0671,-0.0362,-0.0307,0.0651,0.0592,0.0642,0.0288,-0.0604,0.0283,-0.0187,-0.0504,0.0868,0.0761,-0.004,0.049,-0.0027,-0.0034,-0.3621,-0.1909,0.0668,-0.0426,-0.0153,0.0163,0.0514,0.0699,0.0592,0.0648,-0.0645,-0.0189,0.0412,0.0104,0.0537,0.0374,-0.0734,-0.0253,-0.0413,0.0198,0.0336,0.0127,0.0666,-0.0058,-0.0082,0.0593,-0.0139,0.1037,-0.0226,0.1064,-0.1704,-0.0331,-0.0468,0.0934,0.093,0.018,-0.0594,0.0253,-0.0844,0.0964,-0.0823,-0.0096,-0.0425,-0.0732,-0.0426,-0.0202,-0.0359,-0.0602,-0.1127,-0.1071,0.0415,-0.0195,-0.2117,-0.3187,-0.113,-0.0824,-0.3194,-0.2018,-0.1802,-0.2327,-0.1333,-0.1615,-0.099,-0.124,-0.1978,-0.1359,-0.1436,-0.0626,-0.1535,-0.1185,-0.1265,-0.106,-0.119,0.0957,0.0667,0.0866,0.1358,0.1043,0.0805,0.0821,0.0252,0.0284,0.0076,0.1075,0.0707,0.0766,0.022,0.0721,0.0473,-0.0612,0.0486,0.051,0.0228,0.0506,0.0248,0.0126,-0.027,0.0463,-0.034,0.0359,0.0477,-0.0571,0.0278,0.0248,-0.0169,-0.0241,0.062,-0.0468,0.0125,0.0371,-0.0161,-0.0743,0.0383,-0.0069,0.017,0.0633,-0.0971,-0.0991,0.0131,0.0343,-0.0187,0.0156,-0.0015,0.0291,0.0337,-0.0608,-0.0162,0.0184,-0.0419,0.0062,0.0325,0.0186,learning
trm_4a3fd79d0b13d,0.1062,0.0196,0.0844,0.0136,0.0313,-0.0212,0.0982,0.066,0.1072,0.0602,0.0348,-0.0012,0.092,0.0452,-0.0049,-0.0472,-0.0058,-0.001,0.0707,-0.0475,0.0125,-0.0268,-0.0091,0.0228,-0.0043,-0.0093,-0.0034,0.0315,0.0547,0.0563,0.0199,-0.0207,0.0466,0.046,0.0176,0.0073,0.0472,0.0068,0.0466,-0.0393,0.0095,0.0439,0.0387,-0.0158,-0.0296,-0.0067,-0.1036,0.082,-0.0298,-0.0,0.008,0.0827,0.05,0.0492,0.0066,0.0543,0.0498,0.0162,0.0024,-0.019,0.0136,-0.0434,-0.0495,0.0064,-0.0417,0.031,0.0124,0.0482,0.0468,0.0046,-0.0241,-0.0378,-0.0233,0.018,0.065,-0.0098,0.0725,-0.0423,0.0054,-0.0212,0.0433,-0.0145,0.0107,0.0047,0.0068,0.0054,-0.0188,0.0238,-0.0161,-0.0164,-0.0036,0.127,-0.0337,0.0567,0.0101,0.0527,0.0168,0.0765,0.0983,0.0372,-0.0271,-0.0536,0.0252,0.0705,0.0288,-0.0009,-0.007,-0.0605,0.021,0.0223,-0.0029,0.0156,-0.0463,-0.0214,-0.0091,-0.05,0.0112,0.0385,0.0196,0.0433,-0.044,0.0065,-0.0292,0.0185,0.0017,0.0026,-0.0347,-0.0003,0.0074,0.0224,0.0019,0.0359,0.0349,0.0743,-0.0751,0.0189,0.0636,0.0033,-0.0168,0.0372,0.0452,0.0685,-0.0395,-0.0085,-0.0084,-0.0421,0.084,-0.0148,-0.035,-0.0297,0.0008,-0.0284,0.0193,-0.0018,-0.0633,-0.0141,0.0141,-0.0056,-0.0651,0.0095,0.0263,-0.0471,0.01,0.0282,0.0263,-0.0595,-0.0277,0.0339,0.0278,-0.0018,-0.0434,-0.0442,-0.0154,0.0678,0.0731,0.0326,0.0591,0.0383,0.0377,0.0517,0.029,-0.0433,-0.0371,0.0174,0.1012,0.0,0.056,-0.0061,-0.016,-0.0741,-0.0836,-0.0079,0.0483,0.0886,0.0845,0.0384,0.0472,-0.0172,-0.0715,0.0726,0.1118,0.028,0.0071,-0.0176,-0.0686,-0.0094,-0.0042,-0.0122,0.0053,-0.0173,0.0368,0.0548,0.0548,0.0093,-0.0665,-0.019,-0.0521,0.07,0.1312,-0.0294,-0.0216,0.0138,-0.001,0.0071,-0.0404,0.0108,-0.0638,-0.0065,-0.0473,-0.0839,0.0298,0.0224,-0.0164,0.0013,0.0036,0.0608,-0.0195,-0.001,-0.0153,-0.0152,0.0282,0.0613,0.0081,0.042,0.046,0.0222,-0.0098,-0.0171,0.0453,-0.0231,0.0565,0.0019,-0.0061,0.0075,-0.0008,0.0448,-0.0114,0.026,-0.0469,-0.0576,-0.0238,-0.113,0.0043,-0.0597,-0.0632,-0.1094,-0.0585,-0.0076,-0.0444,-0.0248,-0.0291,0.0745,-0.0199,-0.0023,0.017,-0.0697,-0.0425,-0.073,-0.007,-0.0799,-0.0606,-0.0192,-0.0145,-0.0292,-0.0758,0.0207,-0.0237,-0.0536,0.087,0.0823,0.0029,0.0539,0.012,-0.0403,0.0677,-0.0461,-0.0055,-0.0028,-0.0281,-0.0252,0.0537,-0.018,-0.0259,-0.0005,0.0927,0.0935,0.0452,0.0412,0.0081,-0.0041,-0.0219,0.0045,-0.0437,-0.0392,-0.0665,0.0532,-0.0201,0.0555,-0.0394,-0.0176,0.0146,0.0248,-0.0437,-0.0737,0.0313,0.002,-0.0596,-0.0287,0.0784,-0.0296,-0.0461,0.0205,-0.0292,-0.007,-0.0301,-0.0212,0.0057,-0.0575,-0.0335,0.0082,0.0046,-0.0307,0.0635,0.0703,-0.0161,0.0198,0.085,0.0558,0.0728,0.0065,0.0612,0.0261,0.0355,0.0557,-0.0075,-0.0049,-0.0119,0.0295,0.0359,0.019,0.0421,-0.0259,0.0841,0.0889,0.1073,0.0698,0.0492,-0.058,-0.0703,0.1169,-0.0292,0.027,-0.0767,0.057,-0.0061,0.0274,-0.0429,0.0089,-0.0458,-0.0849,-0.0482,0.0638,-0.0096,-0.0561,-0.0029,-0.0086,-0.0092,0.0514,-0.0237,0.0014,0.0676,-0.0472,-0.0153,-0.0727,0.0774,0.1316,0.1309,0.0293,0.0368,-0.0179,-0.0253,0.0368,0.0134,-0.0121,-0.0286,-0.0583,0.0111,-0.0337,0.0417,0.0359,0.0334,0.0245,-0.0149,-0.0402,-0.0047,-0.0572,-0.0322,-0.0515,-0.0305,0.043,0.0047,0.0724,0.0681,0.0467,0.0295,0.0519,0.0443,0.1311,0.0649,0.0846,-0.0163,0.0312,0.0193,0.0163,-0.0065,-0.0097,0.0169,-0.0109,0.0597,0.0575,-0.0426,0.0091,-0.047,-0.047,0.0496,0.0977,-0.0419,0.0329,-0.0446,-0.0413,-0.0301,0.0107,-0.0138,0.0162,0.0242,0.0072,-0.0097,-0.0154,-0.0689,-0.002,-0.0369,0.0241,-0.0168,-0.1562,0.0492,-0.0392,-0.0215,-0.1045,0.0016,0.0285,0.0045,0.0039,0.0665,-0.0075,-0.0295,-0.0026,0.089,-0.0577,0.0115,0.0099,-0.0165,0.0383,0.0191,0.0244,-0.0363,-0.0481,0.0049,-0.0462,-0.0612,0.0494,-0.0303,0.0162,-0.1391,-0.0933,-0.0717,-0.0299,-0.0584,0.0256,-0.0789,-0.018,-0.0196,-0.0535,-0.0357,0.0389,0.0729,-0.0281,-0.0231,-0.007,-0.0396,0.0439,0.0456,-0.0066,0.0635,-0.0379,-0.0211,-0.0147,0.0362,0.0534,0.029,0.0248,0.0599,0.0112,-0.0528,-0.0155,0.0005,-0.0188,-0.0571,0.0297,0.0364,-0.0178,0.0225,0.0337,0.0714,0.0157,0.0212,-0.0218,-0.0255,-0.0339,-0.0209,0.0149,-0.0023,-0.0308,-0.0452,0.0176,-0.0053,0.0329,-0.023,0.0183,-0.0286,0.0038,0.079,-0.0138,-0.0441,0.0894,-0.0331,0.0052,0.0007,-0.0247,-0.0209,0.0447,-0.04,-0.0942,-0.0461,-0.008,-0.0622,-0.0218,-0.0774,-0.0862,0.0071,0.0008,-0.0291,-0.0527,0.0304,-0.0171,0.135,0.0877,0.0285,0.029,-0.0072,-0.0157,0.0326,-0.0017,-0.0103,0.0471,-0.0259,-0.0323,0.0573,-0.0566,0.0065,0.0216,0.0093,-0.0413,0.0009,-0.0516,0.0071,0.0361,0.0308,0.0051,0.0481,-0.0582,-0.0659,0.0259,0.0095,-0.0294,-0.0071,0.1827,-0.0438,0.1103,0.1169,-0.0304,0.0704,0.016,-0.0483,0.0019,0.059,-0.0036,0.0344,-0.0019,-0.0541,-0.0223,0.0223,0.0242,-0.0258,-0.0009,-0.0075,0.0114,0.054,0.0635,0.0602,-0.0145,-0.0305,0.0999,-0.0105,-0.0255,0.0077,0.0512,-0.0096,-0.0055,0.0243,0.0815,0.0445,0.0561,0.0256,0.0949,-0.0337,-0.0022,0.0146,0.0378,0.0495,-0.0058,0.0389,-0.0101,-0.0762,-0.0975,-0.0103,0.0561,0.0818,0.0536,0.0432,0.0246,0.0175,0.0687,-0.0248,0.1363,0.0869,-0.0445,0.1336,-0.0639,0.0573,0.1034,0.0285,0.0644,0.0129,-0.0335,-0.0114,0.0331,0.0437,0.0054,-0.0773,0.0267,-0.036,0.0021,-0.0651,-0.0307,-0.0185,0.015,0.081,-0.0325,-0.0217,0.0083,0.0054,-0.0821,-0.0357,-0.113,-0.0795,-0.0844,-0.0248,-0.0001,0.0336,-0.0172,-0.0499,-0.0668,0.0566,0.0143,0.0278,0.0832,0.009,-0.0396,-0.0414,-0.0334,-0.0713,-0.0618,-0.0705,0.0288,-0.1014,0.0001,0.0368,-0.0521,-0.0273,-0.013,0.0105,0.0412,-0.0847,-0.0851,-0.0379,-0.025,-0.0073,0.0089,-0.0077,0.0277,-0.0624,0.0056,0.0068,0.0093,0.0076,-0.0168,0.0255,0.0175,-0.0276,-0.0372,0.0508,-0.0246,0.0406,-0.0025,-0.0523,0.0498,-0.0487,0.0245,-0.0379,0.0287,-0.0409,0.0347,0.0579,0.0218,-0.0082,0.0016,-0.032,-0.1046,-0.0149,-0.0024,-0.0202,0.0797,0.0151,-0.0627,-0.021,-0.0234,0.0788,0.0188,0.0018,-0.04,-0.0754,-0.0368,0.0529,0.0419,0.0379,-0.018,-0.0302,0.0239,-0.0204,-0.0333,0.0389,0.0301,-0.0307,0.0061,-0.1007,-0.0804,-0.034,0.0212,-0.0095,-0.0604,0.0407,0.0341,-0.048,-0.0056,0.0185,0.0462,-0.0148,-0.0515,-0.017,0.0787,0.0901,-0.0218,-0.0839,-0.0695,-0.0023,0.0221,-0.0148,-0.0048,-0.0346,-0.0159,0.0163,0.0098,0.0119,-0.022,0.0211,-0.0392,-0.0085,-0.0181,0.0006,0.0197,-0.049,0.0539,-0.0103,0.0132,0.0061,0.0118,0.0084,0.0138,0.0021,0.0399,0.0473,-0.0517,-0.005,-0.0289,0.0032,0.0635,-0.0307,0.0504,-0.0317,-0.0439,-0.0476,-0.0852,0.0051,-0.0541,-0.0033,-0.0095,-0.0197,-0.0072,-0.0042,0.0179,-0.0069,-0.0301,0.0371,0.0855,-0.0239,-0.0045,0.0188,-0.056,-0.0051,0.0353,-0.0443,-0.0809,-0.0747,-0.0084,0.0183,0.0581,0.0045,0.0105,-0.0213,-0.0257,-0.0489,-0.007,0.0845,-0.0153,-0.0064,0.0001,0.004,0.0033,-0.0154,-0.0414,-0.003,-0.088,0.0081,0.0416,-0.0112,-0.0527,-0.0464,0.0454,-0.0446,0.0665,0.026,0.0303,-0.0185,0.0191,-0.0134,-0.0257,0.0803,0.0025,0.0076,0.0118,0.0812,0.0334,-0.0772,-0.0037,-0.0394,-0.1298,-0.0284,0.0679,0.0156,-0.0618,-0.0399,-0.0296,0.0164,0.0148,-0.0002,0.0353,0.0217,0.0429,-0.0141,0.0054,0.0344,0.03,-0.0113,-0.0023,0.0783,0.0351,0.0197,0.0214,-0.0386,0.041,0.0502,-0.0075,0.0083,0.0147,0.0159,-0.0729,-0.0074,0.0282,0.011,0.0379,0.0344,0.0212,0.0214,0.0361,0.006,0.0341,-0.0102,0.0283,0.0148,0.0411,-0.0095,0.0127,0.0309,0.0421,0.0011,-0.0089,-0.0229,-0.0334,-0.0151,-0.0279,-0.0842,0.0015,-0.0916,-0.0172,-0.0341,0.0068,0.0367,0.0283,0.0243,-0.0718,0.0079,-0.0194,0.0467,-0.0089,0.0249,-0.0273,-0.0222,0.0688,0.0189,-0.1306,-0.099,-0.1156,0.0693,-0.014,-0.0572,-0.0578,-0.0509,0.0526,0.011,0.0598,-0.0311,-0.0806,-0.0323,-0.0292,0.0095,0.0096,0.0384,0.0408,0.025,0.0174,0.0076,0.0033,0.023,-0.0157,-0.0301,0.0324,0.0588,-0.0121,0.0404,-0.0189,-0.0057,0.0125,0.039,-0.0388,-0.0291,-0.0829,-0.0714,-0.0476,0.0102,0.0254,0.0038,0.0049,0.0208,0.063,0.0503,-0.0723,0.0188,0.0243,-0.0143,-0.0484,0.0637,0.0591,0.0906,0.0955,-0.0343,-0.0314,-0.0086,-0.0283,-0.0282,0.0451,-0.0141,0.0341,0.0101,0.0387,-0.0093,-0.0028,0.0167,-0.0093,-0.0065,-0.0067,0.0857,-0.005,0.0156,-0.0198,0.0487,-0.0299,-0.0376,-0.0357,-0.0026,-0.0132,-0.0082,0.0034,-0.0309,-0.0436,-0.0415,-0.0111,0.0219,0.0053,-0.0248,-0.0347,0.0155,-0.0245,-0.0184,0.0148,0.0253,0.0467,0.0081,-0.0511,-0.0126,0.0265,0.0556,-0.0174,-0.0058,0.036,-0.0021,0.0576,0.0277,-0.034,0.0056,-0.0115,-0.0831,-0.0445,-0.0263,0.0021,-0.007,0.0163,-0.0064,-0.0923,0.0865,-0.0684,-0.0812,-0.0388,-0.0203,-0.0684,0.0252,0.0135,0.0281,-0.087,-0.0464,-0.0023,0.0217,-0.0366,0.0271,0.0659,0.0344,0.0081,0.0231,-0.0132,0.0167,0.0019,-0.0234,-0.0118,0.0251,0.0594,-0.0192,0.0008,-0.0203,-0.032,-0.036,0.0201,0.0268,-0.0055,-0.095,-0.0863,0.0917,-0.0107,0.001,0.0244,0.0432,-0.0836,0.0978,0.0012,-0.0209,-0.0075,0.0328,0.0664,0.2244,0.2007,0.1965,-0.0316,-0.0386,-0.0198,0.0093,0.0076,0.0028,-0.0447,0.0966,0.0463,0.0212,-0.0147,0.023,0.0693,0.0196,-0.001,0.0543,0.0645,-0.0238,0.1314,-0.0646,0.0253,-0.0327,-0.0879,-0.0377,-0.0097,0.0494,0.0696,0.0872,-0.0264,0.0496,0.0666,0.0004,-0.0269,0.0485,-0.0145,0.0305,0.0316,0.0139,0.0004,0.0349,0.0385,-0.0198,-0.0145,0.0543,-0.0635,0.0185,-0.0425,-0.052,-0.0095,-0.0124,-0.1503,-0.1136,-0.0282,0.0544,0.0116,0.028,0.0355,0.0103,0.0244,0.0293,-0.0622,-0.0351,0.0132,-0.0213,0.0395,0.068,-0.0198,-0.016,-0.037,0.0327,-0.0169,-0.0151,-0.0839,-0.064,-0.0721,-0.071,0.0282,0.004,-0.0399,0.0031,-0.0432,-0.005,0.0914,-0.0758,-0.018,-0.0217,-0.0082,0.0154,-0.0044,-0.0306,-0.0046,0.011,0.0258,0.1026,-0.049,-0.0419,0.0007,0.0042,-0.0425,-0.0716,0.084,0.084,0.0384,-0.0813,-0.0336,-0.052,0.0617,-0.0318,-0.0108,0.0506,0.025,0.0186,0.031,-0.0217,0.0658,0.0544,0.0509,-0.0148,0.0494,-0.0198,0.0,0.0213,0.0508,-0.0011,-0.0301,0.0121,-0.0354,0.0258,0.035,0.0456,0.0584,-0.0083,-0.0099,-0.0377,-0.0383,-0.0666,-0.0063,-0.039,0.012,0.1289,0.1041,0.1582,-0.0029,0.0998,0.0451,0.0475,0.0278,0.0307,0.0168,-0.0009,0.1004,0.0128,0.0207,-0.0362,0.1033,0.0273,0.0351,0.007,0.0918,0.0281,0.0064,-0.0224,0.0358,0.1116,-0.0172,0.0136,0.0278,-0.0679,0.0806,0.0932,0.0575,-0.0278,-0.0477,-0.0464,-0.0541,-0.0555,0.0206,-0.0288,-0.089,-0.0512,0.0003,-0.0391,0.0064,-0.0394,0.0165,-0.0377,0.0068,-0.0232,0.0505,-0.0141,0.0032,0.0139,-0.039,0.0101,-0.0089,0.004,0.0176,-0.0101,-0.0569,-0.0508,-0.0384,-0.0366,-0.042,0.0483,0.0162,0.0202,0.0049,0.0269,0.0304,-0.0622,0.0275,0.0649,0.0507,-0.1096,-0.0175,-0.005,-0.0686,-0.1307,-0.0341,-0.0099,-0.0611,0.0217,0.0353,0.0627,-0.0074,-0.0683,-0.0031,0.0164,0.0902,-0.0141,-0.0072,0.0811,0.0353,0.0223,-0.0083,0.0444,0.0284,0.0356,0.0201,-0.0133,-0.0359,-0.025,0.0539,-0.0174,0.0474,-0.0201,-0.0525,-0.0524,-0.0245,0.0265,0.0061,-0.0618,0.039,0.0278,0.0098,0.017,-0.0639,-0.0348,0.0043,-0.0055,-0.003,0.0068,0.0493,-0.0071,0.0186,0.0284,0.0096,-0.015,0.0184,0.034,-0.1017,-0.1272,0.0277,0.1573,0.1487,-0.0112,-0.0284,-0.0479,0.0516,0.0349,0.0181,-0.0333,-0.0272,0.0223,-0.0033,0.0122,0.0756,-0.0047,-0.0009,-0.0167,-0.0201,-0.0554,-0.044,0.0366,0.031,0.019,-0.158,0.0702,-0.0224,0.053,-0.0224,-0.0139,-0.0044,-0.0303,-0.1326,-0.0251,0.0258,0.0193,0.0839,0.042,0.0247,-0.0063,0.0788,0.045,0.0293,0.0287,-0.0072,-0.0089,-0.0346,0.019,-0.0423,-0.0206,0.1451,0.1214,0.0427,0.1443,0.1458,-0.0585,-0.0556,-0.0695,-0.0333,-0.0474,-0.029,0.0695,-0.0028,-0.0415,0.0507,0.1124,-0.0442,-0.0438,-0.0327,-0.0194,-0.0834,0.0132,0.0131,-0.0121,-0.0576,-0.0147,0.0282,0.0787,-0.0912,0.0529,0.0213,0.0336,-0.0211,0.0318,0.0083,-0.0538,0.0332,0.045,0.046,0.0395,0.0189,-0.0292,-0.0848,-0.0954,-0.0712,-0.0493,0.0137,0.0415,0.0499,0.0139,0.0294,-0.0601,0.0069,0.0164,0.0484,0.0077,0.0499,-0.0152,0.0349,-0.017,0.0102,0.0157,-0.0917,0.1494,-0.0165,-0.1022,0.0335,0.0013,-0.0068,-0.006,0.0398,-0.089,-0.0457,0.0202,-0.0296,-0.0639,-0.0542,-0.0881,-0.0501,-0.0648,-0.1029,-0.0945,-0.0189,0.017,-0.0324,-0.0603,-0.0088,-0.0643,0.0182,0.0192,0.0329,-0.0567,0.0204,0.0634,0.0068,-0.0525,-0.0586,-0.0061,-0.0373,-0.0475,-0.0252,0.0015,0.0068,-0.0433,0.0238,-0.0042,-0.0077,-0.0057,0.0237,0.0151,-0.1288,0.0377,-0.0793,-0.0026,0.008,0.0267,-0.0285,0.0414,-0.0058,-0.0588,0.0169,0.0225,-0.029,0.0372,0.0278,0.0202,-0.0222,0.0188,-0.0228,0.0245,-0.0381,-0.0316,0.0002,0.0561,0.041,-0.0013,0.0396,0.0506,-0.1273,0.0115,-0.0194,0.0122,0.0297,0.0614,0.0685,-0.0102,0.0319,-0.0362,0.0414,-0.0073,-0.0115,-0.1011,-0.08,-0.0281,0.0118,0.0255,0.0059,0.0016,0.0079,-0.0388,-0.0226,-0.029,-0.0089,0.0172,-0.0003,-0.0114,-0.0018,0.0258,-0.0171,0.0279,0.0196,0.0294,-0.0073,-0.0649,0.0588,0.0483,0.0167,-0.0826,-0.0639,0.0298,-0.0197,-0.0751,0.0506,0.1376,0.0297,0.017,-0.0211,-0.0709,-0.046,-0.0326,-0.0835,-0.0126,0.1207,-0.0165,0.0406,0.0336,0.0532,0.0027,0.0032,0.0604,0.0681,0.069,0.0077,-0.0443,-0.0681,0.0104,0.0408,0.0428,0.0082,0.0297,-0.0916,-0.0854,-0.0132,-0.0077,0.0287,-0.0437,-0.09,-0.0443,0.0232,-0.0241,-0.0549,0.0669,-0.0176,-0.0366,0.042,0.0379,0.0273,0.0204,0.0368,-0.0049,0.0405,-0.0629,-0.0212,-0.0934,-0.096,-0.0084,-0.0247,0.1115,0.0642,0.0261,0.0301,0.0277,-0.0561,0.0346,0.0283,-0.0022,0.013,0.0541,0.0467,-0.0573,-0.0514,0.0097,-0.0033,-0.019,-0.0046,0.0769,-0.006,-0.0383,-0.0043,0.0298,0.0461,-0.0132,0.0275,0.0569,0.0016,-0.0139,-0.081,0.0126,0.028,0.0156,0.0536,0.0181,0.062,0.0084,-0.021,-0.019,-0.0666,-0.0198,-0.0141,-0.0505,0.0082,-0.0708,-0.0525,-0.0015,0.0129,0.0708,0.0471,-0.0594,0.0061,-0.0188,-0.0487,-0.0528,0.0696,-0.0081,0.0082,0.0078,-0.0227,-0.0194,-0.0004,-0.0366,-0.0541,0.0415,-0.0009,-0.0015,0.0276,0.0534,0.0397,-0.0083,0.0222,-0.0172,0.0518,-0.0879,-0.0299,-0.0223,-0.0659,0.0096,-0.0121,0.0257,-0.0389,-0.0793,-0.0546,0.0734,0.0464,-0.0532,0.0098,0.0098,-0.0188,-0.0725,-0.0388,-0.0817,-0.073,0.0613,-0.0075,0.0296,0.0176,-0.0264,0.0132,-0.0554,0.0459,-0.0166,0.0445,0.0038,0.0338,-0.0148,-0.0202,-0.0218,0.0017,0.0213,-0.0355,0.0695,0.0378,0.1197,0.0476,-0.0089,0.025,0.0029,0.0292,0.005,-0.0832,0.0086,0.0151,0.1749,0.1176,0.1623,0.1315,0.0747,0.1199,0.0337,0.1242,0.0042,0.0699,0.1304,0.178,0.1607,0.141,-0.0237,0.0079,0.028,0.0291,-0.0398,-0.0429,0.0369,0.0231,-0.0569,0.0099,0.1264,-0.05,-0.0424,-0.0093,0.0943,-0.0089,0.0193,0.0406,0.0657,0.0139,0.074,-0.0056,-0.0645,-0.0478,-0.0577,-0.1532,-0.0551,-0.0587,-0.055,-0.0226,-0.0244,0.0335,0.0229,-0.002,0.0155,-0.0067,0.0335,0.0114,-0.0136,-0.0004,0.0095,0.0797,0.0945,-0.0638,-0.0465,-0.0448,0.0514,-0.0355,0.0251,-0.0085,0.0525,0.0166,0.0302,0.0029,-0.0565,0.053,-0.0441,0.0125,0.0886,0.035,0.0393,-0.0047,0.0379,0.0366,-0.0275,-0.0431,0.0329,0.0116,0.0219,0.0112,-0.0044,-0.038,-0.0275,0.0705,-0.0123,0.0136,-0.007,-0.0569,0.0599,0.068,-0.0059,0.0321,0.0265,-0.0314,-0.0006,-0.0337,0.0203,-0.01,0.0699,-0.0883,-0.0252,0.1197,0.0279,-0.0001,0.0027,-0.0362,-0.0325,-0.0555,0.0767,-0.0932,-0.0842,0.046,-0.0125,-0.0595,0.0205,-0.0043,-0.0343,-0.0706,0.0483,-0.0152,-0.0179,0.0123,0.0224,-0.1792,-0.1024,-0.1407,-0.0473,-0.1252,-0.0727,-0.0755,-0.0794,-0.0226,0.001,0.0093,0.0312,-0.0148,0.0576,-0.051,0.0263,0.0298,-0.0261,-0.0775,0.0364,0.0269,-0.0381,0.003,-0.0312,0.0341,-0.1159,-0.0014,-0.0609,0.0528,0.0891,0.1308,-0.0238,-0.0125,-0.0167,-0.0019,0.0339,-0.0772,0.0971,0.0395,0.062,0.0637,0.0578,-0.0034,-0.042,-0.0617,0.0076,-0.1242,-0.0025,-0.0801,0.0034,-0.0023,-0.0258,-0.0255,0.1102,-0.0795,-0.0328,-0.0411,0.0002,0.0193,0.1401,0.0672,0.0712,0.0087,0.0066,0.1353,0.1502,0.1199,-0.0105,-0.0577,-0.0713,0.084,-0.0061,-0.0522,-0.04,-0.0013,-0.0285,0.0136,0.0212,0.0539,0.0255,0.0259,0.0381,0.0132,0.0374,-0.037,-0.0641,-0.0522,-0.035,-0.0652,-0.0893,-0.038,-0.0039,-0.0085,0.0738,-0.0755,-0.0478,-0.0266,-0.0021,-0.069,-0.1373,0.0056,0.0082,0.1148,0.0891,-0.0101,-0.0062,-0.0616,-0.0249,0.0484,-0.0177,0.0239,-0.0212,0.0013,-0.004,-0.0226,-0.0445,-0.0403,-0.0008,0.0127,0.0329,-0.0065,-0.0048,0.0312,0.0293,0.0252,0.0202,0.0416,-0.0193,0.0022,0.0156,-0.0284,0.037,-0.0082,-0.0156,-0.0504,-0.0122,-0.1134,0.0628,0.0034,0.0142,0.0148,0.0315,0.008,0.0401,0.0392,-0.0306,-0.0325,0.0105,0.0378,0.0189,-0.0526,-0.0079,0.034,0.0661,-0.0196,-0.0052,0.0746,0.0005,0.0565,0.0557,0.0407,-0.0031,-0.0174,0.0096,0.0381,-0.0452,0.0507,0.0544,0.0063,0.0106,-0.0046,-0.027,0.075,0.0471,-0.0056,-0.0162,-0.0156,0.0036,-0.0273,0.014,-0.0135,0.0406,0.0196,-0.0277,0.0004,-0.039,0.0741,0.014,-0.0166,-0.0694,-0.0325,0.0214,-0.0181,0.0195,0.0362,-0.0003,0.0028,-0.0119,-0.0001,0.0224,-0.0255,-0.0188,0.0121,0.0235,0.0139,0.0354,0.0207,-0.0028,0.0384,0.0384,-0.0151,0.0305,0.013,0.0339,-0.011,0.1042,0.0842,-0.0731,-0.0354,-0.0374,-0.0159,0.0841,-0.0081,-0.0069,-0.0679,-0.042,-0.0061,-0.0119,-0.0104,0.0225,-0.0532,-0.0457,-0.0701,0.0596,0.1015,0.1025,0.0189,-0.0077,0.0318,0.1611,0.1139,0.0204,-0.1905,-0.0692,0.0043,-0.0005,-0.0267,-0.0148,0.0099,-0.0327,0.0451,-0.011,0.0355,-0.0873,-0.0317,-0.0036,-0.0076,-0.0083,-0.0668,-0.0111,0.0185,0.0002,0.0443,-0.0261,0.1687,0.1593,0.1037,0.0403,-0.0202,0.0306,-0.0588,-0.0366,-0.1138,-0.0351,-0.0253,0.0891,0.0751,-0.0076,-0.0498,-0.0134,0.0667,-0.064,0.0113,0.0231,-0.0612,0.1449,-0.0297,0.1619,0.1352,0.0839,-0.0038,0.1005,-0.059,-0.0087,-0.0199,-0.0416,0.0073,0.0137,-0.0044,0.0053,-0.0361,-0.0156,0.0269,-0.0212,-0.0488,-0.0261,0.0568,0.002,-0.0959,-0.0645,-0.0521,-0.0413,0.011,0.0666,0.0619,0.0039,0.0096,0.1119,0.0198,-0.0021,0.0291,0.0669,0.0864,0.036,0.0477,0.0251,0.025,0.0717,0.0229,-0.0099,-0.0512,-0.0102,0.0053,-0.008,0.0017,0.0188,-0.0003,0.0268,-0.0313,-0.0013,-0.0487,0.0409,0.059,-0.0123,0.001,0.0094,-0.0068,-0.0338,0.0144,0.0301,-0.0025,-0.0364,0.0172,0.0468,0.06,-0.0169,-0.0247,-0.0402,0.1338,-0.061,-0.0106,0.0561,0.0618,-0.0436,0.0044,-0.0164,-0.0083,0.0357,0.0035,-0.0611,0.0257,0.007,-0.0075,-0.0181,-0.011,-0.0554,0.068,0.0386,0.0369,0.0358,0.0511,0.0352,-0.0184,-0.0146,0.0273,0.015,0.0259,-0.0038,0.0182,-0.0014,-0.0634,-0.0327,-0.034,-0.0929,0.0209,-0.1121,-0.0845,0.0022,-0.0791,0.0029,0.0086,-0.006,-0.0336,0.0124,0.0019,-0.0795,-0.0488,-0.0501,-0.0541,-0.0373,-0.0401,-0.0461,-0.0929,-0.0197,0.0206,0.0593,-0.008,-0.0201,-0.0329,-0.007,0.0141,0.047,0.001,0.0321,-0.0537,-0.0185,0.0268,0.027,-0.0181,-0.0484,-0.0321,-0.0556,-0.0597,0.0016,-0.0078,0.0537,0.0423,-0.0075,-0.0543,0.0578,0.0561,0.0537,0.045,0.0502,0.0458,0.1058,-0.0532,0.0041,-0.0386,0.0065,-0.0223,-0.0772,0.0153,0.0071,-0.023,-0.0617,-0.0999,-0.0766,0.0449,0.022,0.0507,-0.0089,-0.0148,0.0032,-0.0528,-0.0164,-0.0041,-0.053,0.0449,-0.0112,-0.0507,-0.0382,-0.0053,0.097,-0.0303,0.0294,-0.0228,0.0269,0.003,0.0644,-0.0283,-0.0337,0.0378,0.0611,0.0107,0.0136,0.0021,0.0419,-0.0015,-0.0346,-0.0424,-0.0732,-0.0457,-0.0448,-0.0735,-0.0491,-0.0271,0.0341,-0.0139,0.0171,0.0109,0.0341,0.0617,-0.0204,-0.005,-0.0866,-0.0007,-0.0276,0.0012,-0.0084,-0.0438,-0.0346,-0.0143,0.0161,-0.0216,-0.0589,-0.0277,0.065,-0.0159,0.0052,0.05,-0.0467,-0.0651,0.0044,-0.0123,-0.0614,0.0244,0.0434,-0.0323,-0.0535,0.0206,-0.0525,0.0507,-0.0355,0.0156,-0.0681,-0.0454,-0.0743,-0.0497,0.0016,0.04,0.0376,-0.0444,0.0179,-0.0012,0.0019,-0.009,0.0322,-0.0251,0.0827,0.0171,-0.0021,-0.0363,-0.0491,-0.0276,0.083,0.0113,-0.0257,-0.0531,0.0613,0.0291,-0.0863,-0.0696,-0.0219,-0.0652,-0.0363,0.0245,0.0213,0.1209,-0.0141,0.0103,0.0065,-0.0743,-0.0578,-0.0144,-0.0178,0.0754,0.0755,-0.0071,-0.007,-0.0265,-0.066,0.0378,-0.0234,-0.022,0.049,0.0334,-0.066,-0.0532,-0.0691,-0.0069,0.1319,0.0222,0.0538,-0.084,0.0091,0.0575,0.0356,-0.0179,0.0004,0.1709,0.1568,0.015,0.0283,0.0209,0.0273,0.0741,0.0004,-0.0244,-0.0901,-0.025,-0.0379,-0.1213,-0.0608,-0.0513,-0.0857,0.0495,-0.0244,0.056,-0.0075,-0.0363,0.0064,0.0232,-0.0062,0.0223,0.0793,0.066,-0.0261,-0.1021,0.0019,0.1491,0.1563,0.0205,-0.0103,-0.0763,0.0748,-0.0472,-0.0442,-0.0392,0.0097,-0.012,-0.0723,0.0071,-0.0211,0.1496,0.059,0.1892,0.0204,-0.0242,0.0603,0.0157,0.0683,-0.0167,0.0279,0.0397,-0.1252,-0.0483,-0.0234,0.0649,0.0017,-0.0157,0.0206,0.0418,-0.0118,0.0278,-0.0933,-0.013,-0.045,0.0031,-0.026,0.041,0.0353,-0.085,0.0166,-0.1408,-0.0733,0.0108,0.0273,0.0133,-0.0327,-0.0067,0.0275,0.0832,0.1092,-0.0797,0.0248,0.0041,0.0096,0.0411,-0.036,-0.0085,-0.0478,0.0045,-0.0094,0.0451,0.1064,0.0307,-0.0336,0.0176,-0.0356,0.0425,0.0304,-0.0802,0.0013,0.0351,-0.0185,0.0404,-0.0309,-0.0312,-0.0586,0.0549,0.0078,-0.0726,-0.0254,0.0339,-0.0665,0.0136,0.0659,0.0914,0.0252,0.0146,0.0145,0.0169,0.1607,-0.0004,0.0223,-0.0049,0.0103,-0.0492,-0.0235,-0.043,-0.0568,-0.042,-0.008,0.006,-0.0742,0.1566,0.1529,0.126,-0.0081,-0.0544,-0.0528,-0.0506,-0.0831,-0.1054,-0.008,0.0342,-0.1201,-0.0814,-0.1324,0.0154,-0.0777,0.0524,-0.0249,0.0347,0.0056,-0.0392,-0.0423,-0.042,-0.0113,-0.058,0.0215,-0.0344,-0.0678,-0.0135,-0.0258,0.0062,0.0248,-0.0039,0.0992,-0.0501,0.0436,0.0124,0.0549,-0.0207,-0.0005,-0.0281,-0.0746,-0.0591,-0.0297,-0.0011,0.0332,-0.0313,-0.046,-0.0444,-0.0206,0.0266,0.0336,0.0001,-0.0315,-0.0192,0.0252,0.0911,0.0113,-0.0259,-0.0083,-0.0452,-0.087,-0.0319,-0.0217,-0.0148,0.0399,-0.1163,-0.0828,0.0084,-0.0286,-0.0582,-0.0371,0.0163,0.0725,0.0482,0.036,0.0159,-0.0645,0.091,-0.0264,-0.0093,-0.018,0.0042,0.0164,0.0588,-0.0037,0.0361,-0.0111,-0.0031,0.0978,0.0181,-0.0298,0.0474,0.0079,0.0062,0.0978,0.0481,0.0801,0.0351,-0.0012,0.0527,0.011,0.0128,-0.0269,0.0139,0.0172,-0.0303,-0.0095,0.0088,0.0293,0.0257,0.0731,-0.0284,0.0135,0.0522,-0.0333,-0.0159,-0.0289,-0.0252,0.0215,-0.0004,-0.0626,-0.0439,0.0113,-0.0294,0.0019,-0.0362,-0.1247,-0.0802,-0.0121,-0.019,0.0174,-0.0662,0.0206,0.0492,0.0319,-0.0683,-0.0457,0.1265,0.1419,-0.0059,-0.0321,0.0211,0.0065,0.0152,0.0442,0.0223,-0.0355,-0.0675,0.0098,-0.0099,-0.0005,-0.0394,-0.0317,0.0707,0.0372,-0.0016,-0.0167,0.0964,0.0101,-0.0274,-0.009,0.0263,0.0134,0.0466,0.0465,0.1348,-0.0108,-0.0166,0.1857,-0.0643,-0.0625,0.0109,-0.0598,-0.0201,0.0417,0.046,-0.0353,0.0786,-0.0576,-0.0507,-0.0505,0.0015,-0.0796,-0.046,-0.0028,0.0131,0.0287,-0.003,0.118,0.0083,0.0367,-0.0333,-0.0485,-0.0363,-0.0682,0.0012,-0.0163,0.0394,0.0163,-0.0156,-0.0109,-0.0278,0.0322,-0.0727,-0.0156,-0.0252,-0.0805,-0.0861,-0.0898,-0.0971,0.0649,-0.0248,0.0852,0.059,-0.0339,-0.0535,-0.0006,0.0758,-0.0477,0.032,0.0157,0.0298,0.0216,0.0775,-0.0106,-0.0318,-0.0602,-0.0748,0.0286,-0.013,-0.0597,-0.0113,0.0683,-0.0161,-0.0115,-0.0459,0.0229,0.0221,0.128,0.0222,0.0316,-0.0303,-0.0175,0.0133,0.0649,-0.0082,0.072,-0.0167,0.0416,-0.0765,0.0311,0.0727,-0.0081,-0.0005,-0.0294,0.0195,0.037,0.0357,0.0427,0.0881,-0.1007,-0.0599,-0.0334,0.141,0.0258,0.0884,-0.023,-0.0044,0.0254,0.0877,0.0197,0.0735,0.0414,0.0514,0.0133,0.0213,-0.0908,-0.0345,0.0224,0.0219,0.0254,-0.0221,0.067,0.0332,-0.0003,-0.1008,-0.0425,-0.0714,-0.0371,0.0127,-0.0314,0.0417,0.0492,-0.0484,-0.0761,-0.0112,0.0183,0.025,0.0456,-0.0043,-0.0278,-0.0334,0.0379,0.0284,-0.0169,0.0118,0.0161,-0.0289,0.0074,-0.0199,0.0264,0.0118,-0.0337,-0.0205,0.0404,-0.0342,0.0111,0.0035,0.0035,0.0454,-0.0448,0.02,0.0981,-0.0325,-0.0433,-0.065,0.0498,-0.0454,0.0727,-0.0547,-0.0279,0.0905,0.0134,0.0369,0.0183,-0.0468,0.0315,0.0513,0.0507,0.0572,0.0158,-0.1337,-0.0195,0.0534,-0.0769,0.0102,-0.0202,0.0428,-0.0175,0.0234,0.0235,0.0452,-0.0601,0.0194,0.0222,-0.0306,-0.0169,-0.0745,0.0123,-0.0051,-0.0833,0.0329,-0.0419,0.021,-0.0069,-0.0176,0.0059,-0.01,-0.0029,0.1332,-0.0125,-0.1049,0.0112,-0.0332,0.0072,0.008,0.0536,0.0435,0.0581,0.0622,0.0402,0.0471,-0.044,-0.0512,0.0357,-0.0448,-0.044,-0.0477,-0.0662,-0.0098,-0.0271,0.0132,-0.1587,-0.1801,-0.1176,-0.1106,-0.0862,-0.0993,-0.0716,-0.1037,-0.0705,0.0354,-0.0302,-0.0212,-0.0663,-0.0943,-0.0683,-0.0291,-0.07,-0.0005,-0.047,-0.0614,0.0091,-0.0743,0.0488,0.0274,-0.0046,0.1112,-0.0542,0.0198,0.0264,-0.0034,0.0167,0.0937,0.0313,0.0218,0.0143,0.0549,-0.064,0.0078,-0.0255,-0.0282,0.0242,-0.0043,0.0288,0.0521,0.0237,0.0361,0.0748,-0.0365,0.0731,0.0884,0.0307,0.0279,0.0523,-0.0385,-0.0306,-0.0159,0.053,-0.0415,0.0582,-0.0282,-0.0636,-0.1075,-0.0342,0.006,-0.0086,-0.0128,-0.012,-0.1078,-0.0439,-0.0139,-0.0389,-0.0583,0.0332,0.0219,-0.024,0.036,0.0353,-0.0033,-0.0395,-0.0535,0.0923,social cognition
trm_557b491318742,-0.0698,0.0106,-0.061,-0.0297,-0.0429,0.0019,-0.0375,-0.024,-0.0344,-0.0311,-0.0953,-0.091,0.0034,-0.0134,-0.0155,0.0107,0.0162,-0.0839,-0.0476,-0.048,-0.0304,-0.0334,0.033,-0.0415,-0.0392,-0.0598,-0.0561,-0.0036,0.0361,-0.0193,0.0083,-0.0612,0.0129,-0.0186,0.0371,0.0702,-0.0279,0.0245,0.0139,0.0065,0.0209,0.0186,0.0048,-0.0159,0.0025,0.043,-0.0548,-0.0269,-0.0247,0.0448,0.0664,-0.0314,-0.0219,-0.0781,0.0179,0.0185,0.0871,-0.0425,-0.0155,-0.0175,-0.0304,-0.03,0.0387,-0.0557,-0.023,0.0406,-0.0421,-0.0249,-0.0296,0.0237,-0.0152,0.0007,-0.0367,0.01,0.0091,-0.0048,0.0533,-0.0645,-0.0885,0.1078,0.0082,-0.0147,0.0243,0.0013,-0.0344,0.0458,0.0478,0.0043,-0.0507,0.4253,0.0518,0.036,0.021,-0.1254,-0.0705,-0.0843,-0.0385,-0.0024,-0.0373,-0.0092,0.015,-0.012,-0.0432,-0.049,-0.0537,0.0297,-0.0088,0.0147,0.0529,0.0379,-0.0581,-0.019,-0.0006,-0.053,-0.019,0.0228,-0.0369,0.0409,-0.0703,-0.0171,-0.0154,0.0237,-0.0132,0.0084,-0.0012,0.0147,0.0019,-0.0306,-0.0624,0.1342,0.0556,0.011,0.0038,0.1412,0.0532,-0.0518,-0.0851,0.001,0.0331,0.0169,-0.0452,-0.0141,-0.0176,-0.0053,-0.0408,0.0032,-0.0306,-0.0413,0.0059,-0.0054,0.0044,-0.0204,0.0146,0.0074,-0.0021,-0.0079,-0.0678,-0.0373,-0.0225,0.002,-0.0134,0.0217,-0.0359,0.0452,0.0292,0.0067,0.0276,-0.0181,-0.0342,-0.0024,0.05,-0.0452,0.0248,0.0915,0.0843,0.0979,0.0749,0.0035,0.0169,-0.0278,0.1137,0.0256,0.0328,-0.0331,0.0071,0.0225,0.0402,0.0691,0.0379,-0.0453,-0.0442,-0.0183,-0.0133,-0.0743,-0.0757,0.0762,0.0292,-0.0036,-0.0266,0.1346,0.0464,-0.0812,-0.0163,0.0651,-0.0883,0.1993,0.0929,-0.0436,-0.0432,-0.0399,0.0426,0.0027,-0.0114,0.0151,-0.011,0.0281,0.0173,-0.0306,0.0276,-0.0295,-0.0484,0.0226,0.0678,0.0198,-0.0404,-0.009,0.0021,0.026,0.109,-0.1279,0.0143,0.06,-0.0314,0.0151,0.0239,0.0569,0.0279,-0.0931,0.0557,0.0522,0.0005,-0.0082,-0.0134,-0.0203,-0.0419,0.0078,0.0303,0.016,0.0793,-0.01,-0.0415,0.0192,0.0221,-0.004,0.0816,-0.0323,0.0373,-0.0343,-0.0273,0.003,0.0392,-0.0151,-0.0369,-0.0296,-0.0503,-0.0438,-0.0276,-0.0266,0.0065,-0.0228,0.0189,0.0043,0.0396,-0.0243,0.2417,0.3069,0.4553,0.4791,0.3713,0.2914,0.2189,0.0512,0.0376,0.0498,0.0523,0.0138,0.0215,0.0212,0.0099,0.026,-0.0312,0.0275,0.0169,0.014,0.0538,-0.0008,-0.0202,-0.0279,-0.0066,-0.051,-0.0451,-0.0249,0.0657,0.0532,-0.0577,-0.0628,0.0092,0.0652,0.128,-0.0459,0.0276,0.0278,-0.0143,-0.0613,-0.0437,0.0116,-0.0747,-0.0212,-0.0254,-0.0489,-0.0186,-0.0465,0.0562,0.034,0.0551,-0.0349,0.0154,0.0741,-0.0324,0.0223,0.0085,-0.0363,-0.0552,-0.0499,-0.0381,0.0005,-0.0108,-0.0155,0.0086,-0.005,-0.0077,-0.0362,0.0225,0.0165,-0.0336,0.0122,0.0652,0.0168,0.0418,0.0739,0.0315,-0.0512,0.0785,0.0664,0.0497,0.0504,-0.0224,0.0104,0.0416,0.0517,-0.0618,-0.0179,0.0262,-0.0485,-0.0188,0.0094,0.0389,-0.1223,0.0309,-0.0626,-0.0329,-0.0715,0.0302,-0.0459,-0.0028,-0.0415,0.0145,-0.0721,0.0182,0.0786,0.0455,-0.0645,-0.0778,-0.0729,-0.0767,-0.0359,-0.0103,-0.0056,-0.0352,-0.0001,0.0535,0.0226,-0.0155,-0.0053,-0.1994,-0.1451,-0.0148,0.0213,0.0267,0.0478,-0.0018,-0.0257,0.0373,0.0311,0.016,0.029,-0.0557,-0.0139,0.0223,-0.0048,-0.0075,-0.0089,-0.0259,-0.0899,0.0152,0.0227,-0.0969,-0.0721,-0.0349,-0.0652,-0.027,-0.0116,0.0058,0.0449,0.0407,0.006,0.0639,-0.0591,-0.0141,-0.0135,-0.0158,0.0103,0.0417,-0.0064,0.0478,-0.0666,0.0587,0.1233,0.0111,-0.0223,0.0508,-0.0158,-0.0207,-0.0396,-0.0275,-0.01,0.1046,0.0396,-0.0198,-0.0879,-0.1032,-0.05,0.0495,0.0247,-0.0591,-0.024,0.0637,-0.0475,0.0343,-0.0149,-0.0844,-0.01,0.0231,0.0386,-0.022,0.097,-0.0445,-0.1453,0.045,0.0942,0.0438,0.0449,-0.0851,0.0194,0.1093,0.0052,-0.0091,0.0018,0.0267,-0.0424,0.048,-0.0115,0.0081,-0.0813,-0.0704,-0.0264,0.0243,-0.0423,0.0047,-0.0275,0.0877,0.0477,0.064,0.0888,0.0234,0.0225,0.1582,-0.0065,0.0333,-0.052,-0.0482,-0.0049,0.0492,-0.0222,-0.0256,-0.0134,-0.0306,-0.0022,0.0099,-0.0797,-0.0189,0.0449,-0.0442,0.0332,-0.0451,-0.0371,-0.027,-0.0293,0.0756,0.0209,0.0328,0.067,-0.067,-0.1041,-0.1026,-0.0504,0.0343,0.0723,0.0867,-0.0185,0.0381,0.0038,0.0069,0.0053,-0.008,0.0775,0.0146,0.0283,-0.0057,0.0258,0.025,-0.0195,0.0502,0.0777,0.002,0.0183,-0.0469,-0.0001,0.0329,-0.0144,-0.0406,-0.0388,-0.0108,0.0581,0.0355,0.0337,-0.0593,-0.0162,-0.0054,0.0463,-0.0105,-0.0284,-0.0381,0.0092,0.0774,0.1023,0.0117,0.0753,0.0127,0.0436,0.0206,-0.0038,0.0814,0.017,-0.0073,-0.0085,0.0614,0.0343,-0.0045,-0.0313,0.0255,-0.0321,-0.0075,0.0057,-0.0652,-0.0585,-0.1272,-0.0035,0.0071,-0.026,0.0784,-0.0432,-0.0815,-0.0344,0.0395,-0.0694,-0.0266,0.0129,-0.0748,0.0904,0.051,-0.0183,-0.0702,0.0937,-0.0613,-0.0713,0.0941,-0.0494,-0.0626,-0.1036,-0.0412,-0.0139,-0.0639,-0.0159,-0.0034,-0.0479,-0.043,0.0343,0.0279,-0.0264,-0.016,0.0304,0.0068,-0.0434,0.0949,-0.0155,0.011,0.0239,0.0079,0.0017,-0.0244,-0.1015,0.0157,-0.0314,-0.0936,-0.0229,-0.0742,0.0616,0.0106,0.0082,0.0647,-0.0362,0.025,-0.0576,0.002,0.0435,-0.0073,0.0041,-0.0756,-0.0253,-0.0944,0.0148,-0.0447,0.0319,0.0012,0.0413,-0.1004,0.0047,-0.0132,0.0322,0.0052,-0.0104,-0.033,-0.0562,-0.0027,-0.0225,0.0022,0.0264,0.1165,-0.1549,0.0042,-0.0239,0.0249,0.1314,0.0092,-0.0261,0.0409,0.0016,0.0222,0.0006,-0.0664,-0.0246,-0.0212,0.0717,0.1308,0.0178,0.0041,-0.0168,-0.0321,0.0083,-0.1767,-0.0778,-0.1116,0.0504,-0.0221,0.0111,0.024,0.0671,-0.0014,-0.0228,-0.0324,-0.0304,-0.0578,0.0067,0.0027,-0.0364,0.0312,0.0757,0.0912,-0.0099,-0.0192,-0.0857,-0.0838,-0.0015,-0.1067,-0.012,-0.0653,0.1612,0.0203,-0.0006,0.0283,-0.0104,0.025,0.0275,0.0328,-0.0302,-0.0371,-0.0309,-0.0235,0.0059,0.0391,0.0247,0.0347,-0.1029,-0.073,0.047,0.0905,-0.0651,-0.0911,-0.1104,-0.0043,0.0019,-0.0141,0.0171,-0.066,-0.0628,-0.0479,0.0631,-0.002,0.0003,0.0572,-0.0017,-0.0064,0.0059,-0.0016,0.0077,0.0087,-0.0754,-0.0629,0.0936,-0.0056,0.0163,-0.0234,0.0886,-0.0395,-0.0158,-0.0476,0.0031,0.0381,0.0299,0.084,0.0093,0.0792,-0.0174,-0.0444,0.018,-0.0481,0.0245,-0.0124,-0.0019,-0.0158,0.0031,0.0064,-0.0423,-0.0282,0.0215,0.0531,-0.0158,-0.0017,-0.0539,0.0099,0.0305,-0.0261,0.0325,0.0643,-0.0192,-0.0632,0.052,-0.0308,-0.0434,-0.0371,-0.0895,-0.0129,-0.0391,0.0306,0.0537,-0.0017,0.0587,-0.0196,-0.0251,-0.0453,-0.0271,-0.0402,-0.0278,0.02,0.0196,0.0604,-0.0009,0.1202,-0.0166,0.0484,-0.0527,-0.0337,0.0001,0.0162,0.0399,-0.0218,-0.0395,0.0244,-0.0052,0.0152,0.043,0.0116,-0.0058,0.0168,-0.0456,-0.0444,0.0112,-0.0304,-0.0207,0.0037,-0.0539,0.0129,-0.0331,-0.0257,0.02,-0.0581,-0.0565,0.0647,-0.0446,-0.0394,0.0721,0.0007,-0.0374,-0.0069,-0.1149,-0.0964,0.013,-0.0242,0.027,-0.02,0.0255,0.029,-0.0359,0.0716,0.0301,-0.0571,-0.0313,-0.0926,-0.019,-0.0247,-0.0056,-0.0585,0.0002,-0.0501,-0.1695,-0.0639,-0.1555,0.0351,0.0338,-0.0496,-0.0306,-0.027,-0.0602,-0.0046,0.0192,-0.0096,-0.0436,-0.0012,-0.0047,0.0071,0.0398,0.0591,-0.0694,0.0584,0.0329,-0.0563,0.0016,0.0275,-0.0094,-0.0042,0.0024,-0.0125,-0.075,-0.0356,-0.0694,-0.0565,-0.04,-0.0567,0.0351,-0.0629,0.0576,-0.0084,-0.0641,-0.0838,-0.0333,-0.0008,0.0367,-0.0792,-0.0534,-0.0118,0.0925,0.0121,-0.0342,0.0743,0.0227,0.0116,-0.0079,-0.0365,0.0377,0.0757,0.0132,-0.0119,0.0321,-0.0285,0.0271,0.0423,0.0003,-0.0386,-0.0408,-0.0319,0.1435,0.0306,0.1237,0.0423,0.0489,0.091,0.0748,0.0566,0.0924,0.0707,0.1309,0.0756,0.0745,0.03,-0.0122,-0.0448,0.0515,-0.0341,0.0452,0.0225,-0.0246,-0.0559,-0.0678,-0.0289,0.0477,0.0688,-0.0398,0.0038,-0.0007,-0.0284,-0.01,0.0304,0.0382,0.0785,0.0224,0.0854,0.014,0.0042,0.0885,0.2113,0.0565,0.0087,-0.0275,-0.0531,-0.0698,-0.0688,-0.0252,-0.012,-0.0448,-0.0193,0.0085,-0.0103,-0.076,-0.0421,0.0107,-0.0022,-0.0767,-0.014,0.0059,-0.0311,0.0346,-0.0104,-0.0137,-0.0057,0.0549,0.0084,-0.017,0.0552,-0.0167,-0.0387,0.0034,-0.0944,0.0018,-0.0295,0.0489,0.0396,0.0246,-0.011,0.01,0.0382,-0.0442,0.0353,0.1425,-0.0181,-0.0993,-0.0089,-0.0045,0.0356,-0.0316,0.003,-0.0512,-0.0663,-0.1092,-0.1494,-0.1073,-0.0794,-0.0492,0.0145,-0.0274,0.0297,-0.0174,-0.0099,-0.0333,0.0319,0.0292,-0.0052,0.0023,0.0284,0.0482,-0.0445,0.1141,0.0702,0.0333,0.0117,0.0135,0.0181,0.0074,0.0429,-0.0521,-0.0428,0.0077,0.0111,-0.0717,0.0228,-0.0336,0.0366,-0.0133,-0.0263,0.0691,0.0678,0.0282,0.0114,0.0894,0.0483,0.0613,0.0128,0.1143,0.0528,-0.0068,-0.0292,0.0461,0.01,0.0018,0.0664,-0.0406,0.0318,-0.0304,0.0303,0.0302,-0.1113,-0.0741,-0.069,-0.0659,-0.0663,-0.0035,-0.0652,-0.041,-0.0745,-0.0151,-0.0484,-0.0322,-0.0101,-0.0121,0.0797,0.0757,0.0525,0.0328,0.0304,-0.0039,0.0659,-0.0333,0.0127,0.0538,0.0093,0.0098,0.0111,-0.0191,0.0351,-0.0598,-0.0324,-0.0329,-0.0304,-0.0528,0.0433,0.0455,-0.0159,-0.0196,0.0082,0.0663,0.054,0.0254,0.0246,0.1087,0.0364,0.0502,0.1229,0.0709,0.0077,-0.0471,-0.0772,-0.1173,-0.0107,0.0184,0.0303,0.0447,-0.1026,-0.1274,-0.0934,-0.0595,0.025,-0.0735,-0.0796,-0.0061,-0.0112,-0.0214,-0.0336,-0.0418,-0.0205,0.0308,0.072,0.0069,-0.0069,0.0254,-0.0689,-0.029,0.0145,-0.073,-0.0162,-0.03,0.0056,-0.0375,0.0174,0.0682,0.0048,-0.0809,-0.0741,0.0399,-0.0032,0.0599,0.0877,-0.0404,-0.0206,-0.0691,-0.035,-0.0383,0.0841,-0.0677,0.0255,0.0424,-0.0637,-0.0481,0.0243,-0.1071,0.0364,-0.1211,-0.1357,-0.0272,0.0798,-0.081,-0.0631,-0.0664,0.0683,0.0325,-0.0669,0.0009,-0.0186,-0.0268,0.0375,0.052,0.0867,0.0462,0.0732,0.0788,0.033,0.078,0.0641,0.0333,-0.0898,-0.0389,0.0353,-0.0541,-0.0518,-0.0415,-0.0273,-0.0645,0.0179,-0.015,-0.0175,-0.0256,0.0294,-0.06,-0.0047,0.0148,-0.0274,0.0333,0.0566,-0.0728,-0.0098,-0.0553,0.0543,-0.038,-0.053,-0.0507,-0.0387,0.0117,0.0242,0.0059,0.0038,-0.0747,-0.0747,0.0066,-0.0704,-0.0204,-0.0633,-0.0172,-0.0663,0.0292,-0.0979,0.018,0.0028,0.0071,0.093,-0.0328,-0.0259,0.0312,-0.0349,0.0152,-0.0235,-0.0103,0.0477,-0.0863,0.1252,0.1595,0.055,0.0422,-0.047,0.0388,-0.0209,0.0542,0.0193,-0.0086,0.0787,0.0481,-0.027,0.3505,0.1068,0.0018,-0.1015,-0.0795,-0.0921,-0.0192,-0.0788,0.0745,0.0374,-0.0754,-0.0129,0.0206,0.0115,-0.0525,0.0171,-0.0346,-0.0073,-0.025,-0.0324,0.0065,0.0098,-0.0045,-0.0209,0.3041,0.2622,0.013,0.0804,0.045,-0.0294,-0.0101,-0.0414,-0.0023,-0.0442,0.01,0.0931,0.0421,0.0799,0.4247,0.4185,-0.0745,-0.0001,0.1912,-0.0491,0.0428,0.0398,-0.0609,-0.0005,-0.0397,-0.0041,-0.0129,0.0659,0.1046,0.0214,0.0282,-0.0679,0.0025,0.0644,-0.0365,0.0034,-0.0271,0.0629,-0.0039,0.0043,-0.0644,-0.0591,0.0822,-0.0745,0.0162,-0.01,-0.0298,0.0509,0.0142,-0.022,0.0004,0.0069,0.0535,0.0908,-0.0174,0.0051,0.0803,0.0355,0.0206,0.038,0.0124,0.0337,-0.0437,0.0236,0.0253,0.0218,0.0435,-0.0311,-0.0554,-0.1257,0.0194,-0.038,-0.0711,-0.1088,0.0132,0.0174,-0.0278,-0.0769,-0.0684,-0.0196,-0.0037,-0.076,0.0238,0.0063,-0.0315,0.0318,0.0017,0.0338,0.0678,0.0357,-0.0108,0.0407,0.0015,-0.0869,0.0269,-0.0244,0.0584,-0.0342,-0.0348,-0.0458,0.0001,-0.0315,-0.0191,0.0723,0.07,-0.0268,0.0134,-0.0219,0.0015,0.0519,0.0411,0.0875,0.0218,-0.0666,-0.067,-0.0236,0.0135,-0.0233,-0.0586,-0.0119,0.0715,0.0492,-0.0182,0.0153,0.0072,0.0017,0.0722,0.0198,0.076,0.0646,-0.0029,0.0267,0.0409,-0.0181,0.0814,0.0296,-0.0003,-0.0943,-0.0417,-0.0938,-0.0555,0.0183,0.0387,-0.0173,0.0567,-0.0192,-0.0117,-0.0141,0.0257,0.0015,0.0445,-0.0172,-0.1001,-0.0241,0.097,0.0495,-0.0232,-0.0466,0.02,0.0034,-0.0378,-0.0427,0.1862,0.0785,0.1142,0.131,0.1189,-0.0053,0.0108,0.0787,-0.0149,0.1961,0.0101,-0.0414,-0.0862,0.0638,-0.0038,0.1321,-0.0042,-0.0312,0.0494,0.0617,0.025,0.0219,0.0478,0.0955,0.0371,-0.0089,-0.1112,-0.0565,0.0361,-0.0709,-0.0235,0.0379,0.0123,0.0629,0.0145,0.0613,-0.0254,-0.111,-0.0375,-0.0171,-0.0044,-0.0083,-0.1394,-0.1343,0.0773,0.0444,-0.0182,-0.0013,0.0151,-0.0594,0.0593,0.0278,-0.0521,0.0485,-0.0442,-0.0151,-0.0563,0.0073,-0.0542,0.0222,-0.0574,-0.0506,-0.0945,-0.0393,-0.031,-0.0152,0.0653,-0.0285,0.0411,0.0189,-0.0304,-0.0604,-0.1233,-0.0728,0.0614,-0.0198,-0.0058,-0.0264,-0.0229,-0.046,0.0687,0.0605,0.0424,-0.0388,-0.0228,-0.0465,-0.0201,0.0156,-0.0481,0.0021,0.0158,0.0298,-0.0121,-0.0094,0.0981,0.1542,0.0754,0.0347,-0.0138,0.0029,-0.0074,-0.0007,-0.0133,-0.0355,0.0097,0.0034,-0.043,-0.1224,-0.0901,-0.0304,-0.1198,-0.0172,0.0002,-0.1237,0.1358,0.0383,0.1102,0.0604,-0.0005,0.0213,-0.0123,0.0478,-0.0021,-0.0919,-0.0698,0.0264,0.0485,-0.0808,-0.0564,-0.0142,-0.0812,-0.0754,0.0862,0.0503,-0.0072,0.0378,0.0711,0.0309,0.0192,-0.0172,0.0265,-0.0129,-0.0847,-0.0537,0.0919,-0.0069,-0.0266,-0.005,-0.0127,0.0527,-0.0461,-0.0368,-0.0231,0.1702,-0.0455,-0.0574,-0.0125,-0.0442,-0.0375,0.368,0.3396,0.4463,-0.022,-0.0421,-0.0645,-0.1057,-0.0054,-0.0672,0.0323,-0.1603,-0.0675,-0.1919,-0.0137,0.0793,0.1362,-0.0265,-0.0393,0.0103,-0.0658,-0.0359,-0.0422,-0.0372,-0.0205,-0.1074,-0.0774,0.0648,-0.0485,0.0024,0.0061,-0.0039,0.1249,-0.0305,-0.0511,0.0079,0.0114,0.0219,-0.0254,0.1223,0.0306,-0.0604,-0.0719,0.017,-0.0474,-0.0473,-0.0348,-0.0913,-0.0046,-0.0208,0.0022,-0.0001,-0.0703,-0.0712,0.0689,0.0712,0.0239,-0.0087,0.0484,-0.0009,-0.0427,0.0117,-0.0231,-0.0232,0.0176,-0.0591,-0.0658,-0.031,0.0589,-0.0311,-0.0358,-0.036,0.0914,-0.053,-0.034,-0.0286,-0.0387,-0.0244,-0.056,0.0611,-0.0388,0.0245,-0.003,0.0009,-0.0062,-0.0216,-0.049,-0.0275,0.0189,-0.0184,0.0162,0.1135,0.0586,0.0343,0.0005,-0.0276,-0.0024,-0.0261,0.099,-0.0337,-0.0256,-0.0115,0.0048,-0.0275,-0.057,-0.0294,-0.0244,0.0412,0.0314,-0.0325,0.0649,0.0414,-0.0448,-0.05,0.0046,0.0092,0.1208,0.0037,-0.1371,-0.0429,-0.0629,-0.0569,-0.0445,-0.0471,-0.0509,-0.0513,-0.0927,0.0066,-0.0411,-0.0172,-0.0352,0.0281,0.1104,0.0572,-0.0273,-0.0011,0.0053,-0.0267,-0.0097,0.0716,0.0275,-0.0383,-0.0338,-0.0291,0.0173,-0.0184,-0.041,0.0931,-0.0235,0.1298,0.0799,0.0092,-0.0222,-0.0405,0.1213,0.1189,0.0843,0.0069,0.0033,0.0342,0.0916,0.0941,0.0224,-0.0447,-0.0256,0.0433,-0.051,-0.0234,0.1387,0.0914,0.1487,0.0211,0.0269,-0.0161,0.0153,0.0127,0.0181,-0.0167,0.0476,0.0921,0.0226,0.0118,0.0272,0.0912,0.0008,-0.0394,-0.055,0.0063,0.0705,0.0152,-0.0145,-0.0773,-0.0341,-0.03,-0.0015,0.0479,-0.0069,0.0354,-0.0119,-0.0069,-0.0122,-0.0427,-0.0092,-0.0895,-0.0866,-0.0393,-0.0878,-0.0715,-0.0895,-0.1102,-0.0858,-0.0254,-0.0434,-0.0381,-0.0779,-0.0667,-0.0985,-0.0667,0.0001,-0.0562,-0.0208,-0.08,0.1506,-0.0718,-0.0365,0.1377,-0.0528,-0.053,0.2057,0.0661,0.1022,-0.0081,0.3141,0.2942,0.1333,-0.0817,-0.0405,-0.0927,0.0204,0.172,0.1119,-0.0244,-0.0505,-0.0153,-0.0485,-0.0233,-0.0769,-0.0153,0.0088,0.0584,-0.0267,0.0238,0.0192,-0.0111,-0.0235,0.0089,0.0224,0.0015,0.037,0.0492,0.0372,0.0173,0.0168,-0.0242,0.0067,0.0308,-0.0239,0.011,0.0623,0.0354,0.027,-0.0125,-0.0304,-0.0297,-0.0284,-0.0239,-0.0411,-0.102,-0.0465,0.059,-0.0177,-0.1056,0.0316,0.1028,0.0197,0.0315,0.0943,-0.0988,-0.008,-0.0627,0.051,0.0255,0.0042,0.0147,0.2666,0.0565,0.0033,-0.027,-0.0824,-0.0231,0.007,0.0206,-0.0105,-0.0508,-0.0072,0.0026,0.0436,0.0677,0.0322,-0.1127,-0.0678,-0.0,-0.1278,-0.1126,-0.0732,0.0166,-0.0956,-0.0506,0.0092,0.0026,-0.1037,-0.0461,-0.0431,-0.0466,-0.0366,0.0047,-0.0409,-0.0423,-0.0196,-0.005,-0.1265,-0.0771,-0.0558,-0.0092,-0.0673,-0.0675,-0.1013,-0.0838,-0.0927,-0.0244,0.0273,-0.009,0.069,0.0082,0.1295,0.0066,-0.0081,-0.0157,0.0249,-0.0398,-0.0414,-0.0122,0.0169,0.0281,0.0645,0.0405,-0.1008,-0.1118,0.0825,0.0217,0.0791,0.0025,0.0182,-0.0118,0.0273,-0.0176,-0.0042,0.045,0.0187,-0.0003,0.0041,0.0458,0.087,0.0366,-0.0987,-0.0912,0.0131,-0.0341,-0.0217,-0.0941,-0.0172,0.0058,-0.0357,0.0096,-0.0114,0.0928,-0.0565,-0.0647,-0.0402,0.0234,0.0396,0.0427,0.072,0.0498,-0.0343,0.0846,0.0808,-0.0172,0.0205,-0.0091,-0.0747,0.0146,0.0496,0.051,-0.0378,-0.0188,-0.0255,0.0652,0.0764,-0.0589,-0.0556,0.0005,-0.0536,-0.0242,0.0289,-0.1388,-0.1419,-0.083,-0.0408,0.0912,-0.0201,-0.0477,-0.1124,-0.0918,-0.1099,-0.0697,-0.0198,0.012,-0.0288,-0.0282,-0.0538,-0.0502,0.0331,0.0217,-0.0086,0.0154,0.0158,-0.0027,-0.0235,0.0735,-0.0148,-0.0256,-0.038,0.1889,-0.0154,0.1032,-0.0314,0.0305,-0.0885,-0.0182,-0.0382,0.0424,-0.023,-0.0365,-0.0345,-0.0428,0.0104,-0.0103,-0.0098,0.0882,0.0288,0.0007,0.1013,0.076,0.0957,0.1693,0.022,-0.1345,-0.1643,-0.004,-0.06,-0.0594,-0.0041,0.0156,-0.0081,-0.0568,0.1085,0.0344,0.0959,0.0393,-0.0094,-0.0058,-0.0034,-0.0182,0.0373,-0.04,-0.0089,-0.0812,-0.0153,-0.0067,-0.0022,0.0453,0.1075,0.1835,0.0097,-0.0166,0.0573,0.0361,-0.0163,0.0073,0.3421,-0.0548,-0.0283,-0.0203,-0.1026,0.4096,0.4086,-0.0047,-0.0418,-0.0045,-0.0611,0.0381,0.0203,0.0253,0.0129,0.003,0.1181,0.006,-0.0307,-0.0473,-0.0162,0.0662,-0.0161,-0.0839,-0.0292,-0.0352,-0.0672,0.0183,-0.0032,0.05,0.0676,0.0009,0.0498,0.0019,0.0637,0.0315,-0.0285,-0.0018,-0.0392,-0.0392,-0.0018,-0.0088,0.0377,0.0261,0.0653,0.0225,0.0207,0.0834,0.0918,0.0251,-0.0372,0.1892,-0.0514,0.0587,-0.0945,0.2371,0.1117,0.0155,0.0483,0.0111,0.0138,0.0629,-0.0519,-0.0039,-0.1021,-0.1464,-0.1159,-0.0048,-0.0232,-0.0392,-0.0427,-0.0232,0.0334,-0.0167,0.0103,0.0135,-0.0125,-0.0734,-0.0681,0.0417,-0.0557,0.0455,0.0125,0.0277,0.0239,0.0066,0.0285,-0.1227,-0.0527,-0.1037,-0.0818,-0.0231,-0.111,-0.015,-0.0855,-0.0594,-0.0068,-0.0639,-0.0469,0.0315,0.0783,-0.0095,0.0666,0.0471,0.0405,-0.0247,0.0473,0.0387,0.0169,-0.0313,0.0103,0.0237,-0.0272,0.0252,0.0265,0.0601,0.4059,-0.0358,0.0826,-0.0634,0.1013,0.0343,-0.0858,-0.0212,0.0143,0.0022,-0.0111,0.0148,-0.0135,0.039,-0.0016,-0.0188,-0.0337,-0.0352,0.0108,-0.0505,0.0017,-0.0013,-0.0454,0.0819,-0.0506,-0.0378,0.0271,0.0597,0.051,0.0771,0.0821,0.113,-0.0305,0.089,-0.0044,-0.0616,-0.0042,0.0345,-0.036,0.0275,-0.033,0.0181,0.078,-0.0467,-0.0898,-0.028,-0.0606,-0.0242,0.0552,-0.0018,-0.0062,-0.03,-0.0631,0.0339,0.016,-0.0099,0.0153,0.1683,-0.0287,-0.0077,-0.0206,0.0516,0.0777,0.0163,-0.0308,0.0191,0.0259,-0.0036,0.0266,0.0124,0.1008,-0.0233,-0.0527,-0.0606,0.0736,-0.0096,-0.0161,-0.0129,0.0057,0.0111,-0.0365,-0.0027,0.075,0.0532,-0.0025,0.0213,0.0416,0.0303,0.004,-0.0249,-0.0444,0.1018,0.0367,0.0305,0.0995,-0.0786,-0.0296,-0.0815,-0.0328,-0.0722,-0.0826,-0.0533,-0.0059,0.0321,0.0065,-0.062,-0.0348,0.0206,0.0498,0.0364,0.011,0.0103,-0.0771,0.0323,0.0631,-0.0464,0.0098,0.0213,-0.0074,-0.0258,-0.068,-0.0062,-0.049,0.0206,0.0469,-0.0382,0.0965,0.0281,0.0193,-0.0304,0.0248,0.0186,-0.029,0.0234,-0.004,-0.0537,0.003,-0.0407,0.0157,0.0199,0.0514,0.023,0.009,0.0203,0.0439,-0.013,0.0317,0.033,0.0457,0.0075,0.0065,0.0092,-0.002,0.0167,-0.0367,-0.0071,0.0445,0.0214,0.0206,-0.0667,0.0024,-0.0406,0.0503,-0.0123,-0.068,-0.0736,-0.0681,0.0354,0.0372,0.0178,0.0846,-0.0644,0.0069,0.0635,0.0131,0.0023,-0.0105,-0.0072,0.0229,-0.0095,0.0211,-0.04,-0.0102,-0.0855,-0.0834,-0.032,0.0269,-0.0295,-0.0261,-0.0425,-0.0208,0.0421,0.0056,-0.074,-0.0116,-0.0452,0.0,0.0582,-0.0373,-0.0288,-0.0693,-0.055,0.0458,0.013,0.0452,-0.0912,-0.0768,-0.0033,-0.0895,0.031,-0.0183,-0.0079,-0.0307,-0.0354,-0.0749,0.0233,0.0113,0.0572,0.0092,0.0759,-0.0043,-0.0549,-0.043,0.0231,-0.0573,0.0353,0.0374,-0.0574,0.0774,0.118,0.053,0.0593,0.0769,-0.0227,-0.0739,-0.0699,-0.0785,0.1429,0.0253,0.0613,0.0326,-0.0222,0.0075,0.0013,-0.0302,0.029,-0.0078,0.0603,-0.0397,-0.0937,-0.0172,-0.0075,-0.0165,-0.0371,0.0571,0.0694,-0.0093,-0.031,0.0438,-0.0229,-0.0115,0.0034,-0.0412,-0.0274,0.0511,-0.0142,-0.0346,-0.0031,0.015,-0.0034,-0.0656,-0.0768,0.028,-0.075,-0.0139,-0.0634,-0.0056,-0.0633,-0.0944,-0.0757,-0.0241,0.0038,0.0294,-0.1028,-0.0618,0.0859,0.0269,0.0133,0.0434,-0.0678,-0.0104,0.2012,0.0157,0.0281,0.0059,0.0057,-0.0003,0.001,0.0402,0.0224,-0.0017,-0.0212,-0.0103,0.0389,0.0921,-0.0686,-0.0205,-0.0079,0.0046,-0.0707,0.0346,-0.0389,-0.0032,0.0065,0.0663,0.0704,0.0178,0.0192,-0.002,-0.0244,-0.0018,-0.0443,0.058,-0.0842,-0.0521,-0.107,-0.0053,0.0114,0.0096,0.0174,0.0023,0.0272,-0.0216,0.0166,0.0231,0.0135,0.0025,0.0607,-0.0115,0.0368,0.0648,0.0299,0.079,0.071,-0.0364,-0.0479,0.1681,0.0404,0.1022,-0.0252,0.1193,0.0791,0.1795,0.0011,-0.0148,-0.0241,-0.0384,0.0234,-0.1077,0.0039,-0.0722,-0.03,0.0404,-0.0334,-0.0135,0.0322,0.0367,-0.0203,-0.07,-0.0271,0.0159,-0.019,-0.0792,0.0139,-0.0598,0.019,-0.0007,0.0108,-0.021,-0.1206,0.0374,-0.0437,-0.0622,-0.0104,-0.0506,-0.0505,0.0199,0.1202,-0.0357,0.0309,0.0501,-0.0152,-0.0288,0.1182,0.0099,0.0013,0.0461,0.0076,-0.0256,0.0303,0.0767,0.017,0.0362,0.0466,-0.0049,0.1066,0.1005,0.0304,-0.0269,0.0868,0.1491,0.0345,0.0245,-0.0265,0.0072,-0.0784,0.0155,-0.0139,0.0951,0.044,0.0108,0.0202,0.0914,0.0646,0.0372,-0.004,0.0274,0.0161,-0.0331,-0.1181,-0.0231,0.0144,0.0468,0.0208,0.0424,0.0429,-0.021,-0.1021,-0.0335,-0.0113,-0.032,-0.03,0.0787,0.0723,0.0602,0.0775,0.046,0.0432,0.0253,-0.083,0.0665,0.0292,0.0918,0.0125,0.3866,0.4622,0.0553,0.1341,-0.0363,0.0459,0.1836,-0.0774,-0.0476,0.009,-0.0444,0.0864,-0.0251,0.3286,0.1002,0.1594,-0.0073,0.0406,-0.0236,0.0202,-0.0144,0.0181,-0.0231,0.3473,0.0514,-0.0001,0.0371,0.3624,0.2883,0.1691,0.2556,-0.0747,0.028,-0.0231,-0.1058,0.2896,0.0305,0.025,-0.029,0.0515,0.0516,-0.0016,0.0563,-0.0429,-0.0122,0.1118,0.0094,0.0406,0.0325,-0.023,0.3818,0.0551,0.1201,0.0451,0.1855,0.105,0.1415,0.0499,-0.0729,0.0587,0.0331,-0.1088,0.0429,-0.0506,-0.0874,-0.0331,0.0764,0.1257,0.0514,-0.0033,-0.0104,-0.0803,-0.0487,0.0401,-0.0481,0.0959,0.0235,-0.0311,-0.1146,-0.0966,-0.0261,-0.0044,-0.0587,0.0334,0.0673,0.0417,0.0411,0.2961,-0.0415,0.0213,0.0373,-0.01,0.0075,-0.0169,0.0427,0.0115,0.0077,0.0077,-0.0419,-0.0305,0.0059,-0.0435,-0.0237,0.0052,-0.0437,-0.0371,0.0523,0.011,-0.0212,0.018,0.0313,-0.0627,-0.0503,-0.0107,-0.0513,0.0851,0.006,0.0193,0.0132,-0.0178,0.0195,-0.044,0.0227,0.1302,-0.0862,0.1554,0.2461,-0.018,0.2859,-0.0711,-0.0731,0.1504,-0.1234,0.4314,-0.0845,-0.0721,-0.0445,0.0162,0.0227,0.038,0.0693,0.1173,0.107,-0.0561,0.0517,0.0614,0.0102,-0.0081,-0.0674,-0.1148,-0.0064,0.029,-0.0163,-0.0205,-0.0237,0.096,0.0268,0.0313,0.0126,-0.037,0.0046,0.0046,0.0341,-0.0043,-0.0064,-0.07,-0.0114,0.094,-0.0025,-0.0074,-0.1868,-0.0714,-0.0266,-0.0405,-0.0052,-0.0259,-0.0032,-0.0813,0.0333,-0.032,-0.0436,-0.0517,-0.0298,-0.1429,-0.0349,0.0104,0.0183,0.0116,0.3007,0.1355,0.1202,0.1635,0.2128,0.3103,0.0764,0.0825,0.1496,-0.0271,0.0461,0.0759,0.3369,0.4086,0.0528,0.1489,0.1496,0.0873,0.0859,-0.0671,-0.0023,-0.0293,-0.0098,-0.0644,-0.0742,0.0156,-0.0531,-0.1237,-0.0358,0.0665,-0.0148,0.0033,-0.0031,-0.0416,-0.037,0.0588,0.1068,-0.002,-0.0185,0.0047,0.0302,0.0156,-0.0182,-0.0621,0.0287,0.0388,0.0241,-0.0267,-0.0054,0.0332,0.1189,-0.0742,0.0338,-0.0538,-0.0615,0.0311,0.036,0.0567,0.0905,-0.0388,-0.0325,0.2563,0.3159,-0.0355,-0.0135,-0.0604,-0.068,-0.0998,0.0706,0.0708,-0.0118,-0.037,-0.0566,0.0122,-0.0157,0.0054,-0.0367,-0.0462,0.0006,0.0119,-0.0134,-0.0357,-0.0223,-0.067,0.0264,0.0268,0.0019,-0.009,-0.0296,-0.0271,-0.0002,-0.0084,0.0202,0.0168,0.0227,-0.0035,-0.062,0.0593,-0.003,0.0176,-0.0248,-0.0203,0.0163,0.0221,-0.0103,0.0455,0.0448,-0.041,-0.0133,-0.0392,-0.0361,-0.0257,-0.02,-0.0147,-0.0295,0.0461,0.0006,0.0093,-0.0122,0.0243,-0.0042,0.0834,-0.0068,0.0004,0.1223,0.0083,-0.0154,0.0323,0.0036,0.0164,-0.0262,0.0872,0.0731,-0.0025,-0.0752,-0.0243,0.0208,0.0231,0.0941,-0.0215,-0.044,0.054,-0.1005,0.0414,0.0045,0.0447,-0.0405,-0.0204,-0.0253,0.0124,-0.0862,-0.0452,0.0772,0.0018,0.0111,-0.0002,0.0467,-0.0005,-0.0301,0.0947,-0.0077,-0.0013,0.0082,-0.0185,0.0409,0.0674,0.0598,-0.0058,-0.0707,0.0239,-0.0173,0.1157,-0.0246,0.0189,-0.0805,0.0265,-0.057,0.0631,-0.0623,-0.007,-0.0349,-0.0389,-0.0292,0.0214,0.0197,-0.0541,-0.0567,-0.0222,-0.1083,-0.0077,-0.1145,-0.065,-0.0458,-0.1689,0.0362,0.0245,0.0502,0.0005,-0.0107,-0.0044,0.049,-0.0156,0.0169,-0.0611,-0.0197,0.1712,-0.0564,-0.0205,0.018,-0.0699,-0.0446,-0.0524,0.0118,-0.0623,0.0076,0.0672,-0.0123,-0.0567,-0.0955,-0.0573,-0.0734,-0.0922,-0.0739,-0.0133,0.0328,-0.0009,0.2407,0.3098,-0.0183,0.009,-0.0613,0.0122,0.0144,-0.0124,-0.0091,0.0586,0.0088,0.0715,0.0178,-0.006,0.0029,0.0059,-0.0026,0.0386,-0.0086,-0.0446,-0.0176,-0.0335,-0.027,-0.0321,-0.0533,-0.0118,-0.0249,0.0383,-0.0525,-0.0568,0.094,-0.1156,-0.0567,0.0132,-0.0289,-0.0509,-0.0098,0.0212,0.0263,0.0832,-0.1358,-0.1346,0.0563,-0.0359,0.0346,0.0219,0.0443,0.016,0.0009,-0.0116,-0.0927,-0.0576,-0.1006,0.018,0.02,-0.0347,oddball detection
trm_55b6b9a666604,-0.1278,-0.0927,-0.1185,-0.167,-0.0412,-0.037,-0.0853,-0.1079,-0.0703,-0.0952,-0.0147,-0.001,-0.0754,-0.0446,-0.1129,-0.0777,-0.0516,-0.1436,-0.0871,0.0048,-0.064,-0.0152,0.0352,0.0519,0.0128,0.0271,0.0237,-0.1219,-0.1124,-0.061,-0.0943,-0.1131,-0.1031,-0.1051,-0.1083,-0.1007,-0.0174,-0.0769,-0.1088,-0.0765,-0.0772,-0.0732,-0.0492,0.0756,-0.0756,-0.0553,0.2085,-0.1213,-0.0007,-0.1388,-0.0447,-0.0192,0.0221,-0.0567,-0.0574,-0.0675,-0.096,-0.0168,0.0127,-0.0267,0.0404,0.0343,-0.1208,0.0163,-0.005,0.0335,-0.1805,-0.2356,-0.1324,0.0359,0.0501,0.036,0.1269,-0.0558,-0.1512,0.0696,-0.0918,0.0478,0.027,0.0464,0.0307,0.0458,-0.045,-0.1332,-0.0063,0.0725,-0.0429,0.0433,-0.0011,-0.1203,-0.0649,-0.0805,0.031,0.1892,0.2101,0.238,0.1446,0.0316,0.139,0.0696,0.1325,-0.0212,0.0258,0.0056,0.0702,-0.1415,-0.097,0.1533,-0.0342,-0.0461,-0.0213,-0.1099,0.084,0.1217,-0.0123,0.0411,-0.1016,0.0651,-0.0843,-0.1009,-0.0768,-0.1175,-0.1142,-0.0434,-0.1107,-0.0811,-0.1015,0.0425,0.0605,0.0183,0.0094,-0.0814,-0.0123,-0.1461,-0.0362,-0.1705,-0.0545,-0.0824,0.0125,-0.0048,-0.1127,-0.1501,0.0503,-0.0309,-0.0381,0.0484,-0.1402,0.0025,-0.0645,0.0625,-0.1013,-0.0632,-0.0818,-0.1523,0.1348,-0.0091,0.085,0.0419,0.0232,-0.0407,-0.0844,-0.0503,-0.1761,-0.1825,-0.0113,0.0404,-0.0018,-0.1047,-0.0998,0.0228,0.0182,-0.0973,0.086,-0.104,-0.0823,-0.0998,-0.0518,-0.0889,-0.0542,-0.0238,-0.0921,0.0561,-0.0713,-0.0375,-0.071,-0.047,-0.0497,0.009,-0.0144,-0.0161,-0.0132,-0.0692,0.025,-0.1806,-0.1703,-0.2274,-0.2335,0.0193,0.0332,-0.1476,-0.0838,0.2345,-0.0732,-0.0935,-0.0609,-0.0491,-0.0317,-0.1105,-0.1081,-0.0705,-0.1506,-0.0555,-0.001,-0.0242,0.042,0.0704,0.1302,-0.1079,-0.1244,0.0378,0.1076,-0.0757,-0.0603,-0.0242,0.0164,0.0469,-0.0569,0.145,0.0214,0.053,0.0312,-0.0727,0.1802,-0.0783,-0.0726,-0.0002,0.0049,-0.0008,0.02,-0.0334,0.0263,-0.1344,-0.0547,-0.0099,-0.0972,-0.0648,-0.0575,-0.1627,-0.0681,-0.0839,-0.0018,0.0395,0.0091,0.0461,0.0161,-0.1278,-0.0178,-0.0883,0.1316,0.261,0.1268,0.2116,-0.1081,0.0946,0.105,0.2012,0.0531,-0.0213,0.075,0.0385,-0.0523,-0.0378,-0.0604,0.0307,-0.0159,0.1016,-0.0671,-0.0703,-0.0974,0.0179,0.0535,0.0211,0.0104,-0.0973,-0.0668,-0.0375,0.045,0.0887,-0.1323,-0.0506,-0.0481,-0.064,-0.0523,-0.0273,-0.0647,-0.012,-0.003,0.0253,-0.0222,0.0524,0.0396,-0.1594,-0.0695,-0.042,-0.123,-0.1164,-0.1388,-0.0521,-0.0027,-0.0575,-0.0373,-0.0342,-0.1284,-0.0109,0.0212,-0.0541,0.0376,0.0431,0.0065,-0.149,-0.04,-0.0012,-0.0573,-0.0743,-0.0629,-0.0778,0.0264,0.0175,-0.0577,-0.0356,0.0095,-0.1066,-0.0321,0.0464,-0.0198,0.0593,0.0093,-0.0581,0.063,-0.1561,-0.127,0.0783,-0.01,-0.0472,0.0568,-0.013,-0.1844,-0.1246,-0.1207,-0.0768,-0.0112,0.2025,-0.0464,-0.0149,-0.0326,-0.0268,-0.05,-0.0808,-0.1559,-0.0978,0.0297,-0.0251,-0.1013,0.0101,0.0087,0.0755,-0.1285,0.0427,0.1176,-0.1371,0.04,0.0628,0.0011,0.1065,-0.1236,-0.0121,-0.0616,0.0773,0.201,0.1078,0.217,-0.0042,-0.1653,-0.0827,0.0182,0.0227,-0.0204,-0.0312,0.0036,-0.0634,-0.0657,-0.0078,-0.0523,-0.0316,-0.0374,-0.0801,-0.097,-0.1092,-0.0936,-0.0841,-0.0857,0.0399,0.0302,-0.0055,0.0669,0.0005,0.0661,0.0116,-0.0572,-0.0309,-0.0121,-0.1262,-0.0046,0.2092,-0.0581,-0.0539,0.1278,-0.0677,-0.1177,-0.0677,0.0029,-0.2297,-0.1383,-0.3016,-0.2724,-0.1441,-0.1597,-0.0661,-0.1426,-0.139,0.0247,0.065,-0.0071,-0.0399,0.0189,0.0288,0.0379,0.0372,-0.1931,-0.1342,0.1384,0.0542,0.0132,0.0694,0.0091,-0.0446,0.0698,0.131,-0.0869,-0.1553,-0.116,-0.0057,-0.0821,-0.086,-0.0657,-0.1052,0.0827,-0.1051,-0.0774,-0.0335,0.006,-0.0517,-0.0054,0.1021,-0.0474,-0.0831,0.0491,0.2491,-0.0466,-0.0432,0.0043,0.0565,0.0202,0.0198,0.0058,-0.0566,0.0378,0.0189,-0.0279,-0.0588,0.1011,-0.0406,-0.0029,0.0138,0.0175,0.0455,-0.0364,-0.001,-0.1152,-0.0563,0.2037,0.0376,-0.0274,-0.0769,0.0953,0.104,-0.0685,-0.0684,0.06,-0.12,-0.1112,-0.0108,-0.0505,-0.0849,-0.1371,-0.0765,0.0459,0.0905,-0.0136,0.0924,-0.1503,0.0173,-0.017,0.0021,0.0967,-0.0018,-0.1491,-0.1477,0.0801,-0.0842,-0.0712,-0.0585,0.0953,-0.014,0.0744,0.0319,0.0829,0.1248,0.0408,0.0158,-0.074,-0.0515,-0.0533,-0.1335,-0.042,0.0485,-0.0709,-0.0413,0.0037,-0.0736,-0.0027,0.0717,0.0288,-0.0378,-0.0736,0.0303,-0.0276,0.0349,0.0153,0.0184,0.0477,-0.0407,0.0082,-0.0213,0.0126,-0.0694,0.0386,-0.0018,0.047,-0.0177,-0.0222,-0.013,-0.031,0.035,-0.0393,0.0682,0.1011,0.0121,-0.0126,-0.0299,-0.0365,0.0208,-0.0707,0.0177,0.0738,0.0305,0.0624,0.0468,0.0823,0.0253,-0.0066,-0.0978,-0.0144,-0.053,0.0092,0.0251,-0.123,-0.0039,0.0425,-0.0545,-0.0681,-0.046,0.0003,0.0223,-0.0861,-0.0872,-0.2146,-0.0251,0.1359,-0.0352,0.0758,0.0382,0.0429,0.0907,0.0672,0.018,-0.0096,-0.1381,-0.1371,-0.0244,-0.1688,-0.0832,0.0329,-0.0615,-0.201,-0.0651,-0.0674,0.0049,0.0255,-0.1458,-0.0956,-0.1358,0.0676,0.0434,0.0064,0.0683,-0.1219,-0.1099,-0.0949,-0.0025,0.0076,-0.0298,-0.0183,-0.0786,-0.0978,0.0068,-0.0124,-0.0252,-0.0701,-0.062,-0.0646,0.0599,0.0054,0.0227,-0.0713,-0.0063,-0.1407,-0.1237,0.0362,-0.0781,-0.0911,-0.0538,0.1141,-0.0173,-0.0142,-0.007,0.0153,-0.1232,-0.0241,-0.0879,-0.0941,0.059,0.1337,-0.0363,0.0644,0.0908,-0.1182,-0.0712,-0.0289,-0.1457,-0.0637,-0.0512,-0.0442,0.0418,-0.0377,-0.0883,0.1191,-0.019,0.0746,-0.0451,0.0169,0.0758,0.0886,0.0579,0.1511,-0.1061,-0.0983,0.057,-0.0042,0.0019,-0.0513,0.0476,0.0502,0.0938,0.1006,-0.0063,0.0728,-0.0247,-0.0944,-0.0834,-0.0126,-0.0255,-0.0489,-0.0379,-0.0806,-0.0862,-0.0593,-0.016,-0.0035,0.0372,0.0997,-0.0682,-0.1127,0.0465,-0.0368,0.0047,-0.0286,0.0419,-0.0333,0.0363,0.0949,-0.0556,-0.1337,-0.1425,-0.0619,-0.0506,-0.0569,-0.1072,-0.0486,-0.0119,0.099,0.0232,-0.0357,-0.0006,0.0477,0.0367,-0.125,0.0482,0.0643,0.0853,-0.0957,0.0245,-0.0975,0.0288,0.017,-0.065,0.0717,0.094,0.0043,0.0123,0.0003,0.0866,-0.15,-0.2076,-0.1672,-0.1236,0.0723,0.2362,0.0378,-0.0735,0.0442,0.0043,0.0475,0.0682,0.0232,0.0447,-0.0368,-0.0795,-0.0233,0.0399,0.0969,0.1629,-0.0319,-0.0681,0.0332,-0.084,0.0399,-0.0624,-0.0631,-0.0617,-0.1356,-0.1004,-0.0811,0.079,0.0661,-0.0017,-0.0293,-0.0638,-0.0413,0.0818,-0.026,-0.0966,0.0621,0.0092,0.0491,0.0207,0.0598,-0.0443,0.0476,-0.1763,-0.1685,0.0283,0.135,0.2202,0.0262,0.0096,0.0531,-0.0153,0.0576,0.1962,0.0492,0.0524,0.1266,0.1212,0.0871,0.0127,0.1647,0.1239,-0.0593,0.0223,0.0225,-0.1637,-0.0916,-0.0662,-0.0883,0.0496,-0.2457,-0.0888,-0.1124,-0.08,-0.1445,0.0724,0.012,0.1617,-0.0847,-0.08,-0.071,-0.0224,0.0536,0.0375,0.0708,0.1064,0.0873,0.0678,-0.0076,0.0037,0.0725,0.1054,-0.0519,0.1219,0.0759,0.0251,-0.0403,-0.0972,-0.0459,-0.0039,-0.1076,-0.1218,-0.1007,-0.0257,0.078,0.0689,0.0075,-0.0228,0.0425,0.0624,-0.1445,-0.1243,0.049,-0.1383,0.0729,-0.0673,0.0869,-0.0723,0.1101,-0.1032,-0.0588,-0.0851,-0.129,-0.094,-0.0731,0.2285,-0.0983,-0.1224,-0.0443,0.0658,-0.0206,-0.1721,-0.0326,-0.1217,0.018,-0.0409,0.1299,0.0314,0.0371,0.1488,-0.162,-0.0721,-0.0388,-0.0099,-0.1167,-0.0011,0.1471,0.0111,0.0169,0.3382,0.0987,-0.0939,-0.0924,-0.0729,-0.0732,-0.0325,-0.0736,0.0459,0.1013,0.0301,0.0165,-0.084,0.0796,0.1214,-0.0201,-0.0343,-0.0731,0.0033,-0.1045,-0.0482,-0.0372,0.0824,0.0469,-0.1063,-0.0489,0.1367,0.0267,-0.1102,-0.047,0.0617,-0.0018,0.0131,-0.005,-0.0952,-0.0942,-0.1161,-0.1077,-0.1212,0.0007,-0.0062,-0.0148,-0.0797,-0.0087,-0.1115,0.002,-0.1129,-0.008,-0.0071,-0.0046,0.0555,0.0505,-0.0361,0.0414,-0.0315,0.0563,0.0931,0.0998,0.114,0.0466,-0.0498,-0.0257,-0.0482,0.0127,0.0952,0.0735,0.1061,0.0029,0.0291,0.0622,0.1368,0.0048,-0.0408,-0.045,0.1022,-0.0344,0.0651,-0.1281,-0.0738,-0.0649,-0.0222,-0.0261,0.032,0.0298,-0.0311,0.1171,0.1546,0.161,-0.099,-0.0404,-0.0072,-0.0563,-0.0156,0.018,-0.0511,-0.0375,-0.0632,-0.0186,0.0762,0.0643,-0.0833,-0.0684,-0.0226,-0.1372,-0.062,0.1205,0.0709,0.0539,0.0597,0.1044,-0.0194,0.0471,0.0706,-0.0466,-0.0307,-0.0268,0.0147,-0.0307,-0.0187,-0.0275,0.0355,-0.097,0.0319,-0.0883,0.0542,-0.1335,-0.0359,0.0807,0.0872,-0.0942,-0.0194,-0.0306,-0.0944,-0.0103,-0.0367,-0.0642,-0.0809,0.0054,-0.034,0.0144,-0.0523,-0.0561,-0.0537,-0.0484,-0.0272,-0.0559,0.03,-0.1101,-0.0387,-0.0598,0.0986,0.0038,0.1036,-0.1205,0.2278,0.1202,-0.0348,0.0027,-0.0343,0.0463,-0.0516,0.061,-0.0958,-0.0924,0.0274,-0.0467,-0.0989,-0.0062,-0.051,0.0678,0.0537,-0.0547,-0.0135,-0.0082,0.0639,0.0671,0.0334,0.0333,0.051,-0.0738,0.0073,-0.044,0.094,0.005,-0.0165,0.4595,0.3163,0.1944,0.0905,0.0974,0.0746,0.1894,0.1507,-0.1745,0.2702,0.2731,0.1864,0.1328,0.206,0.0371,0.0747,0.0374,0.013,0.0642,-0.0133,0.0059,0.0263,-0.0563,0.0896,0.1218,-0.0098,0.0793,-0.0273,-0.0689,0.1762,0.0721,-0.0866,-0.028,-0.1204,0.0317,0.0266,0.1392,-0.0342,-0.0808,-0.0592,0.0092,0.0198,0.1528,0.1745,-0.0477,-0.0581,-0.1001,-0.109,-0.0907,0.2673,-0.1338,0.1846,0.1678,-0.0292,0.0667,0.0402,0.0708,0.0666,0.0173,0.162,0.0691,-0.0365,0.0262,-0.0185,0.0054,-0.08,-0.0177,-0.068,0.0684,0.0577,-0.0592,-0.0683,-0.1003,-0.006,-0.0561,-0.0326,-0.0953,0.0037,0.2236,-0.0179,0.0263,-0.0411,0.1124,0.0828,0.0071,-0.1785,-0.179,-0.0059,-0.1246,-0.0363,-0.051,-0.0626,-0.0766,-0.0563,-0.0328,-0.0153,0.0296,0.1079,-0.0523,-0.0857,-0.0834,0.0043,-0.0598,0.0342,-0.1072,0.0422,0.1675,-0.0448,-0.1082,0.0685,0.056,-0.0705,-0.1014,0.0157,-0.1416,-0.0999,-0.1397,-0.0141,0.0223,-0.0502,-0.057,0.0064,0.0044,0.0008,-0.1018,0.0056,-0.0406,-0.0783,-0.1425,0.0794,0.0016,0.3578,0.2775,0.2314,0.3297,-0.094,-0.0494,-0.1009,-0.1112,-0.1218,0.0196,-0.1176,0.1804,-0.1026,-0.1146,0.0547,0.0741,-0.0197,0.0693,0.0232,-0.0027,0.0056,0.0212,-0.1233,-0.1122,-0.0917,0.2085,-0.0471,0.0151,-0.0851,-0.0851,-0.1326,0.0682,0.0232,0.0402,-0.0508,0.025,-0.0284,0.287,-0.2263,-0.2064,0.0758,-0.0162,-0.2054,-0.2044,-0.1995,-0.0487,-0.0303,-0.0603,-0.0341,0.0086,0.1145,0.0088,0.0552,-0.0394,0.0769,-0.0398,-0.0297,0.0312,-0.0478,-0.046,-0.0643,-0.0462,-0.0095,-0.0271,-0.0199,0.0374,0.0577,0.1347,0.0837,0.0474,-0.02,0.1716,-0.0616,-0.0433,-0.0162,-0.1092,0.0139,-0.1364,-0.28,-0.0607,-0.0885,-0.1915,0.0058,-0.0515,-0.1316,-0.0274,-0.0683,-0.0342,-0.1585,0.0102,-0.0898,-0.1545,-0.0287,-0.0063,-0.025,0.2849,0.0977,0.0232,0.0666,0.0028,0.0455,-0.015,-0.0866,-0.0818,-0.0071,-0.0663,0.0016,-0.0748,0.0244,0.0466,0.042,0.0243,-0.1065,-0.0912,-0.0057,0.0163,0.0001,-0.0467,-0.029,0.0502,0.0068,-0.0134,-0.0412,-0.1102,-0.1294,-0.0047,-0.0937,-0.1036,0.0383,0.039,0.1314,0.0252,-0.0184,-0.1107,-0.1014,0.0085,-0.1299,-0.0038,0.0188,-0.0425,-0.04,-0.0777,0.0224,0.1189,0.1082,0.0516,0.0173,0.0074,0.1532,-0.0391,-0.0302,-0.0373,-0.1711,0.1735,-0.0194,0.1417,0.0806,0.1434,-0.0284,-0.0673,-0.004,0.1529,-0.0589,0.084,-0.0836,-0.026,-0.1203,-0.057,-0.041,0.0236,-0.0365,-0.0258,-0.0875,-0.0026,-0.0133,-0.0202,-0.02,-0.1516,-0.0474,-0.0102,-0.0619,0.0159,-0.0667,-0.0757,-0.0247,-0.1024,-0.098,-0.1001,-0.027,-0.0649,-0.0114,0.0249,0.0649,-0.0266,-0.0342,-0.0143,-0.0138,0.0019,0.0116,-0.0856,0.0591,-0.0615,0.0492,-0.0088,0.0665,0.0761,0.0037,0.0387,-0.0881,-0.0369,-0.0435,-0.0315,-0.1501,-0.0098,-0.0805,-0.0192,0.0124,-0.0489,-0.0547,-0.0589,-0.0636,0.0357,-0.0044,-0.0638,0.2397,-0.0086,-0.0092,-0.0004,0.2404,-0.0069,-0.0012,0.0679,0.2233,-0.0549,-0.0066,-0.1156,-0.1229,-0.0666,-0.0277,0.0135,-0.0173,-0.1058,0.1264,0.186,-0.04,-0.0807,0.0556,-0.0124,0.0431,0.0521,-0.2164,-0.1245,-0.0342,-0.2026,-0.174,0.1025,0.1216,0.0124,-0.0063,0.0921,0.0473,-0.1762,-0.0916,-0.0155,-0.0714,-0.1502,-0.0105,-0.0349,0.0058,-0.0531,0.1318,0.0049,-0.0306,0.0419,0.0135,0.1528,0.0669,-0.0164,0.0589,-0.016,-0.028,-0.0527,-0.0428,0.0682,-0.0025,0.0094,0.1068,0.0368,-0.0066,-0.0645,-0.1091,0.0163,0.3093,0.2923,-0.0736,-0.0691,-0.0168,-0.0982,-0.0489,-0.0371,-0.1666,0.0115,-0.0169,-0.0358,-0.0041,0.0111,0.057,-0.089,0.0279,0.0929,-0.0344,0.0357,0.2391,-0.0039,-0.0886,0.2196,0.0694,0.0185,0.0991,0.0649,-0.0348,0.062,0.0461,-0.0929,0.0246,0.0446,0.0747,0.0746,0.0855,-0.0048,0.021,-0.02,0.1296,-0.1282,0.0143,0.1529,0.0052,0.0297,0.0104,-0.0298,-0.0894,-0.0318,0.0524,-0.0504,-0.0042,-0.0843,0.016,0.082,0.0334,0.0238,0.0686,0.1068,-0.0071,0.1306,0.0544,0.1089,0.0202,0.1753,-0.0228,0.0259,0.5038,-0.1156,-0.0561,-0.0628,-0.0273,0.0174,0.0289,0.063,-0.0382,-0.0148,0.0089,-0.0411,0.0024,-0.074,-0.0713,-0.0029,-0.0317,-0.0046,0.0385,0.1183,0.1628,0.2038,-0.0665,-0.0959,-0.08,-0.0276,0.0576,0.0722,0.0369,0.0672,0.067,-0.0434,0.032,0.0015,-0.1869,-0.0827,0.0767,0.0952,0.017,0.0825,0.0531,0.1148,0.0899,-0.0007,-0.0078,-0.0858,-0.0146,0.0304,0.0404,-0.0544,-0.08,-0.1408,0.0641,-0.0007,-0.0182,0.0432,-0.0712,-0.0512,0.0233,0.0272,0.0299,0.0223,0.018,0.0909,0.0366,0.0231,0.1256,0.1932,0.2184,-0.0686,0.0145,0.0235,0.023,-0.1391,-0.0284,-0.1691,-0.1001,-0.0596,-0.0829,0.0017,0.1072,-0.0928,0.041,-0.0233,-0.051,-0.0531,0.0204,-0.0091,-0.0328,-0.0103,-0.0182,-0.0926,-0.0292,0.1423,-0.0209,0.0273,-0.1644,-0.1077,-0.1307,-0.033,-0.0158,-0.1175,-0.1124,-0.0301,-0.1044,-0.0514,0.0887,-0.0128,0.1119,0.0439,0.0356,0.057,0.039,0.039,-0.0195,-0.0575,-0.1254,-0.0362,-0.1149,-0.0801,-0.0402,0.0145,0.0766,0.2432,0.1685,0.0443,0.0324,-0.0863,-0.2695,-0.1168,-0.2078,-0.1129,0.0204,-0.0054,0.0633,-0.077,-0.1266,-0.1668,-0.0716,0.0372,0.0897,-0.0131,-0.0495,-0.0069,0.0056,-0.1336,-0.064,-0.0492,0.0329,-0.038,-0.0397,-0.1687,-0.0732,-0.0925,-0.133,-0.1915,0.0873,-0.0126,-0.0142,-0.0618,-0.0941,-0.0628,-0.0129,-0.162,-0.0089,-0.0471,0.0021,0.0958,0.0143,0.0332,0.0144,-0.064,-0.0896,-0.0613,0.0626,-0.0883,-0.078,-0.0121,0.1326,-0.0787,-0.0847,-0.0366,-0.0733,-0.0846,-0.1443,-0.0684,-0.0785,-0.0319,-0.0715,-0.023,-0.0236,-0.2296,-0.0016,-0.0921,-0.1114,-0.0905,-0.1351,-0.016,-0.1024,-0.1058,0.0105,0.2109,-0.0171,0.0171,-0.1235,-0.0848,-0.0715,-0.0415,-0.108,-0.0485,0.0298,0.1448,0.1205,-0.036,-0.0842,0.0186,0.1347,0.1669,0.1562,-0.1297,-0.142,-0.0861,0.0192,0.0229,-0.1012,-0.0078,-0.0027,0.068,-0.0433,-0.0959,-0.0615,0.0234,-0.07,-0.1288,-0.0555,-0.0709,-0.0332,-0.0347,-0.0505,0.1705,0.1557,-0.1181,-0.1595,-0.0662,-0.1199,-0.078,-0.2042,-0.1176,0.4335,-0.0964,-0.1204,0.0146,-0.0265,-0.0021,-0.0038,-0.0323,-0.0076,0.0578,-0.0285,0.0232,-0.0206,-0.0683,0.0381,0.0243,0.1216,0.2794,-0.1417,-0.0595,0.0837,0.4039,-0.0103,-0.0401,0.0659,0.03,-0.0172,-0.0147,0.1932,0.034,0.0533,-0.1032,-0.1358,-0.1414,-0.0394,-0.0808,0.023,0.1274,0.1276,0.1075,0.1049,0.0638,0.1215,0.1439,0.0452,-0.0126,-0.0048,0.0354,-0.1965,-0.0748,-0.1175,-0.076,0.0081,-0.1186,-0.1164,-0.0817,-0.0081,-0.0791,-0.1479,-0.063,0.0093,-0.0327,-0.1363,0.0488,-0.0877,-0.0189,0.0696,-0.0848,0.0142,-0.1497,-0.0779,-0.0422,-0.1044,-0.0532,0.007,-0.1024,0.111,0.0494,0.0884,0.0212,-0.09,0.0241,0.0154,0.0033,0.0236,-0.0005,-0.0398,0.0502,0.0016,-0.0892,-0.1438,-0.0341,0.0291,-0.0058,0.003,-0.0267,-0.0803,-0.0539,-0.0702,-0.0352,0.1062,-0.0817,-0.0517,0.0182,0.0094,-0.0318,0.038,0.0904,-0.1954,-0.1013,-0.1816,-0.1319,0.0715,0.096,0.1173,-0.0566,0.4713,0.3083,-0.1616,-0.1135,0.4754,0.2191,0.0144,0.1951,0.1952,0.1818,-0.1273,-0.1234,-0.079,-0.0847,0.4914,0.4002,0.3077,0.0249,0.1666,0.2169,0.4391,0.4394,0.414,0.0095,-0.0066,-0.062,0.0217,-0.0144,0.0108,-0.1312,-0.0656,-0.0151,-0.0019,-0.0835,-0.0627,0.0779,-0.0073,0.0242,-0.0565,0.0869,0.0621,0.0619,-0.0029,-0.0467,-0.0972,-0.0017,0.0488,0.0134,-0.0638,-0.0875,-0.0466,-0.0679,-0.1064,-0.2015,-0.1888,-0.0164,-0.0258,0.0109,0.203,0.0464,0.094,0.0952,0.0796,0.1804,-0.0063,-0.173,-0.1712,-0.0405,0.068,0.0197,0.1208,0.1212,0.131,-0.0197,-0.1222,-0.1223,-0.0815,-0.0674,0.009,-0.1738,-0.1276,0.0173,-0.0152,0.0656,-0.0851,0.036,0.0204,-0.0297,0.0109,0.045,-0.031,-0.0986,-0.1427,0.0416,-0.0079,-0.045,-0.0917,-0.1101,0.0619,0.1634,0.1266,0.0259,0.1444,-0.0332,0.0392,0.0453,0.0733,0.1059,0.1126,0.0667,0.0215,0.0297,0.1315,0.1577,-0.0584,-0.0656,-0.0723,-0.0467,0.0007,0.0506,0.0051,-0.0286,-0.0833,0.0746,0.0332,0.0406,0.1438,0.0574,0.1568,0.1673,-0.0823,-0.1078,-0.1637,-0.1259,-0.1709,0.1227,-0.0405,-0.0514,-0.0687,0.1194,0.0343,-0.1011,-0.0647,0.07,0.0084,0.0391,0.0595,0.1482,0.1485,0.2648,0.3507,0.0955,-0.0185,-0.0114,-0.0658,0.0639,-0.0703,-0.124,-0.0728,0.0247,-0.0125,0.0293,-0.0212,-0.0798,0.0329,-0.1063,-0.1615,-0.1224,-0.0609,-0.0106,-0.1139,-0.1093,-0.0962,-0.027,-0.0459,-0.012,-0.027,-0.0775,0.0489,0.089,0.0565,-0.0935,0.1569,0.1263,-0.1041,0.1342,-0.1821,-0.099,0.0495,-0.039,-0.0386,0.02,-0.0006,-0.0125,0.0249,-0.0795,-0.0383,-0.0025,-0.0136,0.0378,-0.1118,0.0908,0.0549,0.0744,0.0204,-0.1308,-0.1088,-0.0589,-0.1045,-0.0673,-0.0466,-0.0878,0.009,0.0338,0.0126,0.074,-0.1924,-0.0841,-0.0881,-0.1556,-0.1505,-0.1093,-0.09,-0.09,-0.0108,-0.0198,0.0326,-0.1447,-0.0,0.0048,-0.0072,0.0749,0.0175,-0.1865,0.1133,-0.1178,0.0311,0.0235,0.1681,0.0923,0.0285,-0.1047,-0.0603,0.0615,0.1004,0.0091,0.1111,0.0116,-0.0237,0.0399,0.029,0.0031,0.0007,-0.0366,-0.0847,-0.0282,-0.0365,-0.0433,-0.0614,-0.1017,-0.0427,-0.0615,-0.0709,0.012,-0.0704,-0.035,0.0331,0.1113,-0.0379,0.0931,0.0852,-0.1998,-0.0247,-0.226,-0.0651,-0.066,-0.0552,-0.094,0.089,0.0817,0.0471,0.0734,0.0539,0.0414,0.0754,0.0384,0.2966,0.1412,0.0539,0.0782,-0.1254,0.0538,0.0151,0.0935,-0.009,-0.0259,0.009,0.0038,0.0076,0.0032,-0.063,-0.0136,-0.0758,0.0265,0.0236,-0.0123,0.2978,0.005,0.0627,0.0813,-0.038,0.0812,-0.0222,-0.0383,-0.141,-0.0906,0.0457,0.0369,-0.0878,-0.041,-0.021,-0.0147,0.0724,0.1115,0.0136,-0.0288,0.0239,-0.0335,0.0361,-0.0442,-0.0013,-0.0589,-0.013,-0.0093,-0.0432,-0.1147,-0.0644,-0.0259,0.025,-0.0804,0.0618,-0.0294,0.1721,-0.0001,0.0366,0.0917,0.0092,-0.0474,-0.0307,-0.0772,-0.0555,-0.0033,0.0196,0.0117,-0.0565,-0.0048,0.0528,0.0418,-0.1227,-0.1104,-0.1833,-0.1201,0.082,-0.0274,-0.0277,-0.1224,-0.0531,-0.0978,-0.0501,-0.1153,-0.0111,0.0188,-0.1356,0.1471,-0.0282,-0.0763,-0.094,0.0029,-0.1247,-0.0163,0.1109,0.0405,-0.1483,0.0427,0.0318,-0.0141,0.0722,0.0481,0.0391,0.0359,-0.1059,-0.0722,-0.0662,-0.1378,-0.1225,-0.0613,-0.1112,0.0746,0.0859,0.0791,0.0462,0.0947,-0.11,-0.0911,0.0013,0.0992,0.1555,0.0939,0.004,0.0077,-0.0302,-0.0843,0.0118,-0.0996,-0.0795,-0.0811,-0.0857,-0.0974,-0.188,0.2125,0.0392,0.0148,0.1947,0.0731,0.0694,-0.0679,-0.0187,-0.0045,0.0374,-0.0265,0.0095,0.0316,0.0354,-0.0238,-0.0586,-0.0563,-0.0938,-0.0346,-0.0015,-0.099,0.0042,-0.0232,-0.0081,-0.0214,-0.0065,0.0373,0.0343,-0.0535,0.1413,-0.1564,-0.0784,-0.118,-0.1058,-0.0437,-0.1484,-0.0845,-0.2224,-0.0986,-0.0481,-0.002,-0.1039,-0.0735,-0.0588,0.0674,0.0456,0.0736,-0.1081,-0.1206,-0.0526,0.0213,0.0864,0.1176,-0.04,0.0126,-0.0282,0.0538,0.0726,0.0159,0.1379,-0.0203,-0.0667,0.0354,-0.0163,0.0065,0.0559,-0.0003,-0.0243,0.0195,-0.0597,0.1159,-0.0097,0.1585,0.1633,-0.014,-0.0075,-0.0052,-0.1584,-0.0438,-0.0076,0.1862,0.2748,0.0809,0.0626,0.0442,0.0085,0.1221,0.1586,0.0617,0.0591,-0.1032,-0.013,-0.073,0.1252,-0.0428,-0.0167,-0.0477,-0.0246,0.0171,0.0417,0.0902,-0.0685,0.0889,-0.0224,-0.1072,0.1164,0.1118,0.0384,-0.0161,0.1056,0.1582,-0.0004,0.0603,0.0015,-0.0838,0.0187,0.0951,0.0627,-0.019,-0.0487,0.1292,-0.0444,-0.0709,-0.1998,-0.1947,0.0656,0.0627,0.0327,-0.0083,0.0162,0.0083,-0.0486,0.0152,-0.0447,0.0848,-0.0368,-0.0374,-0.0517,0.0659,0.0126,-0.1661,-0.0463,-0.1191,-0.1312,-0.0482,-0.039,0.0052,-0.2243,-0.1027,0.0235,-0.0177,-0.0105,0.0191,-0.0187,-0.0922,-0.0794,0.217,-0.0673,0.0663,-0.0206,-0.012,0.024,0.1179,-0.0146,0.1002,0.0704,-0.0998,-0.0519,-0.0384,0.019,-0.0916,-0.0939,-0.0896,-0.1212,-0.0686,0.0257,-0.0302,0.0545,-0.0006,-0.0739,-0.1089,-0.1881,0.1998,0.1917,-0.1547,-0.0455,-0.0696,-0.1076,-0.194,0.2534,0.1354,-0.0913,-0.0096,0.0754,0.0407,-0.0956,-0.0868,-0.1061,-0.1421,-0.0572,-0.0954,0.0577,0.0198,0.0577,0.064,-0.0531,0.0316,0.356,0.1698,0.1379,0.3673,-0.1711,-0.0991,-0.1339,0.0196,0.0214,-0.015,-0.0642,0.0016,0.0261,-0.1182,-0.1032,0.0086,0.2628,-0.0906,0.0189,0.0312,0.0847,0.1047,0.1416,0.0279,-0.0821,-0.0644,-0.0751,0.0276,0.0872,0.0873,0.0439,0.0124,-0.0293,-0.0111,0.0268,-0.0109,-0.0095,-0.1285,-0.0266,-0.0141,-0.0153,-0.0169,-0.0132,0.0427,0.0168,-0.0132,0.0237,-0.0227,-0.0253,-0.1564,-0.1372,-0.061,-0.0974,0.3427,0.0684,0.251,0.1076,0.0463,-0.0237,-0.0183,0.0537,-0.0373,0.0676,0.1291,0.0887,0.0297,0.0074,0.0359,-0.0402,-0.0339,-0.0311,-0.0125,0.287,0.163,-0.0861,0.0169,-0.0269,-0.0436,-0.0243,0.0559,-0.0157,-0.0794,-0.0119,-0.0918,0.0657,-0.0522,0.135,0.0991,0.1174,0.0318,0.0073,0.0014,-0.0491,-0.0048,0.0801,0.1267,0.0301,0.0309,-0.074,0.1089,-0.042,-0.0557,-0.0269,0.1521,0.0879,0.0118,-0.1332,-0.0819,-0.1281,-0.076,0.0024,0.0039,-0.017,-0.0172,-0.0181,-0.0579,-0.0728,-0.0263,-0.0614,-0.0325,-0.0119,0.0168,-0.0831,0.008,-0.0376,-0.0456,-0.053,-0.0629,0.0106,-0.0545,-0.0517,0.0533,0.1488,-0.008,-0.0344,0.2556,0.2209,0.1543,0.0052,0.1026,0.0128,-0.0515,-0.0157,-0.0396,0.0467,0.1857,0.2504,-0.0039,0.0097,0.0844,0.0027,-0.0326,-0.0265,-0.0141,-0.0187,-0.1075,-0.0972,-0.084,-0.0953,-0.0259,-0.0976,-0.1037,0.1082,0.0004,-0.1251,0.0443,0.0325,0.08,-0.0409,-0.0581,-0.2233,-0.195,-0.0756,-0.1376,0.2589,-0.0609,-0.0266,0.0655,-0.0483,-0.0025,-0.0675,0.0283,0.2448,0.1416,0.2379,0.0895,0.054,-0.0893,-0.072,-0.01,0.032,0.0102,-0.0364,-0.0424,0.2352,0.1259,-0.0891,-0.1924,-0.0907,-0.1424,-0.1761,0.0101,-0.0391,0.065,0.0664,0.1117,-0.0312,-0.0375,-0.185,-0.032,-0.1266,-0.0228,-0.1255,-0.1786,-0.049,0.0898,-0.0444,-0.0152,-0.0632,-0.1433,-0.0811,-0.1381,-0.0472,-0.0786,-0.0355,-0.0009,0.0126,0.0001,-0.0566,0.0293,0.0095,0.0178,-0.1044,-0.0751,-0.0922,0.0186,0.091,-0.0191,-0.0549,0.0432,-0.0591,-0.0248,0.0863,0.0466,0.047,0.0045,0.0196,0.0172,-0.0238,-0.0163,0.1524,0.2949,0.233,0.0599,0.0971,0.0157,0.0597,-0.083,0.1013,-0.005,0.1793,-0.0045,-0.0202,-0.0323,0.0492,0.0121,-0.0309,0.0249,0.051,-0.0015,0.0104,0.1027,0.0895,0.0276,-0.0899,0.0529,0.0556,0.0185,-0.1495,-0.0955,-0.1761,-0.0187,-0.1359,-0.103,0.0003,0.0441,-0.0015,-0.0505,-0.1329,-0.1299,0.1361,0.0416,-0.125,-0.009,0.1606,0.0692,-0.0248,0.0863,0.1064,0.0557,0.0361,0.1011,-0.0737,0.0182,0.1724,0.0349,-0.014,0.1522,0.0181,0.0009,0.0254,0.1508,0.056,-0.1231,-0.0859,-0.0772,0.047,0.1745,-0.016,0.0906,-0.0069,-0.0374,-0.0074,-0.0934,-0.0002,0.1693,-0.0328,-0.1154,0.0791,-0.0386,-0.0631,0.0279,-0.026,-0.0083,-0.0181,-0.0775,-0.0701,-0.1789,-0.117,0.0447,0.143,-0.0314,-0.0526,-0.0098,0.0535,-0.0125,-0.1074,-0.1045,-0.1726,0.0608,0.027,-0.0968,-0.0886,-0.0972,-0.0337,-0.0909,-0.1029,-0.0377,-0.0837,-0.0397,-0.1039,-0.0506,-0.0468,-0.1246,-0.0324,0.0385,0.0431,0.0712,-0.068,-0.0065,0.0649,-0.0157,-0.1061,0.0315,-0.0474,-0.0855,-0.0386,-0.073,-0.0867,0.0406,0.1496,0.218,-0.0432,-0.1245,0.1555,-0.007,-0.0282,0.0709,-0.188,-0.0847,-0.1527,0.0484,0.0416,0.0863,-0.03,-0.1738,-0.1493,-0.0045,0.0187,0.0306,0.0774,0.096,0.017,-0.1025,-0.0961,-0.1007,-0.0948,-0.2138,-0.1012,-0.0734,-0.0083,-0.019,0.0105,0.0048,0.1135,-0.0195,0.0201,-0.0247,0.0703,0.1111,0.0289,0.0269,-0.0118,-0.0806,-0.0251,-0.0716,-0.0311,-0.0448,-0.0472,-0.0597,-0.0288,-0.0922,-0.0082,-0.0568,0.0082,-0.0336,-0.0328,-0.0266,0.1657,-0.014,0.0831,0.032,0.0075,0.029,0.0207,-0.0001,-0.0549,-0.1246,-0.0172,0.1147,0.001,0.0219,-0.024,-0.032,-0.0757,-0.0653,0.0132,-0.0466,0.0393,0.0908,-0.1003,-0.1315,0.0099,-0.0628,-0.0641,-0.0577,0.4053,0.3751,-0.0917,0.052,-0.0603,-0.0223,0.0007,-0.1275,-0.1593,-0.1191,0.0319,-0.0277,-0.0776,-0.0352,-0.1205,-0.064,0.1126,0.0409,-0.0002,0.0226,0.0204,0.0038,-0.142,0.0094,0.1215,-0.0948,0.071,-0.0667,0.1402,-0.1637,0.3385,-0.0384,-0.0186,-0.1399,-0.1318,-0.0069,-0.0562,-0.0593,-0.0389,0.0285,-0.0414,-0.0573,0.08,-0.0531,0.169,0.1723,0.2125,0.1671,0.2577,0.286,-0.045,0.0642,0.3849,0.5444,0.2176,0.1509,0.3972,0.2593,0.217,0.296,0.1949,0.3282,0.3039,0.1441,0.289,0.1626,0.2425,0.2709,0.3064,0.1898,0.2582,0.1243,0.1893,-0.1554,-0.1193,-0.0981,-0.1323,-0.066,-0.2426,-0.1819,-0.1137,-0.0132,-0.0416,-0.2137,-0.195,-0.1154,0.0184,0.0224,-0.1479,0.2377,0.0322,-0.0982,0.0078,-0.0694,-0.0976,-0.1074,-0.0282,-0.1407,0.0731,-0.2066,-0.2148,0.0772,0.0034,-0.0805,0.0279,0.0247,-0.0871,-0.0026,0.05,-0.1304,0.109,0.2546,-0.0092,0.1152,0.0631,-0.0573,0.0227,0.0244,0.0044,-0.0416,0.1095,0.0007,0.0365,-0.1195,-0.0128,0.1582,-0.0892,-0.0869,-0.0502,0.0273,0.0083,-0.0624,working memory updating
trm_557b493e4203a,-0.0859,-0.0459,-0.1013,-0.0268,-0.0358,-0.0635,-0.0552,-0.0476,-0.0327,-0.064,-0.0309,-0.0269,-0.0383,-0.0106,-0.0785,-0.0416,-0.0491,-0.0061,-0.0145,0.0264,-0.051,-0.0496,-0.0284,0.0469,-0.0397,-0.0409,-0.034,0.0216,-0.0019,-0.011,-0.03,-0.0285,-0.0162,-0.071,0.0073,-0.0133,-0.0781,-0.0536,-0.0717,0.0103,0.0018,-0.0337,-0.0163,0.0217,-0.0293,0.0295,-0.0328,0.0062,-0.0349,-0.0415,-0.0091,0.0975,0.0652,-0.0199,0.0555,-0.0185,0.0042,-0.0511,-0.0594,-0.0545,-0.0206,-0.0811,-0.039,0.0405,0.0405,-0.0108,-0.0443,-0.0396,0.0067,-0.0209,0.016,-0.0302,0.0784,-0.0059,-0.0581,0.1128,-0.0128,-0.0353,-0.0119,0.0138,0.0264,-0.0095,0.0604,-0.017,0.0064,-0.0361,0.0073,-0.0041,-0.0002,0.1554,-0.0221,0.0264,0.012,-0.0422,0.0264,0.004,0.0231,-0.0138,-0.0091,-0.0342,0.0178,0.054,-0.0081,-0.0642,0.0068,-0.0236,0.0236,0.0658,0.0282,-0.059,-0.0164,-0.0285,0.004,0.0175,0.0241,0.0541,-0.0496,-0.0226,0.0035,-0.0223,-0.0028,0.003,-0.0136,0.0287,0.0506,0.004,0.0069,-0.0353,-0.0166,0.019,0.0362,-0.05,-0.0047,0.0171,0.0303,-0.0336,-0.0156,-0.0461,-0.0131,-0.035,-0.0439,-0.011,0.058,0.0358,-0.0151,-0.0256,-0.0339,-0.0143,0.0149,0.0733,-0.0152,-0.0262,-0.0734,-0.0064,0.0417,-0.0143,-0.072,-0.023,-0.0627,-0.0327,-0.0094,-0.0105,-0.0553,-0.0616,-0.0131,-0.0057,-0.0544,0.0023,0.0001,0.0652,-0.0663,-0.027,-0.0799,0.0148,-0.01,-0.007,0.0356,-0.0167,0.0224,-0.0452,0.0505,-0.0161,-0.0504,-0.0376,0.02,-0.0122,0.0256,0.0438,0.0477,0.0173,0.0246,0.0034,0.0297,0.0038,0.0074,-0.033,-0.0575,-0.0065,0.0613,-0.0218,-0.0223,-0.0838,-0.0122,0.0032,-0.0237,0.0944,0.1121,-0.0246,-0.0415,-0.0208,-0.01,-0.001,0.1557,-0.0232,0.0297,-0.0108,-0.0255,-0.0722,-0.0999,0.0054,-0.0208,-0.0159,-0.0329,0.0026,0.0023,0.0063,0.0191,0.1155,0.0584,0.0112,-0.1062,-0.0335,-0.0253,-0.0668,-0.0673,0.1198,0.0053,0.0314,-0.0012,0.0209,-0.043,-0.0443,-0.0162,0.0122,-0.0229,0.0122,0.0165,-0.0123,0.0152,0.0178,-0.0085,0.0042,0.059,0.0073,0.0229,-0.0007,-0.0035,0.0052,0.0394,0.0152,0.0111,-0.0291,-0.0407,-0.063,-0.0553,-0.0109,-0.0276,-0.0012,-0.0156,-0.0234,-0.0378,0.0183,0.011,-0.0068,0.0968,0.1417,0.129,0.0924,0.0339,0.0796,0.1248,-0.0013,-0.0048,0.013,0.015,-0.0242,0.0153,0.0119,-0.0413,-0.0267,-0.0433,-0.0452,-0.0113,-0.0296,-0.029,-0.0371,0.0263,0.0744,-0.0073,-0.0008,0.1288,-0.0365,-0.037,-0.0358,-0.1015,-0.1114,-0.0147,0.0353,-0.0063,0.0434,0.0618,-0.007,-0.0687,0.0275,-0.0102,0.0022,0.0306,-0.0097,0.0217,-0.0196,0.0097,0.0083,0.0006,-0.0005,-0.0743,-0.0199,0.0295,0.0292,-0.0361,-0.069,0.015,-0.0154,-0.033,-0.0022,0.0353,0.028,0.0998,0.0456,0.0888,-0.0015,-0.0059,0.0078,-0.0538,-0.0337,0.0077,0.0244,-0.0862,-0.0923,-0.0732,-0.0025,-0.0181,-0.0286,-0.094,-0.0402,-0.0138,-0.1081,-0.0374,-0.0114,-0.0192,0.0024,-0.0243,-0.0039,0.1897,-0.0253,0.0283,-0.0647,-0.0237,0.0002,0.0113,-0.009,0.0405,-0.0177,-0.0119,-0.0187,-0.0364,0.0753,0.0452,0.0104,0.1081,-0.0036,0.0834,-0.0984,-0.0496,-0.0438,-0.0051,0.0254,-0.0595,-0.0436,-0.0303,-0.029,-0.0363,0.0073,-0.1518,-0.0034,-0.0807,-0.1025,-0.0972,-0.0998,-0.009,-0.0109,0.0025,0.0338,-0.0232,-0.0673,-0.0287,0.003,0.0051,-0.0397,-0.0662,-0.0338,-0.0431,-0.0658,-0.0172,0.0806,0.017,0.068,0.0799,-0.0407,-0.0391,-0.0327,-0.0558,-0.0909,-0.0754,-0.094,-0.0693,-0.0651,-0.0313,-0.1221,-0.0247,-0.0914,-0.0096,0.0569,0.0129,0.0143,0.0361,-0.0061,0.0016,0.0528,-0.0664,-0.0304,0.0434,0.0167,-0.0142,0.012,-0.0191,-0.0288,0.0246,0.0212,0.0402,-0.0166,-0.0346,0.0258,0.0049,0.0027,-0.0467,-0.002,0.0382,0.0027,0.0177,-0.054,-0.0978,-0.0318,0.032,-0.002,-0.0251,0.0176,-0.019,0.0036,-0.0171,0.0544,-0.0046,-0.0008,-0.0106,0.0439,0.1181,-0.0053,-0.0048,-0.0128,0.0341,-0.0556,-0.036,-0.0041,-0.0106,-0.0436,0.0159,0.0432,-0.0459,-0.024,-0.0164,-0.0003,0.0286,0.0509,-0.0485,-0.0504,0.0073,0.0512,0.2441,-0.06,0.0059,-0.0131,-0.0132,0.0126,0.0109,-0.0581,0.0019,-0.0182,0.0667,0.0981,-0.0195,-0.033,-0.0331,-0.0349,0.0526,-0.0381,-0.0449,0.0031,-0.0265,-0.0549,-0.0185,-0.0167,0.0097,0.0119,-0.005,-0.0283,0.0693,-0.0224,0.0437,0.0161,0.0426,0.0128,0.0294,-0.0027,-0.0693,-0.1057,0.0053,0.0159,-0.0561,-0.0599,-0.072,-0.0328,-0.0136,-0.0483,0.0384,0.0104,-0.0537,-0.0123,-0.0257,-0.0152,0.0374,-0.0261,-0.0099,0.0668,-0.016,-0.0162,0.0166,0.0029,0.0035,0.0142,0.0116,0.0136,-0.0217,-0.0226,0.0286,0.0068,0.053,0.1019,0.0236,0.1103,0.0268,0.0568,0.0049,0.0244,-0.032,0.008,-0.2,-0.2059,0.0182,-0.0074,0.045,0.0518,0.0636,-0.0717,0.0055,-0.0247,-0.0306,-0.0604,-0.0717,0.016,-0.0038,-0.0006,-0.0336,-0.053,0.0067,0.0454,-0.0413,-0.0377,-0.0751,-0.0554,-0.0088,0.0244,0.0642,0.0612,-0.0043,0.0654,-0.0132,-0.124,0.0733,-0.0145,-0.009,-0.0348,-0.0493,-0.0222,-0.0375,0.0061,-0.0811,-0.0002,-0.006,0.0178,0.0243,-0.0258,-0.0105,-0.0602,-0.0197,-0.0409,-0.0076,-0.0304,-0.0528,0.0064,-0.0122,-0.0088,0.0131,-0.0493,-0.0018,-0.0181,-0.0443,-0.0584,-0.0407,-0.0383,-0.0171,0.0137,-0.0292,-0.0437,-0.0747,-0.1847,-0.0429,-0.0063,-0.0161,0.0036,-0.0247,-0.0576,-0.0055,-0.017,-0.063,-0.0352,-0.0064,0.0081,-0.1558,-0.0392,-0.0699,0.0118,-0.0228,-0.0775,-0.0033,-0.0744,-0.0444,-0.0163,-0.0626,-0.0062,-0.1117,-0.0258,-0.0486,-0.0391,-0.0422,-0.0314,-0.013,-0.0156,0.0892,-0.0449,0.0214,-0.0173,0.02,-0.0038,0.0204,0.0024,0.0225,0.0077,-0.0131,0.0736,0.017,0.0072,-0.0232,-0.036,-0.0556,0.0002,-0.0384,0.041,-0.0339,-0.0068,-0.0039,-0.0151,0.0023,0.0172,0.0531,-0.0037,0.022,-0.0042,-0.0355,-0.0697,-0.0727,0.092,0.0597,0.0051,-0.0791,0.1128,-0.0124,-0.0052,-0.0606,0.1295,-0.0789,0.0041,0.0751,-0.0081,-0.0725,-0.0777,-0.0377,-0.0127,0.0187,-0.0475,0.0373,-0.0323,-0.0004,-0.0254,-0.0321,-0.0323,-0.0306,0.0104,-0.0899,-0.0232,0.0002,0.0868,0.0299,-0.0116,-0.0282,-0.0058,0.0378,-0.0357,0.0447,0.0305,-0.0333,0.0406,-0.0216,0.0475,-0.0323,-0.026,-0.0263,-0.0252,0.024,0.0257,0.0014,-0.0282,0.0397,-0.0161,-0.0127,-0.0145,-0.019,-0.048,0.0058,-0.0354,-0.0697,0.0053,-0.0397,-0.0658,-0.0178,-0.0337,-0.0603,-0.005,-0.0134,0.0283,-0.0176,0.0901,-0.0001,-0.0155,0.0049,-0.0517,-0.022,0.0083,-0.0035,-0.0473,-0.0268,0.014,-0.0448,-0.0039,-0.0014,0.0063,0.0026,-0.0643,0.0635,0.0557,0.0096,-0.0024,-0.0042,-0.04,0.0011,-0.0282,0.0001,-0.0157,0.036,0.0273,-0.062,-0.0334,-0.0257,-0.0077,-0.0134,0.0054,-0.0106,-0.0126,-0.0159,-0.0047,-0.0891,-0.0027,0.0453,-0.066,0.0049,-0.0584,-0.0613,-0.0097,-0.0232,-0.045,-0.024,-0.007,-0.0208,0.0173,-0.065,0.0202,-0.0553,-0.043,0.0348,0.0209,0.0469,-0.0118,0.0571,0.0021,0.0072,-0.0219,0.0066,-0.0055,-0.0212,-0.0687,0.0036,-0.0441,-0.0152,0.0168,-0.0252,-0.0152,0.0584,0.026,-0.0507,-0.0671,0.0035,0.0068,0.0076,0.0721,0.0695,0.0505,0.0812,-0.0543,-0.0383,-0.0437,-0.0995,-0.0367,-0.0528,-0.026,-0.1716,-0.0262,0.0183,-0.0603,-0.0123,-0.0681,0.0115,0.0362,-0.0457,-0.0332,-0.0102,-0.0177,-0.0239,-0.0207,-0.0084,-0.0556,-0.0105,0.0185,0.0546,-0.0074,0.0468,0.0202,0.0455,-0.0874,-0.0768,0.0069,-0.0179,0.1433,-0.0251,-0.0299,-0.0308,-0.0303,-0.0122,0.0127,-0.04,-0.0076,-0.0237,-0.0088,0.0289,-0.0679,0.0263,-0.012,0.0085,-0.0348,0.016,-0.0121,-0.0206,0.0588,-0.0308,0.0245,0.025,-0.0681,-0.1412,-0.0883,-0.0889,-0.0911,0.0337,-0.0015,-0.0095,0.0593,0.0607,-0.0365,-0.0171,0.0537,0.0428,-0.0291,-0.023,-0.0547,-0.0586,0.025,-0.0119,0.0213,0.0278,0.0233,-0.0018,-0.0173,-0.0204,0.028,0.0283,0.0522,0.0345,0.0417,0.0369,0.0241,-0.0223,0.0139,-0.0152,-0.0211,-0.0083,0.0445,0.0046,0.0023,0.0232,0.015,-0.0168,-0.0163,0.0272,0.0653,0.0541,0.0286,0.018,0.1954,0.0237,-0.0152,-0.0044,0.0328,-0.0262,0.0122,0.0546,-0.0013,-0.0135,0.0087,0.0207,0.0045,0.0189,-0.0504,0.0726,-0.0222,0.0409,-0.0147,-0.0155,-0.0559,-0.0446,-0.0002,0.0329,0.0048,-0.0139,-0.0399,-0.0435,-0.0529,-0.035,0.0667,0.0731,-0.0477,-0.0149,0.0149,-0.0101,0.0118,-0.0072,-0.0016,-0.0264,0.0058,-0.0047,-0.0283,0.0681,0.023,0.0403,0.0176,0.038,0.0127,0.0006,-0.0471,0.0115,0.0044,-0.0458,0.0004,-0.0082,0.0224,-0.0517,-0.0478,-0.0778,-0.1218,-0.0364,-0.0207,-0.0005,-0.0431,-0.0308,-0.0205,0.0216,0.0148,0.0106,0.0167,0.0311,-0.0063,-0.0468,0.0023,-0.0088,0.0132,-0.0768,0.026,0.0023,-0.002,-0.0239,0.0561,-0.0695,-0.0395,-0.0254,0.0263,0.0301,-0.026,0.0137,0.0042,0.0636,0.0036,-0.0247,-0.0366,0.0129,0.021,0.0188,0.0508,0.0045,0.0179,0.0319,0.1034,-0.0269,0.0301,0.0041,0.0308,-0.1604,0.048,-0.0058,0.0143,-0.0361,-0.0701,-0.0217,-0.0144,-0.0198,-0.0105,-0.0202,-0.0307,0.0107,-0.0143,0.0024,0.0116,0.0327,0.0288,0.0056,0.1218,0.0853,0.0502,0.0809,0.0769,0.1233,0.0782,0.0828,0.0263,0.0332,0.047,0.0142,-0.0038,0.0127,0.0178,0.0108,0.0516,0.0394,0.0119,0.0286,0.026,0.0032,-0.0182,0.0062,0.0261,-0.0189,-0.0116,-0.0462,0.0019,-0.0503,-0.0112,0.0286,-0.0015,0.0453,0.0679,-0.0998,0.0031,0.0315,0.0105,-0.0341,0.0836,-0.006,-0.0692,0.0005,0.0053,0.0274,-0.0749,-0.207,-0.1541,-0.1517,0.0026,-0.0469,-0.0205,-0.0048,-0.0204,-0.0991,-0.0711,0.1062,-0.0039,-0.04,-0.0059,-0.0134,-0.0142,-0.0469,-0.0212,-0.0471,-0.0212,-0.094,-0.1735,0.117,0.016,0.0208,-0.0001,0.0866,-0.0149,-0.0101,-0.0062,0.0039,0.064,0.0082,-0.0862,-0.047,-0.0149,0.0247,0.0291,0.1185,0.0302,-0.0015,-0.0092,0.0541,0.1615,0.0391,0.012,0.0226,-0.0531,0.1068,-0.0111,-0.0593,-0.0061,0.1641,-0.0576,-0.0256,-0.0279,0.0952,0.0227,-0.0415,-0.0107,-0.113,-0.023,-0.065,-0.0364,-0.0488,0.0506,-0.0169,0.029,-0.0077,0.0144,-0.0172,0.0322,-0.0325,0.014,-0.0293,0.1156,0.0654,0.0495,0.1182,-0.0616,-0.0577,-0.0282,-0.0198,-0.0545,-0.0296,-0.112,0.0345,-0.0127,-0.0079,0.0318,-0.0779,-0.0191,-0.0108,0.0216,-0.0227,-0.0157,0.0018,-0.0033,-0.0252,0.1096,0.0918,0.013,-0.0065,-0.0835,-0.0835,0.031,-0.0539,-0.0535,-0.049,-0.0296,0.0084,-0.0148,-0.109,0.0146,0.0188,0.0967,0.0276,0.0049,0.0048,-0.029,-0.0487,-0.0579,-0.043,-0.0331,-0.0202,-0.1026,0.1031,0.2044,-0.0094,0.1108,-0.0356,0.131,0.0634,0.01,0.0255,0.0191,0.0914,0.0331,0.0341,0.1427,0.0465,0.0218,-0.1992,-0.1062,-0.0806,0.0225,-0.1056,0.0416,-0.0116,-0.0199,-0.0614,-0.0091,-0.0253,-0.1492,-0.0088,-0.0369,-0.0858,-0.0748,-0.0917,-0.011,-0.0044,-0.0748,-0.0095,0.1262,0.1059,-0.0357,-0.0869,-0.0052,-0.0302,-0.0758,-0.0101,0.0995,-0.0189,0.0814,-0.0427,-0.0117,-0.0404,0.0924,0.0894,-0.0068,0.0222,0.0719,-0.0236,-0.0244,-0.0003,-0.0167,0.0452,-0.0149,0.008,-0.0499,0.0371,0.0115,-0.0267,0.0331,-0.0268,-0.0175,0.0011,0.0172,0.001,-0.0304,-0.007,-0.049,-0.0593,-0.0482,-0.0493,-0.0462,-0.0468,-0.0158,-0.0599,-0.0476,0.0381,-0.0194,-0.0251,-0.0142,-0.0695,-0.1215,-0.066,0.0212,0.0031,0.0627,-0.0076,0.0401,0.007,0.0862,0.1433,-0.0095,-0.0001,0.003,-0.0207,0.0384,-0.0179,-0.0665,-0.0447,0.0145,-0.0295,-0.0824,-0.0036,-0.0519,0.0118,-0.0281,-0.035,0.024,0.0144,-0.021,-0.0206,-0.0192,-0.0273,0.0252,0.0302,0.0409,-0.0186,0.0469,-0.0214,0.0037,-0.0132,-0.0522,-0.026,0.0246,-0.0409,-0.0147,-0.0341,-0.0151,-0.0161,-0.0383,-0.0199,0.0164,0.0296,0.0474,-0.027,0.0155,-0.0518,-0.0475,-0.0506,-0.0072,-0.0557,0.0133,-0.1638,-0.2326,0.0052,-0.0143,0.0108,0.0003,-0.0213,0.0244,0.08,0.0054,0.0035,0.0033,-0.0091,-0.1248,-0.0455,-0.0184,-0.0401,-0.0241,0.0103,0.0093,0.1645,0.2067,0.0818,0.12,-0.0522,0.0487,-0.0453,0.1125,-0.021,-0.0311,-0.0061,0.0382,-0.0406,-0.0024,-0.0381,-0.0209,-0.0321,0.0413,0.0275,-0.0704,-0.042,0.0206,0.0096,-0.0433,-0.0307,-0.0391,-0.0247,0.0088,0.0176,-0.0745,-0.0494,-0.038,-0.082,-0.078,-0.0081,-0.0429,0.039,-0.0022,0.0755,0.0272,-0.0073,-0.0133,0.006,-0.043,-0.0623,0.0043,-0.0046,0.0241,-0.0413,-0.0023,0.021,0.0474,0.0164,0.0304,0.0101,-0.0061,-0.0725,0.0247,-0.0453,-0.0681,-0.0561,0.0313,-0.0184,0.0176,0.0246,0.0481,-0.0857,-0.0026,0.0099,-0.0213,-0.0557,-0.0428,-0.0504,0.0069,-0.0496,-0.036,0.0394,-0.0293,-0.0278,-0.0171,0.032,0.0617,-0.0167,-0.0578,0.018,0.0523,0.0233,0.0243,0.0298,-0.0379,-0.0054,-0.0206,-0.2016,0.0471,0.0014,0.0381,0.0141,0.059,0.0193,0.023,-0.011,0.0057,-0.029,-0.0669,0.0202,0.0206,0.0843,0.0717,0.027,0.0404,0.0173,0.0177,-0.0082,-0.0183,0.0195,0.0212,0.0693,-0.0204,0.0335,-0.0475,0.0147,0.0007,-0.0171,0.2939,0.1672,0.1796,0.1859,-0.0234,-0.014,0.0112,0.0081,-0.0128,-0.0003,0.039,-0.0248,-0.0087,-0.0721,-0.0117,0.0068,-0.0031,-0.0255,-0.0824,-0.0623,0.0868,0.0577,0.129,0.1033,-0.0604,-0.0223,-0.0224,0.0073,0.0523,-0.0266,-0.0339,-0.0481,0.0665,0.0327,0.0008,0.0208,0.0921,0.064,-0.0047,-0.0555,-0.0185,-0.0043,0.2044,0.0997,0.03,0.0235,0.0906,0.0194,-0.0766,-0.1027,-0.041,-0.0374,0.0083,0.012,-0.1049,-0.0809,-0.0564,0.0339,0.0156,0.2408,-0.0184,-0.0031,0.0256,0.0554,0.0827,0.1219,0.0985,0.1754,0.0065,-0.0139,-0.0024,-0.0,0.0378,0.009,0.0568,-0.0605,0.0021,-0.0444,-0.0398,-0.0213,0.016,0.0117,-0.0256,-0.0639,-0.034,0.0076,0.0285,0.0779,-0.0106,-0.0231,-0.0096,-0.0121,-0.0287,0.0184,-0.0113,-0.0334,0.0463,-0.0703,-0.2125,0.0014,-0.1,-0.0885,-0.0942,-0.0339,-0.0682,-0.0518,-0.0176,-0.0414,-0.0048,-0.0062,-0.0465,0.0163,-0.0383,-0.0286,-0.0255,-0.0128,-0.0348,-0.0719,-0.0065,0.0009,-0.0204,0.0233,0.0872,0.064,-0.0613,0.0437,0.0085,-0.0334,-0.0292,-0.0493,-0.007,0.0439,0.0205,-0.0153,-0.0196,-0.0119,0.0185,-0.0072,-0.0277,0.0249,0.0532,0.0605,0.0365,-0.0321,0.0184,0.0312,0.0189,0.0037,-0.0319,-0.0578,-0.08,0.0136,-0.0277,-0.057,-0.021,0.2009,0.0861,-0.031,-0.0492,-0.0259,-0.0938,-0.0313,0.0335,-0.0481,-0.0039,0.0119,-0.0074,-0.0272,-0.0328,-0.0327,-0.0185,-0.0126,0.0058,0.0114,-0.1225,-0.0158,-0.0585,-0.0214,-0.0419,-0.0578,-0.0192,0.0045,0.0174,0.0201,-0.0054,0.0167,-0.0161,-0.0177,0.0102,0.0366,-0.0174,-0.019,-0.0001,0.0005,0.0108,0.05,0.0451,0.024,-0.048,-0.0028,0.008,-0.0172,-0.023,-0.0268,0.0447,-0.0636,-0.0487,-0.0674,-0.0141,0.0101,-0.0147,0.0519,-0.0196,0.1844,-0.0168,0.0346,0.0614,0.027,0.1059,0.2241,-0.0384,-0.0229,-0.0035,-0.0712,0.0377,0.0619,0.001,-0.0321,-0.0098,-0.0192,-0.0441,-0.0109,0.0243,0.0414,0.0822,-0.0882,-0.0807,-0.0122,-0.0052,0.0257,-0.0479,-0.0394,-0.037,0.0101,-0.0279,0.0192,-0.01,-0.0266,-0.0031,-0.0358,-0.032,-0.0175,0.0084,-0.0393,-0.0958,-0.0185,-0.0202,-0.0208,-0.0176,0.0085,0.013,0.0608,0.0175,0.0495,0.0726,-0.037,-0.0565,-0.1412,-0.0812,-0.1841,-0.0776,-0.1306,-0.1335,-0.03,-0.0661,-0.0548,-0.0151,-0.0829,-0.1608,-0.1574,-0.1054,-0.0193,-0.011,-0.038,-0.0358,-0.0085,0.1466,0.0046,-0.0081,0.0508,-0.0301,-0.0558,0.0111,-0.0187,0.0777,-0.1106,0.0596,0.0245,-0.0353,-0.0134,0.052,0.1472,0.2032,0.0805,0.0486,0.0279,-0.0123,-0.0199,-0.0191,-0.0238,-0.0051,0.0313,-0.0472,0.0031,-0.0242,-0.0106,-0.013,0.0078,-0.0541,-0.0323,-0.0218,-0.0045,-0.1369,-0.1177,-0.0381,-0.0378,-0.0645,-0.0239,-0.1065,-0.0108,-0.0493,0.0305,0.0369,-0.0291,0.0069,0.0364,-0.0354,-0.0327,0.009,-0.0279,-0.0089,-0.1155,-0.0218,-0.0396,-0.045,0.0336,0.0284,0.0045,0.033,-0.0093,0.005,-0.0306,0.0172,-0.0192,-0.0786,0.0045,-0.0453,-0.0505,0.0347,0.0126,-0.0244,-0.0259,-0.0306,-0.0398,0.0139,0.0295,-0.0167,-0.015,0.1397,0.1171,0.0414,-0.0353,-0.0744,-0.068,-0.052,-0.0164,0.0061,-0.0137,0.0102,0.0136,0.018,0.0327,-0.052,-0.0462,0.0255,-0.0026,0.0075,0.0286,0.0423,0.0551,-0.0119,-0.0093,-0.0545,-0.032,0.0319,0.0237,0.0668,-0.0032,0.0087,0.0256,0.0654,0.0752,0.0831,0.0231,-0.0169,-0.032,0.022,0.0141,-0.0338,-0.0048,0.0281,-0.0258,-0.0238,-0.0161,-0.033,0.0088,-0.0296,-0.0477,-0.0247,-0.0198,-0.0051,-0.005,-0.0287,0.0864,-0.0373,-0.0063,-0.0114,-0.0448,-0.033,0.0112,-0.0543,0.0956,-0.0036,-0.0352,-0.0318,-0.0174,0.0029,-0.0099,-0.0367,-0.0317,-0.0293,-0.0511,0.051,0.139,-0.0897,-0.0459,-0.0556,-0.0203,0.0172,-0.0021,0.0194,-0.0156,0.0325,0.0825,-0.0803,-0.0707,-0.0026,-0.0088,-0.1142,-0.1241,-0.1069,0.0166,-0.0291,0.0955,-0.0835,-0.0029,0.0382,-0.019,0.0083,0.0044,-0.0033,-0.0308,-0.018,-0.0315,-0.068,-0.1011,-0.0424,-0.0286,0.0033,-0.0971,-0.1021,-0.0439,-0.0241,0.0274,-0.0656,-0.0075,-0.0441,-0.0275,-0.024,-0.0483,-0.0168,0.0046,-0.0348,-0.0246,-0.0731,-0.0638,0.1225,0.0864,-0.0478,-0.0044,-0.0051,-0.0402,-0.0084,0.0133,-0.0168,-0.023,-0.0313,0.0461,0.0185,0.0467,-0.0107,-0.0325,-0.0147,-0.0172,-0.0341,0.0366,-0.0225,0.0061,-0.0107,0.008,-0.0655,-0.0635,-0.0641,-0.0203,0.0159,0.0388,0.0277,0.0162,0.0634,0.0808,0.0257,-0.0861,-0.0345,-0.0323,-0.0086,-0.0218,-0.0691,-0.0194,-0.0506,-0.0434,-0.0452,-0.0843,0.1192,-0.0388,0.0362,0.014,0.0074,-0.0109,0.0327,-0.0386,0.0012,-0.0032,-0.0157,-0.0418,-0.0167,-0.0412,-0.0336,0.1338,0.2153,0.023,-0.0027,-0.083,0.1061,0.0269,0.0691,0.0514,-0.0476,-0.0531,-0.0472,0.1074,0.1131,-0.0506,-0.0256,-0.0093,0.0109,-0.008,0.0312,0.0483,-0.0118,0.0698,-0.0026,0.0054,-0.029,-0.0394,-0.0326,0.0501,-0.0103,0.0023,0.014,-0.0472,-0.0481,-0.0011,-0.026,0.0536,0.0155,0.0254,-0.0423,-0.0234,0.0181,-0.0481,-0.0308,-0.0049,-0.0582,-0.0582,0.0165,0.0068,0.0123,-0.0068,-0.0063,-0.1033,-0.0803,0.1037,0.0953,-0.0369,0.0989,-0.0944,-0.0362,0.211,-0.0999,0.2336,0.2006,-0.0412,-0.0473,-0.0791,-0.1116,-0.0117,-0.0641,-0.0289,-0.0323,-0.0264,0.0109,-0.0014,-0.0045,-0.0185,0.0104,-0.0015,-0.0405,0.016,-0.0502,0.0066,-0.0054,-0.0044,0.0096,0.0179,0.0053,0.0445,-0.0255,0.041,0.0228,0.0616,0.0116,-0.0469,-0.032,-0.0474,-0.0174,-0.0622,-0.053,0.0021,-0.0838,-0.0853,0.0114,-0.0756,-0.0511,-0.0054,0.0492,0.009,0.1118,0.041,-0.0018,-0.007,-0.0436,-0.0128,0.1043,0.0259,-0.0014,0.0417,0.0009,-0.0019,0.0309,-0.1984,0.047,-0.1876,-0.1151,-0.1928,-0.0477,-0.1648,-0.0157,-0.0622,0.0276,0.0603,-0.0696,0.0352,-0.0089,-0.0323,0.0229,0.0092,0.0192,0.0297,0.0108,-0.0015,-0.0446,-0.0343,0.0618,0.0805,0.0618,-0.0176,-0.0307,-0.0446,0.0717,-0.0841,0.0635,0.1592,0.004,0.0463,-0.0527,-0.0142,-0.0148,-0.0471,-0.0208,0.004,-0.0103,0.0368,0.0403,-0.0363,-0.0231,-0.0168,-0.0164,-0.0308,-0.0613,-0.0062,0.0298,-0.0214,-0.0121,0.0133,-0.0273,-0.0028,0.1889,0.1837,-0.0267,-0.0063,-0.0325,-0.015,-0.0178,-0.0311,-0.0164,0.0233,-0.0186,-0.0068,0.0038,-0.034,0.0314,-0.0253,-0.1051,0.0173,-0.0125,-0.0099,-0.0286,0.0151,-0.0146,0.0535,-0.0628,-0.0332,-0.0012,0.0052,-0.0371,-0.0384,-0.0359,-0.0005,-0.0197,0.0013,-0.0531,0.0007,-0.0669,-0.0217,-0.0355,-0.0608,-0.0058,-0.0869,-0.1145,-0.0622,-0.0502,-0.0482,-0.0325,-0.0205,0.153,0.1409,0.2546,-0.0066,-0.0458,-0.0041,-0.016,0.0059,-0.002,0.0206,0.0029,-0.0111,-0.0091,-0.0094,-0.0211,0.0598,-0.036,0.0379,0.0769,-0.0226,0.0839,0.0029,-0.0576,-0.0873,-0.031,-0.041,0.0603,0.0552,-0.001,0.0165,-0.0047,-0.0416,-0.0365,0.0019,0.0132,-0.023,-0.0095,-0.0161,-0.0148,0.0322,0.0556,0.0007,-0.0133,0.0088,0.0289,-0.0895,-0.1012,-0.0126,-0.0567,0.0581,0.0004,-0.0128,-0.0045,0.0083,-0.0801,0.036,-0.0594,-0.0437,-0.0107,-0.0132,-0.0015,0.0118,-0.0433,0.0149,0.0264,-0.0439,0.0292,-0.0115,-0.0177,0.0141,0.0284,0.0297,-0.0311,0.0774,0.0074,-0.038,-0.0157,-0.0034,0.0346,0.0022,-0.0366,0.0101,-0.0083,-0.0654,0.0046,0.0083,-0.0289,0.0929,0.0388,-0.0611,0.0401,0.0342,-0.0087,-0.0197,-0.0727,0.0016,0.038,-0.0027,0.0421,-0.0056,0.0029,-0.0065,-0.0185,0.0232,-0.0213,0.0214,0.0167,0.0059,0.0021,0.0032,0.0236,-0.0908,-0.0196,0.0637,-0.0741,0.0232,0.0128,-0.0441,-0.0348,-0.0276,0.0132,0.036,0.0143,-0.006,0.0206,0.0183,0.0014,0.0327,-0.0275,-0.0005,-0.0375,0.0401,-0.0212,0.0128,0.0027,0.0149,-0.0311,-0.0901,-0.1118,-0.1051,-0.0265,-0.0395,-0.033,-0.0127,0.0207,0.0372,0.0179,-0.0028,-0.0023,0.0461,-0.0137,0.0552,0.0091,-0.0136,0.0567,-0.0321,-0.0178,-0.0192,-0.0401,-0.0594,0.0581,-0.0432,-0.0245,-0.0293,-0.0318,0.0105,0.048,0.0567,0.0215,-0.1386,-0.0369,-0.0202,-0.05,-0.0262,-0.02,-0.0029,-0.0254,-0.0319,-0.1458,-0.0099,0.005,0.0271,-0.037,-0.025,-0.0035,0.0116,-0.0097,0.0331,-0.0433,-0.0002,-0.0103,0.0543,0.0293,0.0189,-0.025,0.028,-0.0371,0.0074,-0.0068,0.0238,0.0362,-0.0653,-0.0071,-0.004,0.1026,-0.0604,0.0011,-0.011,-0.0128,0.0336,-0.1832,-0.1671,0.0077,-0.1075,-0.0393,-0.0241,-0.0414,-0.0013,0.0002,-0.0105,-0.0434,-0.0404,0.0737,0.0035,0.0332,0.0332,-0.0631,-0.0377,-0.0037,0.214,0.0325,0.0361,0.0519,0.1123,0.092,-0.0966,-0.0772,-0.0138,0.0996,0.0463,-0.1471,-0.1832,-0.0854,-0.05,0.0041,-0.0768,0.2527,0.1639,0.2702,-0.0008,-0.004,-0.0841,-0.0087,0.0101,-0.0937,-0.0181,-0.0642,0.0268,0.0221,-0.0339,-0.0286,-0.0504,-0.0045,-0.0091,-0.0352,0.0761,0.024,-0.0157,-0.0386,-0.0462,-0.0104,-0.0624,-0.0249,-0.0283,-0.0724,-0.0362,0.0006,-0.0035,0.0058,0.0362,0.0115,-0.0058,0.0303,0.0337,-0.0304,0.0041,0.0843,0.0456,-0.051,0.089,-0.0299,-0.0351,-0.1416,-0.0119,0.022,0.0974,-0.0742,-0.0938,0.0058,0.0241,-0.0503,-0.0156,0.0069,-0.0542,0.0344,-0.1321,0.0737,-0.0243,0.049,-0.0154,-0.0945,0.0101,-0.0672,0.0832,-0.0338,-0.0809,-0.059,-0.0012,-0.0885,-0.0802,0.0189,0.0073,0.067,-0.0376,-0.04,-0.0633,0.0119,0.0244,-0.0763,-0.0168,-0.0156,0.0147,-0.0201,-0.0847,-0.0433,-0.023,-0.063,-0.033,0.0612,0.0384,0.039,0.0406,0.0165,0.035,-0.008,-0.019,-0.174,-0.1742,-0.146,0.0101,0.0878,0.1095,-0.0498,0.03,0.013,0.0758,0.0278,-0.0785,-0.0119,-0.02,-0.0564,0.0104,-0.0545,0.1561,0.1516,0.1371,0.0703,0.0364,0.015,0.0001,0.0355,0.06,0.0093,0.0206,-0.0081,-0.0,-0.0081,0.2625,0.1987,0.1712,0.1139,-0.0269,-0.0677,-0.1119,-0.0316,0.2275,-0.0787,-0.005,-0.0018,-0.0209,-0.0133,0.001,-0.0783,-0.0966,-0.0664,-0.016,0.0223,0.0066,0.058,0.0232,0.1761,-0.1095,-0.1452,-0.1284,0.0454,0.0349,-0.0247,0.0192,-0.0196,0.0204,0.0232,0.0469,0.0439,0.0155,0.0057,0.0124,0.0609,0.0493,-0.0436,-0.0417,-0.0072,-0.0512,-0.0616,-0.0157,-0.0503,0.0524,0.0934,0.0265,0.0102,0.014,0.005,0.0297,-0.0102,0.0926,0.0437,-0.013,0.0516,0.2346,-0.0702,-0.012,0.0051,-0.041,0.0104,-0.031,-0.0269,-0.0587,-0.0188,0.0076,0.0428,-0.0051,-0.0061,0.0251,-0.009,-0.0355,-0.0166,-0.0259,-0.0118,-0.05,0.0217,0.0275,-0.0077,0.0092,0.0143,0.037,0.0258,0.0221,-0.0091,0.0002,0.0381,-0.0285,0.0415,-0.0032,0.0556,0.131,-0.0166,0.1526,0.2059,-0.0843,0.2075,-0.033,-0.0428,0.0627,-0.0725,0.2576,-0.114,-0.1121,0.0502,0.0789,0.0433,-0.0299,0.0022,0.0347,0.0152,-0.0494,0.0062,-0.0035,-0.0347,-0.0726,0.0232,0.0159,0.0015,-0.0069,-0.0266,-0.0127,-0.0262,0.2421,-0.0228,0.0231,0.0062,0.041,0.0065,0.0157,-0.1479,0.0014,0.0124,-0.1459,-0.0665,-0.0563,-0.0194,-0.0631,-0.033,-0.0518,0.0383,-0.011,-0.0498,-0.0049,0.0204,-0.0821,-0.0509,0.0,-0.0275,-0.0096,0.0215,0.0177,-0.0403,-0.0091,-0.0394,-0.0195,0.2496,0.1884,0.06,0.0924,0.1256,0.2256,0.0782,0.0898,0.0738,0.0385,0.0475,0.065,0.2866,0.1131,-0.0242,0.0771,0.0612,0.0609,0.032,-0.0384,0.0118,-0.0002,-0.0007,0.0911,0.103,0.0147,-0.0526,-0.0035,-0.0139,-0.0351,-0.0027,-0.0497,-0.0955,0.0629,0.0322,0.0497,0.0576,-0.0396,-0.019,0.0024,0.0228,-0.0403,0.0044,0.0309,0.015,-0.0002,0.0399,-0.0518,-0.083,-0.0716,-0.0281,-0.0267,-0.0572,-0.0725,-0.0392,-0.0417,0.0231,-0.0659,0.0587,-0.053,-0.0092,0.0268,0.0346,-0.0252,0.0224,-0.013,-0.031,-0.0249,-0.1177,0.0163,0.0161,-0.0085,-0.0125,0.0493,0.0075,0.0258,-0.0055,-0.0042,-0.0146,-0.0263,-0.0212,-0.1016,-0.0947,-0.0633,-0.0492,-0.016,-0.0181,-0.0228,0.0151,-0.0093,-0.0097,-0.0716,-0.0348,-0.0147,-0.052,-0.0539,-0.018,0.006,-0.0213,0.0051,-0.0197,0.0114,0.0067,0.0617,0.0148,0.0314,0.0122,-0.0632,-0.0118,-0.0665,-0.0138,-0.0425,-0.0221,0.0072,0.0395,0.0002,-0.0685,0.0127,-0.0016,0.0269,-0.0422,0.0156,0.061,-0.0769,0.1004,0.0505,0.0191,0.0336,0.0004,0.0357,-0.0291,-0.032,0.0481,-0.0266,0.012,-0.0579,0.0026,-0.045,0.002,-0.0068,-0.0245,0.0023,0.0058,-0.0032,-0.0943,0.0271,-0.0393,-0.0409,-0.0119,-0.0152,0.0436,0.0258,0.0081,0.025,-0.0093,0.0058,-0.0316,-0.0446,-0.0602,-0.0094,-0.0311,-0.0428,-0.039,0.0242,0.0053,0.0074,0.0156,-0.0555,-0.0112,-0.0246,0.0077,0.0138,0.0555,-0.0044,0.0145,0.0089,0.0195,-0.0323,-0.0208,-0.0293,0.0609,-0.0053,-0.0124,-0.0207,-0.0245,0.1747,0.153,0.0867,0.0417,0.1782,-0.0709,0.04,-0.0329,-0.0378,0.0268,0.0403,0.1065,0.0419,0.0223,0.0367,0.0164,-0.0311,0.0063,0.0311,-0.0129,0.0868,0.0137,-0.003,0.0068,-0.0343,-0.0466,0.0333,-0.0158,-0.0191,0.0305,-0.0089,0.0121,0.158,-0.0388,0.0962,-0.0516,-0.135,0.0063,-0.0179,0.0257,-0.0314,0.1542,0.1873,-0.0137,-0.0216,-0.0183,-0.1474,-0.0921,0.0041,0.0207,-0.0291,-0.0364,0.0787,-0.037,0.0399,0.024,0.0144,-0.025,-0.0342,-0.0146,-0.0271,-0.0629,-0.0336,-0.0047,0.0108,-0.0077,-0.0457,-0.0311,-0.0311,-0.0378,-0.0434,0.0006,-0.0174,-0.0279,-0.0033,0.2479,0.1836,0.0563,0.118,0.2428,0.0012,0.0033,0.003,0.0423,-0.0004,0.1459,0.0182,0.0254,-0.0062,0.0027,-0.0109,-0.0305,-0.0284,-0.0436,-0.0062,-0.014,-0.0473,positive feedback processing
trm_4aae62e4ad209,-0.0724,-0.0954,-0.0943,-0.0708,0.0021,-0.0227,-0.0575,-0.0185,0.0144,-0.026,0.0039,0.0006,-0.082,-0.0652,-0.1008,-0.0407,-0.0986,-0.0943,-0.0702,-0.0183,-0.0514,-0.0009,-0.0423,0.0334,-0.0615,-0.0329,-0.0332,-0.0664,-0.0813,-0.029,-0.0802,-0.0629,-0.0982,-0.1047,-0.0874,-0.1361,-0.09,-0.0531,-0.1188,0.0045,-0.095,-0.0915,-0.0579,0.0794,-0.0736,-0.0454,0.0647,-0.0292,0.0897,-0.0677,-0.0543,0.0351,0.0496,0.0575,-0.0327,-0.0465,-0.0735,-0.0209,0.0423,-0.028,-0.0191,-0.0167,-0.1242,0.0389,0.0331,0.0632,-0.1769,-0.1506,-0.0491,-0.0089,0.0933,0.0127,0.0779,-0.053,-0.0835,0.1038,-0.083,0.0359,0.026,-0.0391,0.0215,0.104,-0.0583,-0.0502,0.0606,0.0471,0.031,-0.0205,0.0277,-0.1033,-0.0924,-0.0238,0.0045,0.0701,0.0509,0.0394,0.0882,0.0058,0.1231,-0.0161,0.0282,-0.0009,0.0761,-0.01,0.0503,-0.1037,-0.1539,0.2044,-0.0348,-0.0025,0.0265,-0.0476,0.1157,0.1209,0.0162,0.0257,-0.0609,0.0345,0.0437,-0.0442,-0.0846,-0.1171,-0.0761,0.0281,-0.0729,-0.0814,-0.0497,0.0399,0.067,0.0416,0.0146,-0.0864,-0.0184,-0.1722,0.0232,-0.1508,0.0019,-0.0663,-0.0548,-0.0501,-0.0561,-0.0781,0.033,0.0069,-0.0749,0.0281,-0.0458,0.028,-0.0566,0.082,-0.0077,-0.093,-0.1261,-0.0623,0.1049,-0.0522,0.0806,-0.0061,0.0132,-0.0277,-0.0416,-0.0603,-0.1567,-0.1734,0.0173,0.0061,-0.008,-0.1455,-0.1385,0.0453,-0.0714,-0.1172,0.0317,-0.0869,-0.0735,-0.1231,-0.0965,-0.0274,-0.0021,-0.0259,-0.1091,0.0673,-0.0654,0.0298,-0.0441,-0.028,-0.0865,-0.0255,0.0538,-0.1186,-0.1067,-0.0448,-0.0323,-0.0383,-0.0254,-0.1879,-0.1233,-0.0814,0.0109,-0.0733,-0.0288,0.0875,-0.2007,-0.1837,0.0331,-0.0416,-0.0781,-0.0341,-0.0357,0.0275,-0.078,-0.0001,0.05,0.0023,0.0583,0.0314,0.0569,-0.1361,-0.1752,-0.0214,0.099,-0.1158,-0.1222,-0.0376,0.071,0.0431,-0.044,0.0822,0.0417,0.1741,-0.1086,-0.1614,0.0807,-0.1232,-0.1249,0.0961,-0.01,0.0715,0.0046,-0.0993,-0.0402,-0.1469,-0.0762,-0.0298,-0.0555,-0.0814,-0.0402,-0.1042,-0.0553,-0.0589,0.0429,0.0518,-0.0211,0.0939,0.041,-0.1047,0.0027,-0.0676,0.1412,0.1538,0.0447,0.17,-0.0643,0.0071,0.1443,0.272,0.1364,0.0025,-0.0088,-0.0604,-0.0459,-0.0715,-0.1085,-0.0138,-0.0299,0.0993,-0.0085,-0.0455,-0.0752,0.0563,0.1047,-0.0575,-0.0352,-0.2596,-0.2034,-0.0694,0.0487,0.0972,-0.1639,-0.121,-0.0357,-0.0402,-0.0458,-0.056,-0.0902,-0.009,0.0284,0.1304,-0.0259,0.1612,0.0871,-0.0849,-0.1277,-0.0509,-0.0171,-0.0139,-0.1101,-0.0755,-0.0545,0.0429,0.072,0.0117,-0.0844,0.1114,0.0426,-0.0187,0.1545,-0.0271,0.0958,-0.0927,0.0335,0.0456,-0.1217,-0.1391,-0.0915,-0.0556,0.0256,-0.0536,-0.0479,-0.0894,0.0236,-0.0862,0.0246,-0.0267,0.0876,0.0688,0.1248,0.0462,0.0307,-0.0423,-0.0405,0.0064,-0.04,-0.053,0.067,0.0882,-0.1676,-0.1253,-0.1123,-0.0875,-0.1137,0.0431,-0.089,-0.0153,-0.038,-0.1057,-0.0376,-0.1052,-0.0721,-0.0664,-0.0335,-0.0213,0.046,-0.0191,0.0002,0.0131,-0.1313,0.1707,0.0456,-0.0451,-0.0252,0.0514,-0.0088,0.1011,-0.0711,-0.0179,-0.0346,0.0721,0.1462,0.1327,0.1621,-0.0071,-0.0079,0.0722,0.0515,0.1067,-0.0967,-0.0308,0.0411,-0.0245,-0.0021,-0.0437,-0.135,-0.0488,0.028,-0.0281,-0.1074,-0.12,-0.0718,-0.0368,-0.0102,0.0518,0.008,0.0128,-0.0113,0.0786,0.0299,0.0279,-0.0928,-0.0315,-0.0532,-0.161,-0.057,0.192,-0.0919,0.0361,0.2364,0.015,-0.0261,-0.0343,-0.0289,-0.2044,-0.1675,-0.3042,-0.2693,-0.1181,-0.1678,-0.1054,-0.0794,-0.1324,-0.0868,0.0624,-0.0307,-0.0201,0.0368,0.0739,-0.0494,0.0413,-0.226,-0.1145,-0.0047,0.0228,-0.0635,0.0509,-0.0183,-0.0782,0.0262,0.0818,-0.1062,-0.0181,0.1088,0.0706,-0.0647,-0.048,-0.0009,-0.12,0.034,-0.0684,-0.0251,-0.068,0.0065,-0.0655,-0.0399,-0.03,-0.1056,-0.0879,-0.0057,0.2952,-0.0884,0.0055,0.0111,0.0024,0.0076,-0.0507,-0.0234,-0.0214,-0.0396,-0.0158,-0.0251,-0.0424,-0.0049,0.0026,0.0035,0.0569,0.086,0.1304,-0.0172,-0.0327,-0.0265,-0.0493,0.013,0.1043,-0.1252,-0.1768,0.0264,0.0037,-0.0763,-0.0297,0.0192,-0.038,-0.0288,0.0488,-0.0592,-0.1376,-0.0405,-0.1038,0.0055,-0.0131,-0.0522,0.0633,-0.1205,0.0002,-0.0755,0.0064,0.0608,0.0475,-0.0502,-0.0378,0.067,-0.0432,-0.0122,-0.0702,0.0421,0.1444,0.1676,0.0412,0.1722,0.1482,0.0859,0.0379,-0.0891,-0.0306,-0.0869,-0.258,-0.0487,-0.0074,-0.2031,-0.1666,-0.0569,-0.1386,0.0125,0.007,0.0312,-0.0446,-0.0689,-0.0662,0.0131,0.0665,0.0078,-0.1005,0.0411,-0.0071,-0.0603,-0.0481,-0.0123,-0.1291,0.0999,0.0988,0.0504,-0.0749,-0.0933,-0.0024,-0.1301,-0.006,-0.0396,0.0224,0.0851,-0.0393,-0.0272,-0.0248,-0.0793,-0.0183,-0.1113,0.0232,-0.0834,-0.0727,0.0518,-0.012,0.0396,0.0556,0.0409,-0.1041,-0.0235,-0.0385,0.1049,-0.0282,0.0752,0.0491,0.0511,0.017,-0.0866,-0.0016,0.1035,0.099,-0.031,-0.0255,-0.1405,-0.032,0.0928,-0.0135,0.0019,0.0707,0.0489,0.0485,-0.0027,-0.0606,-0.0223,-0.0621,-0.0451,0.1036,-0.1307,-0.0371,0.0643,0.0048,-0.205,-0.0494,-0.0711,0.0053,0.0031,-0.1884,-0.0578,-0.1977,0.0351,0.011,-0.0865,-0.0081,-0.0562,-0.0653,-0.0596,0.0489,0.0483,0.0044,-0.0426,0.0226,0.0288,-0.011,0.0486,-0.046,-0.0595,-0.0125,-0.0533,0.001,-0.0316,-0.0951,-0.1429,-0.0653,-0.207,-0.0553,0.105,-0.2498,0.0661,-0.2256,0.0749,-0.1981,-0.0096,-0.1483,0.0077,-0.0644,-0.0416,-0.1106,-0.1928,-0.0362,0.1063,-0.0789,-0.0181,0.0178,-0.0789,-0.1101,-0.0837,-0.0251,-0.0605,-0.0339,-0.0935,-0.0873,-0.0509,-0.0498,0.1586,-0.1017,0.0532,-0.0569,0.0548,0.0469,0.0528,0.0534,0.1279,-0.0971,-0.0446,0.0279,0.0342,-0.0027,0.0275,0.1891,0.1017,0.0965,-0.0239,0.0148,0.0041,-0.0206,-0.0391,0.0305,0.008,0.0365,0.001,-0.0796,-0.0367,-0.0304,-0.1983,-0.2454,-0.2003,0.0932,0.0959,0.0624,-0.0126,0.0493,0.0389,0.0134,-0.051,0.0626,-0.136,0.0018,0.101,-0.0578,-0.3596,-0.345,-0.2678,0.0242,0.026,-0.0695,0.0548,-0.0776,0.0494,-0.0332,-0.0523,0.0408,0.0572,-0.018,-0.1157,0.0357,0.0629,0.2108,-0.0867,-0.0157,-0.0687,-0.0309,0.0146,-0.0827,0.0925,-0.0028,-0.0322,0.0024,-0.0151,0.0307,-0.0926,-0.1386,-0.1179,-0.0686,0.0328,0.1537,0.0047,-0.1603,-0.0328,-0.0129,0.0468,0.025,0.0373,-0.0061,-0.1086,-0.0414,-0.0065,0.1485,0.1112,0.0719,-0.0519,-0.023,-0.0086,-0.0429,0.0433,-0.0598,-0.0774,0.0327,-0.0801,-0.0547,-0.023,0.0789,0.0959,0.0447,0.0455,-0.0154,0.0083,0.1005,-0.0351,-0.0541,0.0642,-0.036,0.0343,-0.0124,0.0983,-0.0658,0.0687,-0.0278,-0.044,0.0711,0.1071,0.077,-0.0151,0.0171,0.0455,0.033,-0.0664,0.1186,-0.0247,-0.0161,0.1039,0.1206,0.0293,0.0258,0.1478,0.1301,-0.1182,-0.0025,0.1161,-0.1531,-0.1403,-0.031,-0.0919,0.0238,-0.1144,-0.054,-0.094,-0.0837,-0.124,0.0147,-0.016,0.0421,-0.0736,-0.0425,0.016,0.0871,0.0645,-0.0001,0.0397,0.1126,0.0137,0.0514,0.0429,0.036,0.1011,0.1,-0.1153,0.0727,0.0338,-0.0182,-0.0374,-0.0814,-0.024,0.1028,0.0414,-0.3284,-0.1708,-0.018,0.0766,0.1033,0.066,0.0178,0.0667,-0.0264,-0.0022,-0.0232,0.0094,-0.0094,-0.0401,-0.1523,-0.0166,-0.0278,0.0398,0.1418,0.0487,0.1331,-0.2097,-0.1925,-0.0426,0.0975,-0.0584,-0.0427,-0.0619,0.0241,-0.0285,-0.0459,-0.0206,-0.0354,0.0579,-0.0214,0.0197,0.1142,0.0151,0.0091,-0.1593,-0.0399,0.0145,0.1287,-0.0606,0.0279,0.0729,0.0835,0.0806,0.216,0.0843,-0.0212,-0.01,-0.0774,-0.0434,-0.0322,-0.0015,0.0685,0.1464,0.0426,0.0035,-0.0758,0.0674,0.1775,0.0395,-0.0055,-0.0012,-0.0866,-0.1633,-0.065,-0.0407,-0.0058,-0.0233,-0.0898,0.0054,0.0625,0.0154,-0.0575,-0.0476,0.0714,-0.1052,-0.0398,-0.0767,-0.0692,-0.0688,-0.1487,-0.0846,-0.1577,0.0304,-0.0257,-0.073,-0.1372,-0.0445,-0.0998,-0.0439,-0.148,-0.0858,-0.1162,0.0348,0.0508,0.1004,-0.0168,0.0442,0.0304,0.0261,0.0267,0.0906,0.0887,0.0572,-0.0527,-0.0414,0.0212,-0.0346,0.0292,0.0483,0.0502,-0.0436,0.1385,-0.0182,0.0968,-0.032,0.0041,-0.0485,0.0527,0.0176,0.0636,-0.1397,-0.0355,-0.0844,-0.1322,-0.0938,0.0825,0.0945,0.0438,0.0526,0.1396,0.0743,0.0928,0.0904,-0.0258,0.0079,0.0128,-0.0327,-0.0282,-0.0912,-0.1051,-0.0507,0.0956,0.0835,-0.112,-0.0771,-0.071,-0.1666,-0.0666,0.1243,0.0495,0.1424,0.117,0.0887,-0.1073,-0.0452,0.0547,-0.0102,-0.043,0.0104,-0.0037,-0.0214,-0.1188,-0.0533,0.0666,-0.1052,-0.0147,-0.0604,0.0477,-0.1083,0.0106,-0.0073,0.0724,0.0824,0.0574,0.0358,0.0666,-0.0037,0.0057,-0.0037,-0.0403,-0.021,-0.015,0.0252,0.0138,-0.0065,0.0852,0.0351,-0.0259,-0.0228,-0.1635,-0.1138,-0.1788,-0.077,0.1392,-0.0399,-0.009,-0.136,0.1079,0.0556,-0.0336,-0.0028,0.0243,0.0473,0.0006,0.0582,-0.0989,-0.0607,-0.0192,0.0101,-0.0588,-0.0226,-0.0643,0.0187,0.0527,-0.0609,-0.0454,-0.0271,0.0269,-0.1013,-0.047,0.0089,0.0164,-0.1115,-0.0239,-0.0424,0.0246,-0.0355,-0.078,0.2578,0.1416,0.1775,0.1117,0.0976,0.0224,0.1431,0.102,-0.0334,0.2908,0.2535,0.1894,0.1721,0.2375,0.0889,0.0734,0.0504,0.0081,0.0707,0.0053,0.0575,-0.0153,-0.1138,-0.014,-0.0059,0.0595,0.1014,0.0161,-0.0442,0.0783,-0.0103,-0.0351,-0.0388,0.0173,0.1129,0.0555,0.133,-0.0093,-0.2072,-0.0254,0.0233,0.0489,0.1218,0.1196,-0.0363,-0.0917,-0.1972,-0.0737,-0.0208,0.2651,-0.0385,0.1004,0.0747,-0.0381,-0.0001,-0.0841,-0.0203,0.0165,0.0045,0.112,0.0978,0.0431,0.0387,0.0625,-0.1007,-0.1705,0.0449,-0.0513,0.0546,0.0023,-0.1088,-0.0302,-0.1072,-0.0527,-0.01,-0.0151,-0.185,-0.0421,0.1491,-0.0236,-0.0176,0.0064,0.1646,0.0297,0.0313,-0.0479,-0.0361,-0.0796,-0.0664,-0.1002,-0.1185,-0.0768,-0.0072,-0.0098,0.1586,0.0815,0.0885,0.1379,-0.0017,0.0842,0.0182,0.1025,0.0456,0.1353,-0.0036,0.1581,0.2309,0.0782,-0.034,0.1892,0.1693,-0.0254,-0.0723,-0.0226,-0.1178,-0.0529,-0.2848,-0.0398,0.0448,-0.1129,-0.1154,0.0575,-0.093,0.0119,-0.0221,-0.1155,-0.0879,-0.0885,-0.0068,0.0298,-0.0563,0.3358,0.2605,0.2301,0.2879,-0.152,-0.0079,-0.0216,-0.0504,-0.0171,-0.0373,-0.0152,0.1307,-0.0445,0.0157,0.077,-0.0477,0.0128,0.058,0.0081,0.0057,-0.0047,0.0669,0.0064,0.0175,0.0198,0.0906,0.0237,0.0009,-0.0262,-0.0262,-0.0787,-0.0076,-0.0551,-0.0244,-0.0549,0.084,-0.1173,0.0784,-0.1491,-0.1345,0.1017,-0.0238,-0.1304,-0.1418,-0.1225,-0.0436,-0.0711,-0.0394,0.0014,-0.008,0.0494,-0.008,0.141,-0.0689,0.1396,-0.0645,0.1019,0.0776,-0.0213,-0.0478,0.026,-0.0299,-0.0465,-0.0863,0.0307,0.0514,-0.0098,-0.0384,-0.0237,0.0475,0.0347,0.0166,-0.0255,-0.0061,0.0233,-0.0705,-0.0153,-0.1091,-0.2022,0.0043,-0.0312,-0.1257,-0.0725,-0.0836,-0.1399,-0.0038,-0.0876,0.0263,-0.1208,0.0229,-0.0837,-0.1876,0.0115,0.0248,-0.0561,0.1546,0.1067,0.0302,0.0799,-0.0636,0.0097,-0.0465,-0.0546,-0.054,0.045,-0.0566,0.0456,-0.0389,-0.0352,-0.0174,0.0305,-0.0076,-0.0596,-0.055,-0.0017,0.0603,-0.013,-0.0138,-0.0024,-0.0077,-0.0783,-0.113,-0.0655,-0.1294,-0.0203,-0.0166,-0.1015,-0.1084,-0.0258,-0.0279,-0.046,-0.0263,-0.0026,-0.08,-0.0657,0.0654,-0.1093,-0.0252,0.0125,-0.0707,-0.101,-0.1641,0.0228,0.1017,0.0267,-0.0335,0.0419,0.0255,0.2257,0.113,-0.0287,-0.0293,-0.108,0.0697,-0.0195,0.0407,-0.0252,0.1235,0.0309,-0.1087,-0.1045,0.0344,-0.0713,0.0003,-0.0647,0.0166,-0.0845,-0.0509,0.0214,0.0722,-0.0395,-0.0544,-0.0685,0.0449,0.0176,-0.0001,0.008,-0.0955,0.0044,0.002,-0.1023,0.052,-0.0177,-0.0365,-0.0012,-0.01,-0.0213,-0.0264,-0.0618,-0.0539,0.0097,-0.0035,0.1505,-0.0273,0.0122,-0.0293,0.0432,-0.0148,-0.0972,-0.2009,0.0464,-0.1125,-0.0209,0.0448,0.0399,0.065,0.025,0.0481,-0.0394,0.0121,-0.0715,-0.0082,-0.1441,-0.0273,-0.1783,-0.0141,-0.0591,-0.0759,-0.0654,-0.1404,-0.0806,0.1946,0.1279,0.071,0.3034,0.0624,0.0773,0.0061,0.1554,0.0177,-0.0312,0.064,0.1552,0.0788,0.0407,0.0511,-0.021,0.0057,-0.0585,0.014,-0.0046,0.0078,0.0701,0.078,-0.1064,-0.0968,-0.0474,0.0447,0.0585,0.0554,-0.1809,-0.0804,0.0067,-0.179,-0.1268,0.0823,0.0454,0.0313,-0.0024,0.0122,0.0194,-0.0959,0.0113,0.0078,-0.0504,-0.2021,-0.0783,-0.0045,-0.1076,-0.1233,0.0957,-0.0282,-0.0231,-0.0325,0.0415,0.0625,0.2135,-0.0171,0.0904,-0.056,-0.0611,-0.1005,-0.0194,0.0153,0.0256,0.0429,0.1296,0.07,0.0511,-0.037,-0.0363,0.0102,0.2511,0.2586,-0.185,-0.1718,0.0523,-0.029,-0.0625,-0.0248,-0.1601,0.0742,-0.0408,-0.0236,-0.0128,-0.023,0.1422,0.0047,0.0742,0.044,-0.0497,0.1054,0.2449,-0.1245,-0.0137,0.1978,0.0037,0.0527,0.0668,0.0171,-0.0591,0.1228,0.0811,-0.0503,-0.0541,0.028,0.0011,0.0749,0.0667,-0.0681,-0.0494,-0.0255,0.0862,-0.1184,-0.032,0.0788,-0.0667,-0.0294,-0.031,0.0085,-0.1014,-0.0219,0.0659,-0.0601,0.1124,-0.0436,0.0826,0.1501,-0.0664,-0.0778,-0.0331,0.0109,0.0086,0.0929,0.0833,0.0728,0.033,0.1444,0.0635,0.0132,0.3056,-0.0579,-0.1545,0.0807,-0.1225,0.057,0.0655,0.1055,-0.0821,0.0746,0.0045,-0.0168,-0.0151,0.0466,0.009,0.001,0.0463,0.0719,0.0715,0.0632,0.2216,0.2221,-0.0616,-0.1277,-0.0561,-0.0191,0.104,0.0267,-0.0253,0.0398,0.0705,0.0498,0.0818,-0.1444,-0.1935,-0.0731,0.0089,0.0978,-0.0672,-0.0089,0.0342,0.1062,0.0658,0.061,-0.0252,-0.0071,0.0309,0.0014,0.0916,-0.0649,-0.0843,-0.0775,0.0084,-0.0901,-0.0388,0.1609,-0.0611,-0.0316,0.0196,0.0512,0.0979,0.0644,-0.0115,-0.0206,0.0007,0.0024,0.0893,0.0665,0.093,-0.0227,0.0782,0.1105,0.0518,-0.0358,0.0731,-0.1192,-0.0321,-0.0353,-0.1406,-0.0084,0.0626,-0.0483,-0.0942,-0.0158,-0.0113,-0.0124,0.0016,-0.1093,-0.0143,-0.0445,0.0002,-0.0391,0.0733,0.1476,0.0483,0.1574,-0.1329,-0.0588,-0.0851,-0.0234,0.074,-0.0444,-0.0489,-0.0337,-0.1001,-0.0238,0.1792,0.0456,0.0963,0.1087,-0.0021,0.0027,-0.0775,-0.0279,-0.0389,0.0169,-0.1781,-0.0303,-0.0699,-0.0103,-0.0386,0.0368,0.0356,0.2389,0.1926,0.0554,0.068,-0.1223,-0.1292,-0.0693,-0.1305,-0.0946,0.0244,-0.0353,-0.0174,-0.0677,-0.1027,-0.1003,-0.051,0.0432,0.0127,-0.0489,-0.0547,0.0021,-0.0365,-0.1331,-0.1046,-0.0817,0.1083,0.0443,-0.0228,-0.2835,-0.0489,-0.1168,-0.1127,-0.3453,-0.0211,-0.038,-0.089,-0.0693,-0.0311,-0.0113,0.0052,-0.0718,-0.0934,-0.1685,0.0744,0.0573,0.0933,0.0275,0.0771,-0.091,0.0388,0.1043,0.14,-0.0524,-0.0224,-0.1507,0.0522,-0.2107,-0.2381,-0.195,-0.1173,-0.0164,-0.0912,-0.0573,-0.0726,-0.0586,0.0105,0.0445,0.0424,-0.1435,0.0476,0.0244,-0.047,-0.045,0.0043,-0.0096,-0.1894,0.0995,-0.0066,0.0718,0.0029,-0.032,-0.3101,-0.1249,-0.116,-0.0744,-0.2546,-0.1793,0.0175,-0.0209,-0.0093,-0.0083,-0.0061,-0.0266,0.1091,0.1595,0.125,-0.3371,-0.3494,-0.0202,0.0625,-0.0254,-0.076,0.0792,-0.0799,-0.0042,-0.0307,-0.0256,-0.0633,-0.0245,-0.0402,-0.0318,0.0637,-0.1083,0.0407,-0.0537,0.0609,0.0276,0.0593,-0.0513,-0.0735,-0.196,-0.0991,-0.0255,-0.1303,-0.0479,0.1497,-0.0132,-0.0389,-0.0254,0.0059,-0.1027,-0.0373,-0.0751,-0.0424,0.1782,-0.0144,0.0481,0.0316,-0.0959,-0.0389,-0.078,0.0063,0.1065,-0.2062,0.0011,0.0371,0.1601,0.0169,-0.0266,0.0332,-0.0265,0.0002,0.0106,0.0008,-0.0527,0.0494,-0.1356,-0.0399,-0.0944,0.0245,-0.0529,0.0564,0.159,0.2149,0.0301,-0.0079,0.0567,0.0316,0.0076,0.0849,0.0264,0.0319,0.05,-0.1933,-0.078,-0.1164,-0.0817,-0.0528,-0.111,-0.1311,-0.1002,0.0495,-0.066,-0.1769,-0.2077,-0.1215,-0.1798,-0.3264,0.0214,-0.204,-0.0619,0.0326,-0.0814,0.0509,-0.1152,-0.0666,-0.0079,-0.03,-0.0206,0.0152,-0.1103,0.0013,0.0931,0.1032,-0.0589,-0.0933,0.0647,0.016,-0.0618,0.0423,-0.0591,-0.0261,0.0515,-0.024,0.0367,-0.1581,-0.1635,-0.0954,0.0243,0.0063,-0.0724,-0.0703,-0.0198,-0.0059,-0.0325,0.0752,-0.1337,-0.0395,0.103,0.0473,0.0034,0.0574,0.0197,-0.1946,0.0035,-0.0139,-0.0473,0.1499,0.2253,0.1912,-0.0496,0.2515,0.1645,-0.1117,-0.0689,0.2582,0.0703,0.0783,0.0586,0.1033,0.0492,-0.0381,-0.0353,-0.0149,-0.0862,0.312,0.2569,0.2165,0.0362,0.0874,0.2153,0.3418,0.3378,0.2912,0.0039,-0.0026,-0.0196,-0.0104,-0.0397,0.0219,-0.0862,-0.0419,-0.0295,-0.0542,-0.1035,-0.1164,0.0983,-0.0011,-0.0479,-0.0392,-0.0035,0.0897,0.1656,-0.0652,0.0068,-0.063,-0.0278,-0.0465,-0.0679,-0.0028,-0.046,-0.0422,0.0051,-0.1013,-0.1113,-0.0887,0.0364,-0.0751,-0.0827,0.0859,0.0203,0.1614,0.0372,0.1334,0.2957,-0.0855,-0.0993,-0.117,-0.028,0.0548,-0.0616,0.079,0.016,0.06,0.0184,-0.1131,-0.1134,-0.0899,-0.0836,0.0397,-0.2685,-0.1891,0.0087,-0.0124,0.1461,-0.0262,-0.0134,0.1435,0.039,-0.0902,-0.0207,-0.0938,-0.1416,-0.1554,-0.0188,0.0159,-0.0607,0.0446,-0.036,0.0572,0.1462,0.1316,0.0544,0.1672,-0.0742,-0.0296,0.0524,0.0832,0.1041,0.1919,-0.0012,0.0256,-0.0547,-0.0079,-0.006,-0.0031,-0.0059,-0.0224,0.0068,-0.1329,-0.0251,-0.0386,-0.0002,0.0448,-0.0338,0.0761,-0.0075,0.0654,-0.0511,0.1114,0.0882,-0.1693,-0.1191,-0.0504,-0.0875,-0.0793,0.0723,-0.0202,-0.0381,-0.009,0.1247,-0.0431,-0.2926,-0.0268,-0.0486,-0.0894,0.0439,0.0279,0.023,0.1453,0.1305,0.2661,0.1397,0.1274,-0.0371,-0.0538,0.0667,-0.082,-0.0721,-0.0139,-0.0182,-0.0639,-0.0605,-0.0285,-0.0396,-0.1583,-0.195,-0.1525,-0.161,-0.0407,-0.1652,-0.086,-0.0008,-0.0733,-0.0395,-0.0064,-0.0586,-0.0765,0.0041,0.2267,-0.0095,-0.0676,-0.0822,0.0995,0.0226,-0.0259,0.0363,-0.0866,-0.0623,0.0623,-0.0122,-0.0139,-0.0419,0.0082,0.032,-0.0017,-0.0368,-0.0055,-0.0289,-0.0123,0.0574,-0.1026,0.0212,-0.0202,0.0324,0.024,-0.156,-0.0239,0.0456,-0.0392,-0.0306,-0.0238,-0.0582,-0.0509,0.0627,-0.0184,0.0204,-0.25,-0.0794,-0.1369,-0.1915,-0.135,-0.0906,-0.0615,-0.0615,-0.0359,-0.0893,0.0517,-0.1686,-0.0135,-0.1345,-0.1245,-0.1412,-0.0112,-0.3849,0.0935,-0.1795,0.0085,0.0493,0.1052,0.0777,0.0463,-0.0838,-0.0825,0.0091,-0.0102,-0.0325,0.0785,-0.0116,0.0617,0.1889,0.1792,-0.0203,0.0373,-0.0219,-0.0082,0.0033,-0.2518,-0.1999,-0.0416,-0.0792,-0.0028,-0.0084,0.0318,0.0449,0.0302,-0.0428,0.0297,0.0512,-0.0495,0.1034,-0.0619,-0.084,-0.0445,-0.1324,-0.0214,-0.0001,0.1127,-0.0305,0.0335,0.0367,-0.0482,0.0737,0.1183,-0.0796,0.209,0.0284,0.2231,0.0962,-0.0359,0.0178,-0.0567,0.0215,0.0795,0.0613,-0.087,-0.0241,0.0218,-0.0199,-0.0033,-0.1444,-0.0764,-0.115,-0.1125,-0.0704,-0.0692,-0.1713,0.1204,-0.0218,0.0505,0.1189,-0.0357,0.0009,0.0507,-0.0688,-0.0442,0.0379,0.0234,0.156,0.0601,0.0697,-0.0904,0.023,0.0902,0.049,0.0736,0.0736,-0.005,-0.0486,0.0334,-0.1203,-0.0123,0.0495,-0.0026,-0.025,-0.0873,-0.0168,-0.026,-0.029,0.027,-0.0553,0.0095,0.0112,0.0244,0.0642,0.0641,0.0734,-0.0128,-0.067,-0.0693,-0.0846,-0.0845,0.0062,0.0328,-0.0383,-0.0232,-0.0252,0.1105,0.0025,-0.0865,-0.0607,-0.1487,-0.0887,-0.0007,-0.0035,0.0655,-0.1082,-0.0874,-0.0985,-0.0407,-0.0425,0.0554,0.0067,-0.0715,0.107,-0.0804,-0.0794,-0.0347,0.0514,-0.0669,-0.0148,0.0033,0.0188,-0.0979,0.0413,-0.025,-0.0801,0.0575,0.1011,0.013,0.0134,-0.0475,-0.1564,-0.0636,-0.1375,-0.1744,-0.05,-0.047,-0.0167,-0.0258,0.0801,0.0744,0.0829,-0.0992,-0.0874,0.091,0.2024,0.2586,-0.0126,-0.0616,-0.0336,-0.0164,-0.0448,-0.0025,-0.0923,-0.0898,-0.0036,0.048,-0.1102,-0.0508,0.1526,0.0014,0.0147,0.1756,-0.0241,0.1047,-0.1327,-0.0361,-0.065,-0.0143,-0.0895,0.0051,0.0566,0.0334,-0.0358,-0.0508,-0.0452,-0.0614,0.0038,-0.1012,-0.2705,-0.041,-0.0749,-0.0722,0.0095,-0.0041,0.0061,0.0383,-0.0569,0.0043,-0.1176,-0.05,-0.0776,-0.113,0.0229,-0.0953,-0.0599,-0.1717,-0.0587,-0.1078,0.0888,-0.1073,0.0315,-0.0518,0.0281,0.097,0.0526,-0.12,-0.1369,-0.0144,-0.0973,0.0308,0.0886,-0.0541,-0.0457,-0.0901,0.0591,0.0532,0.0372,0.0632,0.0084,-0.0249,0.0145,0.0087,-0.0289,-0.0057,-0.1123,-0.0908,-0.0308,0.0285,0.0924,-0.0116,0.1035,0.0724,0.0432,0.0521,0.0155,-0.1369,-0.0936,-0.0373,0.0708,0.1327,0.0386,-0.0314,0.0184,-0.0146,0.1874,0.109,0.092,0.0744,-0.1601,-0.0334,-0.0119,-0.0242,0.0015,0.0448,-0.0117,-0.0472,0.0316,0.0041,0.0862,-0.053,0.0443,0.0776,-0.1239,0.13,0.0878,-0.0163,0.0042,0.0988,0.0801,0.0519,-0.0092,0.1064,0.1146,0.0941,0.1756,0.2279,0.0203,0.0284,0.0086,-0.0236,-0.2378,-0.3843,-0.365,-0.0141,0.0883,0.0052,-0.0457,0.0282,-0.0163,-0.0872,-0.1763,-0.1738,0.048,-0.0465,-0.0093,0.0079,-0.0029,-0.0349,-0.0559,-0.0119,-0.105,-0.0634,0.0001,-0.1128,-0.0053,-0.1234,-0.063,-0.0497,-0.0353,0.0471,0.067,-0.0034,-0.0932,-0.0721,0.1593,-0.1267,0.1024,0.1242,0.0984,-0.0383,0.0182,-0.137,0.0931,0.0835,-0.0475,-0.0892,-0.077,0.0273,-0.0664,-0.0731,-0.1576,-0.2215,-0.0678,-0.0152,-0.0468,0.0498,-0.0498,-0.0287,-0.1187,-0.1638,-0.0013,-0.0097,-0.0775,-0.0555,-0.0002,-0.0682,-0.1497,0.1903,0.0981,-0.0608,0.0421,0.0549,0.0948,-0.1878,-0.2136,-0.0971,-0.2527,-0.1165,-0.0494,-0.0112,0.0291,-0.0345,0.0678,-0.0389,0.1456,0.3007,0.1552,0.1017,0.1952,-0.3132,-0.2676,-0.0886,0.0154,-0.0083,-0.0425,-0.1063,-0.0134,0.0608,-0.1295,-0.1526,-0.0304,0.1753,-0.0149,-0.1273,-0.1146,-0.0582,0.029,0.1476,-0.0897,-0.03,-0.0054,-0.0319,0.0922,0.092,0.0615,0.0217,0.0601,0.02,0.1194,0.0265,0.0763,-0.0035,-0.0299,0.0082,-0.0547,0.0002,-0.0088,0.0067,0.1128,0.0655,0.026,0.0294,-0.0402,0.0444,-0.1442,-0.0909,-0.0507,-0.1051,0.2474,-0.0166,0.1474,0.0726,0.0496,0.0024,0.0076,0.1329,-0.0244,0.1682,0.1536,0.0468,0.0925,0.0391,0.0318,-0.1185,-0.0605,-0.1348,0.0189,0.0505,0.1259,-0.0636,-0.0124,0.0369,0.0978,0.0273,-0.0116,-0.0792,-0.0626,0.0355,-0.1689,0.0871,-0.0555,0.0447,0.039,0.0365,0.0823,-0.0499,-0.0693,-0.0401,-0.0565,0.054,0.1082,-0.0526,-0.0155,-0.0138,0.0249,-0.0674,-0.0209,0.0101,0.0974,0.0489,-0.0431,-0.1233,-0.0413,-0.1001,-0.0879,0.0759,0.0377,-0.0353,-0.0071,-0.137,-0.1419,-0.1602,-0.1371,-0.0994,-0.0763,-0.0794,-0.0424,-0.1125,0.0641,-0.2473,-0.2105,-0.2185,-0.0743,0.0205,-0.0628,-0.0918,0.0386,0.0542,0.0312,-0.1223,0.122,0.1994,0.0429,-0.017,0.0044,-0.0514,-0.0601,0.0351,0.0245,0.0461,0.1618,0.1602,0.0436,0.0562,0.002,0.0799,-0.101,-0.0532,-0.0593,-0.0281,-0.0246,-0.0112,-0.0134,-0.0359,0.0058,-0.1326,-0.0979,0.0782,0.0417,-0.2418,-0.0289,0.1179,0.0927,-0.006,-0.1264,-0.3942,-0.2982,-0.16,-0.3159,0.1243,-0.0503,-0.0456,0.0439,0.0121,-0.0683,-0.1549,-0.058,0.1958,0.1028,0.1888,0.1593,0.1449,0.1021,0.1062,0.1343,0.0735,0.0585,0.0418,0.0361,0.1421,0.073,-0.1831,-0.1658,-0.0932,-0.0154,-0.0555,-0.0468,-0.0924,0.0335,0.0193,-0.0255,0.1573,0.1268,-0.0716,-0.0005,-0.0679,0.0314,-0.0927,-0.2186,0.0129,0.0659,-0.0366,-0.0829,-0.0552,-0.0811,-0.0437,-0.1383,-0.0402,-0.145,-0.0914,-0.0283,-0.006,-0.0266,-0.1255,-0.0142,0.0589,-0.007,-0.0158,-0.0052,-0.0905,-0.0452,0.1392,0.0615,-0.0481,0.2151,0.0111,0.0094,0.0639,0.1018,0.028,-0.0182,-0.0488,-0.0053,-0.0645,-0.0303,0.0888,0.2016,0.2499,0.0124,0.0785,-0.0205,0.0709,-0.0474,0.1067,-0.0996,0.1204,-0.0018,0.0253,0.0216,0.1099,-0.0315,-0.0263,-0.0305,0.005,-0.0709,-0.0698,0.0698,-0.0008,-0.0528,-0.0428,0.0656,0.1564,0.1311,-0.1289,-0.1186,-0.1003,-0.0075,-0.1288,-0.0119,-0.0178,0.0293,0.0293,0.0003,-0.053,-0.0756,-0.1157,0.0264,-0.0978,-0.0085,0.1997,0.0241,-0.0586,0.1047,0.2603,0.09,0.077,0.0764,-0.0731,0.0118,0.2037,0.1038,-0.1263,0.2291,0.0462,0.0685,0.0522,0.219,0.0132,-0.0606,-0.0927,-0.0299,0.0114,0.1374,-0.07,0.0278,-0.0479,-0.0222,-0.022,-0.0813,-0.0668,0.1052,-0.0759,-0.1213,0.0402,-0.0139,-0.0527,-0.046,-0.0895,-0.1389,-0.1299,-0.0533,-0.0201,-0.059,-0.0167,0.142,0.21,-0.0416,-0.0568,0.0759,0.0552,-0.1349,-0.0397,-0.0805,-0.0942,0.0071,0.1156,-0.1884,-0.2233,-0.0616,-0.0128,-0.0931,-0.1515,-0.0468,-0.0853,-0.0542,-0.1733,-0.0264,0.0221,-0.0455,-0.0734,-0.0523,-0.0938,0.0983,-0.1158,0.0405,0.1598,0.0549,-0.0894,-0.0382,-0.1796,-0.0853,-0.0524,-0.0179,-0.0017,0.0383,0.0535,0.0484,-0.0581,-0.0671,-0.1117,-0.0633,0.003,0.0597,-0.0796,-0.0237,-0.0501,0.0274,0.0327,0.0747,-0.058,-0.1986,-0.156,-0.004,-0.0014,-0.0012,0.0247,0.109,0.0048,-0.0229,-0.0915,-0.0185,-0.1111,-0.1719,-0.0691,-0.0771,0.0739,-0.0292,0.1619,-0.008,0.1291,-0.0208,0.0709,-0.0138,0.0407,0.1016,0.0808,-0.0153,0.0248,-0.09,0.0616,-0.004,-0.0238,-0.0742,-0.0904,-0.0329,0.0451,-0.0513,-0.0252,-0.0539,-0.0621,-0.1559,-0.0424,0.0422,0.0922,-0.0758,0.1037,0.0321,0.0356,-0.0357,0.0188,0.0561,0.0126,-0.1163,-0.0539,0.1637,0.131,-0.0599,-0.0482,-0.0519,-0.1277,0.0027,-0.0387,-0.05,0.0565,0.0534,-0.1887,-0.072,-0.0135,-0.0932,-0.0227,-0.0159,0.2084,0.1743,-0.1532,0.0427,-0.0272,-0.0171,-0.1088,-0.1078,-0.1634,-0.1615,-0.0027,-0.0077,-0.0862,0.0448,-0.0411,-0.0297,0.1312,0.0397,0.0421,-0.0229,0.0143,0.0311,-0.0546,-0.0366,0.0783,-0.1189,0.0712,-0.2388,0.0476,-0.0795,0.2314,0.0941,0.0933,-0.2062,-0.1933,0.0614,0.177,0.0143,0.125,0.0235,0.0138,0.0959,-0.0108,0.003,-0.007,0.0209,0.0376,0.0815,0.0785,0.1501,-0.0489,0.0334,0.1632,0.3351,0.1115,0.1802,0.242,0.111,0.1257,0.1678,0.1037,0.1297,0.0795,0.12,0.2172,0.1276,0.1051,0.2764,0.1832,0.2272,0.1768,0.0571,0.085,-0.1163,-0.0659,-0.2211,-0.0834,0.0324,-0.135,-0.1146,-0.0524,-0.0283,-0.101,-0.1506,-0.1218,-0.0922,-0.0517,-0.0137,-0.1081,0.065,-0.0238,-0.0727,-0.0017,-0.1333,-0.044,-0.0024,-0.0431,-0.0577,0.0547,-0.053,-0.0739,-0.0099,0.0037,0.001,-0.0217,-0.0182,-0.108,0.1216,0.068,-0.0428,0.2279,0.2546,0.0453,0.1195,0.1526,-0.0732,0.2317,0.2339,-0.0729,-0.0375,0.1301,-0.0347,0.0096,-0.0721,-0.008,0.0994,-0.0896,-0.0673,-0.0333,-0.0299,-0.0666,-0.0478,cognitive control
trm_4a3fd79d0ba30,0.0403,0.0309,0.0352,0.1025,0.0622,0.0303,0.0432,0.0923,0.0668,0.0641,-0.0036,-0.0084,0.0232,-0.0254,0.0574,0.0727,0.0101,-0.0257,0.0198,-0.0807,0.0155,0.014,-0.0336,-0.0377,0.0266,0.0455,0.0445,-0.026,0.0054,0.0373,-0.014,-0.0427,-0.0147,0.0372,-0.0775,-0.0288,0.0295,0.0651,0.0893,0.0421,0.0128,0.0314,-0.0411,-0.0095,0.0218,-0.0434,-0.0413,0.0412,0.041,0.0334,0.0238,0.0279,-0.0411,0.1375,-0.0558,0.0091,-0.0173,-0.0088,0.0241,0.002,-0.0548,0.0054,0.0266,0.0089,0.0159,0.0792,-0.0124,-0.0383,-0.0019,-0.0252,0.0796,-0.0019,-0.0645,-0.0313,0.2361,-0.0871,0.0389,0.0229,0.0135,-0.0554,-0.0657,0.0253,-0.0112,0.0217,0.0794,-0.0203,0.0359,0.0204,-0.0446,-0.0915,-0.0268,0.004,-0.0143,0.0918,0.0103,0.016,0.016,0.0575,0.1266,0.107,0.0191,0.0007,0.0264,0.13,0.0683,0.0342,-0.0621,0.0011,0.0114,0.0809,0.0381,0.0307,0.0702,0.0406,-0.0111,-0.0255,0.0139,0.0534,0.0166,0.0358,-0.0354,0.0063,-0.0186,-0.0115,-0.0231,-0.0951,-0.0272,0.0468,0.0266,-0.0319,-0.0896,0.0144,-0.0328,-0.0884,-0.0029,-0.0536,0.0352,-0.0127,-0.0464,-0.0145,-0.0041,0.0341,-0.0803,-0.0197,0.0014,0.0474,0.1042,0.0379,-0.0037,0.0378,0.0072,-0.0569,-0.06,0.0041,0.0424,-0.0039,0.0063,0.0324,-0.0088,-0.0172,0.0151,-0.0157,-0.0206,0.0351,-0.0102,0.0314,-0.0179,-0.1016,-0.0968,-0.0814,-0.0286,-0.0525,0.0885,-0.1628,-0.0216,-0.1452,-0.097,-0.0639,-0.0778,0.0024,-0.0381,-0.0159,-0.0009,0.0809,-0.0622,0.0019,-0.0771,-0.1657,-0.1278,-0.0529,-0.0558,-0.024,-0.0431,-0.0322,-0.0311,0.1671,0.2296,-0.1358,-0.1143,0.2344,0.1492,0.0869,-0.1046,-0.0631,0.1348,-0.1046,-0.2822,0.0768,0.1314,0.0603,-0.0316,-0.0124,-0.0731,-0.0278,-0.029,-0.0645,-0.0495,0.0561,0.1279,-0.0137,0.01,-0.0192,-0.0248,-0.0159,0.0328,-0.0262,0.0092,-0.0362,-0.0546,0.0634,-0.0041,-0.088,0.0197,0.0202,0.0215,0.0531,-0.0548,0.0019,0.0072,-0.1104,0.0724,-0.0052,0.0315,-0.0181,0.0118,-0.0513,-0.0596,-0.0101,-0.0127,-0.0721,-0.0421,-0.018,-0.0541,0.0204,-0.0164,-0.0675,0.0333,0.045,-0.0287,-0.0398,-0.0102,0.1088,0.0112,0.0524,0.105,0.1629,0.1289,0.0212,-0.0418,-0.0571,0.0455,0.0118,-0.0816,-0.0402,-0.0463,-0.103,-0.051,-0.0782,0.0047,-0.0152,-0.0774,-0.0994,-0.0838,-0.2158,-0.1915,-0.0067,-0.0037,-0.0789,0.0741,-0.0585,-0.0256,0.0141,0.0097,-0.0169,0.0081,0.0745,-0.0725,0.0442,0.0994,0.0745,-0.0282,-0.0163,-0.007,-0.0657,0.1759,0.1938,0.0197,-0.0236,-0.0199,0.0159,0.0384,-0.0088,0.1533,0.0966,0.0617,0.0677,0.1009,0.0203,0.0347,0.0183,0.0172,-0.0328,-0.0828,-0.0644,-0.0099,0.039,-0.008,-0.0048,0.0279,-0.0162,0.0307,0.0253,-0.0155,-0.0211,0.0128,0.0865,-0.0214,-0.0266,-0.1247,-0.023,-0.0088,-0.0533,0.0724,0.0506,0.0084,0.0234,0.0532,0.0112,0.0711,0.0198,-0.0374,0.0139,0.0831,0.0452,0.0307,0.0529,0.0657,-0.0807,0.065,-0.0049,0.0024,-0.015,-0.0226,0.0287,0.0372,0.0861,0.0234,0.1389,-0.0179,-0.0014,-0.0173,0.0863,-0.0259,0.0354,-0.011,-0.0111,-0.0495,-0.0005,-0.1295,-0.0031,-0.1106,0.1655,0.1063,0.1357,0.003,0.0096,-0.0122,0.0266,0.0288,0.0153,0.0609,0.0054,0.0758,-0.0192,0.1248,0.1478,0.07,0.0079,0.0072,-0.0197,-0.0069,-0.0092,-0.0358,0.0123,0.046,0.072,-0.0515,0.0434,-0.0479,0.0036,0.0562,-0.0376,-0.0095,-0.0315,-0.1166,-0.0704,0.0286,0.1407,0.0916,0.0779,0.0265,0.0553,0.0655,0.17,0.1742,0.1073,0.0446,0.0754,0.0714,0.0873,-0.0411,-0.0582,-0.0381,0.0009,-0.0778,-0.0041,0.0046,-0.0062,-0.01,0.0118,-0.1082,0.0363,0.021,-0.0052,-0.0497,-0.0104,-0.038,0.0526,-0.0779,0.125,0.2139,0.0552,0.0209,0.0125,0.0672,-0.074,-0.0526,0.0351,0.0477,0.0542,0.0729,0.0688,-0.0542,-0.0601,-0.0764,0.0096,0.0484,0.0918,-0.0303,-0.0139,0.0177,-0.0027,0.1104,-0.0375,-0.1461,0.036,0.0123,0.0372,-0.0071,0.0416,0.0263,0.0754,0.1071,0.0385,0.0599,0.0559,-0.0029,0.0065,-0.0166,0.0333,-0.0943,0.0548,0.0035,-0.0088,0.0342,-0.0769,-0.2588,0.0683,-0.0234,0.0265,0.0266,-0.0214,-0.0081,-0.004,0.0303,-0.0815,-0.1271,-0.1956,0.0,0.0336,-0.0142,0.05,-0.1532,-0.0019,0.001,0.0821,0.0287,0.0546,0.1005,0.0431,0.0312,-0.0683,-0.0302,0.2273,0.0398,0.0105,0.0533,0.0509,0.031,0.0276,-0.0071,-0.0185,0.0365,-0.0195,-0.1049,0.0172,-0.0375,0.0487,-0.0405,-0.0603,-0.0086,0.0103,-0.0053,0.0172,-0.009,-0.0553,0.0178,-0.0279,-0.0604,-0.0447,0.0149,-0.014,0.0229,0.0649,0.0216,-0.1225,0.0236,0.0234,-0.025,-0.0298,-0.0888,0.0078,-0.1155,0.0152,-0.1,-0.1347,-0.0195,-0.2072,-0.0401,-0.098,-0.0592,-0.0867,0.0307,-0.0233,0.1148,0.1029,0.0208,0.0043,0.0171,0.0046,-0.0366,-0.0118,-0.0264,0.0253,0.1133,0.026,0.2758,0.0247,0.0868,-0.0445,-0.0498,0.1144,0.1367,0.0466,0.1202,0.0957,0.016,0.02,-0.0141,-0.0578,-0.064,-0.0434,0.0345,-0.0452,0.0343,0.1252,-0.076,-0.0112,-0.0014,0.1123,-0.0196,0.0211,-0.0056,0.0244,0.0083,-0.0432,-0.0172,0.0406,-0.0342,-0.0396,0.0588,-0.0197,0.0119,0.0024,-0.055,0.0225,0.2166,-0.0475,0.1528,0.067,0.0285,0.1222,-0.0444,0.1265,0.2233,0.1258,0.1007,0.06,-0.0564,0.0457,0.0719,0.0805,0.0289,0.0615,0.0123,0.0034,-0.0527,-0.0866,0.0959,-0.0573,0.0953,-0.116,0.0996,-0.1052,-0.0644,0.0121,0.1635,0.0986,0.0168,-0.0275,-0.0791,0.0861,0.0287,0.0644,0.0583,0.0366,0.1005,-0.1137,0.1092,0.1238,0.0406,-0.0235,-0.0071,0.0042,0.0523,0.0376,0.0128,-0.0542,-0.0361,-0.0152,0.0151,0.0608,-0.0109,-0.0034,-0.0158,-0.0246,0.0238,-0.0285,0.0498,0.0171,0.0719,0.1223,0.096,-0.0003,0.0226,-0.0334,0.0117,0.0104,0.0158,0.1545,0.0284,0.0135,-0.053,-0.0673,-0.0713,0.0091,-0.0564,-0.0032,-0.0255,0.0028,-0.0256,0.0765,0.1461,-0.0646,0.0361,-0.0465,0.0285,-0.0928,-0.0567,0.0026,-0.0055,-0.0497,-0.0792,-0.0602,-0.0979,0.0274,-0.0034,0.0001,0.0054,0.0576,-0.0352,-0.0524,0.0388,0.0719,0.0887,-0.0094,0.0723,0.0437,0.1068,0.1147,-0.1329,-0.0357,0.0571,0.0034,-0.0629,-0.058,-0.0054,-0.0372,-0.0119,-0.0279,-0.0229,-0.0697,-0.0298,-0.068,-0.0876,-0.0701,-0.0541,-0.0419,-0.015,-0.0543,-0.1346,0.0744,0.0453,-0.0459,0.0489,0.0232,-0.128,-0.0192,0.0242,0.0469,0.0676,-0.0123,0.0158,0.0355,0.012,-0.0113,0.0234,-0.016,-0.0626,-0.0244,-0.0636,-0.0364,-0.0248,0.0415,0.0053,-0.0152,-0.0446,0.0119,0.0081,0.0484,0.0195,-0.0125,-0.0394,-0.0514,-0.0036,0.0514,0.0196,-0.0554,0.1056,-0.049,-0.0492,0.0578,-0.0355,-0.0034,-0.031,-0.0345,0.0166,0.0214,0.0413,0.0417,0.0253,0.0568,0.0366,0.0281,-0.0184,0.0119,0.0457,0.0325,0.0422,-0.0318,-0.0188,-0.0109,-0.0564,0.0707,-0.0327,-0.0936,-0.0093,0.0085,-0.0689,-0.0283,-0.0599,-0.0075,0.0217,-0.0783,0.0267,0.0456,0.0501,0.1233,0.0299,-0.043,-0.0375,0.0182,-0.07,0.0235,0.0469,0.0317,0.0507,0.08,-0.0601,0.0476,0.0026,-0.031,0.0027,0.0008,-0.0091,0.0353,0.2367,-0.0714,-0.056,0.0044,-0.056,-0.0005,0.0116,0.0038,-0.0248,0.0391,0.1181,0.0471,0.2005,0.1885,0.0208,-0.0708,0.1397,0.0013,-0.0097,0.2982,0.0365,0.2971,-0.107,-0.1314,0.0022,-0.0026,0.049,0.0262,-0.0365,0.0721,-0.0024,0.0507,0.0038,-0.0552,0.0153,0.0453,-0.1015,0.0204,-0.0781,-0.0065,0.0409,-0.0403,0.0279,-0.0572,0.0176,0.0314,-0.0559,0.0384,0.0488,-0.0584,0.0402,-0.0495,0.0227,-0.0052,-0.001,-0.0441,-0.0072,0.0123,0.057,0.0613,-0.0257,-0.0017,0.0557,0.0458,0.1001,0.0098,0.0608,-0.0467,0.0844,0.0222,-0.0027,0.0042,-0.014,-0.0565,0.0354,-0.1093,-0.0193,0.0566,-0.0112,-0.064,-0.1132,-0.0673,-0.0227,-0.0176,-0.0124,-0.179,-0.0518,-0.2008,-0.0713,-0.1081,-0.082,-0.0238,-0.1101,-0.127,-0.1786,-0.1848,-0.0646,-0.0659,-0.0106,-0.0026,0.0667,0.0069,0.0324,0.056,-0.0495,-0.0062,-0.0684,-0.1018,-0.0558,-0.0023,0.0482,0.0736,-0.0555,-0.1066,-0.0375,-0.0063,-0.0139,-0.0571,-0.1051,-0.0518,-0.0838,-0.0103,0.0744,-0.0403,0.0239,-0.0079,-0.0728,-0.0408,-0.0352,-0.1649,-0.1441,0.0794,0.017,0.0744,-0.0174,-0.0198,-0.0272,0.2524,0.1677,0.0115,0.0204,0.0516,-0.0493,0.0249,-0.0195,0.0129,0.0192,0.0552,0.0396,0.0017,0.0062,-0.0587,-0.0289,-0.0167,0.067,0.0343,0.1153,0.0113,-0.0088,-0.0595,-0.0994,-0.0074,0.0004,-0.0656,0.0015,-0.056,-0.0166,0.0049,-0.0138,0.0237,0.0218,-0.0209,0.007,0.0365,0.0622,0.0537,0.0592,0.1864,0.2224,0.0941,0.0704,0.1834,0.0068,0.0118,-0.0138,-0.0098,-0.0031,0.0386,0.0062,0.0755,0.067,0.105,0.0512,-0.0254,0.0883,-0.0933,-0.0073,-0.1442,-0.0099,0.0307,0.035,-0.014,-0.0979,-0.0001,-0.0174,-0.014,-0.0494,-0.0238,-0.1011,-0.03,0.0072,0.0037,-0.0071,-0.0285,0.0034,-0.0708,-0.0593,-0.0705,-0.0806,-0.1793,0.0003,-0.0308,-0.0149,-0.0281,0.0511,-0.0681,-0.0131,0.048,0.0351,0.1267,-0.0474,-0.0507,-0.0022,-0.0812,-0.0539,-0.0158,0.09,0.148,0.1187,0.0237,0.0418,-0.04,-0.0324,-0.1937,-0.1402,-0.1012,-0.0718,-0.1975,-0.151,-0.081,-0.1405,-0.0856,-0.0678,-0.0524,0.0352,-0.0177,-0.0633,-0.0363,-0.0378,-0.0003,0.0278,0.0441,-0.0627,-0.1201,-0.1144,-0.0142,0.0231,-0.0195,0.0576,-0.0004,0.0863,0.0226,-0.0392,-0.0945,-0.1119,-0.0721,-0.0252,-0.0754,0.1204,-0.0217,-0.1311,-0.0727,0.0323,-0.1259,0.0125,0.0836,0.057,-0.057,-0.0574,0.0636,0.1551,0.158,0.1468,-0.0152,-0.0189,0.0803,0.0794,0.0541,-0.0007,-0.0459,0.036,-0.0609,0.0621,0.0124,0.0115,0.0699,-0.0099,-0.02,0.0384,-0.0289,0.0605,0.1189,-0.1061,-0.1073,-0.0264,-0.0218,0.0048,0.004,0.0369,-0.0326,-0.0314,-0.0583,0.0026,0.0221,-0.0233,-0.0568,-0.0031,0.0196,0.1112,0.1233,0.1,0.1624,-0.0042,-0.0183,0.0066,0.0336,0.1161,0.17,-0.0724,0.1589,0.1969,0.119,-0.1464,0.205,0.1746,0.036,-0.1195,-0.0346,-0.0174,-0.0509,-0.0266,-0.0169,0.1514,0.038,0.0186,0.0096,0.0284,-0.0543,0.0225,-0.0366,0.0125,-0.054,0.133,0.0045,-0.0081,-0.1759,-0.1175,-0.0981,-0.1595,-0.0294,0.0873,0.0317,0.0212,0.0897,-0.0403,0.1931,-0.0594,-0.0673,-0.0115,0.0268,0.0148,0.0617,-0.0227,-0.024,0.0572,0.0067,0.0569,0.0104,0.0027,-0.0044,-0.0755,0.0793,0.0032,0.1041,0.1041,-0.0538,0.0669,0.0878,0.0438,0.001,-0.0024,0.0076,0.0507,-0.0239,-0.0431,-0.0129,-0.0099,-0.0332,-0.0507,0.0123,0.0504,-0.0009,-0.0322,-0.0171,0.0334,0.1061,-0.1253,-0.1255,0.026,-0.0511,0.0086,-0.0496,-0.008,0.0386,-0.0191,0.0499,-0.0864,-0.0725,-0.0419,-0.0459,-0.0397,-0.0966,0.1158,0.0492,0.0948,0.0088,0.0787,-0.1521,-0.0936,0.0211,-0.0151,-0.0329,0.0232,0.1052,0.0444,-0.0041,0.0151,0.053,0.0306,-0.0498,0.0069,0.0983,0.0363,-0.103,-0.0704,0.031,0.1369,-0.0151,0.0781,0.0102,-0.0249,-0.0123,0.1014,0.0161,0.0037,0.0077,-0.0486,-0.0601,-0.0569,-0.0037,-0.0428,-0.0441,-0.0107,-0.0355,-0.0346,0.0354,-0.0488,-0.0857,-0.0161,0.0601,-0.056,0.0273,0.0475,-0.089,-0.0016,-0.0904,-0.037,-0.1479,-0.1982,0.0107,-0.0034,-0.0185,-0.0002,0.0192,0.0116,-0.0625,0.0718,0.0476,0.0237,0.0093,0.0497,-0.035,0.0002,-0.0055,0.0856,0.0624,-0.0113,-0.047,0.0451,-0.1195,-0.0051,-0.0117,-0.0193,-0.0562,-0.0365,0.0313,0.0079,-0.0451,-0.025,0.0228,-0.0794,0.0918,-0.0701,0.0507,0.0087,0.0325,0.0519,0.0154,-0.0248,-0.0449,0.0028,-0.0307,-0.1112,-0.0245,0.1087,0.0626,-0.0271,-0.0753,-0.0136,-0.0841,0.0365,-0.0856,-0.0199,0.0083,0.0375,0.0153,0.0268,-0.0508,0.0264,-0.0317,0.0535,0.0384,0.0496,-0.0786,0.0138,-0.0076,-0.0017,0.0406,-0.0276,0.0065,0.008,0.1093,0.0198,-0.01,-0.0117,0.0278,0.0599,0.1,-0.0064,-0.0574,0.0068,0.0691,0.0256,-0.0508,-0.071,-0.0177,0.0572,-0.0919,0.0037,0.0688,0.0414,-0.0659,0.0117,-0.0205,-0.1241,-0.123,0.004,-0.0695,0.0358,-0.0957,0.1926,-0.0669,0.0521,-0.1527,0.0029,-0.0151,-0.0438,-0.053,0.1446,0.0932,0.225,0.1662,0.121,-0.0669,-0.0569,0.0911,0.1166,0.0162,-0.0412,-0.0093,-0.0156,-0.0345,0.081,0.0227,-0.0227,0.1608,0.195,0.0909,0.143,0.1449,-0.0644,0.0224,-0.0395,-0.0155,-0.1026,-0.0547,-0.0065,0.0061,0.052,0.0865,0.0766,-0.083,-0.016,-0.0954,0.0678,-0.0025,-0.049,-0.0327,-0.0736,-0.0207,0.0024,0.2034,0.0086,0.001,0.0629,0.0349,0.0273,-0.0253,0.0222,-0.0097,-0.06,0.0029,0.083,0.0486,-0.0084,0.0072,0.0711,0.1239,0.1294,-0.0476,0.0145,0.1007,-0.0009,-0.0056,0.024,-0.0284,0.0102,-0.0241,-0.0315,0.0503,0.0723,0.0954,0.0298,0.1389,-0.0723,0.0312,0.1105,0.1306,0.1052,-0.047,0.0054,-0.0001,0.0697,-0.0651,-0.0739,-0.0279,-0.0242,-0.0213,0.0881,0.0076,-0.0796,-0.0558,-0.124,-0.0894,-0.1112,-0.0713,-0.0307,-0.002,0.0158,0.0101,-0.0449,-0.0824,-0.1594,0.0011,0.002,0.0149,0.0073,0.0009,-0.0032,-0.1805,-0.2052,-0.1135,-0.0686,0.013,-0.0317,-0.002,-0.064,0.0026,-0.0103,0.0452,0.0438,-0.1057,0.0304,0.1043,0.0236,-0.0693,-0.0593,-0.0556,0.1578,-0.164,0.0362,-0.0487,0.0058,0.005,0.067,-0.0114,0.0121,0.0117,0.0758,0.0417,0.0372,0.0001,-0.0203,-0.0753,0.0053,0.0256,0.05,0.0199,0.0533,-0.0017,0.0007,-0.0978,-0.0797,-0.1274,-0.0231,-0.0795,0.0791,0.0772,0.0527,-0.084,0.0102,-0.0171,0.0536,0.063,0.0035,0.0272,-0.0363,-0.0156,-0.1685,-0.0253,0.0158,-0.0268,0.0156,0.0049,-0.111,-0.0896,-0.1093,-0.0563,-0.0216,0.0006,0.1957,-0.149,-0.1323,-0.11,0.1658,0.1009,0.1146,-0.0447,-0.0258,-0.024,0.0205,0.0562,0.0482,0.0073,0.04,-0.0017,-0.0259,0.1047,-0.0364,0.1059,-0.0313,0.0783,0.0308,-0.0377,0.0335,-0.0551,0.1074,0.0724,0.0023,0.1444,0.1384,0.0513,-0.0316,0.0804,0.0478,0.052,0.0726,0.1125,0.1335,0.1315,0.1934,-0.0755,0.0124,-0.0741,0.0239,0.0651,0.115,-0.055,-0.1145,0.0039,-0.0681,-0.0019,-0.0423,0.1021,0.0202,-0.0102,0.0356,0.0228,0.0116,0.0338,0.0443,-0.0134,0.05,-0.035,0.0669,-0.0483,-0.0361,0.0147,-0.0213,-0.0499,-0.0805,-0.0184,0.0892,-0.0496,-0.0501,-0.0223,-0.07,0.003,0.027,0.0585,-0.1168,-0.0612,0.0158,0.0221,-0.1788,-0.1024,0.0443,0.0527,0.0039,-0.0001,-0.0022,-0.0541,-0.0074,0.1023,0.0371,0.0337,-0.1329,0.1101,-0.0425,-0.0644,-0.1445,0.0009,-0.1711,0.0027,0.0325,0.0746,0.0582,0.0302,0.0228,-0.0672,-0.2295,0.0007,-0.1556,0.1561,-0.0493,0.0205,-0.0524,0.0651,0.1001,0.2082,0.0279,0.0362,-0.0715,0.0126,-0.1592,-0.205,-0.1772,0.0318,0.0158,-0.0384,-0.0563,0.0003,-0.0288,0.0347,0.0546,0.0684,-0.0269,0.0025,0.0434,0.0255,0.0826,0.0971,-0.0958,0.041,0.1382,-0.0527,-0.0614,-0.0349,-0.2402,-0.1026,-0.0222,-0.0944,0.011,-0.1842,-0.1559,0.0305,-0.0222,-0.0373,0.052,0.0477,-0.0394,0.0132,0.0501,0.0113,-0.0447,-0.0684,0.0691,0.0626,-0.0196,0.099,0.0833,0.0036,-0.0577,0.0228,0.0301,0.0049,0.0147,0.0335,0.0655,0.0648,0.0165,0.0847,0.0225,0.2178,0.0505,0.0125,0.0063,-0.0628,-0.1244,-0.0173,-0.0673,-0.094,-0.0491,-0.0938,0.0612,0.0572,0.1882,0.1231,0.0843,0.1289,0.1261,0.1023,0.1811,0.0535,0.1098,0.0845,0.1448,0.124,0.1311,0.1209,0.0366,-0.0471,0.0621,0.047,-0.0255,-0.1377,-0.1423,0.0162,-0.0781,0.0584,0.1072,-0.0293,-0.0428,-0.0669,0.0754,-0.0373,-0.023,0.0893,0.0342,-0.084,-0.0363,-0.0686,-0.1459,-0.1433,-0.0565,-0.048,-0.0108,0.0124,0.0568,-0.0014,-0.008,-0.107,-0.0333,-0.0032,-0.0845,-0.1179,-0.075,-0.062,-0.0174,0.0226,-0.0749,0.0621,0.0618,0.1019,0.0423,-0.0758,0.0848,0.0955,0.0311,0.0146,-0.0499,0.0178,0.0256,-0.0243,-0.0268,-0.0325,0.0113,-0.0007,-0.0117,-0.0389,0.0734,0.0536,0.0153,-0.09,-0.0316,-0.0495,-0.1868,-0.1182,-0.0998,-0.0669,0.0232,0.0106,0.0353,0.1595,-0.0392,0.0114,0.1096,-0.0692,-0.0617,-0.0247,0.0343,0.0392,0.0095,0.0104,-0.0308,-0.0151,0.0722,-0.0862,-0.0958,-0.0577,-0.0432,0.1681,0.0984,0.1357,0.0246,0.105,0.129,0.0947,-0.0107,-0.1073,-0.0749,0.023,0.0303,-0.134,0.0165,0.0102,-0.0381,-0.0899,-0.0257,0.0287,0.0303,0.0155,0.0006,-0.1063,-0.0618,-0.0727,-0.0513,-0.0212,-0.0472,-0.0774,-0.0718,-0.0748,-0.0615,-0.0162,0.0269,0.007,-0.0081,0.0465,-0.1021,-0.0219,-0.0122,-0.0472,-0.0172,-0.0368,0.0318,0.0463,0.0004,0.002,-0.0535,0.0471,0.1028,0.0727,-0.0354,0.131,-0.0016,-0.0168,0.0316,0.0437,-0.0183,0.0076,-0.004,-0.0997,-0.0822,-0.068,0.0923,0.0358,-0.0167,-0.0293,0.0154,0.0802,0.0242,-0.025,-0.0431,-0.0068,0.0299,0.03,0.101,0.0273,-0.0483,0.0008,0.0233,0.0122,0.072,0.0674,0.0717,0.0231,0.0289,0.1134,0.1543,0.187,-0.0279,-0.0356,-0.0954,0.1041,-0.0405,0.0845,0.0768,-0.1924,-0.1036,-0.153,-0.0939,-0.0378,0.0438,0.0201,-0.0132,0.14,0.0865,0.0245,0.2055,0.198,0.0958,0.0526,-0.0557,0.0715,0.0112,0.1383,0.11,0.1544,-0.035,0.0327,-0.0317,0.0476,-0.0062,0.0901,0.0842,-0.0492,-0.0354,-0.073,-0.0339,-0.0296,0.0621,0.1017,-0.064,0.0113,-0.011,0.0474,-0.0936,-0.0648,-0.1,-0.1267,-0.0097,0.014,-0.0053,-0.0004,0.0098,0.0011,-0.0794,0.0324,0.0807,0.0455,-0.0407,0.0599,-0.0547,-0.1348,-0.0186,0.0236,-0.0962,-0.0185,-0.086,-0.0473,0.1626,0.2267,0.0771,0.045,0.0921,-0.007,0.0361,0.0725,0.0286,0.032,0.0192,-0.064,0.0162,-0.1399,-0.1332,-0.081,-0.1164,-0.0266,-0.0486,-0.0548,0.0567,0.0605,0.1102,0.0329,0.0069,0.0189,-0.0236,-0.0176,-0.0943,-0.0471,-0.0031,-0.1078,-0.1448,0.0171,-0.0987,0.0439,0.0583,0.1621,-0.0698,-0.0729,-0.0427,-0.012,-0.0055,0.0156,0.0873,0.0155,-0.0212,-0.0111,0.0233,-0.0962,0.0231,-0.0312,0.0584,-0.0282,-0.1779,0.0013,0.0481,-0.0083,0.0486,0.0398,-0.0613,-0.0345,0.0191,0.0426,0.0048,-0.1323,-0.0607,-0.0414,-0.1056,-0.0053,0.0317,-0.012,-0.012,-0.0651,-0.0146,0.0777,-0.0677,-0.0141,0.019,0.0062,-0.136,-0.0765,-0.1077,-0.0374,0.0742,0.0173,-0.1409,0.133,-0.1413,-0.1311,-0.0253,0.0227,0.0027,-0.0326,-0.0217,0.0987,0.0509,0.1967,0.2294,0.1964,-0.006,-0.0109,0.0741,0.0765,0.0022,-0.0328,-0.0745,0.0242,0.0038,0.023,0.0356,0.0786,0.0074,0.0225,-0.0587,0.0619,-0.0317,0.0153,-0.0124,-0.1106,0.1026,0.0571,0.0996,0.0374,0.1012,0.1757,-0.0113,0.1644,0.1511,0.0364,0.1671,0.1231,-0.06,-0.0182,-0.0289,-0.1197,-0.0821,-0.0013,0.0991,0.0995,0.0042,0.0437,-0.0238,0.0038,-0.0532,-0.009,-0.0086,-0.0201,0.0864,-0.0698,0.0861,0.087,0.0772,0.0248,0.0945,-0.0474,0.0425,-0.0567,-0.1013,0.0722,-0.0443,0.0122,-0.018,0.0075,0.0267,0.0251,0.0695,0.0455,0.0343,0.0011,0.1107,-0.0245,-0.118,0.0349,0.0423,-0.0086,0.0418,0.0082,0.0196,-0.0347,-0.0029,0.0035,-0.0545,-0.0271,-0.0074,0.0059,0.0456,0.0332,0.0267,0.0004,0.0308,-0.1075,0.0758,0.0567,0.06,0.0664,0.0443,-0.0005,0.046,0.0174,0.0468,0.0562,-0.0267,0.0005,-0.0707,-0.082,-0.1084,-0.0269,-0.0164,0.0063,-0.0155,0.0125,0.0518,0.0634,-0.0412,-0.0516,-0.0347,0.034,0.0487,0.0154,-0.0036,0.1503,0.0093,-0.0705,-0.0338,0.0173,-0.0474,0.0695,-0.0984,0.0619,0.0884,0.007,0.0041,-0.0244,0.0092,0.0613,-0.0092,0.0573,-0.0092,0.109,-0.0875,0.089,-0.0117,-0.0087,0.0391,-0.0004,0.0492,0.0701,0.1322,0.1141,0.0983,-0.0018,-0.0509,-0.1371,-0.0587,-0.15,-0.0875,-0.0146,-0.0899,0.0205,-0.0377,0.0042,-0.0702,-0.0668,0.0487,0.0452,-0.0274,0.0364,-0.1635,-0.0752,-0.0424,-0.0856,-0.0693,-0.0421,-0.106,0.0074,0.0579,-0.0057,-0.0271,-0.0042,0.0787,0.0195,-0.0267,0.0161,0.0131,0.0247,-0.0223,-0.0415,-0.1216,-0.0153,-0.0376,-0.0047,-0.0519,-0.0308,-0.0456,0.0452,-0.0026,-0.0524,0.0205,-0.0112,-0.0553,-0.0081,0.0234,-0.0358,0.0234,-0.0398,0.0183,0.0375,0.1135,0.0023,0.0067,0.008,0.0396,-0.0127,0.001,0.0108,-0.0655,-0.0258,-0.0475,-0.1028,0.0003,0.0418,-0.0675,-0.0151,-0.0319,0.0534,-0.0271,-0.0236,0.0143,0.0002,0.0518,-0.0409,0.0102,-0.1079,-0.115,-0.0434,0.0518,0.0125,-0.0418,0.0195,-0.0916,-0.0581,0.1034,0.024,-0.0253,0.0002,-0.0182,0.0116,-0.0132,-0.0764,-0.0347,-0.0823,-0.0322,-0.0261,0.1238,-0.0046,0.0321,0.0775,-0.1154,-0.0208,0.0718,-0.0671,-0.0214,0.0676,0.1375,0.0462,-0.0294,0.0435,-0.004,-0.0027,-0.0043,0.1111,-0.0225,0.1092,-0.0074,0.0279,-0.0019,0.0588,-0.0461,0.0348,-0.0326,0.1387,0.2415,0.2033,0.0863,0.1139,0.0098,0.04,-0.1004,0.0433,-0.0107,-0.0515,-0.0623,-0.0313,0.0792,0.0547,-0.0398,0.0272,-0.0798,-0.1147,-0.1519,-0.1256,-0.0123,-0.0563,-0.027,0.0394,0.0607,-0.0553,0.0367,0.0052,-0.0225,0.0592,0.0574,-0.1627,0.0189,0.0415,0.0381,-0.0267,0.0114,0.0304,0.0514,-0.0117,0.1616,0.0139,0.0657,0.007,0.1355,0.1244,0.1186,-0.0495,-0.0591,0.1152,0.0986,0.08,-0.0866,-0.005,0.0804,-0.023,-0.0501,0.017,0.0025,-0.0467,-0.02,-0.0205,-0.1419,-0.0225,-0.0513,0.0219,-0.0113,-0.0305,-0.1841,-0.1968,-0.0376,-0.0393,0.0887,-0.0204,-0.0463,-0.1305,0.0432,-0.0324,0.0435,-0.0358,-0.0094,0.124,0.1238,-0.0246,-0.0026,-0.0352,0.0678,0.0091,0.0683,-0.0021,0.0105,0.0396,0.198,-0.1132,0.0662,-0.0187,-0.132,-0.0494,-0.1183,-0.0163,-0.2547,-0.0991,-0.1175,-0.1429,-0.1425,-0.073,0.1386,0.0621,-0.0239,-0.1063,-0.0283,0.0654,0.0445,0.0429,0.0397,0.0035,0.0303,-0.2042,-0.0949,-0.2233,0.0591,0.0578,0.0747,-0.0061,-0.0385,0.1437,0.1368,0.1445,0.0526,-0.038,0.0207,0.0265,-0.0002,0.0442,0.0394,0.0448,0.0878,0.0365,0.0545,0.016,-0.03,0.0151,-0.0287,-0.0315,-0.0348,0.0348,0.0031,-0.0277,-0.0458,0.0436,0.0095,0.0069,-0.0015,0.0584,0.0534,0.1126,0.0838,-0.0456,0.0732,0.0409,-0.0159,0.009,0.0059,0.0984,0.0664,-0.0682,-0.0517,0.093,-0.0152,0.0205,0.1541,0.0396,-0.0099,-0.005,0.0242,0.0267,0.0676,-0.0691,-0.0075,-0.0745,-0.0052,0.0705,0.0743,-0.0307,-0.0784,0.0683,0.0151,0.0637,0.0166,-0.0358,0.0606,0.0476,0.0051,-0.0673,0.0344,0.0559,-0.0197,0.0345,-0.0054,0.1116,0.0456,-0.0342,-0.0141,0.0831,0.2142,-0.025,0.0097,0.0287,-0.012,-0.2015,-0.1486,-0.1212,-0.1188,-0.111,-0.1327,-0.0219,0.0615,0.1075,0.0917,0.109,0.0114,-0.032,-0.112,-0.0014,-0.0283,-0.0459,-0.0273,0.0178,0.0934,0.0662,0.0146,0.062,0.0121,-0.0402,-0.1453,-0.0202,-0.0701,-0.0913,-0.0209,-0.0351,-0.0132,-0.0332,-0.0584,0.0773,-0.0733,-0.0981,-0.0908,-0.0397,-0.1099,-0.0526,-0.036,-0.0615,0.1051,0.0245,0.0684,0.1024,-0.1574,-0.0585,-0.0027,0.0451,0.0496,-0.0481,-0.0386,-0.1062,-0.0339,0.0113,-0.1049,-0.0514,-0.067,-0.0467,-0.0163,-0.0716,0.0917,0.1147,0.0002,-0.0498,-0.0121,0.1115,0.1055,0.162,0.1709,0.1824,0.1517,-0.0541,0.004,0.0471,0.0527,-0.0658,-0.0022,-0.0388,-0.0391,-0.0443,0.1378,0.0749,-0.0749,0.0094,-0.0453,-0.0892,-0.0235,0.1541,0.0958,-0.067,-0.0296,-0.0589,-0.0784,-0.039,-0.0162,0.0171,-0.1834,-0.0007,-0.0468,0.0376,0.0739,0.0135,-0.0267,0.0038,-0.0377,-0.0166,-0.0409,-0.1223,-0.0264,-0.0338,0.0042,0.0845,0.0609,0.0469,-0.0122,-0.006,0.0131,-0.0016,0.0297,-0.0142,0.1175,0.0107,-0.0512,-0.0187,0.0611,-0.0376,-0.0893,-0.0609,0.0532,-0.0336,-0.0685,-0.0681,-0.0317,0.1218,-0.0817,-0.1538,0.0617,-0.0664,0.0951,0.0802,-0.0266,0.142,-0.1772,0.2399,0.2324,0.0233,-0.0504,-0.0153,0.0342,0.0056,0.0359,0.0408,-0.0141,-0.0427,-0.0831,-0.0481,0.0865,0.1304,0.1528,-0.0384,-0.0594,-0.0157,-0.0181,-0.0382,-0.141,-0.0525,0.0514,0.0157,-0.018,-0.0191,-0.0234,0.0689,-0.0763,-0.0028,0.1659,0.1503,0.0112,-0.0357,0.1103,0.2508,0.104,0.0187,0.1107,0.0521,0.0212,0.032,0.174,-0.0371,0.0618,0.0802,0.105,-0.0285,0.177,0.0091,-0.0054,-0.0263,0.0037,-0.2874,-0.2181,-0.1243,-0.1147,-0.1352,-0.1884,-0.0542,-0.2203,-0.1701,-0.0696,-0.1229,-0.1919,-0.2164,-0.0729,0.055,-0.1128,-0.0877,-0.1108,-0.1022,0.0106,-0.0103,-0.0634,-0.0452,0.0225,0.0039,-0.0313,0.0435,0.0195,0.0258,-0.0289,-0.0605,0.0803,0.1314,-0.0559,0.026,-0.157,-0.2008,-0.0193,-0.0313,-0.0951,-0.1256,0.0477,0.0044,-0.0536,-0.0624,-0.0268,-0.0482,0.0535,0.0896,0.0212,0.0046,0.1213,-0.0029,0.113,0.121,0.0738,-0.0825,0.0312,-0.1547,-0.0327,-0.0301,0.0369,0.0241,-0.0368,-0.0391,-0.0943,0.0564,0.0143,0.0366,-0.0653,-0.0108,0.0831,0.0039,-0.0768,-0.0451,-0.0685,-0.0115,0.0259,0.0566,-0.0782,-0.0724,0.0486,0.0482,-0.0274,0.065,-0.0194,0.0254,-0.008,-0.0759,0.0339,-0.0524,-0.0233,0.0006,0.0037,0.1616,0.0578,0.218,0.0134,0.0916,-0.0119,0.068,0.0086,0.004,-0.0721,-0.002,-0.0035,0.0057,0.026,0.0996,0.0903,-0.0004,-0.0127,-0.0229,-0.0231,0.0114,0.024,0.052,0.0033,-0.0366,-0.1246,0.0517,0.0499,-0.0998,-0.0171,-0.0762,0.0088,-0.0151,-0.0536,-0.0646,-0.0202,0.0445,-0.0172,-0.0713,0.0871,0.115,0.0308,-0.0217,0.072,-0.0325,-0.0066,-0.0119,-0.0286,0.0739,0.0091,-0.0464,-0.0164,0.0706,-0.0115,-0.0215,-0.0172,-0.0729,-0.0304,-0.1831,-0.0105,-0.0482,-0.0332,0.008,-0.0628,-0.0315,-0.0148,-0.016,0.0067,0.0382,0.0063,-0.0012,0.0123,0.0374,0.0493,0.0005,0.0084,-0.0055,-0.0472,-0.0452,-0.0216,-0.0596,-0.0328,0.0088,-0.1123,0.0755,0.0118,-0.1418,0.0652,0.0482,-0.134,-0.1054,-0.0831,0.0788,0.0438,0.1433,-0.1294,0.1012,0.1167,-0.0484,0.0902,-0.0947,-0.1097,-0.1404,-0.0828,-0.1825,-0.1723,-0.0155,0.0045,-0.0471,-0.0724,0.0039,-0.0416,-0.0671,-0.0631,-0.0531,-0.0357,0.0731,-0.0543,-0.0541,0.0188,-0.0266,0.0294,-0.0884,-0.1003,0.0323,-0.0719,0.0274,0.0988,0.0177,-0.0232,0.0089,-0.0996,-0.0317,-0.1133,-0.0361,-0.0396,-0.0044,0.1562,0.071,-0.107,-0.0891,-0.009,-0.0318,-0.0495,-0.0762,-0.0866,-0.0499,0.0068,0.0272,-0.042,-0.03,0.0727,-0.0149,-0.0122,0.0084,-0.0573,-0.0466,0.0398,0.061,0.0555,0.0134,0.0286,-0.0492,0.1761,0.0977,-0.0098,-0.1135,-0.1191,-0.0612,-0.0827,-0.1759,0.0168,0.2461,0.2528,-0.1249,-0.0055,-0.1198,-0.1044,-0.0674,-0.0124,-0.0174,-0.036,-0.0045,-0.0002,0.0649,-0.033,-0.0384,0.1005,maintenance
trm_557b4b05ae470,-0.0885,-0.0114,-0.0921,-0.0699,-0.0712,-0.0182,-0.0779,-0.0782,-0.0434,-0.0778,-0.1178,-0.0851,-0.0146,-0.0898,-0.0835,-0.0082,-0.0119,-0.1318,-0.0814,-0.0793,-0.0755,-0.0437,0.0322,-0.026,-0.0305,-0.0598,-0.0545,0.0247,0.0468,-0.0175,-0.045,-0.0868,-0.0555,-0.0561,-0.0074,0.004,-0.0318,-0.0206,-0.083,0.0068,-0.0401,-0.0042,-0.0348,0.0035,-0.0362,0.0117,-0.0753,-0.0322,-0.0207,0.0864,0.0912,0.0265,0.0182,-0.1058,0.0128,0.0148,0.0907,-0.0813,-0.0478,-0.064,-0.0586,-0.048,-0.0258,-0.0098,-0.0184,0.0635,-0.0735,-0.0907,-0.0563,0.0314,-0.0531,0.0085,0.0015,-0.0556,-0.0854,0.1068,0.0655,-0.0782,-0.0938,0.097,-0.0277,-0.029,-0.0249,-0.045,-0.0004,0.0653,0.051,0.0579,-0.0201,0.6932,0.0403,0.1313,0.0224,-0.1543,-0.0825,-0.1079,-0.0252,0.0118,-0.0,0.0282,0.0343,-0.0035,0.0055,-0.0444,-0.0619,-0.0449,-0.0148,0.077,0.0808,-0.0473,-0.068,-0.0606,-0.0358,0.0253,-0.0087,0.0236,-0.0757,0.0723,-0.0994,-0.062,-0.065,-0.0256,-0.081,0.0071,0.0024,-0.0375,-0.0188,-0.056,-0.0352,0.2082,-0.0027,-0.0385,-0.0055,0.0166,0.0611,-0.0642,-0.0325,-0.0354,-0.0082,-0.0141,-0.0619,0.0005,-0.0606,0.039,-0.0557,0.0081,-0.0033,-0.0715,0.0152,0.0095,-0.0245,-0.0513,-0.0176,-0.0733,-0.0007,0.013,-0.0404,-0.0364,-0.0294,0.0141,-0.0484,0.062,-0.0623,-0.0524,0.0121,0.0103,0.005,-0.0223,-0.0399,0.0623,0.063,-0.0826,0.0102,-0.0533,0.0011,-0.013,-0.0092,-0.0749,-0.0168,-0.0052,0.1123,0.002,0.0094,-0.0297,0.078,0.0747,0.0612,0.0371,-0.0324,-0.0157,-0.0218,-0.0085,-0.0359,-0.0444,-0.0499,-0.0547,-0.1084,-0.0348,-0.0487,0.0275,0.0188,-0.0871,-0.0541,0.04,-0.1027,0.3454,0.1222,-0.0475,-0.1141,-0.0742,-0.0961,-0.0808,0.0885,0.0207,0.0016,0.0333,0.0194,-0.0836,0.0369,-0.0505,-0.0645,-0.0352,0.0004,0.0248,-0.0168,-0.015,0.0027,0.0911,0.1931,-0.124,-0.0252,-0.0348,-0.0575,-0.0471,-0.0324,0.2181,-0.0126,-0.0584,0.1145,0.0898,-0.0528,-0.049,-0.0477,-0.0096,-0.0823,-0.0223,-0.0058,0.0083,0.1209,-0.0345,0.0135,0.0049,0.0619,0.0022,0.1724,-0.0359,0.0611,-0.0283,-0.0229,0.0023,0.0806,-0.0736,-0.0892,-0.0735,-0.063,-0.0868,-0.0613,-0.108,-0.0567,-0.0453,-0.0096,0.0303,-0.0147,-0.0518,0.4245,0.5002,0.7866,0.7701,0.5434,0.4906,0.4151,-0.0028,-0.0085,0.015,0.0181,0.0093,0.0498,0.0618,-0.0698,0.0123,-0.0336,-0.1129,0.0075,-0.0785,-0.0143,-0.0461,-0.0118,0.0048,-0.0843,-0.0172,0.0365,-0.1087,0.0422,0.0687,-0.0603,-0.0657,-0.0272,0.1008,0.152,-0.0574,0.1107,0.025,-0.1433,-0.0749,-0.047,0.0068,-0.0686,-0.0734,0.0096,-0.0739,-0.0609,-0.0557,-0.0079,-0.0308,-0.0282,-0.0669,0.0327,0.0623,-0.0495,0.0101,0.0582,-0.0263,-0.0943,-0.0553,-0.0206,0.0884,0.0627,-0.0141,-0.0242,-0.0877,-0.0835,-0.0679,-0.0125,0.0145,-0.0658,0.026,-0.0016,-0.0144,-0.0036,0.0376,-0.0505,-0.1457,0.0594,0.0996,-0.0074,0.0014,-0.0125,0.0052,0.0345,0.0037,-0.1038,0.0003,0.1992,-0.0255,0.0095,-0.0213,0.0193,-0.1027,0.0258,-0.0489,-0.0425,-0.1046,0.022,0.0228,-0.0692,-0.0067,0.0278,-0.0321,0.0464,0.1418,0.0908,-0.0628,-0.1202,-0.1028,-0.0772,-0.0292,-0.0273,-0.0501,-0.0472,-0.024,0.0879,0.0265,-0.1047,-0.0698,-0.1009,-0.065,-0.0019,-0.0185,0.0633,0.0395,-0.0516,0.0093,0.0679,0.0658,0.0015,-0.008,-0.0792,-0.0264,0.0107,-0.0267,-0.0605,-0.1193,-0.0591,-0.0662,-0.011,0.0962,-0.0512,-0.1161,-0.0857,-0.1043,-0.0257,-0.0683,-0.0668,-0.1265,-0.1152,-0.0726,0.0026,-0.1046,-0.0924,-0.0955,-0.0288,0.0624,0.0151,0.0518,0.0614,-0.0673,0.0936,0.16,-0.0456,-0.0783,-0.0253,-0.0644,-0.0224,-0.0223,0.0254,-0.0098,0.1615,0.0947,-0.0804,-0.1222,-0.1214,-0.0214,-0.0089,0.0425,-0.0499,-0.0359,0.1747,-0.0761,0.0189,-0.0301,-0.1121,-0.0513,0.0753,-0.0197,-0.0709,0.0699,-0.0908,-0.1661,0.0466,0.1955,0.0631,0.0732,-0.0693,0.044,0.1627,0.0026,-0.0242,0.0203,0.0931,-0.0809,0.0795,0.0575,0.0503,-0.0686,-0.0578,-0.0091,0.0285,-0.0283,-0.0897,-0.0371,0.1527,0.1656,0.0193,0.0434,0.029,0.0198,0.3386,-0.0415,0.033,-0.0899,-0.0928,0.0108,0.0961,-0.0192,-0.0265,-0.0456,0.0051,0.0576,-0.0372,-0.0675,-0.0282,0.0544,-0.0013,0.0203,-0.0723,-0.0382,-0.0734,-0.0833,0.1172,-0.0536,0.0372,0.1095,-0.0862,-0.1347,-0.0628,-0.0947,0.0911,0.0842,0.1557,-0.0435,0.0197,0.0155,0.0239,-0.0847,-0.0808,0.0565,-0.0619,-0.0273,-0.0149,-0.0414,-0.0421,-0.0412,0.1415,0.0887,-0.0371,0.0358,-0.066,0.0056,0.0838,-0.075,-0.0245,-0.0316,-0.0282,0.0834,0.0513,0.0013,0.0079,-0.0219,0.0319,0.0881,-0.0513,-0.0411,-0.0464,0.028,0.1307,0.193,0.1036,0.1031,0.0219,0.0421,-0.0124,-0.0484,0.1343,0.0503,-0.0164,0.0072,0.0484,0.0254,0.0828,0.0244,0.0987,-0.1195,-0.0396,-0.0238,-0.016,-0.0801,-0.1367,0.0158,0.0668,-0.038,0.0746,-0.0751,-0.0997,0.0136,0.0332,-0.0113,-0.0912,-0.0674,0.0049,0.1109,0.0713,0.0509,-0.0741,0.1364,-0.0812,-0.0636,0.0658,-0.0436,-0.0489,-0.1076,-0.0243,0.0312,-0.0394,-0.0147,-0.1064,-0.1089,-0.0785,0.0277,0.0359,-0.0481,-0.0234,-0.0281,0.0116,0.0161,0.092,0.0264,-0.0674,-0.0647,-0.0332,-0.0137,-0.0326,-0.0541,-0.0063,-0.1,-0.138,-0.0376,-0.0927,0.0488,-0.0143,0.0259,-0.0105,-0.068,0.0171,-0.0678,-0.0745,0.0267,-0.0815,-0.0697,-0.1002,-0.0873,-0.1008,-0.0211,-0.0726,-0.0223,-0.016,0.0766,-0.0816,-0.0313,-0.065,-0.0358,-0.0668,0.0538,-0.0215,-0.0513,-0.0351,0.002,-0.0237,0.0005,0.086,-0.1247,-0.0336,-0.0797,-0.0015,0.1021,-0.0332,-0.0566,0.1236,-0.0576,0.0521,-0.0215,-0.0675,-0.0567,-0.0601,0.1269,0.235,0.0236,-0.0195,-0.0006,-0.0262,0.036,-0.0828,-0.1416,-0.1077,0.019,-0.0397,0.0145,-0.0007,0.0927,-0.0177,-0.1039,-0.0622,-0.0034,-0.0031,-0.0079,-0.0176,-0.0624,-0.0394,-0.0199,0.0212,0.0623,-0.0082,-0.0877,-0.1801,0.0935,-0.1557,0.0008,-0.0789,0.3181,-0.0396,-0.0278,0.1043,0.0034,-0.0584,-0.0435,-0.0477,-0.0526,-0.0546,-0.0907,-0.0595,-0.0414,0.0384,0.0504,0.022,-0.1353,-0.1066,0.0218,0.0107,-0.0665,-0.1108,-0.0554,-0.0067,-0.0151,-0.0635,-0.0241,-0.0658,-0.0632,-0.0381,0.066,-0.004,0.0072,0.0468,-0.0649,-0.0846,-0.0999,-0.0802,-0.0581,-0.0001,-0.0592,-0.0396,0.0519,-0.0009,0.0608,-0.0098,0.0937,-0.0104,-0.0316,-0.0282,-0.0402,0.0057,0.0537,0.0984,0.0037,0.1143,-0.0136,-0.0549,0.0103,-0.0674,0.0349,-0.0453,0.0259,-0.0368,-0.0308,-0.0407,-0.0817,-0.0858,0.0043,0.0485,-0.008,-0.042,-0.0513,-0.0152,0.0072,-0.088,0.041,0.0648,-0.0192,-0.0353,0.0446,-0.0384,-0.0097,-0.0083,-0.0884,-0.0678,-0.0847,-0.026,0.0199,-0.0169,0.0757,-0.0908,-0.0276,-0.0208,-0.0281,-0.0535,-0.0194,0.0003,0.0242,0.1293,0.0453,0.0375,0.0448,0.0732,-0.0729,-0.0552,-0.0203,-0.0407,-0.099,-0.1427,-0.0849,-0.0331,-0.0609,-0.0793,0.0302,-0.0491,-0.0224,-0.0186,-0.0585,-0.0591,0.0404,-0.0001,-0.0388,0.0461,-0.0199,0.1082,-0.0533,0.0003,-0.0102,-0.0637,-0.0772,0.0262,-0.0497,-0.0423,0.1308,-0.0347,-0.0397,0.013,-0.099,-0.1468,-0.0427,-0.068,-0.0446,0.0742,0.1015,0.0958,0.0355,0.1608,0.0958,-0.1036,-0.0644,-0.1217,-0.1108,-0.0511,-0.0544,-0.0194,-0.0258,-0.0131,-0.1982,-0.1009,-0.2032,-0.0319,-0.0442,-0.1131,-0.0609,-0.0732,-0.1149,-0.0087,0.0226,-0.0172,-0.1313,-0.0552,0.0477,0.1073,0.0547,0.0497,-0.0348,0.0346,-0.0363,-0.1275,-0.0399,-0.0201,0.104,-0.0733,0.0213,-0.0378,-0.0766,-0.0475,-0.0897,-0.054,-0.0833,0.005,-0.0409,-0.0848,0.06,-0.0138,-0.0756,-0.0984,-0.0437,0.0286,-0.0061,-0.1026,-0.0089,0.0364,0.1011,0.004,-0.058,-0.0001,0.0321,0.0346,-0.0078,-0.0548,-0.0195,0.0891,0.0223,-0.0362,0.0034,-0.0416,0.0771,0.0318,-0.033,-0.0703,-0.0678,-0.0645,0.0075,-0.0658,-0.0208,-0.0228,0.0064,0.0891,0.04,-0.022,0.0562,-0.0008,0.0313,-0.0113,-0.0229,0.0414,-0.0449,-0.0672,0.0588,-0.0669,0.0546,0.0216,-0.0004,-0.066,-0.0908,-0.0359,0.0786,0.094,-0.0798,0.0316,0.0228,-0.024,0.0076,-0.0006,0.2031,0.0691,0.0075,0.073,-0.0084,0.0015,0.0637,0.2679,0.0127,-0.0011,-0.0626,-0.0849,-0.0949,-0.0918,-0.0414,0.0559,-0.0059,-0.008,-0.0129,-0.0332,-0.1171,-0.108,-0.0053,0.0095,-0.083,-0.038,-0.0102,-0.0062,0.0135,-0.0132,-0.0009,0.0084,0.0295,-0.0129,-0.0421,-0.0148,-0.0488,-0.0412,0.0092,-0.1184,0.0191,-0.047,-0.0092,0.0296,0.0454,-0.0131,-0.0025,0.0852,-0.0766,0.0083,0.1252,0.0211,-0.1151,-0.0071,-0.0024,0.0182,-0.0197,-0.0678,-0.0289,-0.0524,-0.1088,-0.1374,-0.0869,-0.0733,-0.0583,-0.0298,-0.0212,0.0259,-0.027,0.008,-0.0008,0.1284,0.0277,-0.0245,-0.0328,-0.0035,0.0056,-0.0129,0.0041,0.0336,-0.0479,-0.0194,0.0741,-0.0173,0.0095,0.0173,-0.0536,-0.0234,0.0162,-0.0221,-0.0812,0.0464,-0.0279,0.0565,-0.0176,-0.011,0.0443,0.1157,-0.0013,-0.0315,0.0653,-0.0338,-0.0211,0.0242,0.0838,0.1123,0.0273,-0.0486,0.0819,0.0071,-0.0261,0.0574,-0.0588,-0.0141,-0.0342,0.0756,0.0659,-0.151,-0.0885,-0.0822,-0.0743,-0.0794,0.0031,-0.0594,-0.0493,-0.0481,-0.0587,-0.058,-0.0689,-0.0421,-0.0715,-0.0108,0.0193,-0.048,0.0394,0.0844,0.0287,0.0455,-0.046,-0.0399,0.1009,0.043,0.0561,0.021,-0.0418,0.0034,-0.0567,-0.0372,-0.0483,-0.0131,-0.0001,0.0731,0.0865,-0.024,-0.0083,-0.0705,-0.052,-0.0391,-0.0346,0.0445,0.2011,0.0567,-0.0209,0.0051,-0.0257,-0.0359,-0.0637,-0.0153,-0.1374,-0.0041,0.0512,0.0787,0.1058,-0.0769,-0.1123,-0.0404,-0.0863,0.0762,-0.063,-0.0891,-0.0372,-0.0639,-0.105,0.0146,0.0024,-0.0127,0.0024,0.0686,-0.0155,-0.0328,-0.0191,-0.1129,-0.0911,-0.0513,-0.0739,0.0415,-0.0485,0.0234,-0.0371,0.0554,0.1516,0.0497,-0.0616,-0.0449,0.0549,-0.0133,0.1034,0.1711,-0.0739,0.0077,-0.0574,0.043,-0.0384,0.1004,-0.0716,0.0485,0.1602,-0.045,-0.0235,0.0325,-0.0863,0.0773,-0.1082,-0.1261,-0.0567,0.1921,-0.1073,-0.0598,-0.0807,0.1156,0.0008,-0.0895,-0.0083,-0.1202,-0.1015,-0.0071,0.0429,0.0372,0.1439,0.0637,0.1521,0.0698,0.0877,0.0263,-0.0281,-0.0518,-0.0229,-0.0009,-0.0438,-0.0628,-0.0492,0.001,-0.1132,-0.0771,-0.0379,-0.0573,-0.0974,0.0464,-0.0649,-0.0433,-0.0214,-0.1022,0.0304,0.0269,-0.1197,-0.0472,-0.0277,0.064,-0.0444,-0.0106,-0.132,-0.1,0.0712,0.0741,-0.0182,-0.0033,-0.0862,-0.0862,0.0191,-0.1441,-0.0919,-0.0836,-0.0153,-0.0462,-0.0285,-0.1052,-0.0086,-0.0086,0.0459,0.1037,-0.0454,-0.034,-0.0306,-0.0337,0.006,-0.094,-0.0238,0.0579,-0.1185,0.1807,0.3522,0.0439,0.0827,-0.0415,0.1262,0.0301,0.0486,-0.0081,-0.0296,0.1465,0.0164,-0.0602,0.6095,0.2421,-0.006,-0.1219,-0.06,-0.0354,-0.0178,-0.1057,0.0035,-0.0252,-0.0945,-0.0886,0.0389,-0.0038,-0.1894,-0.0068,-0.1012,-0.094,-0.0352,-0.0773,-0.0135,0.0024,-0.0127,-0.0483,0.47,0.4636,-0.0162,-0.0074,-0.0474,-0.0407,-0.0711,-0.0698,0.1785,0.0752,0.1553,0.1187,0.0888,0.0562,0.6838,0.6728,-0.0819,0.036,0.3391,-0.1168,0.0542,0.0253,-0.0545,-0.0129,-0.0289,-0.0577,0.0093,0.1824,0.1832,0.0307,0.0783,-0.06,-0.0164,0.0531,-0.0753,-0.0638,-0.0985,0.0434,-0.0372,-0.036,-0.0673,-0.0676,0.0632,-0.1374,-0.0498,-0.112,-0.0883,0.051,-0.0614,-0.0356,0.0239,-0.0101,0.0756,0.0477,0.0185,0.0647,0.0511,0.0143,0.0752,0.0472,0.0311,0.1264,0.0206,0.067,-0.0364,0.0374,0.0853,-0.0051,-0.0389,-0.1856,0.0098,-0.014,-0.0641,-0.1029,-0.0476,0.0329,-0.0681,-0.0728,-0.075,-0.0139,-0.029,-0.094,0.0388,-0.0509,-0.0817,0.0647,-0.0167,0.0693,0.0519,0.039,-0.0504,-0.0223,-0.0039,-0.0872,0.0634,-0.0404,0.0745,-0.0989,-0.0935,-0.0815,-0.0332,-0.0107,-0.0077,0.0806,0.1257,-0.0711,0.0313,-0.0517,0.0526,0.0522,0.014,0.0425,0.0512,-0.083,-0.0593,-0.0173,-0.0459,-0.0517,-0.0943,-0.0361,0.0964,0.038,-0.0794,0.0197,-0.0878,0.0004,-0.0332,0.0118,-0.0317,0.0039,-0.0129,0.0325,0.0116,0.113,0.202,0.0825,-0.0147,-0.0915,-0.0256,-0.1025,0.0071,-0.0127,0.0064,-0.0258,0.1437,-0.0777,-0.0414,-0.0977,-0.0389,-0.0606,0.0492,0.0052,-0.0841,0.005,0.1798,0.0922,-0.0761,-0.0669,-0.0101,0.0117,-0.0244,-0.0542,0.0231,-0.0527,0.0811,0.0105,0.004,-0.0332,0.041,0.165,0.0118,0.3431,0.0067,-0.0336,-0.0777,0.0498,-0.0816,0.0443,-0.065,-0.0496,-0.04,0.0587,0.0088,-0.0163,0.0028,0.05,0.0188,-0.0139,-0.1149,-0.0105,0.0262,-0.0478,-0.0599,-0.0531,-0.0426,0.0461,0.0518,0.108,0.0003,-0.0907,0.0116,-0.0486,-0.0411,0.0171,-0.153,-0.1423,0.0352,-0.0487,-0.0699,0.0331,0.0469,-0.0264,0.0022,0.0639,-0.0305,0.013,-0.0445,-0.0288,0.0188,-0.011,0.0307,0.0637,-0.0523,-0.059,-0.1082,-0.0509,-0.0213,-0.0084,0.0856,-0.0268,0.0907,0.0213,-0.0399,-0.0568,-0.1238,-0.0629,0.0043,-0.0353,-0.0177,0.0018,0.0074,-0.042,-0.0079,-0.0236,0.0451,-0.0898,-0.0384,-0.0613,-0.0412,0.0117,-0.0828,0.0378,-0.0292,-0.0303,-0.0318,0.0049,0.3461,0.2913,0.1993,0.1849,-0.0498,-0.0246,0.0235,0.022,-0.0379,-0.0558,0.0813,-0.0009,-0.0424,-0.1859,-0.0992,-0.0345,-0.151,-0.0957,-0.0716,-0.1756,0.149,0.1233,0.2423,0.1942,-0.0049,0.0242,-0.0214,0.0567,0.0121,-0.0885,-0.1037,0.0277,0.0959,-0.0225,-0.0239,-0.0197,-0.0422,0.0081,0.1172,-0.0008,-0.0521,0.0523,0.2295,0.098,0.0007,0.0085,0.076,-0.0223,-0.0766,-0.0357,-0.038,-0.0523,-0.0507,0.0217,-0.0342,0.0246,-0.0809,-0.0422,-0.0291,0.3859,-0.0844,-0.0661,0.0066,-0.0569,0.0599,0.6359,0.5038,0.7443,-0.0619,-0.0605,-0.1078,-0.0955,0.0389,-0.075,0.0799,-0.1078,-0.0671,-0.1146,-0.0445,0.0887,0.2433,0.0365,0.0223,-0.0079,-0.0851,-0.0609,-0.001,-0.0218,0.0123,-0.09,-0.0049,0.0389,-0.0709,-0.0083,-0.02,-0.0507,0.2039,-0.0546,-0.0643,-0.0205,-0.0534,-0.0403,-0.0159,0.1492,-0.0307,-0.082,-0.0785,0.0287,-0.0355,-0.0265,-0.033,-0.0778,-0.0407,-0.0646,-0.0581,-0.0164,-0.085,-0.1644,0.0045,0.0557,0.0127,-0.0408,0.0934,0.0445,-0.0626,0.0675,-0.0394,0.0062,0.0233,-0.0676,-0.0478,0.0568,0.0994,-0.0123,-0.041,-0.0552,0.0637,-0.0569,-0.0466,-0.0324,-0.0478,-0.0089,-0.0153,-0.009,-0.0312,0.0358,-0.0137,-0.0378,-0.0456,-0.0153,-0.0312,-0.0244,-0.0433,-0.0198,0.0024,0.2657,0.0855,0.0238,-0.0618,-0.03,0.0168,-0.0736,0.0785,-0.1341,-0.0099,0.0408,-0.0252,-0.1464,-0.121,-0.0584,-0.0793,-0.0729,0.0159,-0.0547,0.0097,-0.0052,-0.0837,-0.0301,-0.0112,-0.0309,0.1823,-0.0534,-0.134,-0.0629,-0.0742,-0.0889,-0.0746,-0.0792,-0.0757,-0.001,-0.12,-0.0827,-0.0788,-0.0649,-0.0331,0.0013,0.0558,-0.0189,-0.0746,-0.0479,-0.0651,-0.0569,-0.0239,0.1115,0.0447,-0.1093,-0.0831,-0.1088,-0.046,-0.0399,-0.0769,0.0945,-0.0521,0.2083,-0.0261,0.0387,-0.016,-0.051,0.2436,0.2225,-0.0134,0.0186,-0.0052,0.04,0.0187,0.0203,0.0104,-0.0537,-0.0644,-0.0044,-0.0534,-0.0647,0.2363,0.2134,0.2941,-0.0447,-0.0368,0.0317,0.0178,0.0472,0.0041,-0.0583,-0.0217,0.062,-0.0118,0.0137,0.0026,0.1738,-0.0188,-0.0993,-0.0872,-0.061,0.1085,-0.0113,-0.0583,-0.081,-0.0599,-0.0259,-0.0453,-0.0463,0.0167,0.0728,-0.0277,-0.0214,-0.0406,-0.101,-0.1082,-0.0436,-0.0244,-0.0242,-0.0726,-0.0696,-0.0774,-0.0652,-0.0442,0.0015,-0.0158,-0.042,-0.0847,-0.0291,-0.0656,-0.0911,-0.0852,-0.0176,0.0161,-0.089,0.2412,-0.0813,0.0058,0.189,-0.0112,-0.0175,0.2373,0.0524,0.1783,-0.0366,0.5521,0.4895,0.2805,-0.1153,0.0078,0.0297,0.1576,0.2549,0.2091,0.0404,-0.0833,-0.0562,-0.0698,-0.0674,-0.0728,-0.0351,-0.122,-0.0203,-0.037,-0.0384,-0.0463,-0.0491,-0.1316,-0.0754,-0.0023,-0.0078,-0.0186,-0.0171,0.0016,-0.0221,-0.0338,-0.025,-0.0691,-0.0076,-0.0582,0.0588,0.142,-0.0527,-0.0035,-0.0287,0.0051,-0.0547,-0.0504,-0.022,-0.0783,-0.11,0.0103,0.0443,-0.0538,-0.0922,0.0696,-0.0328,-0.0585,-0.0761,0.0665,-0.0628,-0.0307,-0.0454,-0.0309,-0.0035,-0.0616,-0.0516,0.5235,0.0874,0.0312,-0.0285,-0.0095,-0.0201,0.0352,0.0242,-0.0403,0.0146,0.0534,0.0758,0.0608,0.0597,-0.067,-0.0653,-0.1026,-0.0469,-0.1402,-0.1068,-0.0685,0.0145,-0.1102,-0.0753,-0.0566,0.0141,-0.1047,-0.0862,-0.0462,-0.1067,-0.0699,-0.0225,-0.0849,-0.0845,-0.0195,0.021,-0.1714,-0.1188,-0.0625,-0.0318,-0.0632,-0.0658,-0.1147,-0.0988,-0.0678,-0.0537,0.0395,-0.01,0.1003,0.0345,0.1707,-0.0842,-0.0094,-0.0792,0.0117,-0.0457,-0.0669,0.0126,-0.0114,0.0066,0.1072,0.0229,-0.1126,-0.0657,0.1119,0.0935,0.0735,0.016,-0.0167,-0.0712,0.0306,0.0199,-0.0534,0.0991,-0.0358,-0.1252,-0.1146,0.1382,0.1444,0.014,-0.1475,-0.1126,0.0121,-0.0532,0.051,0.0246,-0.0769,-0.0752,-0.1012,0.1022,-0.0262,0.1102,-0.0095,-0.0574,0.0014,0.1381,-0.0026,-0.0039,0.0357,0.0092,0.0218,-0.07,-0.0531,0.0358,0.0291,0.0777,-0.0862,0.0404,0.0847,0.0085,-0.0772,-0.0245,-0.0788,0.0539,0.0324,-0.087,-0.0713,0.0288,-0.0381,-0.0049,0.0784,-0.1722,-0.1604,-0.1112,-0.0347,0.0326,-0.0467,-0.0143,-0.0927,-0.0944,-0.0962,-0.0993,-0.039,0.0149,-0.0423,-0.0769,-0.0523,-0.0516,0.1331,0.0935,-0.0215,0.0392,-0.0248,-0.0003,-0.0167,0.052,0.0089,-0.1045,-0.0048,0.2757,-0.0744,0.1271,-0.0321,0.0042,-0.0361,-0.0366,-0.0735,0.0754,-0.0308,-0.0294,-0.0633,-0.04,0.0063,-0.0859,-0.0367,0.1117,-0.048,0.0571,0.1263,0.0807,0.168,0.2775,0.0865,-0.1038,-0.1444,-0.0255,-0.0358,-0.0249,-0.0302,-0.0447,-0.0147,-0.0561,0.0893,-0.0375,0.1385,0.0172,-0.0954,-0.0309,-0.0908,-0.0626,0.0461,-0.1276,0.0039,-0.1381,-0.0367,-0.0406,-0.0206,-0.0072,0.1101,0.3981,0.2573,-0.0654,0.0531,-0.047,-0.0305,-0.1281,0.5869,-0.0015,-0.116,-0.0711,-0.0947,0.654,0.6607,0.0141,-0.0748,-0.0066,-0.0695,0.0273,0.054,-0.0184,-0.007,-0.0057,0.0748,0.0162,-0.1177,-0.0787,-0.0156,0.0247,-0.0836,-0.0939,0.0052,-0.0757,-0.0934,-0.0304,-0.0132,0.1334,0.0624,0.002,-0.0574,-0.0039,0.0442,-0.0611,-0.1202,-0.0533,-0.0695,-0.0695,0.0413,-0.0086,0.0439,-0.0149,0.0461,0.016,0.0087,0.1148,0.1776,-0.0779,0.0605,0.0674,-0.0625,0.1867,-0.1347,0.3634,0.1964,-0.025,0.0059,-0.0086,-0.034,0.0513,-0.0768,-0.0058,-0.0648,-0.0967,-0.0897,-0.0323,-0.0074,0.0246,0.0216,0.0034,-0.0989,-0.0917,-0.0324,-0.0254,-0.017,-0.0498,-0.077,0.0724,-0.0651,0.0898,0.0406,0.0737,-0.019,-0.0203,-0.0046,-0.2418,-0.0802,-0.2146,-0.0836,-0.0727,-0.141,-0.0421,-0.0412,-0.01,0.0515,-0.1081,-0.0793,0.0627,0.1298,0.0015,0.147,0.0404,0.054,-0.0181,0.0253,0.0543,0.0624,-0.0285,-0.0122,0.0091,-0.0277,0.0584,-0.0029,0.0695,0.6606,-0.0266,0.0061,-0.0643,0.1158,-0.0411,-0.0765,-0.0303,0.0363,0.0689,-0.0584,0.0732,0.0189,-0.0395,-0.028,-0.0323,-0.035,-0.0201,0.0472,-0.0673,-0.007,0.0062,-0.0016,0.1698,-0.0318,-0.0298,0.0346,0.0954,0.1382,0.0582,0.1081,0.3353,0.0353,0.1385,-0.0387,-0.0487,0.0003,-0.0183,-0.0061,0.0453,-0.0085,0.0663,0.1635,-0.0922,-0.114,-0.0077,-0.043,-0.0835,0.0554,-0.0435,-0.0382,-0.0391,-0.0798,0.039,0.0126,-0.0003,0.1683,0.1911,-0.1186,-0.0638,-0.078,-0.008,0.0338,-0.0493,-0.07,-0.0263,-0.0319,-0.0674,0.006,-0.0427,0.2146,0.0089,-0.0642,-0.1114,0.0586,-0.0155,-0.0256,0.0381,-0.0519,0.0208,0.0066,0.0458,0.0746,0.044,-0.0186,-0.0154,0.0453,0.0163,-0.0093,-0.0518,-0.0332,0.0191,0.0023,-0.0162,-0.0354,0.0163,-0.0523,-0.1066,-0.059,-0.1509,-0.1376,-0.0889,-0.0466,-0.0728,0.0763,0.0143,0.1274,0.011,0.0418,0.0112,-0.0591,-0.0037,-0.1094,0.0576,0.0106,-0.0972,-0.0166,-0.0286,-0.0815,-0.0224,-0.0981,0.0143,-0.0805,-0.0212,0.0744,-0.0711,0.0716,-0.0283,0.0699,-0.0205,0.0577,0.0482,0.0239,0.076,-0.0478,-0.0899,-0.0537,-0.0469,-0.0322,-0.0488,0.0878,0.0098,-0.0335,0.0073,0.1022,0.0179,-0.0083,-0.0191,0.0719,-0.0544,-0.0198,-0.0246,-0.0431,0.0953,-0.0603,-0.0731,-0.0737,-0.0218,0.025,0.0311,-0.0379,-0.1155,0.0509,-0.0336,-0.0762,-0.066,-0.109,-0.0161,0.0284,-0.0384,0.0678,-0.0764,0.0152,0.03,0.0356,0.021,-0.0126,0.0613,0.0476,-0.0121,0.0436,-0.0393,-0.0048,-0.0782,-0.0835,-0.0386,0.0182,0.0076,-0.0676,0.0066,-0.0137,0.1835,0.0801,-0.0076,-0.0111,-0.0614,-0.0582,0.0209,-0.0647,0.0282,0.0174,-0.0249,0.0391,-0.0363,0.0378,-0.0492,-0.0738,0.0056,-0.0897,-0.0298,-0.0449,0.0222,-0.0434,-0.009,-0.0447,-0.039,-0.0051,0.0753,-0.0448,0.0925,-0.0385,-0.1124,-0.083,0.0078,-0.0146,0.0707,0.037,-0.0787,0.08,0.1131,0.0392,0.1033,0.0058,-0.0773,-0.0614,-0.0357,-0.0497,0.0798,0.0462,0.0024,0.0205,-0.0661,-0.0818,-0.0831,0.014,0.042,-0.0014,0.0735,-0.066,-0.0841,-0.0115,-0.0503,-0.0482,-0.0142,0.0736,0.0593,-0.0505,-0.0181,0.0604,-0.1078,-0.061,-0.0435,-0.0973,0.0863,0.0839,-0.0526,-0.1389,-0.067,-0.0517,0.0638,-0.0225,-0.0744,0.0497,-0.1303,-0.0514,-0.0913,-0.0351,-0.1128,-0.0821,-0.0799,-0.0495,-0.0354,-0.0067,-0.1133,-0.0739,0.0496,-0.0821,-0.0588,-0.0232,-0.133,-0.0674,0.2345,-0.0474,-0.0241,-0.0353,0.0181,-0.0031,-0.0156,0.0766,0.047,-0.0473,-0.0371,-0.0712,-0.0026,0.1123,-0.0324,-0.0483,-0.0515,0.0071,-0.0499,0.0545,-0.0586,-0.025,0.0678,-0.0144,-0.0092,0.0236,-0.0639,-0.0146,-0.0645,-0.0544,-0.0248,0.0891,-0.0776,-0.0443,-0.0447,0.0486,0.0309,0.0026,0.0359,-0.1087,-0.0509,-0.0504,0.1718,0.0808,0.0647,0.0153,0.1404,0.0657,-0.0196,-0.0129,0.0001,0.1588,0.0223,-0.0187,-0.0543,0.2244,0.0426,0.1641,0.0067,0.3057,0.1997,0.3982,-0.0249,0.0032,-0.0451,-0.0398,0.0798,-0.0142,0.1318,-0.0363,0.0415,0.1005,-0.1172,-0.0104,0.0521,0.0358,-0.0208,-0.0947,-0.0211,0.0256,-0.0538,-0.0598,0.0078,-0.052,-0.0542,-0.0424,-0.0593,-0.0709,-0.166,0.0334,-0.0905,-0.049,0.0632,-0.0039,-0.0347,0.0732,0.1737,-0.0702,0.0092,0.138,0.0538,-0.0283,0.1352,-0.0196,0.0334,0.0072,-0.0027,-0.0055,0.1032,0.095,0.0623,0.0648,0.0073,-0.0869,0.1009,0.1454,0.0137,0.0237,0.0353,0.3116,0.0232,0.0744,-0.0101,0.0085,-0.072,-0.038,0.0237,0.1149,0.0219,0.02,0.065,0.1646,0.0328,0.0704,0.0377,-0.0073,-0.0419,-0.0288,-0.1299,0.0007,0.094,-0.0421,-0.0533,0.0019,0.0547,-0.0089,-0.0589,-0.018,0.0077,-0.104,-0.0903,-0.0437,0.0031,0.0081,0.0481,-0.0126,-0.0035,0.0207,-0.0928,-0.0064,-0.0443,0.0102,-0.0474,0.6504,0.7735,0.0653,0.1957,-0.0284,0.1136,0.2963,-0.0924,-0.0757,0.0228,-0.0281,0.1147,0.0093,0.5194,0.2246,0.3569,0.0096,0.1168,-0.0083,-0.0122,0.009,0.0489,0.0149,0.531,0.0197,-0.0205,0.0044,0.7034,0.5722,0.3606,0.5081,-0.076,-0.0305,-0.0522,-0.1035,0.6036,-0.0752,0.005,0.0005,0.1202,0.0651,-0.0103,-0.044,-0.1175,-0.0485,-0.001,-0.0195,0.0699,0.0008,0.0129,0.6636,0.0309,0.0715,0.0411,0.183,0.1322,0.1592,0.0412,-0.0672,0.0435,-0.0046,-0.0616,0.1093,-0.0343,-0.0884,-0.0292,0.1975,0.218,0.019,-0.0599,-0.0616,-0.109,-0.1239,-0.0104,0.022,0.0806,0.1052,-0.0523,-0.1198,-0.0899,-0.0085,-0.0025,-0.0653,0.138,0.1264,-0.0499,0.0381,0.4901,-0.0758,-0.0279,0.0457,-0.0141,0.0223,-0.0726,0.1048,-0.1346,0.012,-0.0134,-0.0618,-0.0326,0.0213,-0.0543,-0.0548,-0.0357,-0.0791,-0.066,0.0128,-0.0484,-0.022,0.0991,-0.0094,0.0303,-0.0382,-0.0117,-0.0055,0.1509,-0.0857,0.0475,0.008,-0.0264,0.0318,-0.0245,0.0561,0.226,-0.1002,0.1668,0.3933,-0.03,0.5386,-0.1128,-0.0776,0.2245,-0.1152,0.6876,-0.0524,-0.0411,-0.0127,0.0436,0.0563,0.0172,0.084,0.1961,0.1633,-0.0036,0.0383,0.1117,-0.0223,-0.0829,-0.0933,-0.1064,-0.0747,-0.0444,-0.0962,0.0141,-0.059,0.2733,0.0264,0.0352,0.0213,-0.0087,0.0118,0.0048,-0.0144,0.0058,-0.0602,-0.0058,0.0084,0.1238,0.0052,-0.0276,-0.169,-0.0739,0.0208,-0.088,-0.0161,-0.0495,0.0064,-0.1006,-0.0073,-0.0175,-0.0755,-0.0817,-0.0015,-0.0759,-0.0256,-0.0455,0.0496,0.03,0.4902,0.2869,0.1316,0.2511,0.3528,0.5465,0.1409,0.1451,0.1741,-0.027,0.0538,0.0471,0.4913,0.6607,0.0324,0.1235,0.1153,0.018,-0.0101,-0.0737,-0.0534,-0.0023,0.0238,-0.0082,-0.0009,0.0151,-0.0497,-0.0994,-0.0286,0.0356,-0.0006,-0.0188,-0.0676,-0.0522,-0.0422,-0.0113,0.0267,-0.0132,-0.0566,0.0028,-0.0014,-0.0156,-0.0497,-0.0908,-0.0152,-0.0646,-0.0705,-0.0318,-0.0245,0.0358,0.0894,-0.0943,0.0159,-0.076,-0.06,0.1425,0.065,0.1075,0.0159,-0.0693,-0.0326,0.3885,0.5218,-0.0425,0.0325,-0.0352,-0.0566,-0.0826,-0.0038,-0.0276,0.0042,-0.0594,-0.0196,0.0357,0.0323,0.0102,0.0048,-0.0249,0.0643,-0.0852,-0.0933,-0.0267,-0.0125,-0.0391,0.076,-0.009,0.0082,-0.0784,-0.0889,-0.0479,-0.0312,-0.104,-0.0268,-0.005,-0.0272,-0.0766,-0.1008,0.0109,-0.0259,0.019,-0.039,-0.0506,0.0312,0.0521,-0.0441,0.0203,0.0679,-0.0585,-0.037,-0.0641,-0.0824,-0.0757,-0.0335,-0.0857,-0.0269,0.0206,-0.0231,-0.0336,-0.0345,-0.0001,-0.0498,0.0887,0.0077,0.0249,0.2455,0.0072,0.0108,0.0407,-0.0066,0.0639,-0.0863,0.0282,0.0879,-0.0328,-0.0649,-0.0082,0.0228,0.0327,0.0918,-0.0323,0.0009,0.0739,-0.1033,0.0388,-0.0444,0.0191,-0.0371,-0.0502,0.0013,0.043,-0.0866,-0.0402,-0.0164,-0.0061,0.0231,-0.0261,0.0403,-0.0873,-0.0582,0.1208,0.0259,-0.0416,-0.0228,-0.002,0.0326,0.0704,0.1236,0.0026,-0.0203,0.021,0.0008,0.1697,-0.0286,-0.0072,-0.11,-0.0082,-0.0559,-0.014,-0.0134,-0.0874,-0.0494,-0.0771,-0.0751,-0.0458,-0.0529,0.0779,0.1014,0.0226,-0.0059,0.0874,-0.0348,-0.0298,-0.087,-0.0761,-0.0165,-0.0359,0.0203,0.012,-0.1347,-0.1257,0.0488,-0.073,0.0375,-0.0632,-0.0462,0.3324,-0.06,-0.0417,0.0078,-0.1098,-0.0521,-0.0508,-0.0209,-0.093,0.0103,0.0774,0.0123,-0.0011,-0.0813,0.0356,-0.0565,-0.1264,-0.1116,-0.0347,-0.0219,-0.085,0.4739,0.5902,-0.0261,-0.0267,-0.0595,0.0059,0.0097,-0.0245,-0.0278,0.0588,0.0065,0.0156,-0.0581,-0.0124,0.0144,0.029,0.0109,0.0014,-0.0377,-0.0932,-0.0783,-0.0139,-0.0432,0.0018,-0.0353,-0.0329,-0.0241,0.0198,-0.0573,-0.0561,0.0918,-0.1352,-0.0956,-0.1159,0.1296,0.018,0.0101,0.091,0.215,0.0995,-0.0864,-0.086,0.0716,-0.0614,0.1135,0.0208,0.074,0.014,0.0142,-0.0064,-0.0946,-0.0832,-0.0743,-0.0041,-0.0256,-0.0163,visual color discrimination
trm_4a3fd79d0a17f,-0.0082,0.0284,0.004,0.0239,-0.0283,-0.0277,0.0108,-0.0027,0.0032,0.0262,-0.0139,0.0102,0.0326,0.0235,0.0079,-0.0143,0.0106,0.0473,0.0057,-0.0013,0.0074,0.0097,0.0135,0.0219,0.0023,-0.0,-0.0019,0.0143,0.0323,-0.0006,-0.0059,0.0252,0.0246,0.0275,0.0226,0.0231,-0.0125,-0.0101,0.0526,0.009,0.0246,0.0132,0.0063,-0.0048,0.0159,0.0291,-0.0397,0.0008,-0.0197,0.0485,0.0215,-0.0156,0.0057,0.0006,0.0042,0.0059,-0.0048,0.0059,0.0114,0.0085,-0.006,-0.0101,0.0518,-0.0339,0.0277,-0.0382,0.0743,0.069,0.0361,0.0049,0.0071,-0.0118,-0.011,0.0421,0.0646,0.0147,0.0362,0.0091,-0.0357,-0.0106,0.0161,-0.0275,0.0489,0.0332,-0.0136,-0.0257,0.0128,0.0062,0.0185,0.005,-0.0012,-0.0029,0.009,-0.0602,-0.058,-0.0456,-0.025,-0.0194,-0.0624,-0.0154,-0.0203,-0.0014,-0.0414,-0.0371,-0.0198,0.0341,0.0341,-0.0283,-0.0018,-0.0017,0.0044,0.0162,-0.0224,-0.0304,-0.0059,-0.0064,0.0364,-0.0597,-0.003,0.0059,0.0511,0.0499,0.0587,0.0052,0.0452,0.0378,0.0469,-0.0144,-0.042,-0.0242,0.0169,0.0032,-0.0276,0.0416,0.0053,0.0472,-0.0375,0.0405,-0.0025,-0.0147,0.025,0.0067,-0.0083,0.0268,0.0199,-0.0187,0.0049,0.0277,0.0157,-0.0101,0.015,0.0431,0.0212,0.0304,-0.0082,-0.0065,0.0015,-0.0103,0.0049,0.0091,0.0084,0.03,0.0416,0.0446,0.0058,0.0008,0.0242,0.026,0.026,0.0079,-0.0242,0.0488,-0.0046,0.0469,0.0368,0.0243,0.0481,0.0355,0.0207,-0.0183,0.0245,-0.0256,0.0292,0.0014,0.0091,0.0215,0.002,0.0391,0.0146,0.0268,0.0272,0.0141,-0.0044,0.0263,0.0247,0.0563,0.0739,0.0042,0.0035,0.0105,-0.0177,-0.0832,0.0475,0.0259,0.0135,-0.0233,0.0109,0.0275,0.027,0.0135,0.0477,0.0224,-0.0105,-0.0164,0.001,-0.0192,-0.006,0.0182,-0.0177,0.0147,-0.0219,0.001,0.0335,0.0021,-0.0082,-0.004,0.0331,-0.0273,0.0354,-0.015,-0.0359,0.0518,-0.0488,0.0371,0.0292,-0.0363,0.0099,0.0021,-0.0141,0.0043,-0.0032,0.0141,-0.0171,-0.008,0.0245,0.0367,0.0201,0.0284,0.0045,0.0233,-0.0171,0.0002,0.0033,0.0015,-0.0135,0.0149,-0.0101,0.009,-0.0277,-0.0532,-0.0196,-0.0441,0.0296,-0.0011,-0.0392,-0.0551,-0.0006,0.0065,-0.015,0.0131,0.0038,0.0062,0.029,-0.0033,-0.0244,-0.0465,-0.0213,-0.0054,0.0031,-0.0318,-0.0267,0.0174,0.0184,0.0612,0.0525,0.0068,-0.0199,-0.0211,0.0117,0.0185,0.0223,0.0083,-0.0058,0.0391,0.0135,0.0023,-0.0056,-0.0179,0.005,-0.0293,-0.0225,0.0648,0.0203,0.0165,-0.0189,-0.0228,0.0264,-0.0028,0.0021,0.015,0.0057,-0.0144,0.0227,-0.0108,-0.0068,-0.0114,-0.013,0.0031,-0.0002,0.0363,0.0366,0.0068,0.014,0.0196,0.021,0.0233,-0.0039,0.0041,0.0309,0.0046,0.0175,0.005,0.023,0.0051,-0.0006,-0.0325,-0.0272,-0.0103,0.0173,0.0372,0.0307,-0.0174,-0.0288,-0.0182,-0.0203,-0.0274,0.0295,0.0148,0.0259,0.0069,0.0114,-0.0564,-0.0139,-0.0291,0.0183,0.008,0.0055,0.0397,0.0089,0.0193,-0.0107,0.0223,-0.0154,-0.001,-0.0254,-0.0329,0.0139,-0.0225,-0.0123,0.0076,0.0174,-0.0026,0.0011,-0.0382,0.0298,-0.0132,-0.0022,-0.0302,-0.0583,-0.0352,-0.0518,-0.0293,0.0221,0.0066,-0.0086,-0.0161,0.0046,-0.0118,0.0078,0.022,-0.0293,0.0123,-0.0254,0.0259,-0.0359,-0.042,-0.0378,0.0192,-0.0074,0.0231,0.0204,-0.0307,0.012,0.0223,-0.0111,-0.0243,-0.0083,0.0117,0.0084,0.0104,-0.0182,0.0395,0.0241,-0.0284,0.0472,0.0278,-0.0097,0.0414,0.0386,0.0432,-0.0076,0.0245,0.013,0.0908,0.0915,0.0219,0.0344,-0.0007,0.0409,0.0205,0.0039,-0.0265,-0.003,-0.01,0.0103,-0.0088,0.0083,-0.0116,0.0385,0.0329,-0.0287,-0.0288,0.0011,-0.0203,0.0166,0.0122,-0.0023,-0.0333,0.0463,0.0259,0.0106,-0.0314,0.0092,0.0212,0.0063,0.0318,-0.0229,0.0238,0.0428,-0.0225,0.0096,0.0349,0.0103,-0.001,0.0128,0.0501,-0.0162,-0.0609,0.0085,0.0017,-0.0426,-0.0256,-0.0064,0.0255,0.0122,-0.0147,0.008,-0.0152,0.0024,0.0043,-0.0549,-0.0229,-0.0141,-0.0281,-0.0123,-0.0444,0.0041,0.0038,0.0346,0.0189,-0.0094,-0.0148,0.0452,0.0454,0.01,-0.0005,0.0164,-0.0124,-0.003,0.0382,0.0401,-0.002,0.0328,0.0054,-0.0041,0.0082,-0.0084,0.0256,0.0195,-0.0406,0.0539,0.0028,0.025,0.0169,-0.0188,-0.0192,0.0206,0.0152,-0.0379,0.0041,0.0145,0.0091,-0.0383,-0.0128,-0.0113,0.0049,-0.0194,-0.0532,-0.0392,-0.0024,0.013,0.0165,0.0247,0.0838,0.0338,0.0167,0.0514,0.0342,0.0352,0.0343,0.0117,-0.0117,-0.0024,0.0067,0.0154,0.0155,0.0129,-0.0095,-0.0252,0.0023,-0.046,0.0368,0.0119,-0.0234,-0.0094,0.0276,-0.0174,-0.0054,-0.0033,-0.0016,0.0229,0.0156,0.0519,-0.0185,-0.0128,-0.0383,-0.0171,0.0254,0.0012,0.0479,0.0571,0.0364,0.0057,-0.0153,-0.0604,-0.0528,-0.0151,-0.0134,-0.0395,-0.01,0.0144,0.0261,0.0323,0.021,-0.023,0.0148,-0.0143,-0.0038,-0.0172,0.0287,0.0323,-0.0021,-0.019,-0.028,-0.0176,0.0111,0.0378,0.0167,-0.0551,0.0301,-0.001,-0.0124,0.0058,-0.0096,-0.0254,-0.0225,0.0156,0.0115,0.0076,0.0081,0.014,0.0112,-0.0188,0.0172,0.0574,0.0137,-0.0029,0.0022,0.0265,0.0529,-0.0065,0.0529,-0.0297,0.0043,-0.0094,-0.026,0.067,0.0188,0.0137,0.0039,0.0008,-0.0335,0.0186,0.016,0.0276,-0.0226,-0.0092,-0.0061,0.0105,0.0184,0.0084,-0.0203,-0.0016,-0.0125,0.0576,-0.0027,0.1051,0.0515,-0.0229,0.0722,-0.0024,0.0761,-0.0506,0.0283,0.0134,0.0086,-0.0507,0.0056,0.0054,0.0073,0.1205,-0.0463,-0.0369,-0.028,-0.0225,-0.0428,-0.0049,0.0221,-0.0425,0.0122,-0.0005,0.0096,0.0048,0.0182,-0.0096,0.0129,-0.0617,0.0367,-0.0034,0.009,0.0037,-0.006,-0.0147,-0.0091,-0.06,0.0519,0.0127,0.0082,0.0059,0.0003,-0.0065,-0.0341,-0.0246,-0.013,-0.0086,0.035,0.0254,-0.0197,0.0041,0.0215,-0.0076,0.004,-0.0087,0.0286,0.0347,0.0273,0.0319,0.0551,0.0232,-0.0199,-0.0147,0.0372,0.0466,-0.0178,0.0333,0.0153,-0.0107,-0.0104,0.0276,-0.0193,-0.0293,0.003,0.1155,0.1134,0.072,-0.0018,0.0173,0.0295,-0.0177,0.0106,0.0157,0.0021,0.0013,0.0084,-0.0083,0.0012,0.023,-0.016,-0.0042,-0.03,0.0271,0.0335,0.0182,0.0149,0.0358,0.0058,-0.0176,-0.0235,0.0101,-0.0068,0.0174,-0.033,0.0585,0.075,0.0649,0.0426,-0.0107,-0.0376,0.0112,0.0055,0.0284,-0.0313,-0.0036,-0.0282,-0.0041,-0.007,0.025,0.0044,-0.023,-0.0224,-0.0427,-0.046,-0.0236,-0.004,-0.012,0.0279,-0.0041,0.0197,0.0324,0.0237,0.027,0.0319,0.0416,-0.0106,-0.0107,0.0009,-0.0144,-0.0097,-0.0027,-0.0317,-0.0141,0.0135,-0.0079,0.0043,-0.0189,-0.0181,-0.0101,0.0412,-0.0176,0.0184,0.0201,-0.0361,-0.0073,-0.0391,0.0219,-0.0118,-0.0021,-0.0049,0.015,-0.0448,-0.019,-0.0466,-0.0082,-0.0373,-0.0267,-0.0113,-0.0717,-0.0466,-0.0088,-0.0252,-0.0113,0.0377,0.0367,-0.0035,0.0071,0.0226,0.0672,0.0285,0.0326,0.0369,0.0802,-0.0227,0.0047,-0.0096,-0.0058,0.0057,0.0308,-0.0081,-0.0233,0.015,-0.0101,-0.0074,0.0074,0.021,0.011,0.03,-0.0206,-0.0401,0.0224,-0.0328,0.0006,-0.0242,0.0179,0.0053,0.0204,-0.0229,0.0308,0.0922,0.0518,-0.0096,-0.0183,-0.0125,0.0116,-0.015,-0.0234,-0.0294,0.0249,0.0401,-0.0174,0.0373,0.0238,0.0376,-0.0569,0.0235,-0.0113,0.0036,0.008,0.0029,0.0569,0.0588,0.0179,-0.0442,0.0155,0.0077,0.0254,-0.0182,-0.0163,0.0216,0.0454,0.012,0.0026,-0.0069,-0.0009,-0.0178,0.014,-0.0298,0.0487,0.0317,0.0137,-0.0175,0.017,-0.0249,0.0013,-0.0113,-0.0061,-0.038,-0.0102,0.0032,0.0027,0.0691,0.0208,0.006,0.016,-0.005,-0.023,0.0059,-0.0216,0.0411,-0.0039,-0.0377,-0.023,-0.0093,0.0236,0.0141,-0.0119,0.0081,0.0206,-0.0192,0.0058,0.0282,0.0066,-0.0214,-0.0085,-0.0065,0.0169,-0.0023,0.0314,-0.0017,0.0081,0.0302,0.027,0.0727,0.0537,0.0662,-0.0045,-0.0084,0.0207,0.0555,0.037,0.0416,0.0366,0.0542,-0.0042,-0.0044,-0.0064,-0.0116,-0.0211,0.0097,-0.0017,-0.0089,-0.0165,-0.0361,0.0214,-0.0417,-0.0192,0.0231,0.0053,-0.0166,-0.0049,-0.0072,0.0163,-0.0268,0.0069,0.0035,-0.0049,-0.0192,0.0107,0.0092,0.0113,-0.0124,0.0179,-0.0088,0.0365,0.0005,0.0224,0.0511,0.0374,-0.0079,0.0086,-0.016,-0.0267,-0.0227,-0.0367,0.0012,-0.0008,0.001,0.0018,0.0131,0.0047,-0.0095,0.0242,0.0335,0.022,-0.0131,-0.0092,0.0367,0.0148,0.0337,0.0558,0.0261,-0.0143,-0.0096,-0.0255,-0.0207,-0.0227,0.0409,0.0144,0.0069,0.0254,0.0109,0.0094,-0.0022,0.0045,-0.0187,-0.0067,0.0261,0.0157,-0.0029,0.0365,-0.012,0.0248,0.0011,-0.0671,-0.077,0.0043,-0.0198,0.019,-0.0105,-0.0075,0.0176,0.0412,0.0651,-0.0286,0.0053,-0.0073,0.0341,-0.008,-0.0123,0.0077,0.023,0.0238,0.0327,0.0249,0.0486,0.0122,-0.0393,0.0157,0.0011,0.0299,-0.0577,-0.036,-0.0323,0.0022,0.0136,0.0087,-0.0132,-0.0459,0.0168,0.0337,0.0318,0.0242,0.0097,0.0147,-0.0185,0.0049,0.0188,0.0157,0.0124,0.0406,-0.0041,-0.0198,-0.0241,-0.0179,-0.0169,0.021,-0.0124,0.0399,-0.0094,0.0237,0.0187,-0.0747,-0.065,-0.0727,-0.0469,-0.0517,-0.0304,-0.0573,-0.0342,0.025,-0.0403,-0.0507,-0.0243,-0.0009,-0.0287,0.0148,0.0023,0.0162,0.0387,-0.0308,0.0043,-0.0306,-0.0331,0.0324,-0.0346,-0.0313,-0.0142,-0.0416,-0.006,0.0253,-0.0105,-0.0011,0.0209,-0.0073,0.0024,-0.0177,-0.0036,-0.0565,0.0307,0.0563,0.0458,0.0322,0.0181,-0.0098,-0.0186,0.001,0.023,0.0357,0.0412,0.0206,-0.0483,0.0044,-0.0629,-0.0594,0.0251,-0.0048,-0.0195,-0.067,-0.0734,-0.0451,-0.0484,-0.0234,0.0019,-0.0162,-0.0151,-0.0026,0.028,-0.0162,-0.0064,-0.0371,0.0147,0.0175,0.0027,0.041,0.0233,0.0056,0.0086,0.0078,-0.0332,-0.0061,0.0061,-0.0113,0.0139,0.0122,-0.0518,-0.0321,0.0293,0.0255,0.0203,0.0104,-0.0219,-0.0034,0.0193,0.0063,0.0111,-0.018,-0.0188,-0.0433,-0.0555,0.0172,-0.0107,0.0355,0.0079,-0.0152,-0.0076,0.0224,-0.0146,-0.0389,0.004,0.0271,-0.0192,-0.0301,0.0366,0.0197,-0.0042,0.0588,0.0427,0.0845,0.0004,-0.0259,0.0148,0.0311,-0.0449,0.0147,0.0141,0.0116,0.019,0.0127,0.0343,0.006,0.0089,-0.0202,-0.0581,-0.0448,-0.0625,-0.0396,0.0476,0.0223,0.0328,0.0617,0.0391,-0.0149,-0.0221,-0.0435,0.0367,0.0168,-0.0291,-0.03,0.0059,-0.0143,-0.0098,0.0008,-0.0159,-0.0432,0.0172,0.0215,0.0052,-0.0329,-0.0178,0.0163,-0.0129,-0.0129,0.0185,0.0162,0.0376,0.0028,-0.0147,-0.013,0.0172,-0.0785,0.0393,0.041,0.0047,-0.0021,0.0259,0.0331,0.0264,-0.0087,-0.0098,0.042,-0.0074,0.0069,-0.0597,-0.0123,-0.0313,0.0011,-0.0073,-0.0192,-0.0105,-0.0004,0.0172,0.0243,0.0167,0.0078,0.0122,0.0197,-0.0227,-0.0173,0.0051,-0.0668,-0.0256,-0.0632,-0.0052,-0.0696,0.0429,0.0239,-0.0372,0.0479,-0.0393,0.0478,0.0389,0.014,0.018,0.048,-0.0245,-0.0026,0.0503,-0.0167,-0.0067,0.0008,0.0299,-0.0037,0.0233,-0.0068,0.0166,0.0054,0.0254,-0.0603,-0.0595,-0.0487,-0.0389,-0.0159,-0.0106,0.0023,0.0081,0.0077,-0.0105,0.0186,0.0106,0.0316,0.0076,0.0006,0.0081,-0.0092,0.011,0.0229,-0.0137,-0.01,-0.0317,0.0168,0.0237,-0.0194,-0.0063,0.0069,0.0272,0.041,0.0372,-0.0069,0.0546,0.0579,0.0097,0.0103,-0.0401,-0.0255,-0.0092,0.0331,0.0281,-0.0196,0.0144,0.0105,0.0026,-0.024,-0.0297,0.0493,-0.0001,-0.0344,0.0288,-0.0004,0.0068,0.0099,-0.0227,-0.007,-0.024,-0.014,0.0517,-0.0312,-0.013,-0.0345,-0.0385,-0.0399,-0.0322,0.0022,-0.0004,-0.0504,0.023,-0.0015,0.0295,0.0079,0.0253,0.0206,0.0191,-0.0242,0.006,0.0199,0.0444,0.0127,0.0062,0.0059,0.0058,0.0258,0.0087,-0.0011,0.0049,-0.0319,0.0144,-0.0103,0.0143,0.0409,0.0293,0.0368,0.0149,0.0143,-0.0184,0.0126,-0.037,0.0204,0.0306,0.0067,0.0043,0.0009,0.0307,0.053,-0.0252,-0.0197,-0.0401,-0.0026,0.0009,-0.0039,-0.0338,-0.0053,0.0028,0.0227,0.0358,-0.0074,0.0698,0.0112,-0.0263,-0.001,0.0205,0.0163,0.0193,0.0188,0.0298,-0.0327,-0.022,0.0039,-0.0378,-0.0256,0.0052,-0.0207,-0.011,-0.0075,0.0206,0.0026,-0.0471,0.0041,0.0061,0.0068,0.0128,0.009,0.0159,-0.0117,-0.0044,-0.0307,-0.0603,-0.0715,0.0238,0.0099,0.0277,-0.0222,-0.0127,-0.0132,0.0276,0.006,-0.019,0.0055,-0.0056,-0.0108,-0.0233,-0.0359,-0.0103,-0.0482,-0.0172,0.028,0.0269,0.0039,0.0234,0.0251,0.033,0.0065,0.0289,0.0237,-0.0234,0.0117,0.0062,0.0169,0.0181,-0.0246,-0.0485,0.0103,-0.0012,-0.0086,0.0269,0.0312,0.0324,0.0046,-0.0028,-0.0088,-0.0357,-0.0048,-0.0297,0.0121,0.0255,-0.0022,-0.0835,-0.0831,0.0335,0.0515,-0.0455,0.0082,-0.0169,-0.0036,0.0393,-0.0362,0.0168,0.0186,0.0181,-0.0164,-0.0369,0.0219,-0.0386,-0.0031,0.024,-0.0227,-0.0765,-0.0323,0.0144,-0.062,0.014,-0.0104,-0.0392,0.0126,0.0352,-0.032,-0.0003,0.0013,-0.0001,0.0163,0.002,0.0255,0.0016,0.0486,0.0135,0.0343,-0.0094,0.0491,0.0124,-0.0016,0.0046,0.0227,0.0094,-0.0049,0.0283,0.036,-0.022,0.0055,-0.0169,0.0073,-0.0111,-0.0124,0.0255,0.0279,-0.0162,-0.0096,-0.0196,0.0005,-0.038,-0.0391,-0.0004,-0.0253,-0.0016,0.0013,-0.0785,0.0511,0.0443,0.0187,0.0235,-0.0135,-0.022,-0.0406,0.0185,-0.0196,-0.0114,0.0197,-0.0214,-0.0009,0.0301,-0.0185,-0.0056,-0.0464,-0.0413,-0.0479,-0.0467,-0.0546,0.0111,0.0124,0.028,0.0083,-0.0235,-0.0154,0.0258,-0.0248,-0.0251,0.0117,-0.0345,-0.0221,0.0532,0.043,0.0294,-0.0049,-0.0243,-0.0264,-0.0253,-0.0289,-0.0096,-0.0138,0.0186,0.0387,0.0016,0.0058,-0.0089,0.0015,0.0197,0.0058,-0.0251,0.0127,0.0266,-0.0348,0.0241,0.0418,-0.0089,-0.041,-0.0132,-0.0341,-0.0026,-0.0229,-0.0374,-0.0152,-0.0345,-0.0576,-0.0298,-0.0061,0.0038,-0.0013,-0.0249,0.0127,-0.0172,0.0468,0.0394,0.0089,0.0284,0.0248,-0.0084,-0.009,-0.0271,0.011,-0.0184,-0.0156,-0.048,0.0054,0.0443,-0.0002,-0.0012,-0.0132,0.0137,-0.0131,-0.0024,-0.0182,0.0607,0.04,0.0442,0.018,0.0107,0.047,0.0023,0.0231,0.0208,0.0006,-0.0093,0.0091,-0.0341,0.0008,0.009,-0.0339,0.0164,0.0103,-0.02,-0.0444,0.0357,-0.006,0.0571,0.0196,0.0267,-0.015,-0.0197,-0.042,0.0013,-0.0087,-0.0142,-0.0102,0.0419,0.0125,0.0363,0.0174,0.0151,-0.0033,-0.0032,0.024,0.038,0.0234,0.0036,0.0071,-0.0014,-0.0301,0.015,-0.0069,-0.008,0.0126,0.0191,0.0156,0.0038,-0.0095,0.0016,0.1041,0.043,0.0267,0.0821,0.1183,-0.0322,0.0217,-0.0205,0.0456,0.0065,-0.004,-0.0134,0.0454,0.001,0.0458,0.0087,-0.002,-0.043,-0.0119,-0.0119,0.0603,0.0032,-0.0009,-0.0285,0.0103,0.0078,0.0494,-0.0129,0.0606,0.0765,0.0472,-0.0019,0.0284,0.0278,0.0078,0.036,0.0047,0.0248,0.0192,0.0208,0.0677,-0.0078,0.0174,0.0066,0.0184,0.002,0.0196,0.0406,0.006,-0.0016,-0.0289,-0.01,0.0243,0.0575,-0.0022,0.033,-0.0137,0.0673,0.0395,0.0243,-0.0509,-0.0253,0.0359,0.0154,-0.0077,-0.0668,-0.046,-0.0421,0.1103,0.1002,-0.0022,-0.0305,0.0095,-0.0014,-0.0208,0.0203,0.0208,-0.0009,0.0095,0.0248,-0.0004,-0.0048,0.0574,-0.0045,0.0595,-0.0098,0.031,-0.0048,-0.0398,-0.0772,0.0087,0.0683,0.0544,0.0238,0.0136,0.0307,0.0187,-0.0608,0.0128,0.0142,-0.0673,-0.033,-0.0311,-0.0594,-0.0114,-0.0336,-0.0309,-0.0282,-0.0364,-0.0403,-0.0479,-0.034,-0.0507,-0.072,-0.0678,0.0992,-0.0221,-0.0437,-0.0424,-0.0198,0.0419,-0.0298,-0.0131,-0.0183,-0.0532,-0.0842,0.0,-0.0004,-0.0049,0.0016,-0.0088,-0.0494,0.017,-0.0015,-0.0579,-0.032,-0.0285,-0.0274,-0.0014,-0.0174,-0.0521,-0.0208,0.0173,0.0011,-0.0034,0.085,0.0391,0.0387,0.0262,0.0204,0.0508,0.0474,0.0331,0.0072,0.0229,0.009,-0.0298,0.0185,0.0455,0.0869,-0.0394,0.0291,0.0042,0.0045,0.0134,-0.0389,0.0522,0.0393,0.0245,0.001,0.008,0.0019,0.0063,-0.0263,-0.0372,-0.0548,-0.0172,0.0307,-0.0001,0.0071,0.0438,0.0161,0.0128,-0.01,-0.025,0.0147,0.0227,0.0072,0.0229,0.0175,-0.0079,-0.0335,-0.0044,0.0182,0.0189,-0.0051,0.0106,-0.0141,0.0272,0.0152,-0.0114,0.0152,0.0055,-0.014,-0.027,0.0071,-0.0093,0.0171,0.0322,-0.0043,-0.033,-0.0366,-0.0118,-0.0816,-0.0367,0.0199,0.0079,-0.0843,-0.0635,-0.0197,-0.0191,-0.0519,-0.0454,0.0419,0.0412,0.0286,0.0124,-0.0788,-0.0691,-0.044,0.0038,-0.0166,-0.0286,-0.0699,-0.0737,-0.073,-0.0489,-0.0087,0.0214,-0.0128,-0.005,-0.0254,0.0561,0.0237,0.0006,0.0191,0.0256,0.0291,-0.0177,0.0213,0.0103,0.0052,-0.0266,-0.0226,-0.0343,-0.0118,-0.0072,-0.0246,0.0256,0.0039,0.0125,0.0146,0.0091,0.0467,-0.0155,0.042,0.0684,0.0676,-0.0306,-0.0044,0.0065,-0.0362,-0.0179,-0.0248,-0.0248,-0.0135,-0.0277,0.0083,0.0718,0.0739,-0.0342,-0.0126,-0.0055,-0.0381,-0.0116,-0.0434,-0.0455,0.0288,0.0253,0.0074,0.0085,-0.053,0.0029,-0.0215,-0.0134,-0.0006,-0.0126,-0.0129,-0.0101,-0.0195,0.0046,0.0114,-0.0025,0.018,0.0307,0.0359,-0.0035,0.0017,0.0062,-0.0152,-0.037,-0.0252,-0.0665,-0.0557,-0.0089,-0.0463,0.0183,-0.0361,-0.0255,-0.0386,-0.0699,-0.0268,-0.0159,-0.0079,0.0054,-0.0459,-0.0409,0.0004,0.0001,-0.0033,-0.0072,0.0171,-0.0062,0.0116,-0.0146,-0.0079,0.0042,0.0,-0.0041,-0.069,-0.0131,-0.0458,-0.0333,0.0434,0.0477,0.0183,0.0314,0.0481,-0.0218,-0.0005,0.0108,0.006,-0.0305,0.0118,0.081,0.0029,0.0017,0.0437,-0.0205,-0.0136,-0.027,-0.026,-0.0759,-0.0774,-0.0592,-0.0269,0.0254,-0.0056,-0.0232,0.0407,0.0081,0.0215,0.007,0.0327,-0.0285,-0.0033,0.0,0.0418,0.0648,0.0708,0.0422,0.0228,0.0092,0.0034,0.0284,0.0037,-0.0145,-0.0289,-0.007,-0.0159,-0.0115,-0.027,0.0291,-0.0329,-0.014,-0.0158,0.0089,-0.0181,-0.0281,0.012,-0.0092,-0.0439,-0.0197,-0.0173,0.0082,0.018,-0.0054,-0.0034,0.0065,0.0029,0.0104,-0.0058,-0.0165,0.0369,-0.0245,0.0018,0.0061,-0.0018,0.0527,0.0186,0.0119,0.0108,0.0112,0.0096,0.0271,0.0356,-0.0283,-0.0121,-0.0152,0.0935,0.0447,0.0209,0.0735,0.0462,0.044,0.0275,0.0275,0.0168,0.0031,-0.0096,0.0242,-0.0077,-0.0154,-0.0022,0.0038,0.0184,0.1058,-0.0325,0.0173,0.0143,-0.004,-0.0546,-0.0329,-0.0065,0.0378,0.0065,-0.0175,-0.0164,0.0018,-0.0502,-0.0222,-0.0325,-0.0455,-0.023,0.0136,-0.0103,-0.0454,-0.0255,-0.0289,0.0496,0.036,0.0129,0.0138,0.0188,0.0279,0.0218,-0.0202,0.0192,0.0455,-0.0377,0.0148,0.0837,-0.0357,0.0115,0.0887,0.0265,0.1052,0.003,-0.0041,-0.0353,0.0178,-0.0796,-0.0779,-0.0215,-0.0461,-0.0207,0.0136,-0.0531,-0.0004,-0.0575,0.0088,0.0231,-0.0553,0.0044,-0.045,-0.0057,-0.0036,-0.0111,0.0471,0.0029,-0.0079,-0.0048,-0.0497,0.0005,-0.03,-0.0343,-0.0264,-0.0199,-0.0438,-0.0517,-0.0221,0.0006,-0.0252,0.0177,-0.0186,0.006,0.0397,0.0482,0.0222,-0.0119,-0.0109,0.0263,0.0082,0.0054,-0.0277,-0.0037,-0.0247,0.0095,0.0279,-0.0231,-0.0179,-0.0273,0.015,-0.022,-0.0365,0.0069,-0.0001,0.0064,0.0005,0.0197,-0.0174,-0.0135,0.0257,-0.0397,-0.0149,-0.0366,0.0052,-0.0033,-0.0143,-0.0084,0.029,0.0323,0.0305,0.0323,-0.0262,-0.0026,0.0076,0.0407,0.0243,-0.0248,-0.0012,0.0556,0.0405,0.0374,0.0238,-0.0251,0.0255,0.0138,0.0202,-0.0051,0.0462,0.0073,0.0263,0.0013,0.0098,-0.0055,-0.0443,0.0194,0.025,0.0188,-0.0148,-0.0026,0.0305,-0.0437,-0.0338,0.0276,0.001,0.0119,0.0219,-0.0306,-0.0227,-0.0216,-0.0024,0.0051,0.0338,0.0074,0.0285,0.0586,-0.004,0.0319,-0.0019,-0.0361,-0.0443,-0.0408,-0.0337,0.0428,0.0273,0.0031,-0.0054,-0.0412,-0.0107,0.0077,0.0185,0.0127,0.0504,0.045,0.03,0.0281,0.0164,-0.0142,0.01,0.0182,-0.039,-0.0052,-0.0236,-0.0148,-0.0046,-0.0137,0.0192,-0.0072,0.0203,-0.0404,0.0132,-0.0005,-0.0079,-0.0218,0.0033,0.016,0.0081,0.0168,-0.0233,0.053,0.0879,0.015,0.0058,0.0103,0.0132,-0.0179,0.0021,0.0126,0.0258,-0.0039,0.0323,0.0202,0.0106,0.0612,0.0206,0.0516,0.0331,0.074,0.0276,-0.0236,-0.0491,0.0582,0.0221,0.0292,-0.0112,-0.0056,0.0339,0.0136,0.0389,0.0149,0.022,-0.0148,-0.0115,0.0269,-0.0178,0.0179,0.0066,-0.0027,-0.0043,-0.0212,0.0398,0.038,0.0028,-0.0091,-0.0011,-0.0208,0.0196,-0.0017,-0.0349,-0.0134,-0.0155,-0.0156,-0.0396,-0.017,-0.0327,0.005,0.0077,0.0555,-0.0022,-0.0136,-0.0365,-0.0414,-0.0267,0.0021,-0.0143,-0.0049,-0.0441,-0.028,-0.0192,0.0036,0.0621,0.0212,0.0011,-0.0518,-0.0005,0.0008,-0.0175,-0.0029,-0.0254,-0.0166,0.024,0.0052,0.0041,0.0168,0.0211,-0.0264,-0.0102,0.0138,-0.0126,-0.0368,0.0084,0.0086,-0.0089,-0.0323,-0.002,-0.0406,0.0006,-0.0565,-0.0024,-0.0161,-0.0148,-0.0136,0.0543,0.1017,0.099,-0.0423,-0.0218,-0.0005,-0.0138,-0.0191,0.0274,0.0497,0.0495,0.0567,0.0003,-0.0155,-0.0065,0.0437,0.0128,0.0059,0.0599,0.0237,0.0448,0.0829,-0.027,-0.0007,-0.0102,0.0598,0.0345,0.0045,-0.0001,0.0045,0.0082,0.0158,0.0013,0.0267,-0.0286,0.0439,-0.0118,0.012,0.0054,0.0119,-0.015,-0.0412,-0.0505,-0.0381,0.0323,0.0312,0.0152,0.0155,0.0409,0.0142,0.0181,0.0547,0.0295,-0.01,-0.0061,-0.0146,0.0242,0.0072,0.0241,0.0288,0.0033,-0.0167,0.0446,0.0416,-0.04,0.0371,0.0452,-0.0306,-0.0321,-0.0026,0.0076,-0.0163,-0.0195,-0.0441,-0.046,0.0519,0.0391,0.0316,0.0139,-0.0345,-0.0134,-0.005,-0.0002,0.0201,-0.0145,-0.0703,-0.0148,-0.0204,-0.0653,0.0785,0.0852,0.0411,0.0256,0.0062,0.0146,0.051,0.0085,0.0005,-0.0217,-0.0091,0.0107,-0.0183,0.0358,-0.048,-0.0263,-0.0713,-0.058,-0.0319,-0.0303,0.017,0.0161,0.0187,-0.011,-0.0408,-0.05,-0.0357,-0.0129,-0.056,-0.0287,-0.0601,-0.0408,0.0063,0.0234,0.0063,-0.0107,-0.0239,0.0228,0.0092,-0.0008,-0.0042,-0.0284,-0.0244,0.0329,0.0079,0.0518,0.0352,0.0152,0.0261,-0.0501,0.0157,-0.049,-0.037,-0.0171,-0.015,-0.0133,-0.0063,0.0063,-0.0175,-0.0358,-0.0336,-0.0395,-0.0018,-0.0229,-0.0078,-0.0081,-0.0198,-0.0469,-0.0316,-0.0357,-0.0019,0.0088,-0.0298,-0.0067,-0.0049,-0.018,-0.0072,0.0216,0.0003,-0.03,-0.016,0.0396,-0.0067,-0.0166,-0.0335,-0.0009,0.0024,-0.0068,-0.0159,0.0012,-0.0372,-0.0577,-0.0253,-0.0354,-0.0203,-0.0508,-0.0002,0.0425,-0.0086,-0.0203,-0.0432,-0.0338,-0.0225,0.0037,0.0089,0.0136,-0.0264,-0.0616,0.0129,-0.0024,0.0538,0.07,0.0591,0.0385,0.0525,0.0289,0.0502,0.0085,0.0029,0.0257,-0.0468,-0.0431,-0.0342,-0.0037,-0.0362,-0.0073,0.0312,-0.038,-0.0311,-0.0098,0.0067,-0.057,-0.0493,-0.0337,0.0108,-0.0501,-0.0205,-0.006,-0.0212,-0.0148,0.0193,-0.0392,-0.017,0.0156,0.0141,0.0084,-0.0203,0.0004,0.0144,-0.005,0.0236,-0.0163,-0.0169,-0.0224,-0.0004,-0.0352,0.0326,-0.0124,-0.0455,-0.0152,0.0503,-0.0068,-0.0303,-0.0156,0.0057,0.028,0.1038,0.0814,0.0466,0.0727,-0.0458,0.0107,0.0283,0.0061,-0.0174,-0.033,-0.0555,-0.0449,-0.0553,-0.0608,-0.065,-0.0365,-0.0482,-0.0029,-0.0134,-0.0217,0.0144,-0.0041,-0.016,0.0114,-0.07,-0.0416,0.013,0.0637,0.0481,0.018,0.0471,0.0427,-0.0097,-0.0287,-0.0122,-0.0178,-0.0095,-0.0117,0.0185,-0.0079,0.0192,-0.0054,0.0245,0.0191,-0.0244,-0.0214,-0.0005,0.0073,0.0155,-0.0068,0.0062,0.0502,-0.0235,0.0512,-0.0021,0.0133,0.009,0.0027,0.0263,-0.0012,0.0108,0.0066,0.0104,0.0192,0.0081,-0.067,-0.0238,-0.0035,0.0175,-0.0515,-0.003,0.0135,-0.0063,-0.033,-0.0025,0.0276,0.0058,0.0022,-0.0104,0.0256,-0.0255,-0.0825,-0.0745,-0.0025,-0.018,0.0201,-0.0526,-0.0166,-0.0574,0.0109,-0.0759,-0.0119,-0.0643,-0.0609,-0.0136,0.0021,0.0045,0.0168,0.0104,-0.0196,-0.0185,-0.0494,0.0092,-0.0076,0.0463,-0.0159,-0.0341,-0.0262,0.0456,0.0388,0.0683,0.0004,0.0213,0.0115,0.0468,-0.0285,0.0182,0.0074,0.0043,0.011,-0.0916,-0.0065,0.0257,-0.0375,-0.0405,-0.0104,0.0187,-0.0299,-0.0446,-0.0322,-0.0397,-0.0072,0.0238,-0.0075,-0.0484,-0.0193,0.0391,-0.0581,-0.0134,-0.0138,-0.0066,-0.0581,0.0057,0.0394,0.03,0.0065,0.004,-0.0171,0.0275,-0.0152,0.0011,0.0004,-0.0007,0.0357,-0.0044,-0.0169,0.0247,0.0457,-0.0117,-0.0173,0.0209,-0.0061,0.0067,0.0166,0.0322,-0.0001,0.0211,0.0238,0.0129,-0.026,-0.0375,0.0198,-0.0214,0.0203,-0.0063,-0.0161,0.0032,0.0204,-0.0055,0.0295,-0.0048,0.0522,0.0504,0.0009,0.0205,0.0256,0.0538,0.0099,0.0243,0.0454,0.0681,0.026,0.0211,-0.021,-0.0086,-0.0269,0.0185,-0.0159,0.0219,-0.0243,-0.0602,-0.0372,0.012,-0.055,0.0458,0.0311,0.001,-0.0219,-0.0065,0.0224,-0.0347,-0.0345,0.0062,0.0287,-0.0786,0.0389,0.0123,-0.0439,0.0071,-0.0056,0.0103,-0.0459,-0.0128,-0.0523,-0.0341,0.062,0.0502,-0.0372,-0.048,-0.0142,-0.0258,0.0035,0.0077,0.032,0.0487,0.001,0.0471,0.0581,0.0152,0.0505,-0.0166,-0.0037,-0.0199,-0.0397,-0.0384,0.0066,-0.0256,0.0224,-0.0152,-0.0102,0.0042,0.0046,-0.0091,0.0153,-0.0062,0.0191,0.0237,0.0308,0.0229,0.017,0.0389,0.0268,0.0012,0.0087,0.0374,0.0479,-0.0018,0.0019,-0.0287,-0.0165,-0.0468,0.0146,-0.0047,-0.0141,-0.0286,-0.0048,0.0159,0.038,0.0013,-0.0403,-0.0152,-0.0327,-0.0047,0.0017,0.0086,0.0236,-0.0126,0.0059,-0.028,-0.0236,0.0534,0.0253,0.0151,0.0359,-0.0088,0.0195,-0.06,-0.0629,0.0669,0.0025,0.0439,0.0198,0.0216,0.065,0.0559,0.0278,-0.0378,0.0238,0.0033,-0.0113,0.0464,0.0331,-0.0308,-0.0046,-0.0144,-0.0029,0.0017,-0.0118,0.0244,-0.0033,0.0129,0.053,0.0045,0.0879,-0.0732,0.0702,-0.0573,-0.0132,-0.0064,0.1238,0.1256,-0.0109,-0.0241,-0.0086,-0.03,-0.0115,-0.0327,-0.0002,0.0066,-0.0138,-0.0331,-0.0351,-0.0303,-0.0105,-0.0238,-0.046,0.0179,-0.0036,-0.0596,-0.1035,-0.0608,-0.0413,-0.0876,-0.0416,-0.0378,-0.0557,-0.031,-0.034,-0.0629,-0.0334,-0.0423,-0.0227,-0.0604,-0.0139,-0.082,-0.049,-0.049,-0.0604,-0.0268,0.0197,0.0138,0.1294,-0.0186,-0.0112,0.0312,0.0125,0.0082,-0.0387,-0.0267,0.0257,0.0284,0.0099,-0.0267,0.0093,0.0425,-0.0456,0.0399,0.0179,0.0087,0.034,0.0204,0.0014,0.0007,0.0038,-0.0179,0.0241,0.0303,-0.0395,0.0205,-0.0137,0.0095,0.007,-0.0027,-0.0161,0.005,0.0338,-0.0144,-0.0118,0.014,-0.0131,-0.0036,0.0202,-0.0344,-0.0344,0.0214,0.0198,-0.0155,0.0153,-0.0048,0.0148,0.0075,-0.0371,0.021,0.019,0.0127,0.011,0.0368,0.0036,emotion
trm_557b49206928b,0.0713,0.0565,0.0491,0.0702,-0.001,0.004,0.0159,0.0252,0.0085,0.0536,0.0293,0.0194,0.0501,0.0039,0.0586,0.0615,0.0509,0.0298,0.0337,0.0017,0.0431,-0.0105,0.003,-0.0269,0.0178,0.0044,0.001,0.0422,0.0776,0.031,0.0472,0.0319,0.0404,0.0475,0.0364,0.0378,0.0139,0.0093,0.0677,0.0285,0.0416,0.038,0.0289,-0.0418,0.061,0.0431,-0.0829,0.0582,0.0119,0.0575,0.0217,-0.0118,-0.0229,0.0261,0.0229,0.027,0.0546,-0.0172,-0.0041,0.0108,-0.0019,-0.0382,0.0873,-0.057,0.0124,-0.0077,0.0876,0.099,0.0779,0.0131,0.0035,-0.0075,-0.0748,0.0249,0.0925,-0.0561,0.0573,-0.0218,-0.0296,0.025,-0.0492,-0.0301,-0.0063,0.0459,-0.0094,-0.0089,0.0213,-0.005,-0.0194,0.0944,0.0258,0.0154,-0.003,-0.0326,-0.0613,-0.0352,-0.0433,-0.0041,-0.0613,-0.0055,0.0066,-0.0228,-0.0209,0.0079,-0.0108,0.0558,0.0532,-0.0963,0.0329,0.047,0.0236,0.0494,-0.0336,-0.0514,0.0022,0.0201,0.0335,0.0121,0.0063,0.0412,0.0472,0.0563,0.0159,-0.005,0.0239,0.0389,0.0578,0.0022,-0.0341,-0.0532,-0.0455,0.0139,-0.0067,0.0646,0.0002,0.0636,0.0212,0.0249,0.014,-0.0165,0.0521,0.0498,-0.0316,0.0012,0.0261,0.0145,0.0533,0.0256,0.0295,-0.0713,0.0254,0.0338,0.0344,0.0673,-0.0294,0.021,-0.0269,0.0053,-0.0024,0.0303,0.0496,0.0447,0.0765,0.1079,-0.0068,0.0055,-0.0154,0.0575,0.0548,-0.001,-0.0068,0.0547,-0.0193,0.0072,0.0319,0.0296,0.0396,0.0323,0.0113,0.0243,0.063,-0.0597,0.0094,-0.0154,0.0157,0.0021,0.0394,-0.0155,-0.0393,0.0662,0.0638,0.0361,-0.0118,0.075,0.0642,0.1382,0.1249,-0.0072,0.0202,0.0807,0.0286,-0.0241,0.0576,0.062,0.0366,0.0036,-0.0202,0.0353,0.0444,0.0255,0.041,0.0254,0.0024,-0.0363,-0.0529,-0.0422,-0.0915,0.0657,0.0715,-0.0264,-0.0141,0.0405,0.0201,0.0091,0.0171,-0.0092,0.0766,-0.0638,-0.0325,-0.004,0.0283,0.0282,-0.0919,0.0787,0.0763,0.001,-0.0319,0.0059,-0.0166,0.0011,0.0287,0.0647,0.0336,-0.0026,0.0367,0.0036,0.0367,0.0579,0.0143,-0.0001,-0.032,-0.0261,0.0121,-0.0314,0.0214,0.0616,0.0159,0.0474,-0.0442,-0.1528,0.0114,-0.0635,0.0321,-0.0076,-0.0514,-0.1038,-0.0178,0.003,-0.0339,0.0118,0.0401,0.0109,0.0263,-0.0486,0.0417,-0.0543,0.0642,0.0688,0.0702,0.0317,-0.0235,-0.026,-0.0363,0.0526,0.0495,0.0231,-0.0504,-0.0462,0.0554,0.0397,0.0408,0.0348,0.008,0.027,0.0523,0.0233,-0.0306,0.0153,0.0268,-0.004,-0.033,0.0445,0.0677,0.0366,0.0515,0.0505,0.0605,-0.0233,-0.0045,-0.0038,0.0213,-0.0046,0.0891,-0.0145,-0.0277,0.0636,-0.0258,-0.0667,-0.04,0.0855,0.0027,-0.0333,0.0256,0.0462,0.0143,0.0507,0.0164,0.0294,0.0247,0.0505,-0.0087,0.0338,-0.0014,-0.013,-0.0514,-0.0268,-0.0631,0.0036,-0.0478,0.0418,0.0362,-0.0244,0.0194,0.0281,-0.0318,0.0017,0.0939,0.0518,0.0736,0.0424,0.0381,-0.0423,0.0446,-0.0122,0.0357,0.0397,0.0336,0.0205,0.0693,0.0417,-0.0146,0.0268,0.0112,0.0259,0.038,-0.0381,0.0481,-0.0082,-0.02,0.0619,-0.0068,-0.0194,0.0211,-0.0664,0.0611,0.0358,0.0441,-0.0784,-0.1506,-0.0673,-0.1932,0.0321,0.0783,0.0419,-0.008,-0.0061,0.0196,-0.0236,-0.0119,0.0291,0.0208,0.0209,0.0438,0.026,-0.0216,0.0048,0.0416,0.0415,0.034,0.0591,0.0105,-0.0169,0.0198,0.0362,-0.0333,-0.0298,-0.0513,0.0196,0.0523,0.0165,0.0665,0.0478,0.0594,-0.1076,0.0171,0.0013,-0.1268,0.0311,0.0835,0.0161,0.006,0.0964,0.0718,0.1765,0.1556,0.0661,0.0788,0.059,0.0519,0.0901,-0.0184,-0.0428,-0.0228,0.0058,-0.0256,-0.0301,-0.0062,0.0066,0.1182,0.0713,0.0074,-0.0455,0.0311,-0.0425,0.0152,0.0218,-0.0318,-0.0383,0.0243,0.0669,0.0444,-0.0086,0.0632,0.0687,0.0032,0.0652,-0.0663,0.0441,0.0165,-0.0,-0.016,0.0377,0.0006,-0.031,0.0388,0.0537,-0.0042,-0.1494,0.0545,0.0233,-0.0347,-0.0446,0.0163,0.0064,-0.0191,0.0364,-0.0063,0.0146,-0.0252,0.0095,-0.0226,-0.0168,0.0252,-0.0403,-0.0341,-0.1,0.0281,0.0254,0.0246,0.0285,-0.0637,-0.0285,0.0723,0.0609,-0.0244,-0.0319,0.0377,0.02,0.0224,0.0533,0.0562,-0.0205,0.0536,0.0616,0.0781,0.0106,-0.0133,-0.0265,0.0112,-0.0307,0.0813,0.0022,0.0021,0.0057,-0.0094,0.0116,0.0413,0.0447,-0.0122,0.0342,0.0774,0.0404,-0.0153,0.0095,-0.0417,-0.0356,-0.04,-0.0596,-0.0544,-0.0296,0.0336,0.0028,0.021,0.0828,-0.0154,-0.0091,0.0416,0.0684,0.0354,0.0312,-0.0044,-0.0427,-0.0121,0.0164,0.0162,0.0273,0.0005,-0.0279,-0.0256,0.0098,-0.059,0.0046,0.0398,0.0382,0.0086,0.0537,-0.049,-0.027,-0.0626,0.043,0.0254,0.0133,0.0354,-0.0204,0.012,-0.0529,-0.0442,-0.0158,0.0085,0.0118,0.0432,-0.0045,0.0667,-0.0011,-0.0088,-0.0116,-0.0466,0.0171,-0.0088,-0.0564,0.0152,0.0532,0.0025,0.0296,0.0131,0.0047,0.1003,-0.0024,-0.0114,0.0371,0.0539,0.0328,0.0204,0.007,0.0533,0.0423,0.0865,0.0178,-0.0793,0.0198,-0.0153,-0.0257,-0.0202,-0.0579,-0.0013,-0.01,-0.031,0.0591,0.0619,0.0215,0.0677,0.0204,-0.0127,-0.0009,0.1154,0.0214,0.0411,-0.0152,0.0189,0.0991,0.0508,0.1171,-0.047,-0.021,-0.0015,-0.0586,0.0791,0.0376,0.0461,0.003,-0.0212,-0.0029,0.0448,0.0014,0.0736,-0.0088,0.0145,0.0652,0.0,0.06,0.0513,-0.0263,-0.0023,0.0186,0.0642,0.0399,0.0505,0.0285,-0.0278,0.0803,0.0237,0.0342,-0.0005,0.0558,-0.0002,0.0576,0.0061,0.0265,0.0006,0.0495,0.0353,-0.0021,-0.0557,0.0204,0.0072,-0.0049,0.0657,0.054,0.0439,0.009,0.0206,0.0158,0.017,0.0444,0.0036,0.0311,-0.1028,0.0492,0.0185,-0.0001,0.0062,-0.0055,-0.006,0.03,-0.0286,0.0726,0.0319,0.0023,0.0022,0.0198,0.0002,0.0029,0.0015,0.0172,0.0076,0.0064,-0.0264,-0.0104,0.0149,0.0101,0.0083,0.0248,-0.0007,0.0304,0.0098,0.0138,0.0663,0.0532,0.0791,-0.0091,-0.0548,-0.0287,0.0187,-0.0785,-0.0455,0.01,0.0264,-0.0276,0.0231,-0.015,-0.069,-0.0048,0.1022,0.1046,0.0583,0.0283,0.0096,0.0368,-0.0215,0.0037,-0.0948,-0.0389,0.0329,-0.0087,-0.0192,0.0139,0.0979,-0.0794,-0.0679,-0.0623,0.038,0.0081,0.0384,-0.0017,-0.0268,0.0598,-0.0287,-0.0588,0.0381,-0.0023,-0.0342,-0.0502,0.0336,0.0766,0.0704,0.0489,-0.0139,-0.0743,0.0043,0.0384,0.0004,0.0187,-0.0042,-0.0175,-0.0055,-0.0159,0.0178,0.0477,0.0437,-0.0296,-0.0094,-0.0556,0.0026,0.0185,0.0053,0.0437,-0.0029,0.0092,0.0664,0.0093,0.0545,0.053,0.0304,-0.0226,-0.0262,0.0022,-0.0138,0.0128,0.0254,-0.0338,0.0196,0.0456,-0.0664,0.004,0.0058,-0.0055,-0.0144,0.0332,-0.0073,0.0809,0.074,-0.0083,-0.0507,-0.0425,0.0064,-0.0438,-0.0389,0.0137,0.0099,-0.0868,0.0062,-0.0366,-0.0506,-0.1277,0.0027,0.0155,-0.082,-0.0952,0.0645,-0.0371,-0.0094,0.0831,0.0452,0.049,0.0391,-0.0784,0.0852,0.0237,0.0668,0.0498,0.056,-0.0071,0.0081,-0.1122,0.0256,0.0412,0.0182,0.0035,0.0023,-0.0239,-0.015,-0.0038,-0.0214,0.053,0.0155,0.0389,-0.0255,-0.0534,0.0519,-0.0743,-0.0334,0.0071,0.0157,0.0262,0.0391,-0.0543,0.0706,0.0921,0.0448,0.0311,-0.0312,-0.0417,0.0067,-0.0239,-0.029,-0.0355,0.0424,0.0527,0.0168,0.0554,-0.0034,0.0579,0.0132,0.0292,-0.0406,0.0485,0.0397,0.0428,0.0579,0.0634,0.0416,-0.0567,0.0365,0.0346,0.0625,-0.0238,0.0008,0.0836,0.0333,0.0423,-0.0113,0.0345,-0.0521,-0.0169,0.0008,-0.033,0.0652,0.0303,0.0383,-0.0281,0.0351,0.0076,-0.1122,-0.0232,-0.0512,-0.1711,-0.0393,-0.011,0.0278,0.0132,0.0578,-0.0012,0.0096,-0.0213,-0.0663,-0.0566,-0.0596,0.0443,-0.0381,-0.0865,0.0162,0.0439,0.0179,0.0034,0.0868,0.0184,0.0151,-0.0062,0.0006,0.0356,0.0132,-0.0961,0.002,0.0428,0.0071,-0.006,-0.012,0.021,0.0334,0.0683,0.0768,0.0289,0.0525,0.0192,-0.0597,-0.0586,-0.0086,0.0433,-0.0206,0.0347,-0.0475,0.0106,0.0395,0.0324,0.0052,0.0019,-0.0298,0.0077,-0.0278,0.0536,-0.0439,-0.0612,-0.0498,-0.0984,-0.0642,0.0413,0.0343,0.0132,-0.0115,-0.0378,-0.048,-0.0364,0.0334,-0.047,-0.0233,-0.0728,0.0001,0.0271,0.0299,-0.0009,0.0287,-0.0166,0.0521,0.0367,0.0142,0.0481,0.032,-0.0123,-0.0361,-0.0047,-0.0555,-0.0815,-0.092,0.0827,0.0361,0.0121,0.0096,-0.0055,-0.0115,0.0044,0.03,0.0911,0.0083,-0.0768,-0.0717,0.0503,0.0319,0.0068,0.0681,0.0224,-0.0243,0.0208,-0.0406,-0.046,-0.067,0.0556,0.0045,-0.0269,0.024,-0.0162,0.0009,-0.0157,0.0214,0.0055,-0.0025,-0.0016,0.0417,-0.0066,0.0399,-0.0301,0.0502,0.0308,-0.011,-0.0246,0.0225,-0.0229,-0.0006,0.0604,-0.0054,0.0143,0.038,0.0331,-0.0025,-0.015,0.006,0.036,0.0493,-0.0131,0.0028,0.0254,0.0352,0.0473,0.0669,0.0647,0.054,-0.0879,0.0177,-0.0463,0.0335,-0.096,-0.0854,-0.0065,-0.0028,0.0031,-0.034,-0.005,-0.0501,0.0356,0.0229,-0.0177,0.0351,0.0599,0.0259,-0.0194,-0.0868,-0.0981,0.0182,0.0094,0.033,-0.0264,0.0044,-0.0024,0.0013,-0.0217,0.048,0.0079,0.0008,-0.0165,-0.0006,0.0107,-0.2519,-0.1748,-0.0818,-0.0196,-0.0301,0.0008,-0.0729,-0.0617,0.0626,-0.2765,-0.2637,-0.2014,-0.1563,-0.2481,-0.0915,-0.0957,-0.0678,-0.0206,-0.0627,-0.042,-0.0559,0.0102,0.0502,-0.0454,-0.0341,-0.0279,-0.0175,0.0284,0.0157,-0.0973,-0.0277,0.0221,0.0141,0.0394,-0.0425,-0.002,-0.0724,0.0288,0.0504,-0.015,-0.0702,-0.0695,-0.0541,-0.0692,0.0297,0.0307,0.0345,0.0236,0.024,-0.2633,0.0495,-0.1057,-0.05,0.0081,-0.0243,0.0462,-0.0073,-0.0315,0.0015,-0.0615,-0.0342,0.0147,0.0123,-0.0119,0.0271,0.0649,-0.0278,0.0093,-0.0071,0.0207,0.0229,0.0267,0.0512,-0.004,0.0017,-0.0084,0.0789,0.0251,-0.1093,-0.0287,0.0055,0.0296,-0.0625,-0.0334,-0.0007,0.0722,0.0734,-0.0032,0.0521,0.0448,0.0668,0.0126,0.0144,0.019,0.0202,-0.0115,0.0181,-0.0348,0.0207,0.0254,0.0188,-0.0331,0.0188,-0.0157,0.0303,-0.0013,-0.0469,0.0112,0.0273,-0.0518,-0.0259,0.044,0.0327,0.0045,0.0679,0.0219,0.0991,-0.0026,-0.0508,0.0564,0.0294,0.005,0.0472,-0.0058,0.0437,0.0046,0.04,0.0378,0.0443,-0.0763,0.0454,-0.3119,-0.2723,-0.17,-0.2731,0.0454,0.0045,0.0269,0.0111,0.066,0.007,0.052,-0.1157,0.0019,0.0468,-0.0239,0.0086,-0.0049,-0.0766,-0.0076,-0.0093,-0.024,-0.0176,0.0374,0.0335,0.0413,-0.0518,0.0094,0.0068,0.0112,0.0112,0.0622,0.0113,0.0143,-0.0004,0.0067,-0.0655,0.0451,-0.0824,0.1171,0.1078,-0.0129,-0.0053,0.0885,0.0884,0.0889,0.0071,0.009,-0.0029,-0.0014,0.0298,-0.0074,-0.0303,-0.0797,0.0488,-0.0656,0.0139,-0.012,-0.0263,0.032,0.0225,0.0173,0.011,0.0163,0.0189,-0.0009,-0.0051,-0.0382,0.0031,0.0269,-0.0325,0.0316,-0.0423,-0.0411,-0.0369,0.0021,0.051,-0.0128,0.0556,0.1094,0.0112,0.0255,0.0758,0.0103,0.0258,0.0695,0.0125,0.0477,-0.0291,0.0861,0.0312,0.0514,0.0949,0.0055,0.003,-0.0174,-0.1595,-0.0394,-0.0144,-0.0242,0.004,0.0127,0.0057,0.0542,0.0524,0.0095,0.0409,0.0183,0.016,0.0049,-0.0259,-0.0243,-0.0041,0.0199,0.035,0.0273,-0.0059,0.0377,0.0313,0.0225,-0.0293,-0.0096,0.0462,-0.0097,0.0437,0.0407,-0.0148,0.083,0.0847,0.0116,0.0088,-0.0163,0.0213,0.0195,0.0475,0.0348,0.0109,0.0363,-0.0207,0.0059,0.0235,0.0661,0.0651,-0.0176,-0.071,-0.0455,0.0007,-0.0017,0.0141,-0.1695,-0.0093,-0.0262,-0.0133,0.0596,-0.0208,0.0315,-0.0907,-0.0191,-0.1319,0.0015,0.048,0.0395,-0.0592,0.0421,0.003,0.0094,0.0115,0.051,0.0411,0.0114,-0.0219,0.0331,0.0178,0.0293,-0.018,-0.0165,0.0253,-0.0167,0.0487,-0.0059,0.005,0.0346,-0.0297,0.0073,0.0297,0.0629,0.0505,0.0421,0.0268,0.0072,0.039,-0.0051,0.0014,-0.0408,-0.0178,0.0105,0.0017,-0.0068,0.0017,0.0129,0.079,-0.0533,0.0484,0.0275,0.0048,-0.0697,-0.0252,-0.0025,0.0086,0.0474,-0.0179,0.0056,0.0305,0.0708,0.0031,0.0656,-0.001,-0.0366,0.0081,0.0334,0.0579,0.0245,-0.0137,-0.011,0.0287,-0.2036,0.0486,-0.0333,0.0091,-0.1215,0.0013,0.0371,-0.0962,-0.0833,0.0753,0.0231,0.061,0.0516,0.0615,0.007,-0.0258,0.0436,0.0165,-0.0261,-0.0893,0.0269,0.0273,0.0222,0.0062,0.0175,-0.0367,0.1307,0.0826,0.0253,0.096,0.0707,-0.0309,0.011,-0.0287,0.0026,-0.0331,-0.0189,0.0747,0.0327,0.0608,0.0395,0.0879,0.0039,0.0008,0.0409,0.0442,-0.0661,-0.0305,-0.0017,-0.0432,-0.0009,-0.0283,-0.0524,0.0269,-0.0301,0.0182,0.0201,0.0418,0.0113,0.0081,0.0046,-0.0121,-0.0527,-0.0004,0.0059,0.0531,0.0262,0.0454,-0.0699,-0.0649,0.0882,0.0718,-0.0064,0.0203,0.0403,-0.0057,0.0564,-0.0239,0.0106,-0.0155,0.0002,0.0014,-0.0351,0.0349,0.0007,-0.0175,0.0257,0.0317,-0.0685,0.0267,0.0243,-0.1198,-0.0391,-0.0017,-0.0489,-0.0422,0.0215,-0.0688,-0.0222,0.0297,0.0185,-0.044,-0.0181,-0.0639,-0.0401,0.0201,0.0125,0.0234,-0.0802,0.0332,-0.0299,-0.0693,0.0222,0.0315,-0.0189,0.0018,0.0604,0.0205,-0.0454,0.0396,-0.0373,0.0426,-0.0487,-0.0397,0.0474,0.0266,-0.0046,-0.0421,-0.01,-0.0875,-0.0536,-0.1106,-0.0467,-0.0577,0.0245,0.0092,-0.1814,0.0242,0.0781,0.0292,0.0033,-0.0294,-0.0383,-0.0665,0.0476,0.0081,-0.0296,0.0351,0.0147,-0.0189,0.0072,0.0155,0.0347,-0.0212,-0.0633,-0.089,-0.1075,-0.1222,0.0298,0.0498,0.0556,0.0214,-0.0517,-0.0464,-0.0015,-0.0512,-0.0465,0.0619,-0.0448,0.024,0.0918,0.0644,0.014,-0.0081,0.0177,-0.0097,-0.0167,-0.1169,-0.0981,-0.021,0.0034,0.0298,-0.0049,-0.0239,-0.0268,0.058,0.0554,0.0741,-0.0443,0.0004,-0.0175,-0.0451,0.0241,0.0028,-0.0395,0.0015,0.0335,-0.0382,-0.0333,0.0138,-0.0329,-0.0233,-0.0356,-0.0442,-0.061,-0.0,-0.0202,-0.0488,0.0144,0.0438,-0.0019,0.0651,0.0123,0.0041,0.0581,0.0082,-0.0413,0.0388,0.0074,0.0104,-0.0108,-0.0131,-0.002,0.0151,0.0222,0.0246,0.0088,0.0293,0.0177,-0.0346,0.0318,0.0231,0.0862,0.0572,0.0563,0.0069,0.0275,0.0423,0.0328,-0.0032,0.0237,0.0264,-0.0553,0.0157,-0.0294,-0.0207,-0.0115,0.0024,0.0174,0.0088,-0.0061,0.0262,0.105,0.0243,0.0527,0.0434,-0.0104,-0.0266,-0.055,-0.1592,-0.1072,-0.0421,-0.06,0.0702,0.1221,0.0552,0.0912,0.055,-0.0,-0.0019,0.0018,0.0535,0.0735,0.053,-0.0003,-0.0271,-0.0356,0.034,0.0191,-0.0228,0.0136,0.0668,0.0387,0.0277,-0.0138,-0.0155,0.0009,0.0757,0.0668,0.0279,0.0351,0.0923,0.0242,-0.0225,0.0348,0.0601,0.0277,0.0395,0.0331,0.0653,0.0125,-0.0014,-0.0241,-0.0693,-0.0361,-0.0383,-0.0238,0.0693,-0.0154,-0.0043,-0.0343,0.0247,0.014,0.0312,-0.0509,0.0568,0.0399,0.0384,0.0182,0.0307,0.0631,0.0469,0.0245,0.0109,0.0492,-0.0078,0.0096,0.0763,-0.0262,0.0229,0.0505,0.0109,0.0433,0.0189,0.0751,0.0515,-0.0123,-0.0681,-0.007,-0.0039,0.0999,0.033,0.0701,0.0487,0.0541,0.0348,0.007,-0.0212,-0.0273,0.0061,0.0288,0.0075,-0.0226,-0.0978,-0.0474,0.1098,0.1092,0.0587,-0.0069,-0.0092,0.0289,-0.0014,0.0335,-0.0192,0.0061,0.0362,0.0095,0.0189,0.0426,0.0419,0.0088,0.0439,0.0359,0.0397,0.0441,-0.0103,-0.0236,0.0229,0.0322,0.0314,0.0623,0.031,0.0923,0.0464,-0.131,0.0372,0.0312,0.0102,0.022,0.0161,0.0063,0.014,0.0078,-0.013,0.0141,-0.0005,-0.0298,0.0334,0.0102,0.0285,-0.0161,-0.0538,0.0476,0.0125,-0.046,-0.0899,-0.004,-0.0002,-0.0162,0.0043,-0.002,0.0136,-0.0269,-0.0419,-0.0497,0.0605,0.0658,0.069,0.0197,0.0455,-0.0451,-0.0985,-0.0955,0.0008,-0.0339,-0.025,-0.0491,-0.0501,-0.0558,-0.0053,-0.0055,-0.0151,0.0774,0.0411,0.0559,0.0213,-0.0212,0.0476,0.0281,0.0144,-0.0335,0.0194,0.0824,0.0434,0.0506,0.0592,0.096,0.0068,0.0831,0.0259,-0.0012,0.0582,0.0171,0.0495,0.0277,-0.0004,0.0399,0.0114,-0.022,0.0218,-0.0265,-0.0321,-0.0171,0.045,0.0446,-0.0245,-0.0076,-0.0239,-0.0838,-0.02,0.0234,-0.0441,-0.0014,0.0128,0.0786,0.0428,0.0139,0.0037,-0.021,0.0102,0.045,0.0509,0.0214,0.0183,-0.0477,0.0539,0.0069,0.0127,0.0067,0.0065,-0.0115,-0.0067,0.0995,0.0211,0.0714,0.046,-0.0182,-0.0416,-0.0675,0.0176,-0.2069,-0.1611,0.0889,0.0382,-0.2427,-0.0518,-0.018,-0.0303,-0.0757,-0.066,0.061,0.0595,0.0362,0.0519,-0.2311,-0.2021,-0.1349,-0.0308,-0.0316,-0.1244,-0.2555,-0.2546,-0.2283,-0.0614,-0.0114,0.0348,0.0157,0.027,0.031,0.044,0.0132,0.0282,-0.0118,0.0488,0.0479,-0.0645,-0.004,0.0214,0.0503,-0.0378,-0.0099,-0.055,0.0347,-0.0037,0.0616,0.0147,0.0395,0.0126,0.0473,0.0358,0.0013,-0.0304,0.0453,0.0725,0.07,0.0314,0.0574,-0.0154,-0.079,-0.0095,-0.0019,-0.0427,-0.0161,-0.136,0.004,0.0661,0.094,0.0169,-0.0367,0.017,-0.0514,-0.0119,-0.0485,-0.0399,0.0737,0.0734,0.044,0.0427,-0.0087,0.1196,0.1008,0.0196,0.0028,-0.0451,0.0112,-0.0251,-0.0067,0.0293,-0.0313,-0.0407,0.0141,0.0788,0.0628,0.0093,-0.0238,0.022,0.0296,0.038,-0.0276,-0.0109,-0.0338,-0.0041,-0.0315,0.0107,0.0371,-0.0432,0.001,-0.0661,-0.0123,-0.0228,-0.0277,0.0218,-0.0177,-0.0249,0.036,0.0342,0.0053,-0.0037,0.016,-0.044,0.0054,-0.008,-0.0075,-0.0146,-0.0248,-0.0207,-0.0578,-0.0007,-0.0758,-0.0601,0.0466,0.0529,0.036,0.0507,0.0809,-0.0516,-0.0196,0.0034,0.0248,-0.0953,0.0163,0.1118,0.0485,-0.0364,0.0064,-0.0284,-0.0255,-0.0419,-0.0453,-0.1293,-0.2047,-0.0506,0.0013,0.0085,0.004,0.0087,0.05,0.0582,0.0819,0.0034,0.0494,-0.0077,0.0162,0.0163,0.0059,0.0558,0.0569,0.0547,0.0071,0.0107,0.0438,0.0437,0.0572,0.008,-0.0037,0.049,0.042,0.0505,-0.0624,-0.0709,-0.0292,0.0149,-0.102,-0.0914,0.0668,-0.0659,0.0461,0.0471,-0.0035,0.0555,0.0574,0.0012,-0.0007,-0.0529,0.0219,0.0529,0.0137,0.0185,0.0069,-0.0263,0.0285,-0.0212,0.0023,-0.0017,-0.041,0.0462,0.0455,0.0546,0.0293,0.025,0.0184,0.0366,-0.0075,-0.0334,0.0049,0.0033,0.0859,0.0547,0.0618,0.0656,0.0581,0.0554,0.0677,0.0677,-0.0034,0.0428,-0.0109,0.0668,-0.0168,0.0389,0.0389,0.0216,-0.0384,0.1363,-0.0581,0.0698,0.0256,-0.0302,-0.0272,-0.0282,0.0195,0.0513,0.0797,-0.0437,-0.0525,0.0386,0.0003,-0.0255,0.021,-0.0386,0.0095,-0.0162,0.0024,0.0318,0.0216,-0.0097,0.1019,0.0645,0.0185,0.0487,0.0247,0.0135,0.0167,0.0048,0.0233,0.0135,-0.0168,-0.0479,0.0159,-0.09,-0.0292,0.0822,0.0571,0.091,0.0219,0.0538,-0.0098,0.0202,-0.0,0.0064,0.0366,-0.0143,0.0258,0.0034,-0.0817,-0.0138,-0.1385,-0.0459,-0.0115,-0.0545,0.0489,-0.0242,-0.0257,-0.0237,0.0167,0.0379,-0.028,0.0181,-0.0014,0.0416,0.0485,0.0321,0.0351,-0.0021,0.0381,0.0626,-0.1556,0.0242,-0.048,-0.0734,0.0156,-0.0045,0.0114,0.0377,0.0593,0.0571,-0.0714,-0.0475,0.0368,0.0133,0.0505,-0.0148,-0.0247,-0.0589,0.0112,0.0048,-0.0318,0.028,-0.0196,0.0503,-0.0023,-0.0031,0.0173,0.0318,0.0271,0.0386,0.0192,0.0182,0.0143,0.0268,-0.049,0.0154,-0.0719,0.0403,0.0065,-0.0154,-0.0077,0.0352,0.0475,0.0592,0.0403,-0.0224,-0.0187,-0.0201,-0.0046,-0.0239,-0.0402,-0.0173,0.0371,0.0267,0.0646,0.0638,0.0222,-0.0024,-0.0312,0.052,0.0422,0.0552,0.0379,0.0337,0.024,-0.0046,0.0548,-0.0275,0.0305,0.0264,0.0423,-0.0134,0.0674,-0.0317,-0.0158,-0.0032,0.0847,-0.0478,-0.0172,0.0569,-0.0289,-0.0231,0.0175,-0.0233,0.0347,0.0405,0.0386,0.0601,0.0871,0.026,0.0572,0.0285,0.0185,0.003,-0.0058,-0.0332,0.0689,0.0499,-0.0022,-0.0642,-0.1216,-0.0231,0.024,0.0202,0.0102,0.0476,-0.0201,0.0425,0.0298,0.0427,-0.0012,0.0548,0.0784,-0.1342,-0.0021,-0.0171,-0.1323,-0.0226,-0.0484,0.0692,0.0159,0.0225,0.0336,0.0258,-0.0001,0.0041,0.003,0.0343,0.0214,0.0073,0.0485,-0.0027,0.0108,0.067,-0.0024,-0.0019,0.0032,0.0314,-0.0142,0.0274,-0.0056,0.0222,-0.0673,0.0986,0.0249,0.0552,0.0859,0.0074,0.068,0.0596,0.0994,0.067,0.032,-0.0207,0.0851,-0.0277,0.0513,-0.0195,-0.0254,-0.0209,0.0461,0.0723,0.0371,-0.0136,-0.0515,-0.0183,0.0136,-0.0087,0.0397,-0.0156,-0.0133,-0.0083,-0.0267,-0.0188,0.0452,-0.0022,0.0007,-0.0012,-0.0507,-0.0148,0.0038,0.0183,-0.0005,-0.079,0.0259,-0.1006,-0.0841,0.0204,0.0284,-0.0249,0.0593,0.0592,-0.0098,-0.0676,-0.0986,-0.074,-0.0415,-0.0255,0.0227,-0.0329,-0.0404,-0.0277,-0.0237,0.0804,0.0157,0.038,-0.0793,-0.0105,-0.0154,-0.0142,0.0077,-0.0537,-0.0109,-0.0235,0.0136,-0.0616,-0.015,0.0437,-0.0531,-0.0382,-0.0211,-0.0403,-0.0678,-0.0555,-0.0214,-0.06,-0.0197,0.0498,-0.0206,-0.0686,-0.0841,-0.0218,0.0123,-0.0632,0.0012,0.0584,0.1454,0.1399,-0.0144,-0.0153,-0.0278,0.0176,-0.0219,0.017,0.046,0.0321,0.0547,-0.0446,0.007,0.014,0.0262,0.0202,0.0173,0.0549,-0.0084,0.0494,0.0454,0.0169,0.0033,-0.0236,0.0959,0.0276,-0.0057,0.0226,0.0119,-0.0229,0.0153,0.044,0.0405,-0.0602,0.0582,0.0036,0.0091,-0.0006,0.0013,-0.039,0.0541,-0.0361,-0.0362,-0.0035,0.0108,0.0154,-0.0408,-0.0077,0.0265,0.0786,0.0985,0.0461,-0.0104,-0.0227,-0.034,0.002,0.0366,0.0534,0.0551,-0.0649,-0.054,0.0688,0.0242,0.0316,0.0275,0.0637,-0.1679,-0.0181,0.025,-0.0044,-0.0658,-0.0281,0.0686,0.0693,0.0726,0.077,0.052,0.0397,-0.051,-0.0276,-0.011,-0.0316,0.0373,-0.0303,-0.2167,-0.0458,-0.077,-0.1776,0.1094,0.0681,0.0303,-0.0449,-0.0044,0.011,0.0291,-0.0298,-0.0388,0.0979,0.0471,0.052,-0.1232,0.0225,0.0092,0.0071,0.0088,-0.0195,-0.069,0.041,0.0548,0.0785,0.0429,-0.005,-0.0393,-0.0154,-0.0199,-0.0163,0.0144,-0.001,-0.0122,-0.0207,0.009,0.0546,-0.0339,-0.0023,-0.0027,0.0022,0.0021,-0.0045,0.0146,-0.0164,-0.0049,0.0323,0.0182,0.0855,0.063,0.055,0.0466,-0.1399,-0.0224,-0.1226,-0.0238,-0.002,-0.0194,-0.0232,-0.0032,0.0456,-0.0242,-0.0585,-0.0409,-0.0377,-0.0174,-0.0176,0.0497,0.0343,0.0552,0.0076,-0.0756,-0.0556,0.0735,0.0153,-0.0243,0.0403,0.0008,0.019,0.0114,0.0562,-0.0046,0.0777,-0.0249,0.0058,-0.0718,-0.0299,-0.0243,-0.0129,-0.0103,-0.003,0.0077,-0.0041,-0.0106,-0.0765,-0.0061,-0.0257,0.0317,-0.0516,0.0358,0.0359,0.0358,-0.0327,-0.0224,0.0216,0.0647,0.0332,0.0373,0.0402,0.0041,-0.0032,0.0218,0.0119,0.0679,0.0644,-0.0067,0.0302,0.0163,0.0127,0.0185,-0.0245,0.0274,-0.0074,0.0625,0.0574,0.065,0.0167,0.0333,0.0682,0.0585,-0.0674,-0.0225,0.0154,0.0462,-0.0735,-0.0848,-0.0008,0.0425,-0.0323,-0.0167,0.0449,-0.0166,0.0228,-0.0405,-0.0698,-0.1159,0.026,-0.0145,-0.0411,-0.0017,0.0567,-0.0095,-0.0097,-0.0172,0.0505,0.0415,0.0285,0.0638,-0.0227,0.0889,0.0508,-0.0293,-0.0198,0.1044,-0.0082,-0.0522,-0.0736,0.015,0.0296,0.1474,0.1285,0.054,0.0985,-0.0735,0.0001,0.0151,0.0059,0.0102,0.0228,0.0455,0.014,-0.1153,-0.0628,-0.1133,-0.0484,-0.0476,0.0557,0.0377,-0.0387,0.0257,-0.0058,0.0244,0.0178,-0.1264,-0.084,0.0272,0.116,0.0517,0.0471,0.0618,0.0284,0.0281,-0.0279,-0.0344,0.0094,0.0032,-0.0046,0.0599,-0.0092,0.0607,0.0036,0.0589,0.0806,-0.0116,-0.0553,0.0171,0.0154,0.024,0.0705,0.0357,0.0686,0.0181,0.0547,0.0298,-0.0002,-0.0528,0.008,0.0414,-0.0047,0.0193,-0.0037,0.0424,0.0398,0.0781,-0.0249,-0.0588,-0.0044,0.0026,-0.0471,0.0363,0.0267,-0.0232,0.0075,-0.016,0.0307,-0.0062,0.0036,0.0071,-0.0359,-0.0479,-0.0659,-0.0698,-0.025,-0.0413,-0.0411,-0.0058,0.0447,-0.0289,0.0557,-0.0607,0.0116,0.0228,0.018,-0.0418,0.0178,0.046,0.0123,-0.0155,0.0465,0.0384,-0.0394,-0.0445,0.0175,0.0401,0.007,-0.0404,-0.027,0.0722,0.0169,0.0753,0.0125,0.0639,0.0661,-0.0019,-0.0048,-0.0096,0.022,0.059,0.0644,0.0068,-0.045,0.028,0.0325,-0.0432,0.0009,0.0147,-0.0456,-0.0721,-0.0418,0.0014,-0.0365,0.0455,0.0302,-0.1216,-0.017,0.0196,-0.0917,0.0032,-0.0028,-0.0326,-0.0627,-0.0143,0.0461,0.0563,0.0363,-0.0383,-0.0908,0.0246,-0.04,0.0198,0.0061,0.0471,0.0198,-0.0126,-0.0724,0.0335,0.0268,-0.0306,0.0574,0.0513,0.0108,0.0287,0.0435,0.0321,0.0395,0.0217,0.0786,0.0458,-0.065,-0.1114,0.0094,0.0312,0.0093,-0.0499,-0.0273,0.0326,0.0659,0.0796,-0.0293,-0.0273,0.0362,0.0378,0.0449,0.022,0.0542,0.0449,0.0251,0.0215,0.0155,0.0627,0.0101,-0.0348,0.0367,0.0587,-0.0026,0.0542,-0.0041,0.0402,0.0214,-0.0646,-0.0302,0.0703,-0.004,0.0313,0.08,0.0394,0.0486,0.054,-0.0119,-0.0511,-0.0817,0.0276,0.0547,-0.0222,0.0259,0.0302,-0.0132,0.0528,0.0376,0.0609,-0.0421,-0.0529,-0.0463,0.0409,0.0826,0.0633,0.0065,0.0039,0.0024,-0.0199,-0.0729,0.0345,0.0447,0.0414,0.0223,0.047,0.0919,0.0294,0.0385,0.0105,0.0124,-0.0039,0.0122,-0.0493,-0.0106,-0.004,-0.0045,-0.039,-0.0435,-0.043,-0.0024,-0.0246,0.0386,0.0013,0.0598,0.0243,0.0179,-0.0019,0.0152,0.0094,0.0456,0.0641,0.0392,0.008,0.0084,-0.0038,0.0173,-0.115,0.001,-0.0817,-0.0134,-0.0244,-0.0228,-0.0685,-0.01,0.0193,0.0579,0.0085,-0.0182,0.0072,-0.0119,0.0368,0.018,0.0719,0.0457,-0.037,0.0186,-0.0281,-0.0613,0.0925,0.0748,0.0093,0.0263,0.018,0.0227,-0.2103,-0.0984,0.0405,-0.0503,0.0146,0.0137,0.0331,0.0324,0.062,0.046,-0.0365,0.0177,0.0298,0.0161,0.0805,0.0271,-0.1015,0.0019,-0.0047,0.0495,-0.0033,-0.0342,0.0544,-0.0138,-0.0693,0.0763,-0.0087,0.0527,-0.0316,0.0666,-0.2509,0.0209,0.0072,0.0524,0.0497,-0.0077,-0.0341,0.0016,-0.0255,0.0277,-0.0115,0.0224,-0.0544,-0.0042,0.0072,0.0014,-0.0694,-0.0738,-0.1,-0.1717,0.0132,-0.0031,-0.1264,-0.2665,-0.0921,-0.0859,-0.2475,-0.1379,-0.0934,-0.1763,-0.0902,-0.0922,-0.1087,-0.1036,-0.1612,-0.0677,-0.1986,-0.1579,-0.1428,-0.1581,-0.0705,-0.0125,-0.0438,0.0518,0.0589,0.0508,0.0474,0.0065,0.0973,0.0803,0.0411,0.0458,0.034,0.1029,0.0886,0.0603,0.0138,0.0251,0.0483,-0.0463,0.0234,0.0639,0.0173,0.065,0.0317,0.0736,0.0061,0.0576,-0.0595,0.0781,0.0906,-0.0669,0.0285,0.0316,0.0066,0.0034,0.0543,-0.0137,-0.0037,0.0418,-0.0846,-0.1669,0.009,-0.0823,-0.0824,0.0532,-0.0316,-0.0339,0.0356,0.028,-0.0901,-0.0165,-0.0518,0.0303,-0.0045,-0.0991,-0.0101,0.0338,0.0141,-0.0149,0.0183,0.0269,pattern maintenance
trm_557b494ca540d,0.0376,0.0493,0.1069,0.0457,0.0001,0.0094,0.0596,-0.0332,-0.0789,0.0401,0.034,0.066,0.0696,0.081,0.0629,0.0213,0.068,0.1321,-0.0041,0.1226,0.1082,0.0584,0.015,-0.0337,0.0876,0.0618,0.0618,0.1028,0.0837,0.0616,0.1128,0.0815,0.0752,0.0415,0.135,0.1128,0.0669,0.0402,0.0572,0.0436,0.0908,0.064,0.0008,0.0557,0.0623,0.1009,-0.0401,0.0139,-0.1015,0.0485,0.0249,-0.0326,0.0139,-0.0496,0.0894,0.0668,0.0731,0.0508,0.0194,0.0665,0.0142,0.0169,0.1588,-0.0655,-0.081,-0.0985,0.1683,0.2152,0.0938,0.0064,-0.085,-0.0491,-0.0875,0.104,0.0483,0.059,0.0491,0.0295,-0.0576,0.0054,0.0482,-0.0127,0.0835,0.0972,-0.0658,-0.0971,-0.0624,-0.0334,0.0468,0.0455,0.0868,-0.0199,0.019,-0.3463,-0.2366,-0.2651,-0.1236,-0.1242,-0.2267,-0.2156,-0.0399,0.0187,-0.1171,-0.163,-0.1513,0.1213,0.1466,-0.0857,-0.048,-0.0079,-0.0013,0.09,-0.0526,-0.1275,0.0117,-0.0002,0.0992,-0.1633,0.0502,0.0242,0.1225,0.1494,0.1871,0.0587,0.0706,0.1758,0.0712,-0.0592,-0.0473,-0.0342,0.1646,0.0201,0.0175,0.2191,0.0831,0.2159,-0.0317,0.1294,0.0446,-0.024,0.0622,0.0629,-0.0041,0.11,0.052,-0.073,0.0166,0.0018,0.0394,0.0273,0.0504,0.1203,0.0586,0.1368,-0.097,0.0203,-0.0615,-0.0515,0.015,0.0647,0.0228,0.101,0.1766,0.1646,0.0338,-0.0014,0.0411,0.1579,0.1534,0.0323,0.0975,0.135,0.004,0.2484,0.1262,0.1654,0.1322,0.1399,0.0941,0.0427,0.1385,0.0049,0.0971,-0.0214,0.0661,0.0263,0.0072,0.1687,0.127,-0.0073,-0.0038,0.1192,0.0472,0.1519,0.144,0.0672,0.1217,0.0775,0.019,-0.0003,-0.0821,-0.4409,0.1657,0.1068,-0.047,0.0003,0.1691,0.0466,0.0547,0.0154,0.1934,0.1018,-0.0249,0.0367,-0.0031,0.0122,-0.0082,0.0755,-0.033,0.0367,-0.1015,0.1062,0.1169,0.0543,-0.1311,-0.0278,0.0376,-0.1103,0.0844,-0.2055,-0.1316,0.1315,-0.1744,0.0501,0.0437,-0.1014,0.0826,-0.0424,-0.0353,0.038,-0.0403,0.129,-0.0046,-0.0379,0.0305,0.1059,0.1036,0.1388,0.0069,0.1826,0.034,-0.035,-0.0117,-0.0475,-0.038,0.1449,-0.0257,0.0029,-0.075,-0.1109,-0.1184,-0.2831,0.0889,-0.1387,-0.1862,-0.3033,-0.1319,0.0419,0.039,0.0339,0.05,0.0025,0.0938,0.0552,-0.0402,0.0433,-0.0184,0.0788,-0.0023,-0.0215,-0.0027,0.1164,0.0961,0.2175,0.1782,0.0692,-0.0237,-0.0153,0.0185,0.0625,0.0795,0.1247,0.0064,0.077,0.0655,-0.0876,0.0402,-0.073,0.0318,-0.1989,-0.0202,0.2006,0.0478,0.1214,-0.0681,-0.0913,0.0735,0.019,-0.1058,0.0454,-0.0049,0.0047,0.0408,-0.0054,-0.0303,-0.019,-0.1318,0.0215,0.0009,0.1,-0.0006,-0.0028,0.081,0.1533,0.0335,0.0397,0.0154,0.0349,0.016,0.0692,0.0019,0.1,0.0608,0.0289,0.0046,-0.144,0.0237,0.0502,0.1085,0.1429,0.1403,0.0897,-0.0657,-0.0441,-0.0678,-0.0463,0.1235,0.0745,0.0815,0.0436,0.0274,-0.1231,-0.023,-0.0409,0.0736,-0.0085,0.0408,0.0846,0.0896,0.0329,-0.0085,-0.0473,-0.0717,-0.0208,-0.0203,-0.0431,0.0739,-0.3439,0.0014,0.0811,0.075,-0.0796,-0.0029,-0.1507,0.0905,-0.0273,0.0468,-0.0204,0.0477,-0.0122,0.0572,-0.1134,0.0492,-0.0481,-0.0637,-0.0894,0.0655,0.0525,-0.0323,-0.001,-0.0607,0.0008,-0.0244,0.0714,-0.0374,-0.0656,-0.0998,0.0992,-0.0081,0.037,0.0532,-0.0007,-0.0526,0.044,-0.0227,-0.078,0.0008,-0.0135,0.0765,0.0006,-0.0054,0.1333,0.0496,-0.0704,0.1603,0.1104,-0.0767,0.0024,0.0538,-0.0123,-0.0383,0.0967,0.0407,0.1909,0.1848,0.008,0.1095,-0.0866,0.1051,-0.0673,0.0412,-0.0279,0.0109,0.0061,0.1109,-0.0009,-0.0694,-0.0408,0.1395,0.054,-0.0601,-0.1069,0.0503,-0.0439,0.1313,0.0277,-0.062,-0.24,0.0857,-0.025,-0.0549,-0.0433,0.0908,-0.0007,-0.0751,0.124,0.0514,0.0019,-0.0455,-0.0262,-0.0553,-0.0159,0.0623,0.015,0.0966,0.0604,-0.0624,-0.1978,0.0514,-0.0022,-0.091,-0.0297,-0.1657,0.0203,0.0799,0.0307,-0.0795,-0.0515,0.0241,0.0135,-0.2103,-0.0574,-0.0602,-0.0587,0.0005,-0.0505,-0.0436,-0.0435,0.1035,0.0262,-0.0427,-0.164,0.091,0.1411,-0.0703,0.0453,0.1094,0.0167,-0.0152,0.0701,0.0485,-0.0294,0.0145,0.0703,0.054,0.0728,-0.0074,0.0493,0.0167,-0.1836,0.122,-0.0775,0.0252,-0.0177,-0.0675,-0.0772,0.1486,0.155,-0.1669,0.0902,0.0249,0.0041,-0.012,-0.0688,-0.1003,-0.042,-0.0963,-0.1655,-0.0097,-0.0762,0.0401,0.0072,0.0219,0.1709,0.1404,0.0171,0.1495,0.0221,-0.0095,0.111,0.0533,0.0174,-0.0143,0.0502,0.0775,-0.0261,-0.0149,-0.0245,0.0185,0.0698,-0.0728,0.0509,-0.0294,-0.1262,-0.0128,0.1194,-0.0044,-0.0411,0.0436,-0.0531,0.0376,0.0094,0.0663,-0.0542,0.0668,-0.0182,0.0132,0.133,-0.0338,0.0798,0.0474,0.1064,-0.0095,-0.0536,-0.1625,-0.1164,-0.027,-0.0829,-0.0478,-0.0431,0.017,0.0604,0.0323,0.0062,-0.0946,-0.0472,-0.185,-0.039,-0.1546,0.0538,0.0735,-0.0633,-0.1017,-0.1289,-0.0544,-0.0238,0.2131,0.0675,-0.1497,0.0891,-0.0502,-0.0165,-0.0514,-0.04,-0.0985,-0.1888,0.0232,0.0946,0.0811,-0.0185,0.1812,0.0076,-0.0354,0.0638,0.1778,0.0859,0.063,0.0212,-0.0235,0.2038,0.0287,0.1212,-0.0696,0.0074,0.0111,-0.08,0.0543,0.1328,-0.0306,-0.0412,-0.0525,-0.1221,0.0392,0.0003,-0.0999,-0.1664,-0.067,-0.0096,0.0978,-0.0815,0.0418,-0.1293,-0.0523,-0.0851,0.0733,0.0364,0.2316,0.1625,-0.1849,0.1965,-0.0084,0.0863,-0.3136,0.1163,0.0608,-0.072,-0.1808,0.0049,0.0444,0.0343,0.1262,-0.1591,-0.1058,-0.1501,-0.1896,-0.1551,-0.0294,0.1087,-0.1103,0.0074,0.0253,0.0772,0.0497,-0.0032,0.0267,0.0479,-0.149,0.0969,0.0504,0.044,-0.0211,-0.086,-0.0943,-0.031,-0.0986,0.0924,0.0757,-0.0524,-0.0462,-0.082,0.0279,-0.1569,-0.2006,-0.0759,0.0424,0.1029,-0.0237,0.0082,0.012,-0.0101,-0.0449,0.0004,0.0321,0.1107,0.0639,-0.009,0.0559,0.0511,0.0514,-0.0656,-0.0045,0.0461,0.0555,0.0588,0.1106,0.0768,0.0116,0.0242,0.1405,-0.0264,-0.0603,0.0995,0.2273,0.2273,0.1669,0.047,0.051,0.0858,-0.0083,-0.0268,0.0347,0.0529,-0.0269,-0.0615,-0.1282,-0.0454,0.0423,-0.1204,-0.106,-0.2082,0.1528,-0.0021,0.0155,0.0253,0.0293,0.1391,-0.0406,-0.0627,-0.0111,-0.0197,-0.0382,-0.0061,0.1696,0.2503,0.1985,0.1504,-0.0227,-0.0361,0.0531,0.0131,0.0398,-0.0819,-0.0693,-0.0256,-0.0552,-0.0138,0.1021,0.0046,-0.085,-0.0785,-0.0719,-0.1059,0.0271,-0.0046,-0.0894,0.0874,-0.0137,0.0842,0.095,0.0586,0.1467,0.1168,0.0721,-0.0484,0.0169,0.0147,0.0185,0.062,-0.0874,-0.0753,-0.0198,0.0386,0.0512,0.0067,-0.0174,-0.0313,-0.0931,0.0821,-0.1307,0.1526,0.141,-0.1345,-0.0548,-0.0986,0.0209,0.0635,-0.0416,0.0165,-0.1626,-0.1824,-0.0318,-0.1644,-0.0285,-0.0565,-0.0616,-0.0823,-0.1556,-0.0863,0.0223,-0.0428,-0.0421,0.1036,0.134,-0.0718,0.0704,0.1201,0.2465,0.0882,0.1555,0.1252,0.2324,0.0158,0.0182,0.0439,0.1036,0.0362,-0.0195,-0.0825,-0.1061,-0.0234,-0.1033,-0.1595,-0.0569,-0.1207,-0.0642,-0.0249,-0.0788,-0.0512,0.0946,-0.1125,-0.0496,-0.026,0.0994,0.0691,0.0491,-0.0815,-0.1026,0.2189,0.1739,-0.0024,-0.0616,-0.0976,-0.0585,-0.0529,-0.1004,-0.1811,0.0113,0.037,-0.2164,0.0739,-0.0419,0.1491,-0.3134,0.0675,-0.1371,-0.1679,-0.0087,-0.1684,0.156,0.162,0.0729,-0.204,0.0292,0.0708,0.0805,-0.0506,-0.0163,0.0996,0.0917,0.1176,-0.08,0.018,-0.0056,-0.0942,0.0413,-0.0191,0.1198,0.083,0.0554,-0.0157,0.0855,-0.0527,0.098,-0.025,-0.0769,0.0027,-0.0879,0.1154,0.0954,0.1251,0.054,0.1448,0.0512,-0.0382,-0.0844,-0.0398,0.0686,0.0571,-0.1267,-0.1226,-0.1375,-0.0454,0.0236,0.0692,0.0255,0.0571,0.0702,-0.0315,-0.0145,0.1136,-0.0058,-0.0192,-0.0326,0.0554,0.0584,-0.0225,0.0702,0.0084,-0.0084,0.1435,0.1349,0.3015,0.1566,0.3153,0.1133,0.1113,0.0947,0.1481,0.1829,0.1549,0.1997,0.26,0.0551,0.0643,-0.0016,-0.0318,-0.1231,0.0299,-0.0541,-0.0507,0.03,-0.063,-0.0055,0.0306,0.0604,0.0306,-0.0908,-0.1352,0.0151,-0.0402,-0.0371,-0.0425,-0.0621,-0.0135,0.0768,-0.0195,0.0552,0.0057,-0.0086,-0.0926,-0.0154,-0.0367,0.1149,0.095,0.0875,0.1838,0.1593,-0.0125,-0.0689,-0.0542,-0.0662,0.0107,0.028,-0.0327,-0.0363,-0.0375,-0.018,-0.0632,-0.0269,0.021,0.0495,0.0272,0.015,-0.0012,0.0255,0.026,0.0827,0.1246,0.1965,0.1441,-0.0766,-0.087,-0.0743,0.048,0.0276,0.1068,0.0281,-0.0246,-0.0229,0.0176,0.0061,0.0056,0.0386,-0.0075,-0.0553,-0.0442,0.0789,0.0025,0.0979,-0.0024,0.0854,-0.0678,-0.1751,-0.3869,-0.1252,-0.0716,-0.0289,-0.0976,-0.0332,0.0129,0.0019,0.0502,-0.0049,-0.0342,-0.0446,-0.0324,0.0274,-0.0926,-0.0156,0.0739,-0.0428,0.1007,0.0813,0.1227,0.0681,-0.1199,0.0013,-0.0312,0.129,-0.1773,-0.0534,0.0153,0.056,0.0523,0.0391,0.048,-0.0784,0.0154,0.092,0.0426,0.0067,0.1458,0.1052,0.0655,0.123,0.1697,0.0754,0.0517,0.0931,-0.02,-0.0551,-0.0269,-0.0338,-0.0816,0.0426,-0.0923,0.1419,0.0512,0.0442,0.1154,-0.05,-0.0216,-0.3282,-0.3078,-0.346,-0.1023,-0.2921,-0.0011,0.1511,0.1386,0.1034,0.1018,0.0513,0.1954,0.2073,0.095,0.162,0.0758,-0.0143,0.0225,-0.0506,-0.0368,0.0889,-0.0648,-0.039,0.0332,-0.0835,-0.0018,0.1002,-0.0569,-0.0003,0.1418,-0.0719,0.0979,-0.0768,-0.0265,-0.1246,0.0428,0.1612,0.2157,0.1495,0.0819,-0.0497,-0.0374,-0.0792,0.075,0.1471,0.157,0.0485,0.1019,0.0863,-0.1625,-0.2941,0.1004,-0.0276,-0.0805,-0.2907,-0.3314,-0.2132,-0.1304,-0.0062,-0.0904,-0.1071,-0.0947,0.0489,0.1679,0.0132,0.0757,-0.2056,0.0034,0.0399,-0.0071,0.0661,0.0462,-0.0122,0.0969,-0.0355,-0.1147,-0.027,0.0989,0.0343,0.0258,-0.0744,-0.0567,-0.0995,0.1663,0.1481,0.1078,0.078,0.0173,0.0904,0.1153,-0.0201,0.0607,-0.2015,-0.0724,-0.1443,-0.3873,0.0025,-0.0358,0.0614,-0.0379,-0.0236,-0.2583,0.0714,-0.262,-0.3805,-0.0277,0.106,-0.2776,-0.2404,0.0408,0.1033,-0.031,0.1256,0.0629,0.1759,0.0423,-0.1333,0.0642,-0.0118,-0.1248,-0.0248,0.0405,0.0535,0.0164,-0.0161,0.0758,-0.0461,-0.0398,-0.0043,0.1016,0.1062,0.023,0.0956,0.0711,0.0283,0.0545,0.0893,0.0421,0.1011,-0.0906,-0.0955,0.2201,0.1027,-0.0741,-0.0399,0.032,-0.0655,-0.0204,0.0018,-0.0012,-0.1528,0.0922,0.1381,0.0329,-0.1412,-0.1267,0.0519,-0.0383,-0.0383,0.1355,-0.1465,-0.1037,-0.0959,-0.016,-0.0003,0.0523,-0.3239,0.2057,0.2028,-0.0226,0.0472,0.1736,0.1845,0.1523,0.0449,0.057,0.0888,-0.0022,-0.053,-0.2901,0.0759,0.0351,0.0036,0.0072,0.005,-0.0317,-0.0485,0.0191,0.0673,-0.0007,0.0598,0.0413,0.0781,0.0078,-0.0418,0.0358,-0.2861,-0.1527,-0.265,-0.0415,-0.2703,0.1658,0.1281,-0.0004,0.1171,0.0339,0.1509,0.1475,-0.0267,0.0923,0.182,-0.1312,0.0354,0.0922,-0.0006,-0.0128,0.0232,0.055,0.0197,0.055,0.0113,0.0889,-0.1008,0.0636,-0.0256,-0.1205,-0.1556,-0.1872,0.0215,-0.0273,0.0781,0.0843,0.0976,-0.0093,0.0636,-0.0564,0.155,0.0702,-0.0143,-0.0522,0.0606,0.1638,0.1475,-0.0275,0.0002,-0.0664,-0.0168,0.104,0.0185,0.0637,0.0822,0.1675,0.2178,0.1305,0.0728,0.1281,0.1092,0.053,0.0557,-0.0353,-0.0761,-0.0584,0.0941,0.0826,-0.0413,0.1343,-0.0038,-0.0922,-0.0744,-0.0367,0.1506,-0.0679,-0.0817,0.0562,0.0181,0.0508,0.0782,-0.0054,-0.0179,0.0418,0.0,0.1881,-0.025,-0.0183,0.0643,-0.3052,0.1227,0.0032,-0.0437,-0.1554,-0.1719,0.075,-0.011,0.1244,0.0518,0.083,0.1012,0.0863,-0.1121,-0.0757,0.1007,0.0983,0.0128,0.0986,-0.0405,0.1382,0.0792,0.0003,-0.0221,-0.0256,-0.0497,0.0527,-0.0285,0.04,0.0939,0.0618,0.0822,0.0494,0.0203,0.0295,0.0298,-0.1206,0.0347,0.0155,0.0519,-0.0462,-0.0759,0.0444,0.1684,-0.0887,-0.0899,-0.1723,-0.0058,0.0424,0.0054,-0.0768,-0.0597,0.0419,0.0859,0.1152,0.029,0.2169,0.0069,0.0648,0.0086,0.0789,0.055,0.0095,0.0911,0.1144,-0.1906,-0.058,-0.0117,0.044,-0.3754,0.0167,-0.1414,0.0445,0.0517,0.0265,0.0603,-0.1522,-0.0574,-0.0365,-0.0174,-0.0044,-0.0101,0.0879,-0.0324,-0.0349,-0.0755,-0.0826,-0.0274,0.077,0.0661,0.0099,-0.1056,-0.1114,-0.0543,0.0913,0.0325,-0.0262,0.0438,0.0096,0.026,-0.0958,-0.0476,-0.046,-0.0407,-0.0073,0.1179,0.014,-0.0833,0.0017,0.1163,0.0591,0.0215,0.058,-0.0274,-0.0949,0.0668,0.0503,0.0297,-0.0119,-0.1161,-0.2333,0.0288,0.0808,-0.0998,-0.0482,0.0829,0.1033,-0.0646,-0.0235,0.0443,-0.1321,-0.108,-0.0768,0.0828,0.0811,-0.094,-0.5223,-0.509,0.1028,0.0836,-0.1035,0.0486,-0.0153,0.0549,0.1338,-0.0301,0.0564,0.0707,-0.0169,-0.0275,-0.234,0.0547,-0.1801,-0.0595,-0.0241,-0.2221,-0.4319,-0.1073,0.0748,-0.1576,-0.0644,-0.1113,0.0384,-0.0228,0.0305,-0.0182,-0.0024,0.0064,-0.0479,0.0178,0.0087,0.0237,0.0157,0.0739,-0.0142,0.0216,-0.0663,0.1191,0.0537,0.0024,0.0941,0.0745,0.0481,-0.0426,0.0714,0.0083,-0.0238,0.0851,-0.0023,0.058,0.0238,-0.0322,-0.0136,0.0376,-0.049,0.0734,-0.0132,0.0375,-0.1023,-0.0084,0.0966,-0.0745,-0.0796,-0.0231,-0.0934,0.1563,0.0763,-0.0699,0.1625,-0.1224,-0.047,-0.1112,0.0608,-0.0062,-0.0261,0.0013,-0.0631,-0.0378,0.0574,-0.1087,-0.1142,-0.0875,0.0057,-0.0998,-0.1565,-0.1407,0.072,0.0375,0.0505,0.0171,0.0126,0.0179,0.126,0.0511,0.0024,-0.0485,0.0108,-0.107,0.1996,0.0872,0.0389,-0.1375,0.0012,-0.0404,0.0067,0.0251,0.0202,-0.0023,0.0135,0.0505,0.0362,-0.0457,-0.0378,0.0501,0.0594,0.0505,-0.0333,0.0147,0.0018,-0.2754,0.0815,0.1258,0.0813,-0.2918,-0.184,-0.1176,0.0955,-0.0264,-0.065,-0.0031,-0.1305,-0.2346,-0.1576,0.0063,-0.0578,0.0117,-0.0634,0.0801,-0.0559,0.201,0.0665,0.1384,0.0998,0.0536,0.0151,-0.0179,-0.1163,0.0666,-0.0673,-0.0563,-0.1641,0.0455,-0.0492,0.0244,0.0089,-0.0843,-0.0771,-0.1775,-0.1496,-0.2648,0.1859,0.1229,0.1529,0.0537,-0.0953,0.074,0.1157,0.1188,0.0864,0.0977,-0.0935,-0.0292,-0.1722,-0.0153,-0.0305,-0.153,-0.0591,0.0557,0.0137,-0.0807,0.0625,0.0447,0.1383,0.0721,0.0987,0.0567,-0.0268,-0.0556,0.0208,-0.0573,-0.0538,0.0058,0.2344,0.1224,0.1681,0.1205,0.0502,0.02,-0.0025,0.1146,0.1699,0.0545,0.026,0.053,-0.0094,-0.0374,0.073,0.0359,0.0415,0.1415,0.0198,0.0508,-0.0573,-0.0131,-0.0147,0.2637,-0.0068,0.0854,0.1173,0.2925,-0.0852,0.1249,0.0386,0.0325,-0.0113,-0.0161,0.0035,0.081,0.0514,0.1991,-0.0587,0.084,-0.2576,0.044,-0.0201,0.0765,-0.0415,-0.093,-0.2884,0.0934,0.0626,-0.0983,-0.1709,0.1581,0.1792,0.1309,0.0054,0.0987,0.1299,0.1385,0.0993,0.1285,-0.0264,0.0364,-0.0046,0.2114,0.0838,0.0037,0.0608,0.047,0.0733,0.0691,0.0837,-0.0828,-0.0044,-0.0085,0.0274,0.1514,0.1414,0.0721,0.1123,0.0132,0.1901,0.1489,-0.0154,-0.2021,-0.1736,0.0553,0.0873,-0.0044,-0.1402,-0.1132,-0.176,0.1999,0.2307,-0.0225,-0.0569,0.0009,-0.028,-0.0278,0.058,-0.0408,0.0009,0.0437,0.1091,-0.0592,0.0702,0.1105,0.037,0.0709,-0.0611,-0.0107,-0.0929,-0.2095,-0.1502,0.0179,0.2015,0.1847,0.0944,0.107,0.2192,0.14,-0.1142,0.0507,0.0519,-0.2938,-0.1606,-0.1523,-0.3193,-0.1041,-0.1476,-0.2098,-0.104,-0.1003,-0.0686,-0.1517,-0.1692,-0.2253,-0.3236,-0.2272,0.2248,0.0323,-0.0343,-0.1297,0.0965,0.1297,-0.0381,0.067,-0.021,-0.1802,-0.1136,0.0631,0.0505,-0.0278,-0.0363,0.0017,-0.1671,0.0436,0.0629,-0.0286,-0.0795,0.0741,0.0555,0.0107,-0.0554,-0.0352,0.0216,-0.036,0.049,-0.0218,0.3257,0.1432,0.1374,0.1318,0.147,0.1397,0.1931,0.121,0.1028,0.0929,0.0584,-0.0273,-0.1748,0.0734,0.2326,-0.191,-0.0484,-0.06,-0.0338,0.0492,-0.1331,0.0948,0.0766,0.0693,0.0498,0.0858,-0.0628,0.0207,-0.1774,-0.095,-0.0909,-0.0328,0.0921,-0.0201,0.0813,0.2042,0.1394,0.1514,0.0829,-0.0588,0.0062,0.0689,0.0037,0.0454,-0.0383,-0.0515,0.1061,0.0164,0.0785,0.0542,0.0543,0.0227,-0.0055,0.06,0.0621,-0.0613,0.0233,0.0406,0.0115,0.0313,0.0347,0.0626,0.0774,0.0949,-0.2355,-0.3295,-0.3001,0.0063,-0.1995,0.0046,0.0735,0.0949,-0.1331,-0.2478,-0.0353,-0.1374,-0.0555,-0.1329,0.0634,0.0585,0.0839,0.0171,-0.0415,-0.0326,0.014,0.0313,-0.0081,0.0026,-0.1047,-0.0955,-0.0876,0.0355,0.0332,0.0136,-0.0142,-0.0355,-0.0135,0.188,0.0759,0.0397,0.0991,0.081,0.0646,-0.0061,0.0123,-0.0571,-0.0189,0.0465,-0.1817,-0.2339,-0.0784,-0.0533,-0.0687,-0.0024,0.0627,0.0127,-0.0186,0.0719,0.0789,-0.0028,0.1387,0.2101,0.1893,-0.1291,-0.0893,-0.0692,-0.1059,-0.1244,-0.2013,-0.0693,-0.0216,-0.0832,0.0627,0.1501,0.1671,-0.0954,-0.0373,0.1142,-0.1102,-0.0376,-0.1549,-0.1461,0.0914,0.0798,0.0445,0.0272,-0.2446,0.0479,-0.0077,-0.0234,0.0933,-0.0108,-0.0383,0.0323,-0.0866,-0.0603,0.1832,0.0539,0.1698,0.143,0.1118,-0.0266,0.0622,0.0126,-0.1122,-0.0506,-0.0894,-0.5054,-0.4541,-0.2162,-0.2768,0.0888,-0.2095,-0.0769,-0.3385,-0.2923,-0.2926,-0.0798,-0.1006,-0.045,-0.2161,-0.1123,-0.0675,-0.0603,-0.0239,-0.0533,0.0452,-0.013,0.0532,-0.053,-0.0312,-0.0386,-0.0183,0.0382,-0.1263,-0.0023,-0.0127,-0.0497,0.1404,0.1151,0.1222,0.0618,0.1676,-0.0785,0.0722,0.0754,-0.0207,-0.1142,-0.0648,0.1931,-0.04,0.0535,0.1709,-0.0058,0.0358,-0.0182,-0.0761,-0.021,-0.1343,-0.2594,-0.2439,-0.0366,0.0032,-0.1724,0.0556,0.0739,-0.0559,0.0556,-0.0117,-0.0561,-0.0049,0.079,0.1264,0.1746,0.2177,0.2029,0.1192,0.0261,0.1337,0.0253,0.0238,-0.0469,-0.0148,0.0049,-0.0075,0.0112,-0.1341,0.1083,-0.0766,0.1115,0.0952,0.1707,-0.0958,0.0472,0.1177,0.0337,-0.3164,0.0044,0.0056,0.0016,-0.0156,-0.006,-0.0191,-0.0432,-0.0097,0.0685,-0.0226,0.0445,0.1556,-0.0206,0.0015,-0.1486,0.0368,0.2009,0.1184,-0.0111,0.0833,0.0121,-0.0069,0.109,0.0196,-0.0882,-0.0818,-0.1819,0.2973,0.1259,0.0431,0.23,0.1499,0.0807,0.1368,0.1368,0.0698,-0.0133,-0.0943,0.1374,0.0754,-0.0427,0.0139,-0.0384,0.0534,0.2568,-0.1439,0.047,-0.0348,0.0376,-0.3949,-0.031,0.0525,0.162,0.0136,0.0373,0.0397,0.0218,-0.319,-0.114,-0.2188,-0.294,-0.2292,0.0184,-0.0054,-0.2153,-0.0967,-0.0105,0.0567,0.0741,0.03,0.1094,0.045,-0.0115,0.0357,-0.0784,-0.0002,0.067,-0.1017,0.0331,0.0836,-0.0595,-0.0129,0.077,0.0077,0.1157,0.0381,-0.0235,-0.1973,0.0939,-0.4153,-0.3699,-0.1903,-0.2726,-0.2503,0.0514,-0.006,0.0831,-0.0734,-0.0452,0.0186,-0.0778,0.0645,-0.0551,-0.061,-0.0635,-0.0177,0.0676,-0.0424,0.0174,0.028,-0.1101,0.0674,-0.1398,-0.0658,-0.1221,-0.0089,-0.1227,0.0271,-0.1168,0.0453,0.1116,0.0156,0.0005,0.0232,0.1255,0.0776,-0.0014,-0.1104,-0.0506,-0.0195,-0.0277,0.0287,-0.0077,-0.0634,-0.0187,-0.1047,-0.031,-0.0295,-0.0193,-0.0452,0.0129,-0.0373,-0.0505,0.0017,0.0474,0.0572,0.0359,0.0605,-0.0335,0.0072,0.0614,-0.0088,-0.0797,-0.0155,-0.042,-0.0925,-0.1681,-0.1037,-0.0216,0.0332,0.0494,0.0055,-0.1034,0.0294,0.0132,0.0354,0.0613,-0.0599,0.054,0.1709,0.1215,0.1151,0.1371,0.0622,0.034,0.0074,0.1768,0.1139,0.1405,-0.0123,0.0747,-0.0451,-0.0056,-0.0348,-0.0922,0.0984,0.1216,0.0476,0.008,0.0376,0.0713,-0.0798,-0.0565,0.055,-0.0248,0.0253,0.0296,-0.0387,-0.019,-0.0036,-0.011,0.0247,0.142,-0.0011,0.1433,0.1694,0.0494,0.0627,-0.1099,-0.2251,-0.1653,-0.1344,-0.1443,0.1123,0.1779,0.0614,-0.0498,-0.0512,-0.0328,0.0005,0.0464,0.0237,0.0903,0.0383,0.0936,0.105,0.0421,0.0454,0.0375,0.1206,0.0888,0.0546,0.0162,0.0515,0.0578,0.0173,0.1043,0.0718,0.0434,0.0504,0.0033,-0.0552,-0.2206,-0.1069,-0.0281,0.0641,0.0652,0.101,0.0675,0.0157,0.2029,0.024,0.0229,0.0177,0.0704,-0.0142,-0.0087,0.023,0.0786,-0.0546,0.1591,0.0669,0.144,0.1182,-0.0638,0.1196,0.1043,0.2227,0.0822,-0.0707,-0.2362,0.1074,0.0904,-0.0079,-0.0365,-0.0002,-0.027,0.1066,0.1519,0.0709,0.1067,0.0317,-0.0464,-0.0034,0.0142,-0.0006,-0.0682,-0.0172,-0.0961,-0.1258,0.0718,0.044,-0.0443,0.0276,-0.0238,0.1076,0.0891,0.1121,-0.1025,-0.0145,-0.0074,-0.0521,-0.017,-0.1051,-0.1163,0.0206,0.0876,0.1311,0.0493,0.0455,-0.2475,-0.216,-0.0583,0.0403,0.0437,-0.0793,-0.2529,-0.1095,-0.159,-0.0983,0.1743,0.0176,0.0323,0.0024,0.1281,-0.0365,-0.0619,-0.1304,0.0085,-0.0548,-0.0086,0.0702,-0.0197,-0.0323,0.1065,-0.2198,-0.0423,0.0009,0.0101,-0.0403,-0.0022,0.0585,0.0027,0.0228,-0.0617,-0.2269,-0.1432,-0.1635,0.1774,-0.0581,0.0595,0.0266,0.0615,0.2565,0.2538,-0.036,-0.0448,-0.1529,0.0853,-0.0563,0.0636,0.0912,0.0997,0.1207,-0.0239,0.073,-0.0231,-0.0033,-0.1105,-0.0123,0.1499,0.0645,0.0906,0.0894,-0.0758,0.1408,-0.0026,0.2359,0.0717,0.0599,0.0429,0.0218,-0.0075,-0.049,-0.0777,0.0663,-0.2285,0.0936,-0.181,-0.1094,-0.1183,-0.0266,0.0278,-0.1317,-0.3086,-0.275,0.1725,0.1105,0.0469,0.0713,0.17,0.0712,0.0577,0.1645,0.118,0.0174,0.1446,-0.0306,0.0473,0.0318,0.0259,0.1511,0.0622,0.0939,0.2194,0.1061,-0.1249,0.0947,0.1944,0.0865,-0.1107,0.025,-0.0438,-0.0578,-0.0413,-0.0681,-0.0624,0.0924,0.1051,0.0768,0.0683,-0.0021,-0.1083,-0.099,-0.0275,-0.0302,-0.1721,-0.1027,-0.1734,-0.136,-0.0505,0.1855,0.1966,0.134,0.1207,0.0798,0.0599,0.1404,0.0642,-0.0337,-0.0264,0.0005,0.0073,0.0314,0.1259,-0.1731,-0.0905,-0.1326,-0.11,-0.0412,-0.1101,0.0802,0.0143,0.0573,-0.0886,-0.1521,-0.1703,0.0015,0.023,-0.2541,-0.2246,-0.2792,-0.1629,-0.0214,0.0989,-0.0087,-0.015,-0.0157,0.0354,-0.0395,-0.0995,-0.06,-0.0319,-0.0455,0.0614,0.0306,0.1591,0.1009,0.0737,0.0422,-0.1953,0.0271,-0.1015,-0.1349,-0.1164,0.0619,0.0683,-0.1202,-0.0889,-0.1333,-0.2185,-0.1087,-0.1684,-0.0363,-0.0366,0.0247,0.0435,-0.0837,-0.0631,-0.0104,-0.0546,0.0444,0.0033,-0.0179,-0.0081,0.0597,0.0044,0.0199,0.0855,-0.0313,-0.042,0.0012,0.0767,-0.0331,-0.0252,-0.2027,-0.0825,0.0444,-0.0463,-0.0413,0.0579,-0.0908,-0.1185,-0.0779,-0.0272,-0.0538,-0.048,0.0574,0.0599,-0.0734,-0.0501,-0.1779,-0.1,0.022,0.0873,0.1063,0.0029,-0.0627,-0.2826,0.0691,0.0315,0.0452,0.0806,0.285,0.1471,0.1439,0.141,0.0773,0.1326,0.0811,-0.1061,-0.0962,-0.0713,-0.0635,0.0708,-0.0483,0.0466,0.0561,0.0528,-0.1479,-0.0653,-0.0046,-0.3574,-0.3142,-0.1627,-0.0561,-0.0924,0.056,0.0722,0.0164,0.0319,0.0385,-0.1243,-0.061,0.0451,0.0306,-0.0413,-0.0857,0.0866,0.1175,0.1165,0.0707,0.0541,0.0407,-0.0009,0.0396,-0.0685,0.0555,0.0242,-0.2939,0.027,0.1618,0.0366,-0.093,-0.1145,0.0924,0.0653,0.2954,0.2135,0.1335,0.1872,-0.1098,0.1164,0.0854,-0.0588,0.048,-0.0877,-0.0569,-0.0823,0.0071,-0.073,-0.1898,-0.1632,-0.1968,-0.0149,-0.0376,-0.1534,-0.0011,-0.0007,-0.0245,-0.0128,-0.1593,-0.1325,0.1065,0.1865,0.1365,0.043,0.0958,0.02,-0.0631,-0.0183,0.0103,-0.0368,-0.0891,-0.069,0.176,0.0615,0.1344,0.0441,0.0807,0.1297,-0.051,0.0762,-0.0161,0.108,-0.0018,-0.0008,0.0496,0.1204,-0.0138,0.165,-0.0762,0.0969,0.1283,0.0549,0.0547,-0.03,-0.0729,-0.0794,0.0806,0.0886,0.032,-0.0347,-0.0412,-0.0433,-0.0321,-0.2652,0.0641,0.1077,0.0217,-0.1313,0.0457,0.0374,0.0787,-0.0939,-0.0299,0.0777,-0.1683,-0.3474,-0.4166,0.031,0.0642,0.0127,-0.1267,-0.0759,-0.2156,-0.0159,-0.3997,0.1058,-0.3017,-0.2726,-0.0872,-0.0723,-0.029,0.0088,-0.0343,-0.2355,-0.2389,-0.1109,-0.0032,-0.0036,0.1206,-0.0311,-0.1573,-0.1435,0.1631,0.131,0.1657,-0.0242,0.0874,0.0145,0.0331,-0.0481,-0.0184,0.0358,0.1109,0.1329,-0.2249,0.0849,0.0945,-0.2337,-0.2401,-0.0716,0.0567,-0.1634,-0.3293,-0.1143,-0.1292,-0.1144,0.001,-0.0555,-0.1212,-0.1866,0.0347,-0.1647,-0.0848,-0.1155,-0.0185,-0.3857,-0.0776,0.1093,0.0665,-0.0055,0.2013,0.0891,0.0996,0.0414,0.0671,0.1218,0.0054,0.1864,0.1383,0.0449,0.0621,0.18,0.103,0.0056,0.0226,0.042,0.0856,0.0584,0.0834,0.0453,0.0291,0.1564,0.1253,-0.0924,-0.1137,-0.0126,0.0076,-0.0266,-0.0001,0.0565,0.0703,0.0949,0.0758,0.0619,-0.0078,0.1589,0.1971,0.0861,0.021,0.1205,0.1622,-0.0312,0.0671,0.0462,0.1047,0.1226,0.1162,0.0672,-0.0236,0.0045,-0.0121,-0.2051,0.0492,-0.0886,-0.1651,-0.0749,0.1052,-0.1512,0.1553,0.1467,0.0871,0.004,-0.0022,-0.013,-0.0951,-0.0959,0.045,0.1,-0.1471,0.0421,-0.0175,-0.1658,0.0718,0.0729,0.1144,-0.0264,-0.0537,-0.1236,-0.1371,0.2304,0.2058,-0.1369,-0.1666,-0.0203,-0.2041,-0.0038,0.0677,0.1253,0.1272,0.0272,0.1048,0.2084,0.0841,0.0687,-0.1054,-0.0221,-0.1488,-0.0029,-0.1827,0.0371,-0.0329,0.0002,-0.0466,-0.0715,0.0349,0.0049,0.0244,0.0218,-0.0958,0.0329,-0.044,0.0492,0.0502,0.0646,-0.0066,0.0109,-0.0212,0.0418,0.0436,0.1046,0.0374,0.0269,-0.0072,0.0109,0.0078,0.0375,0.0422,0.0677,0.0917,0.0159,0.0396,0.1227,0.1074,-0.1795,-0.1583,-0.0806,-0.0191,-0.0462,0.0727,0.0894,-0.0155,0.0795,-0.0938,-0.0839,0.1508,0.1341,-0.0461,0.1094,0.0037,0.0452,0.0472,-0.1053,0.2325,-0.0678,0.1033,0.0109,-0.013,0.1768,0.1523,0.0879,-0.0245,0.0358,0.0925,-0.0174,0.0815,0.0328,-0.0728,-0.0224,-0.0208,-0.0289,-0.0146,-0.0312,0.1486,0.0486,-0.0055,0.0867,-0.0479,0.1456,-0.356,0.1499,0.0206,-0.098,-0.0533,0.2017,0.1771,-0.0194,-0.1324,-0.0095,-0.0912,-0.0352,0.0049,-0.1151,0.0196,0.0065,-0.0711,-0.0817,-0.0137,0.0272,0.0927,0.0425,0.0399,-0.0968,-0.086,-0.1838,-0.1548,-0.0493,-0.0164,0.04,-0.0205,-0.0536,-0.1729,-0.111,-0.0399,-0.1747,-0.0661,-0.0646,-0.0368,-0.0686,-0.2769,-0.0604,-0.2282,-0.2891,-0.2822,0.1233,0.0349,0.1487,0.0206,0.0607,0.2283,0.1306,0.1131,-0.1897,-0.0639,0.2492,0.211,0.097,0.0028,0.0246,0.1774,-0.0823,0.0147,-0.0057,-0.025,0.015,-0.0253,-0.0023,0.0878,0.1267,-0.0509,0.187,0.1851,-0.0674,-0.0475,-0.0422,0.0597,0.0556,0.1151,-0.222,-0.1594,0.1288,-0.0184,-0.0346,0.0694,0.0274,0.0377,0.104,-0.3382,-0.3412,0.0851,0.0623,0.0305,0.089,0.034,0.1254,0.0078,-0.0553,0.1259,0.0943,0.0326,-0.0089,0.0186,-0.0241,potential monetary loss
trm_557b493133416,0.1347,0.1051,0.1295,0.2035,0.0423,0.0321,0.0784,0.0885,0.0317,0.0985,0.0045,-0.0072,0.0887,0.0278,0.1191,0.0503,0.1099,0.1724,0.0888,0.01,0.0976,0.0329,0.0197,-0.0515,0.0303,0.0018,0.003,0.1296,0.1216,0.0556,0.097,0.1187,0.0819,0.1298,0.0898,0.1405,0.0331,0.0665,0.1444,0.0462,0.1205,0.1016,0.0517,-0.0907,0.1041,0.0772,-0.2025,0.0981,0.0036,0.1392,0.0621,-0.019,-0.0233,0.0652,0.0966,0.0706,0.0977,0.0019,-0.0408,0.0155,0.0213,-0.0008,0.1549,-0.0469,0.0363,-0.0582,0.2318,0.2642,0.1612,-0.0287,-0.0717,0.0157,-0.1125,0.0398,0.1852,-0.1033,0.0997,-0.0185,-0.0568,-0.033,-0.0621,-0.0277,0.0468,0.1304,0.0012,-0.0463,0.0311,-0.0233,-0.0292,0.1276,0.0614,0.0566,-0.0295,-0.1812,-0.237,-0.2132,-0.1477,-0.0475,-0.1597,-0.0493,-0.0754,0.0365,-0.0386,-0.0561,-0.0804,0.1404,0.1389,-0.2526,0.063,0.0529,0.021,0.1218,-0.064,-0.1641,-0.0291,-0.0261,0.1376,-0.0556,0.0417,0.0918,0.1317,0.1666,0.1334,-0.0111,0.1312,0.1099,0.142,-0.0427,-0.0711,-0.0372,-0.028,0.0918,-0.0429,0.1374,0.0358,0.2155,0.0383,0.0854,0.0222,0.0047,0.1068,0.1536,-0.1134,0.0559,0.1184,-0.0398,0.1231,0.0078,0.0684,-0.0948,0.0735,0.099,0.1063,0.1686,-0.1198,0.033,-0.0809,-0.003,-0.0382,0.0539,0.0851,0.0903,0.2313,0.2049,-0.0065,-0.0581,0.0125,0.1496,0.1439,-0.0414,0.0161,0.1397,-0.0629,0.0615,0.1023,0.0972,0.0609,0.0889,0.0082,0.0401,0.1024,-0.1187,0.0771,0.0273,0.0733,0.0769,0.0188,-0.0323,-0.0617,0.1411,0.1284,0.0659,0.0132,0.1805,0.1563,0.2802,0.2837,0.0077,-0.0332,0.1318,0.0726,-0.1633,0.1424,0.1464,0.1002,0.0216,-0.0187,0.1243,0.1001,0.0376,0.1335,-0.0012,-0.0593,0.0017,-0.071,-0.0362,-0.1086,0.1173,0.1343,-0.0174,-0.1301,0.0924,0.1101,0.0636,-0.0327,-0.0442,0.1146,-0.1287,-0.0213,-0.0406,0.0029,0.0631,-0.1397,0.1465,0.1449,-0.0591,-0.0368,-0.0366,-0.0028,0.0272,0.046,0.1555,0.0726,0.017,0.1253,0.0687,0.0437,0.1709,0.0661,0.1056,-0.0403,-0.0617,-0.0012,-0.0689,0.0224,0.1351,-0.0132,0.1035,-0.2097,-0.2312,-0.0624,-0.1407,0.1444,-0.013,-0.1194,-0.1757,-0.0135,0.0316,-0.1021,-0.0212,0.0651,0.0472,0.0475,-0.0435,0.0094,-0.1779,0.0384,0.0631,0.0897,-0.0158,-0.1164,-0.0296,-0.0228,0.1678,0.1199,0.0607,-0.1002,-0.1614,0.1148,0.0942,0.0465,0.05,0.0437,0.0674,0.0991,0.0587,-0.0188,-0.0506,0.064,-0.049,-0.0793,0.1975,0.0965,0.0467,0.0834,0.083,0.1191,0.0776,-0.0275,-0.0068,-0.0032,0.017,0.1998,-0.0141,-0.0122,0.0766,-0.0811,-0.0543,-0.0271,0.1608,0.0109,-0.0222,0.0733,0.1048,0.0786,0.11,-0.0165,0.0081,0.0681,0.0962,0.0049,0.0989,0.0156,-0.028,-0.016,-0.0511,-0.0858,0.0416,-0.1155,0.1598,0.1591,-0.0377,-0.0012,0.0274,-0.1002,-0.0105,0.2023,0.1484,0.1402,0.0729,0.0262,-0.2409,0.0535,-0.0101,-0.0128,0.0681,0.0764,0.0823,0.1414,0.0983,-0.0059,0.021,0.0769,0.0516,0.0316,-0.0673,0.156,-0.0158,-0.1017,0.1345,-0.0089,-0.0043,0.0236,-0.1434,0.14,0.0152,0.0687,-0.1008,-0.3041,-0.1773,-0.3246,0.021,0.1814,0.0848,-0.0685,-0.1019,0.0443,0.0032,-0.0063,0.0707,0.0343,0.0438,0.098,0.0297,0.0091,0.0384,0.0785,0.136,0.1037,0.0867,0.0619,-0.0402,0.0047,0.0333,-0.0035,-0.009,-0.1008,-0.0163,0.1068,0.0364,0.0502,0.1408,0.0611,-0.2865,0.0671,0.0384,-0.2549,0.0768,0.1514,0.1116,0.031,0.2183,0.144,0.3957,0.3274,0.1826,0.2206,0.0944,0.1534,0.1757,0.0349,-0.0951,0.0051,0.0155,-0.0175,-0.0484,-0.0701,-0.0352,0.2704,0.1623,-0.1415,-0.046,0.0402,-0.1033,-0.0265,0.0827,-0.059,-0.1079,0.1155,0.2179,0.1452,-0.0126,0.1144,0.1321,0.0778,0.1427,-0.0686,0.1243,0.0767,0.0531,0.0467,0.1275,0.0102,-0.0795,0.0919,0.118,-0.0309,-0.2865,0.0732,0.0192,0.0307,-0.0329,0.0279,-0.0092,-0.0557,0.0847,-0.0166,-0.0381,0.0038,0.0683,-0.0804,0.0468,0.0246,-0.0552,-0.0097,-0.083,0.0274,0.0228,0.1052,0.047,-0.1931,-0.0611,0.1205,0.1648,-0.0641,-0.0887,0.0442,0.0762,-0.0466,0.1348,0.1203,-0.0001,0.1099,0.1344,0.1311,0.0711,-0.0626,-0.0631,0.0639,-0.0999,0.1766,-0.0225,0.0395,0.0202,-0.1072,-0.0392,0.14,0.118,-0.1044,0.07,0.0932,0.0867,-0.1111,0.0588,-0.1128,-0.0361,-0.0938,-0.1598,-0.1023,-0.0608,0.0808,-0.0035,0.0516,0.2191,0.0281,-0.034,0.1461,0.1285,0.0584,0.0922,0.0042,-0.0466,-0.0303,0.0208,0.0813,-0.0067,0.0544,-0.0652,-0.0371,0.0726,-0.0877,0.0357,0.0455,0.0242,0.0003,0.0923,-0.0936,-0.0651,-0.094,0.0544,0.0487,-0.0111,0.0662,-0.0306,0.0268,-0.0837,-0.0999,-0.0467,0.0295,0.032,0.0904,-0.0021,0.1529,0.0062,-0.0554,-0.0255,-0.0948,-0.0234,-0.0698,-0.0455,-0.0369,0.1144,0.031,0.0685,-0.0056,0.0299,0.1135,0.0021,-0.0392,0.0527,0.0824,0.0899,0.0078,-0.0294,0.1288,0.0916,0.2266,0.0351,-0.1071,0.0452,-0.0862,-0.0531,-0.0147,-0.0899,-0.0342,-0.0187,-0.0054,0.1421,0.1345,0.049,0.1777,0.0503,-0.0365,0.0047,0.2337,0.0659,0.0627,0.0294,-0.0316,0.1727,0.1083,0.2115,-0.0769,-0.0219,0.0429,-0.0328,0.1414,0.0629,0.1321,-0.01,-0.0379,0.0032,0.0178,0.0651,0.1518,0.003,0.0112,0.0659,0.0789,0.0595,0.0639,-0.059,0.0101,-0.0067,0.1417,0.0339,0.1943,0.1086,-0.0469,0.1691,0.1,0.1327,-0.0439,0.0923,0.0021,0.088,-0.0303,0.085,0.0451,0.1302,0.1652,-0.0503,-0.1683,0.0271,-0.058,-0.0384,0.0801,0.1108,0.0438,0.1032,0.0342,0.0341,0.0655,0.0254,0.0673,0.1085,-0.179,0.0739,-0.0802,0.0679,-0.0036,-0.0869,-0.074,-0.0219,-0.1663,0.1761,0.0926,-0.0629,-0.0139,-0.0013,0.0257,-0.067,-0.0382,-0.076,0.024,0.0292,-0.0335,0.0311,0.0822,0.0798,0.0249,0.0025,0.0439,0.0719,0.0726,0.077,0.1301,0.1357,0.1032,-0.0231,-0.1147,0.0524,0.1323,-0.0913,0.0495,0.0182,0.0812,-0.085,0.097,-0.0234,-0.1434,0.0516,0.2758,0.2841,0.1466,0.0446,0.0424,0.1371,0.0185,0.0516,-0.1208,0.0037,0.0589,0.0562,-0.0067,-0.0423,0.1343,-0.0161,-0.06,-0.1115,0.1076,-0.0289,0.1283,-0.0763,-0.0207,0.1121,-0.095,-0.0972,0.0374,-0.004,0.0281,-0.1286,0.1667,0.224,0.1954,0.152,-0.0757,-0.2331,0.0035,0.1107,-0.0259,0.0089,-0.0488,-0.0819,-0.0277,-0.0312,0.0511,0.0889,0.0479,-0.0648,-0.1072,-0.1425,0.0487,0.0347,-0.0317,0.0762,-0.0544,0.0659,0.1086,0.0444,0.1187,0.1032,0.0697,-0.1016,-0.1026,-0.0389,0.001,0.0323,0.0367,-0.0918,0.0106,0.1128,-0.1051,0.018,-0.0436,-0.0183,-0.0843,0.0398,-0.0405,0.1593,0.1704,0.0127,-0.1364,-0.1706,0.0078,-0.0346,-0.0775,0.0096,-0.0109,-0.1898,-0.0023,-0.0264,-0.1489,-0.1693,-0.092,0.0034,-0.197,-0.1561,0.0655,-0.0444,-0.0649,0.2113,0.1348,0.0491,0.0724,-0.1208,0.2701,0.1225,0.1523,0.1231,0.14,-0.062,0.0122,-0.1699,0.0992,0.0917,0.0806,-0.0289,-0.0376,-0.0417,-0.0549,-0.0743,-0.0547,-0.0176,0.0185,0.0094,-0.0383,-0.0856,0.0769,-0.0479,-0.0361,-0.0171,0.0422,0.0922,0.0414,-0.03,0.1656,0.2562,0.1607,0.0037,-0.0982,-0.0518,0.0031,0.0306,-0.1042,-0.0521,0.149,0.1255,0.025,0.1196,0.0086,0.1238,-0.0468,0.0922,-0.0748,0.1422,0.0744,0.1313,0.1754,0.1323,0.0783,-0.1534,0.1241,0.1198,0.0816,-0.0503,0.0022,0.1501,0.0717,0.1292,-0.0222,0.0217,-0.1735,-0.1154,-0.0372,-0.0739,0.2029,0.0452,0.0347,-0.0992,0.1198,0.0189,-0.1168,-0.0087,-0.0345,-0.3311,-0.0715,0.0474,0.0854,0.0765,0.0823,0.0243,0.0344,-0.1093,-0.1736,0.0093,-0.0327,0.1059,-0.0647,-0.1509,0.0426,0.0361,0.0653,0.0706,0.1044,0.0739,0.0465,-0.0482,-0.0112,0.0841,0.0306,-0.152,-0.0324,0.1145,0.0222,-0.0936,0.0307,0.0382,0.0194,0.1418,0.149,0.1084,0.1008,0.0954,-0.0354,-0.0158,0.0303,0.127,-0.001,0.0972,-0.0213,0.0723,0.0221,-0.0303,-0.0189,-0.0836,-0.0644,0.0195,-0.0451,0.0338,-0.0544,-0.1063,-0.0858,-0.1211,-0.0574,0.0617,0.0403,0.0447,0.0018,-0.1051,-0.0609,-0.0844,0.0006,-0.0951,-0.0558,-0.1462,-0.023,0.0386,0.0572,-0.0722,0.0359,-0.0413,0.1557,0.0954,0.1194,0.0891,0.0779,-0.0837,-0.062,-0.0126,-0.072,-0.1705,-0.1433,0.0946,0.0294,-0.0058,0.0481,0.0008,0.0292,0.0407,0.108,0.1262,0.0707,-0.1134,-0.0961,0.1006,0.1194,0.0723,0.1742,0.0889,-0.1088,-0.0511,-0.0661,-0.1034,-0.0991,0.0655,-0.0218,-0.0717,0.033,0.0115,0.0089,-0.0293,0.0117,-0.0016,0.0142,0.0143,0.1301,-0.0069,0.0939,-0.0376,0.1592,0.0371,-0.0863,-0.1057,0.1334,0.0252,0.0878,0.1028,0.043,0.0343,0.0492,0.1006,-0.0113,0.0188,-0.0548,0.0495,0.0455,0.0254,0.0134,0.0083,0.0428,-0.0032,0.0825,0.085,0.0852,-0.1613,0.0234,-0.0668,0.1306,-0.2403,-0.1567,0.0282,-0.0247,0.0052,-0.0682,0.0236,-0.0428,0.1241,0.0832,-0.0164,0.0708,0.0776,0.015,0.0418,-0.1384,-0.1595,0.0758,-0.0038,0.044,-0.0761,-0.028,-0.0525,-0.0641,-0.0161,0.1078,0.0278,0.0497,-0.0441,0.0232,0.0451,-0.4973,-0.3063,-0.1676,-0.0416,-0.049,-0.0117,-0.1556,-0.1875,0.1646,-0.5042,-0.4869,-0.3606,-0.259,-0.4043,-0.1889,-0.1882,-0.1489,-0.0378,-0.1184,0.013,-0.0726,-0.0204,0.1143,-0.0947,-0.1161,-0.0658,-0.0923,0.0317,0.0786,-0.2071,-0.0593,0.0791,0.0328,0.1022,-0.1003,-0.0499,-0.1396,0.0551,0.1594,0.0115,-0.0799,-0.0839,-0.1494,-0.2125,0.0425,0.0567,0.071,0.0663,0.0862,-0.4795,0.1213,-0.1099,-0.095,0.0473,-0.0812,0.0366,-0.0718,-0.0703,-0.0454,-0.1499,-0.1045,0.0786,0.0154,-0.0108,0.0565,0.151,0.0204,0.0598,-0.0521,-0.0201,0.1004,0.0712,0.0851,0.0216,-0.0036,0.0271,0.106,-0.0306,-0.272,0.0052,0.0013,0.057,-0.1454,-0.0824,-0.0089,0.1831,0.1769,0.0312,0.1561,0.0921,0.0899,0.0775,0.0407,0.0345,0.0419,0.0188,-0.0029,-0.0622,0.0503,0.0347,0.1015,-0.0481,0.0308,-0.0093,0.0891,0.0087,-0.1257,0.0679,0.0861,-0.0541,-0.0423,0.0541,0.0867,0.0091,0.2094,0.1134,0.2466,0.0317,-0.0503,0.0946,0.0939,-0.038,0.057,-0.0301,0.1098,0.0161,0.065,0.1235,0.1451,-0.051,0.0179,-0.5692,-0.4815,-0.3545,-0.4996,0.1446,0.0483,0.1106,0.1239,0.1717,0.0339,0.0854,-0.2164,0.0742,0.0784,-0.0927,-0.0393,0.0317,-0.1095,0.006,-0.006,-0.0113,-0.0706,0.1022,0.0814,0.0643,-0.2386,0.0233,-0.0097,0.0834,0.0834,0.1677,-0.022,0.0108,-0.0076,0.0661,-0.0471,0.056,-0.2371,0.2567,0.2381,-0.0793,0.0171,0.1988,0.2047,0.1926,0.0633,0.0253,0.0413,0.0401,0.0094,-0.0804,-0.0489,-0.1452,0.0447,-0.1306,0.0694,-0.0297,-0.1058,0.0284,0.0459,0.0399,0.0431,0.0328,0.0614,-0.0234,-0.0433,-0.0317,-0.1083,-0.0521,-0.0895,0.0102,-0.1785,-0.0046,0.0175,0.0394,0.1246,-0.0164,0.1547,0.2698,0.0445,0.067,0.198,0.0183,0.0577,0.1445,0.0049,0.0762,0.029,0.1521,-0.0362,0.1082,0.1525,0.016,0.0227,0.0628,-0.2717,-0.1318,-0.018,-0.0655,0.002,-0.0036,-0.0123,0.0829,0.0794,0.0275,0.0753,-0.0022,0.0921,-0.0066,-0.0443,-0.0107,0.0035,0.0867,0.1092,0.0379,-0.0503,-0.0181,0.0515,-0.0004,-0.032,-0.0093,0.082,0.0622,0.1355,0.1199,-0.0475,0.1383,0.1532,0.0005,-0.0028,-0.095,0.0039,0.037,0.1307,0.1332,-0.0171,0.1121,0.0247,-0.0603,0.0776,0.0515,0.1584,-0.0301,-0.1181,-0.0877,-0.0443,-0.0427,-0.0027,-0.291,-0.0277,-0.0178,0.0202,0.1801,-0.1886,0.0208,-0.1254,-0.0166,-0.2351,-0.0426,0.073,0.0637,-0.1546,0.0867,-0.0444,0.0817,0.0112,0.1221,0.0646,0.0017,-0.0007,0.0497,0.0745,0.1194,-0.0177,-0.0633,0.0195,-0.0306,0.144,0.0033,0.0078,0.0842,-0.0629,0.0492,0.1051,0.0346,0.1094,0.1027,0.0977,0.049,0.0781,-0.04,-0.0317,-0.0977,0.0129,0.0457,0.0883,0.0642,0.0214,0.0461,0.183,-0.0602,0.072,-0.0426,-0.0292,-0.1043,-0.0759,-0.0322,-0.0529,0.076,-0.0071,0.0309,0.0179,0.1424,0.0331,0.085,-0.004,-0.0098,0.0765,0.0522,0.0619,0.0638,-0.107,-0.0629,0.0177,-0.4373,0.0157,-0.0102,0.0149,-0.2536,-0.0162,0.0283,-0.128,-0.2011,0.0756,0.0026,0.1004,0.122,0.0883,0.0387,-0.0424,0.0469,0.0945,-0.1541,-0.2339,0.0544,0.0781,-0.0099,0.0104,0.0048,-0.0373,0.1973,0.0949,0.0274,0.194,0.1492,-0.1739,-0.0747,-0.039,-0.0235,-0.1512,-0.0687,0.1839,0.099,0.0147,0.0522,0.1669,0.0544,0.0391,0.0054,0.1005,-0.1319,-0.0056,0.0151,-0.064,-0.0089,-0.1772,-0.0645,0.0421,-0.0762,0.0469,0.0696,0.068,-0.0015,-0.0786,0.0023,-0.0432,-0.1564,0.0011,-0.0062,0.0548,0.0743,0.0524,-0.2425,-0.2302,0.1332,0.1523,-0.018,0.0461,0.0614,0.0272,0.1488,-0.0519,0.0367,-0.0028,0.0117,0.0103,-0.1244,0.1183,0.0071,-0.132,0.0654,-0.0412,-0.1784,0.0021,0.072,-0.223,-0.0826,-0.0199,-0.1017,-0.0739,0.091,-0.0955,-0.0139,0.0975,-0.0119,-0.0889,-0.0472,-0.0839,-0.072,0.0385,0.021,0.053,-0.12,0.1381,-0.0211,-0.1371,-0.0146,-0.0041,-0.0019,-0.0068,0.1294,0.0224,-0.1215,0.0494,-0.0931,0.0537,-0.0843,-0.1525,0.0503,0.0346,-0.0164,-0.0935,0.0001,-0.0801,-0.0848,-0.0876,-0.0131,-0.2144,0.0548,-0.0499,-0.5747,0.1144,0.1445,0.0851,0.0358,-0.0581,-0.065,-0.1163,0.0768,-0.0157,-0.0184,0.0491,0.0236,0.0488,0.0475,-0.0058,-0.0108,-0.0427,-0.1082,-0.1534,-0.2218,-0.2394,0.07,0.0972,0.0715,0.0336,-0.1109,-0.1061,-0.0216,-0.0923,-0.1068,0.0092,-0.0621,0.0328,0.1872,0.1434,-0.0658,-0.0737,0.046,-0.0671,-0.0232,-0.1027,-0.0478,-0.0535,0.032,0.1064,0.0013,-0.0265,-0.0506,0.0823,0.086,0.1106,-0.0669,0.0609,0.0561,-0.0133,0.0847,0.0427,-0.0497,-0.0148,-0.0308,-0.0337,-0.0374,-0.0526,-0.0734,-0.025,-0.1214,-0.1075,-0.1314,0.0586,-0.0105,-0.053,0.0076,0.1143,-0.0161,0.1601,0.1154,0.0942,0.1211,0.0172,-0.1079,0.1357,-0.0343,0.0331,0.0454,0.0403,-0.0012,0.0841,0.0531,0.0137,-0.0176,0.0654,0.0329,-0.0943,0.0558,0.0263,0.2142,0.1263,0.1753,0.0183,0.0137,0.165,0.0614,-0.0371,0.1234,0.0406,-0.1558,0.0162,-0.0769,-0.0843,-0.042,-0.0773,0.0154,-0.0028,0.0188,0.0228,0.1645,0.0492,0.1212,0.0916,0.0362,-0.0439,-0.0768,-0.3321,-0.2685,-0.0401,-0.0671,0.0662,0.2869,0.1513,0.2152,0.1295,0.0101,-0.0208,0.0045,0.082,0.1715,0.1664,0.0713,-0.0895,-0.1111,0.0428,0.0692,-0.0123,0.0336,0.1666,0.1027,0.0537,-0.0541,0.0252,0.0394,0.2455,0.1391,0.115,0.1224,0.2764,-0.0113,0.021,0.0234,0.0908,0.0821,0.0826,0.0198,0.1705,0.0561,0.0932,0.0679,-0.0935,0.0233,-0.0259,-0.0122,0.1243,0.0883,0.046,-0.0214,0.0838,0.0441,0.1269,-0.044,0.1171,0.1143,0.053,0.1243,0.0631,0.1433,0.094,0.132,0.0199,0.0529,0.0006,0.0179,0.2443,-0.018,0.0614,0.1116,0.0528,0.1029,0.0146,0.1281,0.0952,0.0069,-0.178,0.0118,-0.0416,0.2031,0.126,0.1249,0.0612,0.1496,0.0846,-0.0272,-0.1405,-0.1284,0.0076,0.0779,0.0018,-0.1402,-0.1721,-0.1528,0.2727,0.2856,0.0939,-0.0631,0.0085,0.098,-0.0087,0.0411,-0.0754,0.0474,0.0629,0.0421,0.017,0.0576,0.1127,0.0111,0.1337,0.0226,0.0776,0.06,-0.1333,-0.1472,0.0986,0.1534,0.1218,0.139,0.0648,0.2049,0.096,-0.4027,0.0945,0.0925,-0.0453,-0.0316,-0.0175,-0.0293,0.0113,0.0097,-0.0893,-0.0124,-0.025,-0.0202,0.0444,-0.0288,-0.0105,-0.121,-0.2473,0.2012,0.0455,-0.0667,-0.3133,-0.0313,0.0408,-0.0923,-0.0054,0.0485,0.0237,-0.1646,-0.0056,-0.0731,0.0662,0.1192,0.1389,0.0256,0.0851,-0.0384,-0.2083,-0.2512,-0.0882,-0.1124,-0.0712,-0.0568,-0.0909,-0.0912,0.0133,-0.0004,-0.0512,0.2324,0.0904,0.143,0.0769,-0.0449,0.1395,0.1354,0.088,-0.0013,0.0837,0.1535,0.0676,0.0782,0.141,0.2554,-0.0222,0.1926,0.0347,-0.0669,0.1226,-0.0267,0.1843,0.0747,0.0259,0.0761,0.096,0.0138,0.0941,-0.1146,-0.0568,-0.1092,-0.0017,0.1035,-0.0236,-0.0259,-0.0209,-0.092,-0.0032,0.0297,-0.0437,0.0439,0.0816,0.1461,0.0955,0.0251,0.0393,-0.0265,-0.0186,0.0849,0.1107,0.058,0.0555,-0.0901,0.1173,0.052,-0.072,-0.0688,0.0072,-0.0535,-0.0587,0.1876,0.0767,0.1629,0.1283,-0.0344,-0.0966,-0.0896,0.0915,-0.4947,-0.3437,0.1731,0.1244,-0.5282,-0.2572,-0.0659,-0.197,-0.2616,-0.2122,0.1343,0.1296,0.0725,0.1218,-0.5551,-0.4474,-0.3617,-0.043,-0.1029,-0.3092,-0.5281,-0.5449,-0.505,-0.0572,0.0021,0.0695,-0.0356,0.0336,-0.0028,0.124,0.0321,0.0324,0.0537,0.1563,0.1426,-0.1091,0.0299,0.0557,0.0733,-0.0764,-0.0318,-0.0888,0.0054,0.0124,0.0835,0.0359,-0.0203,0.014,0.0953,0.0931,0.082,0.0069,0.1324,0.1939,0.1771,0.0204,0.0417,0.0276,-0.1885,-0.027,-0.0724,-0.0713,-0.0672,-0.3236,0.0566,0.159,0.2319,-0.0009,-0.0543,-0.0243,-0.1015,-0.0747,-0.1092,-0.0127,0.1412,0.1409,0.0774,0.0692,-0.0474,0.1831,0.1199,0.0023,0.0017,-0.1366,0.0834,-0.0039,-0.0516,0.0181,0.0294,-0.0336,0.062,0.1375,0.1528,-0.0029,0.0202,0.0453,0.0615,0.1072,-0.0816,-0.0837,-0.0628,-0.008,-0.097,0.0555,0.0432,-0.0431,-0.0456,-0.1019,-0.0611,-0.0231,-0.0251,0.0024,-0.0271,-0.0548,0.0588,0.063,0.0388,0.0124,0.0522,-0.0461,-0.0145,0.0194,0.0505,-0.0598,-0.0481,-0.0643,-0.1642,-0.0966,-0.2323,-0.207,0.1494,0.1512,0.1457,0.1252,0.1809,-0.1391,0.0085,-0.0043,0.0213,-0.1464,-0.0001,0.2173,0.0597,-0.0578,-0.0254,-0.0508,-0.0977,-0.1545,-0.1796,-0.3614,-0.4271,-0.0859,0.0531,0.0978,0.0892,-0.0545,0.1111,0.0968,0.1068,0.0008,0.0908,0.0196,0.0419,0.0707,0.0256,0.1465,0.1916,0.1532,0.0702,0.1026,0.1202,0.1258,0.1285,0.0243,0.0218,0.0075,0.008,0.0747,-0.1549,-0.1048,-0.1104,0.083,-0.1856,-0.1596,0.0721,-0.1359,0.1598,0.1048,-0.0034,0.0063,0.0155,0.0165,-0.0247,-0.0495,-0.0383,0.1113,0.0621,-0.0384,0.0014,-0.039,0.0914,-0.0695,-0.0301,-0.0018,-0.0515,0.1345,0.1191,0.0345,0.1122,0.0909,0.072,0.0519,0.0227,-0.0862,-0.0226,-0.0304,0.2469,0.1043,0.1562,0.1914,0.172,0.1326,0.1375,0.1375,0.0148,0.0514,-0.0183,0.151,-0.0523,0.0435,0.0502,0.0021,-0.0429,0.313,-0.1364,0.1085,0.0318,-0.074,-0.0776,-0.1552,-0.0802,0.0921,0.1243,-0.0589,-0.0961,-0.036,-0.0408,-0.0449,0.0271,-0.0771,-0.0613,0.0025,-0.0348,0.0219,0.0339,-0.023,0.193,0.1057,0.056,0.1049,0.0652,0.0582,0.0521,-0.0241,0.0496,0.0485,-0.0162,-0.1174,0.0513,-0.1372,-0.0918,0.2697,0.1105,0.3087,0.0992,0.0829,0.0326,0.0716,-0.1059,-0.094,-0.0141,-0.0767,-0.0653,-0.0117,-0.1538,-0.0518,-0.342,-0.1749,-0.0177,-0.0691,0.0775,-0.0524,-0.0377,-0.1004,0.0435,0.0148,-0.01,0.0086,0.0128,-0.0003,0.0765,-0.0031,0.0284,-0.0259,0.0061,0.0314,-0.212,-0.0046,-0.1161,-0.1592,0.041,-0.0679,0.0107,0.1034,0.1157,0.0608,-0.0593,-0.0655,0.0476,0.0572,0.0681,0.0022,-0.0636,-0.0953,-0.0025,-0.0011,-0.0354,0.0484,-0.0958,0.0907,-0.0504,-0.0069,0.0221,0.0706,0.0735,0.0746,0.0461,0.033,-0.0205,0.101,-0.0709,-0.0416,-0.208,0.0168,-0.0282,-0.0855,0.0611,0.0804,0.1057,0.1048,0.0837,0.0367,-0.0552,-0.0038,0.0413,-0.0218,-0.1538,-0.0869,0.117,0.0891,0.1762,0.1386,-0.0981,-0.0103,-0.034,0.1238,0.049,0.1402,0.0353,0.1183,-0.0115,0.014,0.0788,-0.1452,0.0502,0.0681,0.0331,0.0105,0.1295,-0.0084,-0.0392,-0.0074,0.1452,-0.0955,-0.0057,0.0882,-0.0522,-0.1155,-0.0252,-0.0308,0.1042,0.0832,0.1062,0.1578,0.1289,0.0901,0.1088,0.0145,-0.0018,-0.0689,-0.0548,-0.0826,0.1206,0.0887,-0.0944,-0.2022,-0.3141,-0.074,0.0245,0.0028,0.0616,0.1032,0.0386,0.1559,0.069,0.0796,0.0224,0.1043,0.1743,-0.2742,-0.0031,-0.0267,-0.2718,-0.0714,-0.1327,0.1408,0.0045,0.044,0.0144,0.0284,-0.008,-0.0019,-0.0551,0.0236,0.0416,0.053,0.0744,0.0049,0.068,0.1868,-0.0067,0.05,0.0459,0.008,0.0094,0.0103,-0.007,0.0746,-0.104,0.2098,0.0671,0.1159,0.1541,-0.0164,0.1639,0.0929,0.2254,0.1115,0.0334,-0.0061,0.1552,0.0363,0.1055,-0.0425,-0.017,-0.0005,0.1549,0.1737,0.0633,0.0399,-0.0666,-0.1154,0.0576,-0.0289,0.0693,-0.0701,-0.0398,0.0007,-0.0788,0.022,0.078,-0.0077,-0.0337,0.0677,-0.0245,0.0325,0.0395,-0.0142,0.0066,-0.1811,0.0524,-0.1992,-0.1711,0.0084,-0.0336,0.0064,0.1678,0.0675,0.01,-0.1975,-0.2689,-0.1226,-0.0533,-0.0423,0.0306,-0.0917,-0.1467,-0.07,-0.0365,0.1379,0.0256,0.1127,-0.0956,0.034,0.024,0.0347,0.036,-0.0749,-0.0119,-0.0902,0.0512,-0.1045,0.0272,0.1345,-0.0804,-0.1022,0.0066,0.0284,-0.136,-0.1708,-0.0532,-0.0675,-0.0566,0.0804,-0.0207,-0.1339,-0.1134,-0.0768,0.0011,-0.1691,0.0339,0.1591,0.3533,0.3415,-0.0735,-0.1018,0.0115,-0.0026,-0.0051,0.0487,0.0889,0.0983,0.1345,-0.0942,0.034,0.0143,0.0646,-0.0242,0.0364,0.1584,0.0342,0.1406,0.1513,0.0121,0.0255,-0.0162,0.2832,0.0949,0.0071,-0.0031,0.0067,-0.073,0.0633,0.1478,0.1332,-0.1892,0.1444,-0.0549,0.0418,0.0421,-0.0015,-0.0767,0.0199,-0.0331,-0.0205,0.0537,0.0548,0.0575,-0.0317,0.0833,0.1286,0.108,0.2052,0.0888,-0.0047,-0.0089,-0.0921,0.0426,0.0705,0.1188,0.1824,-0.1286,-0.1442,0.172,0.0387,0.0652,0.0993,0.2012,-0.377,-0.138,0.075,0.0206,-0.0601,-0.099,0.0747,0.0739,0.1761,0.2327,0.1082,0.12,-0.104,0.0039,-0.0081,-0.0359,0.0962,-0.0076,-0.4535,-0.1297,-0.143,-0.4057,0.2449,0.1853,0.1043,-0.0666,-0.0066,0.0181,0.0912,-0.0134,-0.051,0.1293,0.1019,-0.0312,-0.3115,0.0564,-0.0211,-0.0206,-0.0651,-0.0809,-0.1861,0.0124,0.0529,0.0452,0.0226,-0.0637,-0.075,-0.059,-0.0699,-0.0909,0.033,0.0036,-0.0351,-0.0159,-0.0071,0.1137,0.0069,0.0398,0.0195,-0.0091,0.0122,-0.0439,-0.0246,0.0288,-0.022,0.0747,0.0148,0.2078,0.1291,0.0459,0.1298,-0.3303,0.0021,-0.273,-0.0585,-0.0354,0.0142,0.0085,-0.0654,0.047,-0.0374,-0.1312,-0.0923,-0.0479,-0.0438,-0.0367,0.1086,0.0368,0.034,0.0174,-0.1688,-0.2232,0.0982,-0.0371,-0.0276,-0.0094,0.0117,-0.0701,0.0533,0.0997,-0.0449,0.0783,-0.1334,0.0435,-0.1587,-0.0792,-0.1074,-0.0378,-0.0199,-0.0362,0.034,0.0326,-0.0866,-0.1315,-0.0134,-0.0269,0.0372,-0.1383,0.0409,0.1015,0.0196,-0.11,-0.0897,-0.0242,0.1255,0.0669,0.121,0.0867,0.0076,-0.0393,0.0065,0.0431,0.1008,0.1121,0.0546,0.041,0.0739,0.0463,0.032,-0.0331,0.0964,0.0124,0.0504,0.0355,0.0658,0.0752,-0.0176,0.0712,0.0845,-0.0699,-0.093,0.0018,0.0769,-0.1277,-0.1866,-0.0617,0.0759,-0.0875,0.0266,0.0255,-0.0576,-0.0055,-0.0696,-0.2281,-0.2692,-0.0203,-0.0132,-0.056,-0.0276,0.0992,0.0244,-0.0055,0.0165,0.0467,0.0558,0.0126,0.1087,-0.0163,0.1668,0.0936,-0.0577,-0.0578,0.1841,-0.0174,-0.0188,-0.0761,0.037,0.1066,0.3629,0.298,0.1577,0.211,-0.3134,0.0673,0.0216,-0.039,0.0118,0.0115,0.0767,0.0034,-0.3443,-0.1519,-0.2682,-0.1002,-0.0503,0.0457,0.0151,-0.0143,-0.0447,-0.01,0.0164,0.0616,-0.247,-0.0967,0.1295,0.2194,0.1338,0.1413,0.1671,0.0087,0.0293,-0.0762,-0.0571,-0.1003,0.0198,0.0193,0.1717,0.0446,0.149,-0.0184,0.1525,0.1853,0.0226,-0.1503,0.0674,-0.0037,0.0605,0.1084,0.0845,0.1618,0.0049,0.0875,0.0791,-0.0083,-0.0241,0.0498,0.1059,-0.0278,0.0268,0.0174,0.0862,0.061,0.0989,-0.0387,-0.1422,-0.012,0.0714,-0.0898,0.0637,0.0375,-0.0876,-0.0572,-0.1186,-0.0231,0.0256,0.0113,0.0314,-0.0226,-0.1287,-0.2736,-0.1934,-0.094,-0.1613,0.0023,-0.068,0.1398,-0.1151,0.0401,-0.1254,-0.0465,-0.0198,-0.0242,-0.0679,0.0248,0.0576,-0.0066,-0.0423,0.0284,0.0152,-0.1114,-0.0827,0.0021,0.093,-0.0532,-0.054,0.0243,0.2035,0.1383,0.1866,0.0154,0.1125,0.0634,-0.0083,-0.0533,0.0073,0.0409,0.0992,0.1074,-0.0839,-0.0706,0.1805,-0.0043,-0.1626,-0.0565,0.0398,-0.0774,-0.1186,-0.0287,-0.0338,-0.0933,0.1012,0.0092,-0.2203,-0.0184,0.0959,-0.186,-0.014,-0.012,-0.0609,-0.1457,-0.0571,0.1224,0.0999,0.0768,-0.0941,-0.2649,0.0263,-0.1155,-0.0085,-0.0082,0.0342,0.0771,-0.0209,-0.1929,0.0597,0.0968,-0.1449,0.0155,0.1209,-0.0232,0.0505,0.0567,0.0553,0.1241,0.0968,0.1784,0.1153,-0.0698,-0.1893,0.042,0.0689,0.0206,-0.0563,0.0539,0.1054,0.1234,0.1619,-0.055,-0.0244,0.1188,0.1114,0.0651,-0.0416,0.1247,0.1413,0.0337,0.1013,0.0845,0.1713,0.0644,-0.0107,0.0863,0.0754,-0.0118,0.0263,-0.0719,0.0902,-0.0026,-0.1019,-0.0233,0.1181,-0.0091,0.0858,0.1469,0.0712,0.074,0.0736,-0.0151,-0.1257,-0.2084,0.0526,0.158,-0.1199,0.057,0.0392,-0.0511,0.1709,0.0523,0.1524,-0.0918,-0.0336,-0.1097,0.0249,0.231,0.1978,0.019,-0.0001,-0.0195,-0.0199,-0.1054,0.0444,0.0863,0.1027,0.1092,0.112,0.2248,0.1007,0.107,0.0247,0.0232,0.0024,-0.0193,-0.1787,0.0592,-0.0441,0.0073,-0.0761,-0.1421,-0.0848,-0.0272,-0.0155,0.1399,0.0494,0.1177,0.0436,0.0843,0.066,0.0337,0.022,0.1105,0.0466,0.0631,-0.0017,0.0391,0.0506,0.0246,-0.2288,-0.0008,-0.1725,-0.0367,-0.0328,-0.016,-0.069,-0.0273,0.0656,0.1181,0.0208,-0.1546,0.0155,0.0001,0.0417,0.0434,0.1148,0.0687,0.0309,0.037,-0.043,-0.1191,0.1785,0.1175,0.0183,0.0929,0.0658,0.067,-0.3294,-0.3654,0.1022,-0.0354,0.0661,0.0482,0.0471,0.1388,0.2027,0.1598,-0.0752,-0.0042,0.0952,0.0159,0.1348,0.0426,-0.1628,0.0047,-0.0342,0.0083,-0.0067,-0.0283,0.1144,0.0027,-0.1646,0.1338,-0.0639,0.1518,-0.1646,0.1645,-0.4423,0.0466,0.0384,0.1798,0.1684,-0.0498,0.0211,0.0591,0.0057,-0.0849,0.0471,0.0875,-0.0476,0.0227,-0.1403,-0.1779,-0.2497,-0.1877,-0.2988,-0.3905,0.0651,0.0029,-0.3083,-0.5747,-0.1794,-0.2288,-0.3921,-0.2458,-0.2166,-0.294,-0.1633,-0.3158,-0.3058,-0.1151,-0.2948,-0.0999,-0.2911,-0.368,-0.3348,-0.3213,-0.2137,-0.1024,-0.1137,0.1523,0.1519,0.1722,0.073,0.004,0.2249,0.2028,0.1134,0.0494,0.0736,0.2118,0.1932,0.1179,-0.0288,-0.04,0.1388,-0.1951,0.0154,0.1046,0.0167,0.1063,0.0761,0.0793,0.0366,0.1245,-0.1175,0.1961,0.223,-0.0329,0.0195,0.0707,-0.0034,0.0008,0.0976,0.0449,-0.0153,0.0935,-0.2199,-0.362,-0.0104,-0.1652,-0.1609,0.1028,0.0192,0.0201,0.0241,0.0881,-0.2142,0.0131,-0.0287,0.1243,0.0121,-0.2372,0.1514,0.1196,0.0755,0.0178,0.05,0.0562,place maintenance
trm_4a3fd79d0a038,0.038,-0.0035,0.0191,-0.0177,-0.0357,-0.0346,-0.0141,0.0708,0.0396,0.0305,-0.0024,-0.0018,0.0107,-0.0228,0.0024,0.0443,-0.0313,-0.0327,0.0565,-0.0606,-0.0296,0.0107,-0.0306,-0.0214,-0.0015,0.0177,0.0207,-0.0524,-0.0268,0.0105,-0.0342,-0.071,-0.0504,-0.0151,-0.0904,-0.086,0.0372,0.0111,-0.0248,0.0147,-0.0366,0.0016,0.0058,-0.0194,-0.0161,-0.0611,0.0038,0.0695,0.0693,-0.0407,-0.0338,0.1226,0.0474,0.0745,-0.0695,-0.0327,-0.0076,-0.0197,-0.0039,-0.0217,-0.0199,0.0493,-0.0621,0.0956,0.0092,0.0979,-0.0216,-0.0546,-0.017,-0.0218,0.0291,0.0382,0.0076,-0.0772,0.0281,-0.0134,0.0124,0.0358,0.0419,-0.0269,-0.0621,-0.033,-0.0311,-0.0622,0.0387,-0.0376,-0.0114,0.0318,0.0044,-0.0762,-0.0421,0.0945,-0.0474,0.2018,0.1304,0.1061,0.0883,0.0508,0.1385,0.1803,-0.0076,0.0279,0.0862,0.2199,0.0929,-0.0583,-0.0914,0.0465,0.0176,-0.0589,0.0232,-0.0064,0.0087,0.101,0.0031,-0.0582,-0.0418,0.1126,0.03,-0.0042,-0.0708,-0.0709,-0.1089,-0.0447,-0.0039,-0.1038,-0.0658,0.0545,0.0506,-0.0138,-0.1427,-0.0315,-0.0191,-0.1904,-0.0542,-0.0476,0.0822,-0.0872,-0.0532,0.005,-0.0016,-0.0461,-0.0422,-0.0242,-0.027,0.0626,0.0804,0.0126,-0.0099,-0.0472,-0.0238,-0.021,-0.0501,-0.088,0.0312,0.0707,0.0254,0.0404,-0.0398,-0.0132,-0.0297,-0.0505,-0.0702,-0.07,-0.0519,0.0015,-0.0115,-0.1254,-0.1129,-0.0394,0.0067,-0.0179,-0.0054,-0.2607,-0.1348,-0.2019,-0.1369,-0.1353,-0.088,0.0746,-0.1373,-0.0138,-0.0416,0.032,0.0578,-0.0111,0.0357,-0.1736,-0.1339,-0.0316,-0.0253,0.0042,-0.0487,0.029,0.0224,-0.0559,-0.0309,-0.116,-0.0296,0.0307,0.0427,0.1275,-0.1242,-0.0739,0.0345,-0.0914,-0.2479,0.0474,0.0309,0.0149,-0.1486,-0.0682,0.0415,0.0087,-0.0157,-0.032,-0.048,0.0414,0.1122,0.0256,0.0238,-0.0663,-0.0968,-0.0061,0.0584,0.0176,-0.0225,0.0379,-0.0765,0.0731,0.143,-0.1008,-0.0077,0.0148,0.0117,0.1512,-0.0819,0.0276,-0.0226,-0.0948,0.0336,-0.0113,0.0379,0.028,0.0063,-0.0292,-0.1201,-0.0402,-0.0345,-0.134,0.0045,0.0197,-0.0207,0.0079,0.0333,-0.1053,0.0643,0.0782,0.0621,-0.052,-0.0111,0.057,-0.0144,0.0058,0.0816,0.0753,0.0371,-0.0333,-0.04,-0.0595,0.0106,0.0658,-0.1618,-0.0577,-0.039,-0.1079,-0.0429,-0.1274,-0.0644,-0.0484,-0.0283,-0.1355,-0.1148,-0.2256,-0.201,0.0174,-0.0069,-0.003,0.0401,-0.0461,-0.0442,-0.0883,-0.0033,-0.089,-0.0437,0.0153,-0.0434,0.0865,-0.0102,0.0983,0.0909,-0.1227,-0.0125,-0.0776,0.1982,0.212,-0.0141,-0.0499,-0.0112,0.0092,0.0486,-0.0111,-0.0227,0.0178,0.0188,0.0387,0.0964,0.0429,-0.0162,-0.0251,-0.0222,0.0184,-0.1403,-0.1508,-0.0586,-0.0122,-0.0415,-0.0743,0.0449,0.0081,0.0113,-0.0017,-0.0433,-0.0058,-0.0223,0.0906,0.073,-0.0594,-0.1083,-0.1016,-0.0866,-0.0159,0.0831,0.0824,0.0114,0.029,-0.0373,0.0156,-0.0125,-0.0643,-0.0319,0.0762,0.0196,0.0003,-0.0302,-0.0036,0.0211,-0.0513,0.0368,-0.0371,0.0291,0.0088,0.1045,0.0795,0.0779,0.0112,-0.0135,0.1414,-0.0254,0.0482,-0.0308,0.037,-0.0031,0.0615,-0.0636,0.0888,-0.0181,0.0305,-0.1077,-0.0124,-0.0813,0.1955,0.0831,0.0931,0.0551,0.0668,-0.0658,-0.0541,0.0393,0.0086,0.0709,-0.0047,0.1098,-0.0553,0.2305,0.2635,0.1605,0.0088,0.0452,-0.0664,-0.0219,0.0025,-0.0137,-0.0192,-0.0308,0.0004,-0.0148,-0.0097,-0.0484,0.0114,0.0291,-0.1118,-0.0286,0.0451,-0.1063,-0.0717,0.0742,-0.0125,-0.0497,0.0053,0.0192,0.0676,0.0139,-0.0709,-0.0609,0.017,-0.0635,0.0735,-0.0118,0.088,-0.0438,0.0189,-0.0613,0.0388,-0.0829,-0.0003,0.0805,-0.0462,-0.0288,0.0121,-0.0812,0.0324,0.0517,-0.0086,0.0198,-0.0133,-0.0468,0.0156,-0.1396,-0.0009,0.0943,0.0652,-0.0699,0.0029,0.097,-0.1138,-0.0653,0.0249,-0.0347,0.0221,0.0443,0.0206,-0.0182,-0.0814,-0.0919,-0.0642,0.0103,0.0898,-0.0441,0.0107,0.0009,0.0114,0.105,-0.0574,-0.1493,-0.0026,0.078,0.0701,-0.0418,0.0459,0.1043,0.1015,0.0929,0.0717,0.0781,0.0128,0.0032,0.0967,-0.0922,0.037,-0.0568,0.1174,-0.0901,-0.1408,-0.0131,-0.0648,-0.1288,0.0354,-0.0275,-0.0207,-0.0344,-0.0328,-0.034,0.0172,0.0342,-0.0151,-0.0645,-0.0978,-0.023,0.1022,-0.0357,0.0641,-0.0375,-0.0056,0.0192,0.0667,-0.0406,-0.0038,0.0582,-0.0264,-0.0553,-0.0016,-0.0001,0.1309,0.0905,-0.0224,0.0339,0.0136,0.0028,0.0454,-0.0107,0.0472,0.0335,-0.1146,-0.1142,-0.0521,-0.0984,-0.0508,-0.0177,-0.0916,-0.0897,-0.0146,0.0571,-0.0294,-0.0599,-0.0084,0.0026,-0.0283,-0.0362,-0.0661,0.0307,-0.0389,0.0011,0.0961,0.0434,-0.0941,0.0722,0.0475,-0.0319,0.0134,-0.0792,-0.0313,-0.0786,0.0195,-0.0511,-0.0438,-0.0199,-0.2008,-0.0451,-0.0607,-0.0681,-0.1261,-0.033,-0.0175,0.1798,0.2254,0.0212,0.0074,0.0213,0.0278,0.0321,-0.0109,-0.0226,-0.0201,0.0995,-0.0023,0.2193,-0.0003,0.0781,-0.0315,-0.069,0.0515,0.0635,0.0705,0.0279,0.1429,-0.033,-0.0862,0.1016,-0.027,-0.0759,0.0198,0.0437,-0.0572,0.0747,0.2087,-0.1178,0.0382,0.0482,0.0303,-0.0107,0.0578,-0.0013,-0.0476,-0.0696,-0.0111,-0.0066,-0.0879,-0.0687,-0.0372,0.0369,-0.0524,0.0569,0.0178,-0.047,0.0637,0.0357,-0.0979,0.0669,0.0481,0.0801,0.1652,-0.0731,0.0082,0.1021,0.1383,0.0606,0.031,-0.0793,0.0345,-0.019,0.0236,0.0554,0.1719,-0.0469,-0.0332,-0.154,-0.1048,0.1001,-0.1347,0.0596,-0.0824,0.0922,-0.1431,-0.0228,-0.0096,0.26,0.0298,0.0014,-0.0425,-0.1605,0.1967,0.0691,0.1686,0.0772,0.0218,0.1356,-0.0703,0.0521,0.1571,0.0413,-0.0568,0.0072,-0.083,-0.0267,-0.0006,0.1471,-0.0706,-0.0279,-0.0469,-0.0077,0.0075,-0.042,0.007,0.0077,-0.0317,-0.0032,-0.0563,0.0506,0.104,0.1516,0.0827,0.1434,-0.0626,-0.022,-0.1356,-0.0539,-0.0564,0.0032,0.0072,0.0476,0.0446,0.0172,-0.1013,-0.0699,0.0308,-0.0569,-0.0893,-0.0431,0.0441,-0.0071,-0.0114,-0.0176,-0.0099,-0.0497,-0.0793,0.0235,-0.0724,-0.084,0.006,0.0089,0.0077,-0.1854,-0.1743,-0.1592,0.0046,0.0117,-0.0248,-0.0537,0.0902,-0.0863,-0.0433,0.0347,0.1097,0.0563,-0.0055,0.0161,0.0183,0.0556,0.1416,-0.1391,-0.0536,0.038,0.0131,-0.0022,-0.0315,0.0466,-0.0397,-0.0539,-0.027,-0.0224,-0.0188,-0.0911,-0.1547,-0.1218,-0.0918,-0.0112,-0.0002,-0.009,0.0195,-0.053,0.1046,0.0737,-0.058,0.065,0.0489,-0.0677,0.0017,0.0337,0.0081,-0.0154,0.0051,-0.0087,0.04,0.057,0.0127,0.0198,-0.0885,-0.0568,-0.0178,-0.0829,-0.0893,-0.0242,0.0224,-0.0018,-0.0063,-0.0367,0.0041,0.0231,0.0258,0.0044,-0.0838,-0.0017,-0.0281,-0.0159,0.0474,0.0815,-0.0795,0.0459,0.0122,0.0046,0.0676,-0.0731,-0.0101,-0.0624,-0.0956,-0.0212,-0.0065,0.001,0.0709,0.0788,0.0932,0.0201,0.0348,-0.0177,-0.0036,0.0062,0.0109,-0.0536,0.0457,-0.0154,-0.0197,-0.0818,0.0582,-0.0204,-0.1383,-0.126,-0.0364,-0.0834,-0.0819,-0.132,-0.0725,-0.0356,-0.0592,-0.0354,0.0327,0.0092,0.097,0.0545,-0.0375,-0.0101,0.0032,-0.0151,-0.013,0.066,-0.033,0.0961,0.0351,-0.0922,0.0133,0.0281,0.0043,-0.047,-0.0278,-0.0352,0.0549,0.1002,-0.1706,-0.1048,0.0281,0.0365,0.0069,0.0056,0.0043,0.072,0.1283,0.0463,-0.0079,0.1588,-0.0008,-0.0607,-0.0589,0.2184,-0.0081,0.0961,0.1442,0.0026,0.1374,-0.1452,-0.1573,-0.0016,0.0417,-0.0031,0.0235,-0.0123,-0.002,0.0149,-0.0106,-0.0316,-0.0091,0.0516,0.0394,-0.0638,0.1229,-0.0936,-0.0325,-0.05,-0.065,-0.0333,0.0619,-0.0382,0.0396,-0.0871,0.0565,0.0258,-0.0289,0.0434,-0.0372,0.02,-0.0686,0.0111,-0.0669,-0.0521,0.0184,0.0804,0.0602,-0.0146,-0.035,0.0297,0.0645,0.0797,-0.0024,0.0144,-0.0328,0.1289,-0.0148,-0.0185,0.0511,0.0088,-0.073,-0.0203,-0.045,-0.0155,-0.007,-0.0188,0.0312,-0.0955,-0.0734,0.0359,-0.002,0.0013,-0.2747,-0.1338,-0.278,-0.0961,-0.1107,-0.1233,-0.1185,-0.1641,-0.1288,-0.1955,-0.2453,-0.0877,-0.1116,-0.0015,-0.0515,0.0587,-0.0082,-0.0202,0.0746,-0.0454,0.0566,-0.0443,-0.0505,-0.0692,-0.0396,0.0009,0.0626,0.0385,-0.0423,-0.0143,0.0255,0.0238,0.0278,-0.0959,-0.0275,-0.0833,-0.0004,0.0807,-0.0707,-0.1037,-0.0654,-0.0757,-0.0671,0.0132,-0.1674,-0.1441,0.0593,0.062,0.0792,-0.0063,-0.0653,-0.0374,0.0809,0.0264,-0.0013,0.0381,0.1041,0.0011,0.0115,0.0332,-0.0201,-0.0513,-0.0332,-0.0453,-0.052,-0.0025,-0.0745,-0.1336,-0.0777,0.0473,0.0485,0.1031,-0.0444,-0.0357,-0.0961,-0.0988,-0.0271,-0.0072,-0.0494,0.0112,-0.0132,-0.0182,0.0424,0.0165,0.0804,-0.0273,0.0024,-0.0309,-0.0078,-0.0208,0.112,0.2166,0.2913,0.1172,0.0603,0.0233,0.0846,-0.0268,-0.0345,-0.0612,-0.0534,-0.0039,0.065,0.0952,0.0666,0.0515,0.0073,0.0085,-0.0503,0.0963,-0.1398,-0.0314,-0.1512,-0.0504,0.0516,-0.0223,0.0163,-0.0818,0.0474,-0.0174,0.005,-0.0449,0.0252,-0.0583,0.0118,0.0047,-0.0379,-0.025,-0.0651,-0.0163,-0.0777,-0.0793,-0.1329,-0.1277,-0.2009,-0.0074,-0.0845,-0.0239,0.0058,0.2311,-0.0102,0.0148,0.0285,-0.0534,0.0633,-0.1236,-0.0186,-0.0292,-0.1009,-0.035,0.003,0.1448,0.1748,0.1734,0.0365,0.1492,0.0258,0.0114,-0.1837,-0.0984,-0.1288,-0.0882,-0.2167,-0.1962,-0.1254,-0.1691,-0.0602,-0.0719,-0.0105,0.0137,0.0229,-0.0763,0.0116,0.0236,-0.0326,0.0442,-0.0151,-0.0951,-0.0747,-0.0917,-0.0845,-0.0271,0.048,-0.0084,0.0445,0.0456,0.013,-0.0943,-0.1707,-0.1707,-0.098,-0.043,-0.0345,0.1025,-0.0211,-0.146,-0.1173,-0.0201,-0.1039,0.1022,0.1182,0.1087,-0.0741,0.0015,0.0836,0.2219,0.2164,0.1933,0.0248,0.0139,0.0749,0.0676,0.0479,-0.0063,-0.0583,0.0899,-0.0471,0.1209,-0.049,-0.0454,0.0592,-0.0531,-0.0193,0.0668,-0.0465,0.3063,0.1662,-0.0357,-0.0511,-0.0032,0.0108,0.0043,0.0202,0.0411,0.0203,0.0281,-0.0875,-0.0073,0.0664,0.0088,-0.0231,0.0341,-0.006,0.145,0.0516,0.0457,0.1833,0.0412,0.0108,-0.0123,0.0184,0.1092,0.1515,-0.0176,0.1098,0.1444,0.0469,-0.0796,0.0884,0.0832,-0.0223,-0.0965,-0.0229,0.0049,-0.0352,-0.1194,-0.0261,0.0898,-0.0372,-0.0756,0.0497,-0.0181,0.0051,0.0151,-0.0654,-0.0574,-0.0732,0.1346,0.0405,-0.0285,-0.103,-0.1027,-0.0247,-0.0991,-0.0599,0.0185,-0.0081,-0.0736,-0.015,-0.0301,0.2095,-0.0155,-0.1191,-0.0661,-0.014,-0.0182,-0.0103,0.032,0.0053,0.0361,0.0556,0.1691,-0.0442,-0.0803,0.0366,-0.0046,0.0393,-0.0138,0.0976,0.0976,-0.0839,0.0034,0.0213,0.0175,0.0555,0.0173,-0.0543,0.1112,-0.062,-0.066,-0.0363,-0.0277,-0.0104,-0.0261,-0.0304,0.052,0.0566,-0.0611,-0.0183,-0.0184,0.1544,-0.0403,-0.0814,-0.0615,-0.0254,0.0294,0.0341,0.0766,0.0088,-0.0805,0.0155,-0.0822,-0.1026,-0.051,-0.047,0.0019,-0.0792,0.2236,0.1681,0.2281,0.0448,0.1082,-0.1827,-0.1074,-0.0031,-0.108,0.0146,-0.0665,0.0273,-0.0077,-0.0567,-0.0591,0.0777,0.0403,-0.0679,-0.0059,0.1005,-0.0006,-0.0628,-0.0476,-0.0077,0.0557,-0.105,0.0768,-0.0368,-0.0339,0.1221,0.1824,0.1324,-0.0237,0.0134,-0.0529,-0.1002,-0.1071,0.0113,-0.0354,-0.086,-0.0788,0.023,-0.0401,0.03,-0.0297,-0.0876,-0.0947,0.0211,-0.0167,0.0151,0.0664,-0.1132,0.0026,-0.0322,-0.0803,-0.1638,-0.2076,-0.0722,0.0018,-0.0528,-0.0499,0.0087,0.0037,-0.0675,0.0783,0.0083,-0.039,-0.0247,0.0063,-0.084,0.0154,0.0216,0.0591,0.1055,-0.1508,-0.0255,0.091,-0.1301,0.0099,0.0087,-0.0639,-0.0861,0.044,0.0674,0.0724,-0.0884,0.0168,0.0395,-0.0291,0.2597,-0.0549,-0.0131,0.1593,0.132,0.1381,-0.0279,-0.0353,-0.0912,-0.0246,-0.035,-0.0973,-0.0738,0.0457,-0.0192,-0.0652,-0.0963,-0.02,-0.0492,-0.0114,-0.1009,0.0031,0.0129,-0.0263,0.0961,0.0852,-0.0143,0.0205,-0.0117,-0.0326,-0.0176,0.0038,-0.0843,0.006,0.028,-0.0496,0.0051,-0.0003,-0.0475,0.0069,0.0779,-0.0228,-0.1093,-0.1573,0.0303,0.1381,0.1386,-0.0093,-0.058,-0.0307,0.0522,0.0267,0.0194,-0.0504,-0.0593,0.0213,-0.1282,0.0051,-0.0006,0.0365,-0.086,-0.0458,-0.0296,-0.061,-0.1352,0.1122,0.0242,0.0479,-0.0729,0.1674,-0.0045,0.1407,-0.0414,-0.049,-0.0547,-0.0754,0.0034,0.0451,0.0391,0.0597,0.0508,-0.0055,-0.0542,-0.0234,0.1165,0.1599,0.0682,0.0325,0.0123,-0.0163,-0.0683,0.0897,0.0597,-0.0225,-0.015,0.0317,0.0069,0.0538,0.0503,-0.0581,0.0321,0.0043,0.016,-0.0571,-0.0044,0.0027,-0.0046,-0.0118,0.0059,-0.011,-0.117,-0.0594,-0.1696,-0.0083,-0.0637,-0.0278,-0.0957,-0.1288,-0.0578,0.0091,0.1419,0.0115,-0.061,0.0436,-0.0372,-0.0167,-0.1144,-0.0108,0.0334,-0.0605,0.0431,0.1303,0.1028,-0.0015,0.05,0.0089,0.1646,0.1665,-0.129,-0.1015,0.0724,0.0126,-0.0087,-0.0162,-0.0599,0.0435,-0.0162,-0.057,0.051,0.0391,0.1847,-0.0432,0.1356,-0.0364,0.0558,0.1247,0.1101,0.1866,0.0101,-0.0237,-0.0386,0.035,-0.0392,-0.0285,-0.0153,-0.0218,0.0014,0.1495,0.0916,-0.0701,-0.0675,-0.0673,-0.0232,-0.1052,-0.1421,-0.1244,0.0053,-0.0342,0.0108,-0.0387,-0.0984,-0.1126,0.0088,0.0327,-0.0222,-0.0489,-0.0314,-0.0101,0.0255,-0.0906,-0.0089,0.0551,-0.0466,-0.0896,-0.0466,-0.0638,-0.0368,-0.0256,0.0836,-0.0226,-0.0831,0.0157,0.0577,-0.0146,0.0032,-0.094,-0.1286,0.0754,-0.1813,0.06,0.043,0.1041,0.0112,0.002,0.0314,-0.0151,0.0201,0.1165,0.0031,0.0147,0.0089,0.0552,0.0098,0.0351,0.1035,0.0894,-0.0216,-0.0218,-0.0202,-0.0565,0.0404,0.0008,-0.1414,-0.0275,-0.0533,0.0613,0.1176,0.2721,-0.1674,-0.0157,-0.0209,-0.0009,0.0051,-0.022,0.0095,-0.03,-0.0292,-0.0394,-0.0288,-0.025,-0.0003,0.0002,0.071,-0.0874,-0.1157,-0.1092,-0.0246,-0.0322,-0.009,0.1605,-0.0922,-0.0694,-0.1206,0.2675,0.1008,0.2135,-0.0583,-0.0193,-0.0606,0.0644,0.1439,0.0539,-0.0001,0.028,0.0116,-0.0395,0.1248,0.0574,0.146,-0.0729,-0.0163,-0.0279,-0.0187,-0.0005,-0.0585,0.1262,0.1821,-0.0663,0.0899,0.0819,0.0923,-0.0522,-0.0176,0.0313,0.0913,0.0758,0.0812,0.0569,0.1302,0.1562,-0.0563,-0.044,-0.0981,0.0335,0.0046,-0.0356,-0.0723,-0.1178,-0.0394,-0.0606,-0.0156,-0.0653,0.0827,-0.0055,-0.0059,0.092,0.0131,0.0037,0.0364,0.1076,0.0101,0.0492,-0.0449,-0.0045,-0.1142,0.0205,0.0576,-0.0307,-0.061,-0.0758,0.0178,-0.0211,-0.0254,-0.0807,-0.0076,-0.0708,-0.0448,-0.0008,0.1008,-0.0898,-0.0779,0.0585,0.0142,-0.0626,-0.0658,-0.017,-0.0022,-0.0274,-0.0122,-0.0288,-0.0509,-0.0303,0.0461,0.025,-0.0118,-0.205,0.0159,-0.0637,-0.0909,-0.2357,0.0077,-0.1426,0.0099,-0.0292,0.0509,0.0448,-0.0509,-0.0436,-0.0877,-0.2104,-0.0382,-0.0839,0.0727,-0.0874,0.0001,-0.1154,-0.0148,0.0926,0.1546,0.001,0.0228,-0.0468,0.1138,-0.1555,-0.2232,-0.1846,0.0284,-0.0474,-0.0945,-0.0935,-0.0214,-0.0463,0.0054,-0.02,-0.0225,-0.1077,-0.0423,0.0172,-0.0093,0.0082,0.0274,-0.0826,-0.0104,0.0597,0.0021,-0.0217,0.008,-0.1846,-0.1301,-0.0734,-0.1269,0.009,-0.2291,-0.2038,0.0397,0.0817,0.0164,0.006,0.0156,-0.0509,0.0223,0.0313,0.0433,-0.1527,-0.1698,0.0649,0.0801,-0.0284,0.027,0.002,-0.0262,-0.1201,0.0068,-0.0247,-0.0376,-0.0173,0.0233,-0.0152,-0.0063,-0.0411,0.0794,0.0033,0.063,0.1486,0.068,0.0546,-0.1195,-0.1633,0.0242,-0.0591,-0.0997,-0.1037,-0.015,-0.0055,-0.0675,0.3525,0.2378,0.2464,0.3407,0.2039,0.2056,0.1977,0.1573,0.0773,0.1012,0.3238,0.1479,0.3036,0.307,0.1063,-0.1615,0.1319,0.0425,0.0467,-0.1172,-0.0792,0.0334,-0.0834,0.0543,0.1498,-0.0208,-0.1186,-0.0896,0.2233,-0.0054,-0.0498,0.088,0.0177,-0.0205,0.1298,0.0457,-0.1247,-0.1249,0.0033,-0.0179,-0.0049,0.0205,-0.0148,0.0012,-0.0003,-0.218,-0.1182,-0.0309,-0.1329,-0.1279,-0.101,-0.1352,-0.0899,-0.0764,-0.0838,0.0948,0.0917,0.0167,-0.0459,-0.1693,0.0595,-0.0229,0.0154,0.0297,-0.0065,0.0495,-0.0552,-0.0565,-0.0294,-0.0122,-0.0539,-0.0051,0.0605,0.0205,0.0922,0.1075,0.0165,-0.055,-0.0305,-0.0926,-0.2506,-0.157,-0.119,-0.1317,0.0252,-0.0134,0.0166,0.154,-0.0454,-0.0306,0.0074,-0.0668,-0.0379,0.0003,-0.0309,0.0585,0.0234,-0.0252,-0.0591,-0.0182,0.0631,0.0303,0.0275,-0.039,-0.0639,0.0981,0.114,0.0681,-0.0609,0.0941,0.1431,0.103,-0.0158,-0.0112,-0.0757,0.0232,-0.0491,-0.0433,0.1415,0.0178,0.0077,-0.0904,0.0023,-0.0333,-0.0305,-0.0166,0.0033,-0.0375,-0.0222,-0.0397,-0.0639,0.0349,-0.0093,0.0139,-0.0164,0.0295,-0.0731,0.0002,-0.0004,0.001,0.036,-0.0098,-0.1265,-0.0205,-0.0267,-0.1127,-0.0211,-0.0208,-0.0006,-0.0009,-0.0115,0.0041,-0.044,0.0871,0.1235,0.1318,0.1262,0.1291,0.0012,-0.0391,-0.0231,-0.0267,-0.0053,-0.0594,0.0478,-0.0992,-0.1607,-0.1472,0.1182,0.0952,0.0193,-0.0211,0.0107,0.0529,0.0021,0.0048,0.1359,0.0067,-0.0715,-0.0762,0.1596,-0.0039,-0.1033,0.0375,0.0706,0.0764,0.1784,-0.0173,-0.0127,-0.0653,-0.049,0.2018,0.0599,0.0765,0.063,-0.0863,0.0002,0.0976,-0.0278,-0.0284,-0.0363,-0.1532,-0.0653,-0.1517,-0.1087,-0.1064,0.0574,0.0101,0.0137,0.0904,0.0603,-0.0164,0.1963,0.165,0.0812,0.0948,-0.1445,0.0793,0.0069,0.205,0.1443,0.1108,-0.0289,0.0018,-0.0154,0.0942,0.0202,0.1046,0.1008,0.1142,0.1262,-0.0597,-0.0024,-0.0552,0.0868,0.0683,-0.0661,0.0205,-0.0001,0.0819,0.0223,-0.0502,-0.1054,-0.1401,-0.0276,0.007,-0.0084,-0.0532,0.0376,0.0372,-0.0093,-0.0167,0.1318,0.0877,-0.1275,0.0432,0.0199,-0.1686,0.0353,-0.0086,-0.0791,-0.0209,-0.0544,-0.0003,0.208,0.1752,0.0089,0.0835,0.1482,-0.0074,-0.0067,0.0716,0.0035,-0.0328,0.0657,0.0015,-0.0247,-0.1616,-0.148,-0.1489,-0.1467,-0.0319,-0.0649,-0.0577,-0.006,0.0063,0.081,0.0496,-0.0102,0.012,0.0079,0.1757,-0.1161,0.0129,-0.0057,-0.1034,-0.1948,-0.0207,-0.0068,-0.0171,0.0178,0.2378,-0.0602,-0.0637,0.0625,-0.0162,0.0111,0.0523,-0.0063,-0.0073,-0.0323,-0.009,-0.0076,-0.1225,0.0158,-0.0466,0.0535,-0.0204,-0.1827,-0.0645,0.0506,-0.034,-0.0303,0.0025,-0.0743,-0.0424,0.0338,-0.0511,0.0625,-0.2029,-0.0437,-0.0309,-0.1881,-0.0919,-0.0436,0.001,0.001,-0.0344,0.0273,0.0481,-0.0564,-0.0001,-0.0066,-0.0344,-0.1158,-0.0878,-0.2059,0.0617,-0.0051,-0.0176,-0.0276,0.1426,-0.1099,-0.0899,-0.0952,0.004,-0.0115,-0.0504,-0.0771,0.0966,0.1073,0.2233,0.2887,0.212,-0.0216,0.0144,0.2041,0.1855,0.0245,-0.1327,-0.1375,-0.0377,-0.0561,-0.0155,0.0259,0.0301,0.0343,0.0226,-0.0215,0.0444,-0.0277,-0.0875,0.0053,-0.0853,-0.076,-0.0232,-0.0841,0.0131,0.0069,0.0999,-0.0423,0.3166,0.2877,0.13,0.2265,0.1135,-0.0229,-0.0772,-0.03,-0.0858,-0.0347,0.0064,0.0622,0.0302,0.0073,0.0015,0.0206,0.0514,-0.0551,-0.0071,-0.0312,0.005,0.1683,-0.1127,0.2475,0.0795,0.2286,0.0906,0.1143,0.006,0.0748,-0.0523,-0.0536,0.0102,-0.0144,-0.014,-0.0771,-0.0236,0.0067,0.0744,0.0289,-0.0027,0.0095,-0.0293,0.0257,-0.0016,-0.0839,0.02,0.0303,0.0158,-0.0046,0.0777,0.0134,-0.0413,0.1562,0.0102,-0.0766,-0.0457,-0.0034,0.0577,0.0448,0.0522,-0.0035,0.0583,0.1227,-0.0674,0.0016,0.0145,0.0682,0.0512,-0.0577,0.001,0.0045,-0.0019,0.0474,0.0318,-0.0075,-0.004,-0.0539,0.0942,-0.1001,-0.138,-0.1042,-0.023,-0.0907,-0.051,-0.0308,0.023,-0.0875,-0.1072,-0.0936,-0.0074,-0.0416,0.0405,0.0545,0.2031,0.0357,-0.1187,-0.0315,0.0119,-0.0058,0.0052,-0.0994,0.0564,0.0653,0.0207,-0.0435,-0.009,-0.0212,0.018,-0.0516,0.0882,-0.0028,0.0356,-0.1242,0.0408,-0.0582,-0.1037,0.0944,-0.0257,0.0897,0.0717,0.0724,0.0683,0.0833,0.0192,-0.0964,-0.0292,0.0585,0.0611,-0.0682,0.0357,-0.1075,-0.0095,-0.0298,-0.0337,-0.0726,-0.1466,-0.0325,0.0288,-0.0506,-0.0487,-0.1762,-0.0958,-0.0548,-0.0621,-0.0682,-0.0629,-0.1156,-0.0217,0.0198,0.0347,0.0538,0.0338,0.0643,0.1002,-0.0012,0.0075,-0.0326,-0.0248,-0.0152,-0.092,-0.1804,-0.0644,-0.0479,-0.0253,-0.048,0.0232,0.0113,-0.0265,-0.0942,-0.0417,-0.0369,-0.0091,-0.055,-0.0505,0.0718,-0.0298,-0.0564,-0.1293,-0.0511,0.1599,0.2206,-0.048,-0.0449,0.0351,0.0454,0.0118,-0.0548,-0.022,-0.0736,-0.072,-0.0572,-0.0908,0.0138,0.0534,-0.0464,-0.0266,0.0733,0.0083,0.028,-0.0332,-0.0201,0.0056,0.0229,0.022,-0.005,-0.0342,-0.1294,-0.0645,0.1409,-0.0093,0.0807,0.0179,0.0407,0.0132,0.1715,-0.0237,-0.053,-0.0894,-0.0092,-0.0286,0.117,0.0947,0.0492,-0.0948,-0.0606,0.0055,0.1108,0.0393,0.0179,0.0699,-0.1605,-0.0411,0.0246,0.0167,-0.0411,0.0669,0.0812,0.0679,-0.0074,0.021,0.0041,-0.0552,0.0361,0.0386,-0.0002,0.1359,-0.021,-0.0044,-0.053,-0.0228,-0.0736,-0.0679,-0.0139,-0.0371,0.0779,0.1628,0.0453,0.0524,-0.0997,0.0708,-0.1235,-0.0337,-0.0086,-0.1284,-0.1328,0.0468,0.0613,0.1351,-0.0198,0.0276,-0.0916,-0.1136,-0.1409,-0.1221,0.0217,-0.0426,0.0114,-0.0366,0.0425,-0.0679,-0.079,-0.0188,-0.0552,-0.044,0.2024,-0.1565,0.0054,-0.0877,-0.0441,-0.059,0.0328,0.0159,0.0319,-0.0244,0.1018,-0.0803,0.0841,-0.0465,0.1111,0.0952,0.0821,-0.006,-0.0981,0.1412,0.1477,0.1291,-0.1606,-0.111,-0.0479,-0.1324,-0.1025,-0.0209,-0.0262,-0.1127,-0.0527,-0.0377,-0.1454,0.0102,-0.0754,0.0035,0.0035,-0.0084,-0.1029,-0.1433,-0.1269,-0.083,0.122,0.001,-0.0977,-0.0883,0.0529,-0.0325,0.0363,-0.0458,0.0064,0.1224,0.1232,-0.0317,-0.0505,-0.0468,0.0076,0.003,0.0826,-0.0392,0.0144,0.0306,0.1518,-0.0804,0.0349,-0.0298,-0.0737,-0.1575,-0.1847,-0.0586,-0.094,-0.0549,-0.0574,-0.1069,-0.0971,0.037,0.0951,0.0773,-0.0376,-0.0773,-0.0807,0.25,0.1975,0.09,-0.0085,-0.0625,0.1352,-0.0771,0.0007,-0.0746,0.063,0.0869,0.0784,-0.0032,0.0175,0.2289,0.1429,0.1945,0.1817,-0.0189,-0.0507,0.0134,0.0512,0.0137,0.0615,0.0524,0.0593,-0.0291,0.0643,0.059,-0.0469,0.0393,-0.0667,-0.0261,-0.0708,-0.0367,0.0083,-0.0798,-0.0589,0.0808,0.0858,0.0227,0.0051,0.0597,0.0068,0.0743,0.0461,0.0114,0.0979,0.0374,-0.0562,0.0026,-0.0001,0.1539,0.0875,-0.0089,-0.0175,0.0146,0.0428,0.0297,-0.0132,-0.0316,-0.0772,-0.0878,-0.0575,0.0508,0.1586,0.0125,-0.0786,-0.0357,-0.0074,0.0764,0.08,-0.033,0.0381,0.0283,-0.0098,0.0432,0.066,0.0448,0.0297,0.0405,0.0631,-0.0792,-0.0818,0.1033,0.0108,0.0954,0.1025,0.006,-0.0259,-0.0378,-0.0281,0.0709,0.3713,0.0047,-0.0258,-0.0366,-0.0822,-0.2999,-0.2103,-0.162,-0.1569,-0.1342,-0.1248,-0.0538,0.0227,0.1259,0.1104,0.0631,-0.0997,-0.0218,-0.1191,-0.0174,-0.0566,-0.0441,-0.0058,0.0285,0.0726,0.0721,0.0256,0.0291,-0.0314,-0.0462,-0.128,0.043,0.0169,-0.0155,0.0861,-0.0376,-0.026,-0.0102,-0.0319,0.0913,-0.1215,-0.1244,-0.0586,-0.0776,-0.0365,-0.0348,0.063,-0.0688,0.1271,-0.0016,0.141,0.1749,-0.0569,-0.1108,-0.0851,0.0297,0.0528,-0.0681,0.0258,-0.1833,-0.0988,-0.0452,-0.157,-0.0003,-0.0562,-0.0786,0.0003,-0.0859,0.1285,0.1039,0.0149,-0.1566,-0.0511,0.0263,0.0062,0.0867,0.0214,0.0233,0.1359,-0.0457,-0.0164,0.0659,-0.0014,0.0349,0.0119,-0.0491,-0.0521,-0.0911,0.0741,-0.0132,-0.0908,0.1846,-0.0533,-0.025,-0.0133,0.116,0.0592,-0.0083,-0.0254,-0.0167,-0.0031,-0.0218,-0.0429,0.0228,-0.1597,0.0407,-0.1112,0.0272,0.1248,0.0486,-0.0702,0.0937,-0.0911,0.0051,-0.0439,-0.0792,0.003,-0.0281,-0.0418,0.0412,0.0369,-0.0195,-0.0208,-0.0071,0.0377,-0.011,0.0478,-0.0095,0.1457,-0.0274,-0.0936,0.0068,0.0567,-0.0084,-0.0871,-0.0914,0.0321,0.0239,-0.0695,-0.0247,0.0159,0.1058,-0.0856,-0.128,0.0011,0.0061,0.0573,0.1104,-0.0182,0.2092,-0.1606,0.3926,0.378,0.0135,0.0166,-0.0275,-0.0066,-0.0138,0.0716,0.0628,0.1184,-0.0504,-0.0693,-0.0664,0.014,0.0923,0.1292,-0.0692,-0.0781,-0.0948,0.0228,0.0009,-0.0221,-0.0935,-0.0479,0.0426,0.0238,-0.0391,-0.0439,0.063,-0.0462,-0.0657,0.2256,0.1078,-0.0107,-0.033,0.0416,0.2024,0.1121,0.0678,0.0537,0.0065,0.0233,-0.0071,0.0982,-0.0682,0.0449,0.0106,0.0462,0.0033,0.2566,0.0671,-0.0392,0.0013,0.0324,-0.2445,-0.1181,-0.1201,-0.1457,-0.0737,-0.1544,-0.0273,-0.1858,-0.1945,-0.0633,-0.1046,-0.1878,-0.2118,-0.0637,-0.0172,-0.1231,-0.1329,-0.163,-0.1843,-0.0138,-0.0742,-0.0136,-0.0256,0.0531,0.0406,0.0058,0.0512,0.024,-0.0229,-0.0493,-0.0546,0.0148,0.0723,-0.0702,0.0069,-0.1948,-0.2539,-0.0329,-0.0199,-0.0522,-0.159,0.0239,-0.0188,-0.0128,-0.1234,-0.1152,-0.1203,0.0754,0.0324,0.0528,-0.0832,0.1209,-0.0216,0.0725,0.0994,0.1467,-0.0455,0.0341,-0.2035,-0.0075,-0.0358,0.007,-0.0302,-0.0143,0.0394,0.0087,0.0297,0.0437,0.0105,-0.1598,0.012,0.0975,0.0782,0.0279,0.0206,0.0204,0.0313,0.0994,0.2097,-0.1333,-0.1598,0.0888,0.0942,0.0187,0.1052,-0.0628,-0.0093,-0.0849,-0.0743,0.0212,-0.0522,-0.0871,-0.0207,-0.0819,0.0902,0.0418,0.0936,-0.0044,0.0767,-0.0388,0.0077,-0.005,0.0342,0.0173,-0.0404,-0.0826,-0.0413,0.0054,-0.007,-0.042,-0.009,-0.0382,-0.0213,-0.0472,-0.0234,-0.0293,0.0365,-0.0641,-0.027,-0.0905,-0.0358,0.0066,-0.0686,0.0522,-0.0552,-0.0166,-0.0339,-0.1011,-0.0529,-0.0006,-0.0409,-0.0928,-0.0786,0.0621,0.0862,0.1577,0.0133,0.0824,-0.0845,-0.028,-0.0181,-0.0579,0.1288,0.0055,-0.0544,-0.0655,0.1045,-0.0323,0.0259,0.0036,-0.0473,0.0541,-0.2156,-0.0636,-0.0494,-0.0296,-0.0346,-0.1567,-0.0398,-0.0346,0.0168,0.013,0.0305,-0.0046,-0.0738,-0.0029,-0.038,0.0131,0.0856,0.0053,0.0249,-0.0896,-0.0796,-0.0564,-0.0139,-0.0553,0.017,-0.1674,0.2317,-0.0906,-0.0779,0.0186,-0.0106,-0.2097,-0.1936,0.1086,0.1646,0.1107,0.2136,0.0612,0.1861,0.0898,-0.0603,0.1984,-0.0355,-0.0635,-0.1111,-0.0571,-0.164,-0.1617,-0.0258,-0.0283,-0.0638,0.0003,-0.0181,-0.0024,-0.041,-0.0548,-0.0514,-0.0113,0.0964,0.038,-0.0363,0.0123,-0.0514,-0.0266,-0.0079,0.0243,0.1333,0.0311,0.0709,0.1895,0.02,-0.0633,-0.0226,-0.1609,0.0103,-0.1212,-0.0377,-0.0488,0.0096,0.2461,0.108,-0.1005,-0.1026,-0.0396,0.037,-0.0734,-0.1403,-0.037,-0.0202,-0.0119,0.0263,-0.042,0.0424,0.0262,-0.0552,-0.0111,0.0242,-0.0136,0.0026,0.0323,0.0178,-0.0076,-0.0019,0.0035,-0.0775,0.141,0.0613,-0.0353,0.045,0.0044,-0.0606,-0.0134,0.0085,-0.0265,0.1998,0.2063,-0.1466,-0.0786,-0.0216,-0.1054,-0.0589,-0.0309,0.0153,0.0457,-0.0033,-0.0111,0.0857,-0.0541,-0.0502,0.0759,decision making
trm_55c6f87595b39,0.0066,0.0754,0.0139,-0.0182,0.0205,0.0507,0.0372,0.0422,0.0122,-0.0052,-0.0352,-0.0373,0.0557,-0.0229,0.0057,0.0411,0.0426,-0.0315,0.022,-0.0617,-0.0324,-0.0514,0.0099,-0.0107,0.0141,-0.003,-0.0022,-0.0399,-0.0025,-0.0007,-0.0029,-0.0076,0.0695,0.019,0.0086,0.0232,0.0975,0.0317,0.0494,-0.0141,0.0286,0.0818,0.0713,-0.03,0.0079,-0.0299,-0.0285,0.0448,-0.0261,0.0092,0.0239,0.029,-0.0183,-0.0414,-0.0349,0.0376,0.0369,-0.0147,-0.0073,-0.0033,-0.0023,0.0138,-0.0071,-0.0283,-0.0682,0.0657,-0.006,-0.0514,-0.0183,-0.0318,-0.0205,-0.0376,-0.0745,-0.0267,-0.0157,-0.062,0.0712,-0.0451,0.0196,0.0678,-0.0001,-0.0485,0.0144,-0.0559,-0.0389,0.04,0.0279,0.0532,-0.0309,0.1381,0.081,0.0522,0.0368,0.1171,0.0931,0.1034,0.0436,0.0177,0.052,0.1408,0.0036,-0.0034,0.0159,0.1438,0.0343,0.0199,-0.0295,-0.042,0.0393,0.0422,-0.0246,-0.0552,-0.0603,0.0485,-0.0161,-0.069,-0.0603,0.1181,-0.0897,-0.0238,-0.075,-0.0211,-0.0885,-0.0167,-0.006,-0.0751,-0.0745,0.0206,0.0085,0.0097,-0.0834,0.0375,0.0551,-0.0055,-0.0378,0.0027,0.0446,-0.0013,0.0209,0.0727,0.0053,0.0279,-0.0295,-0.047,-0.0132,0.037,0.01,-0.0618,0.0151,-0.0217,-0.039,-0.0134,0.0796,-0.0709,-0.0649,0.0559,0.0202,0.007,-0.0052,0.0284,0.0231,-0.0194,-0.053,0.0052,0.0139,0.0117,-0.0267,-0.0482,-0.0574,-0.0683,0.0552,-0.0365,0.0547,-0.1024,-0.0481,-0.018,-0.0247,-0.0937,-0.0546,0.0091,0.0262,-0.0171,0.0115,0.0329,0.0171,-0.028,0.0847,-0.0635,-0.0727,-0.0475,-0.0564,-0.0402,-0.0039,-0.0673,-0.0656,-0.0387,-0.0669,-0.0555,-0.0195,0.0772,0.057,0.1123,-0.0514,0.0166,-0.0423,0.056,-0.0462,0.0027,-0.031,-0.0338,-0.0805,-0.0046,0.0365,0.0012,-0.0343,-0.041,-0.0219,0.0776,0.2344,0.0093,-0.0003,-0.0295,0.0239,0.0273,-0.0135,0.0068,-0.0075,-0.0031,-0.0299,-0.0892,0.197,0.0021,0.002,0.0122,0.0217,0.0589,-0.0653,-0.0932,0.0451,0.019,0.0583,0.0377,0.0673,-0.0027,-0.0382,0.0234,-0.0423,0.0248,0.1053,-0.0579,-0.0344,0.0172,-0.0108,-0.0167,0.042,-0.0303,0.0289,0.0662,-0.0368,-0.0446,0.0036,-0.0501,-0.0649,-0.0141,-0.0202,-0.0721,-0.0265,-0.0636,-0.0108,-0.0136,0.0795,0.0367,-0.0194,-0.0557,0.1374,0.0763,0.1703,0.137,0.17,0.074,0.0463,-0.0502,-0.0634,-0.086,-0.0765,0.0559,-0.004,-0.0067,0.0606,0.0269,0.0675,-0.0599,0.0214,-0.0345,0.0143,-0.0192,-0.0713,-0.0011,-0.025,-0.0243,-0.0145,-0.1452,0.0861,0.051,0.0659,0.0707,0.034,-0.0152,0.1274,-0.0375,0.0131,0.0151,-0.0168,-0.0801,-0.0198,0.0222,-0.0283,0.032,-0.0554,-0.0561,-0.0486,-0.0361,0.044,-0.0418,0.0191,-0.0035,-0.0081,0.06,0.0545,0.0966,0.0245,0.0042,-0.0885,-0.017,-0.0697,0.0276,0.0062,-0.0805,-0.0543,-0.1053,-0.0954,-0.0317,0.1106,0.0586,0.0069,-0.0082,0.098,0.0565,0.0751,0.0838,0.0899,0.1159,0.1558,0.1122,0.0383,0.1188,0.0354,0.0231,0.0314,0.025,-0.0262,-0.0237,-0.006,0.0427,0.0503,0.0774,0.0577,-0.0383,0.0051,0.0138,-0.0042,-0.0573,-0.0046,0.0116,-0.0398,0.0267,0.0667,-0.0342,-0.0702,0.0382,-0.0764,0.1008,-0.081,-0.0874,0.0465,0.0315,0.0312,0.0491,0.0131,-0.0058,0.0341,0.0076,0.125,-0.017,-0.0137,0.0796,0.1426,0.0415,0.0725,0.0033,-0.0396,-0.0263,0.0151,0.0133,0.0439,-0.0769,-0.0297,0.0115,0.0246,0.0231,0.0019,0.031,-0.0415,-0.0466,-0.0437,-0.0734,-0.0525,-0.039,-0.0601,-0.0355,-0.0047,0.0776,0.0732,-0.0015,-0.0044,0.0443,-0.0073,0.0887,-0.0365,0.0895,0.0087,0.0063,-0.0279,0.0138,-0.0589,-0.0481,0.1405,-0.0205,0.0825,0.0157,0.0303,0.0231,0.0422,-0.0096,0.0053,0.0329,0.036,0.0749,-0.0989,-0.1587,-0.1361,-0.0197,0.0018,-0.0077,-0.0151,-0.0763,0.0544,-0.0344,-0.0575,-0.0408,-0.0797,-0.0047,-0.0293,-0.0128,0.0098,0.0422,0.055,-0.1263,0.0963,0.0796,0.0364,0.0262,-0.0066,0.0119,-0.0066,-0.0113,0.0723,0.0742,0.0152,-0.0038,0.1468,0.0732,0.1017,0.0065,-0.0699,-0.0185,0.0798,0.0675,-0.0847,0.0462,0.0765,0.0382,0.0385,0.0532,-0.0141,-0.0058,-0.0254,0.0072,-0.0484,-0.0584,-0.0507,-0.0465,0.0138,0.0361,-0.0345,0.0188,-0.0197,-0.0549,0.023,0.0739,0.0075,0.1196,-0.0484,0.0266,-0.0215,-0.0168,-0.0663,-0.0658,0.0961,-0.0292,-0.047,-0.0053,0.0213,-0.1097,-0.1084,-0.0603,-0.0341,0.0291,0.0393,0.0076,0.0102,0.0407,0.0925,0.049,-0.0888,0.0223,0.0018,0.0514,-0.0247,0.0096,-0.0499,-0.0503,-0.0217,0.0602,-0.0234,0.0352,-0.0095,-0.0189,0.0136,-0.0024,0.0435,-0.0682,-0.0085,0.1002,0.0082,0.0317,-0.0533,-0.0471,0.0088,0.0705,-0.0483,-0.0291,-0.0511,0.0255,0.0122,0.0419,-0.0261,-0.0721,-0.0214,-0.0805,-0.0586,-0.0889,0.029,-0.0575,0.3335,0.2093,0.0245,0.0718,-0.0131,-0.0315,-0.0044,-0.0093,-0.0289,0.0288,-0.0466,-0.0333,-0.0108,-0.0325,0.0581,-0.041,-0.0105,-0.0312,-0.0439,-0.0632,0.0175,0.0354,-0.0185,-0.0439,0.0083,0.0244,0.0385,-0.0279,-0.0604,0.0036,0.0222,0.1933,-0.0266,0.0089,0.0138,-0.1036,0.01,0.0643,-0.043,0.0047,0.0154,-0.0505,-0.0039,-0.0591,-0.0029,0.051,0.0429,0.0267,0.0782,-0.0007,0.0627,0.0887,-0.0304,-0.0396,0.0468,0.0062,-0.0005,0.0829,0.022,-0.0722,-0.0609,0.0869,-0.0405,0.0531,-0.0652,0.0133,0.0261,0.0494,0.0251,0.2611,0.0039,0.0017,-0.0984,-0.0893,0.0191,-0.0365,-0.1002,0.0301,0.0255,-0.0092,-0.0363,0.0519,0.1217,0.04,-0.0029,0.0346,-0.0322,0.1961,-0.0332,0.1954,0.0434,0.0453,0.1139,-0.0059,0.1874,0.0316,0.0577,0.0216,0.0544,0.1521,0.0154,0.0029,0.0596,-0.0303,-0.0215,-0.0137,-0.0344,0.063,-0.0356,-0.0263,0.0052,-0.0297,0.0324,0.0102,-0.001,0.0297,-0.0797,-0.0829,-0.0298,-0.0817,-0.0458,-0.0731,0.0233,-0.0009,0.011,-0.08,-0.0253,-0.0465,-0.0046,-0.04,-0.0366,0.0052,0.0097,0.0659,0.0544,-0.0806,-0.041,-0.1085,-0.0906,-0.0124,-0.1588,-0.0638,-0.0033,-0.0127,0.0116,-0.0606,-0.0019,-0.0195,-0.0028,0.0002,0.0033,-0.0168,-0.0446,-0.0612,-0.0765,0.0512,0.0183,-0.0051,0.0302,-0.0306,-0.0187,0.0431,0.0863,-0.0582,-0.0331,-0.1054,-0.0578,0.0145,0.0246,0.0754,-0.0686,-0.0333,-0.0379,0.0654,-0.025,-0.0295,-0.0144,-0.0342,-0.0704,-0.0901,-0.094,-0.083,0.0125,-0.0415,-0.0387,0.1122,-0.0174,0.0555,0.0161,-0.0032,0.0067,0.0432,-0.0584,-0.003,0.0902,-0.0294,0.025,0.0244,0.053,0.0091,0.0036,0.0078,0.0051,-0.0111,-0.0562,-0.0403,-0.0412,-0.0259,-0.0368,0.0095,-0.0191,0.0049,0.0049,0.0062,-0.0075,-0.0788,0.0731,-0.0023,-0.059,0.007,-0.0034,0.044,-0.0356,0.0113,-0.0102,-0.0509,-0.0497,-0.0398,-0.0599,-0.0108,-0.053,-0.0427,0.0092,0.0142,0.0375,-0.0105,0.0346,0.022,-0.0535,-0.0489,0.0378,0.0157,-0.0232,-0.0567,0.108,0.0222,-0.0507,0.0033,-0.0469,0.0972,-0.0016,-0.0762,-0.1057,-0.0596,-0.0587,-0.0333,-0.0829,0.0263,-0.0165,-0.0199,-0.0241,0.0093,-0.0725,0.0354,0.0007,-0.0368,0.0054,-0.0313,-0.0048,-0.0375,-0.0095,0.0052,-0.0241,-0.0452,-0.016,-0.0418,-0.0626,0.0604,-0.0191,-0.0334,-0.0191,-0.0612,-0.0743,-0.0013,-0.0403,0.0286,-0.0117,-0.0903,-0.0303,-0.0947,0.0501,0.1402,-0.0424,-0.0475,0.0585,-0.0842,-0.01,-0.0297,0.2095,-0.0488,-0.0108,-0.1353,-0.086,-0.119,-0.0665,-0.0623,-0.0412,-0.0258,-0.0263,-0.0418,0.0124,-0.0134,0.0271,-0.0398,-0.0222,-0.047,0.0229,0.0653,0.1011,0.059,-0.0158,0.0466,-0.0172,-0.0265,-0.0011,-0.0312,-0.0693,-0.0363,-0.065,-0.0798,-0.0661,-0.1363,-0.0349,-0.0693,-0.0432,0.0002,0.0128,0.0962,-0.0497,0.0228,0.0009,-0.0265,-0.0043,0.0051,-0.0052,-0.0207,0.0035,-0.0028,-0.016,-0.0101,0.1809,0.0788,0.0638,0.0685,-0.0237,0.001,0.0516,-0.0468,0.0191,0.0329,-0.0137,-0.0402,0.0181,-0.0015,0.0237,-0.0553,-0.0552,-0.0905,-0.0691,-0.1171,-0.0785,-0.0872,-0.0312,-0.0403,-0.1079,-0.0573,-0.0994,-0.0554,0.0135,0.0298,-0.024,-0.009,-0.0255,0.025,0.0355,0.0544,-0.0377,0.0341,-0.082,-0.1128,-0.0807,-0.0039,0.0762,0.0244,-0.0141,-0.0226,-0.0332,-0.0108,0.0292,-0.0193,0.0194,-0.0694,0.0171,-0.0018,0.072,-0.0279,-0.0148,-0.0473,-0.0055,-0.0487,-0.0671,-0.106,-0.0973,0.0203,-0.0114,0.0623,0.0027,-0.0701,-0.0758,-0.0423,-0.0707,0.0519,-0.0064,0.0202,0.0102,0.0262,0.0231,0.1047,-0.0286,-0.0106,-0.0212,0.0907,0.06,-0.0597,0.0011,-0.0413,-0.0282,0.039,-0.035,-0.0526,-0.059,-0.0479,-0.0467,-0.0619,-0.0104,-0.0226,0.001,-0.0377,0.017,0.1619,0.0337,-0.0566,-0.0233,0.0297,-0.0218,-0.0741,0.0347,-0.0034,0.152,0.1524,-0.0963,-0.0793,-0.0887,-0.0459,-0.0077,-0.0844,-0.0298,-0.0478,0.0273,0.0188,0.0329,0.0364,-0.013,-0.0607,-0.0141,0.0132,0.067,0.0779,0.0252,-0.0341,-0.0079,-0.0113,0.0293,0.0517,0.0061,0.0354,-0.0026,-0.0318,-0.0059,-0.0459,-0.0785,-0.0344,0.009,0.0017,0.0177,0.0017,-0.012,-0.0658,-0.0396,0.0104,-0.0259,-0.0601,-0.0358,0.0225,0.0142,-0.0025,0.1827,0.0364,0.0706,0.0012,0.0352,0.035,-0.0783,-0.0687,0.026,-0.0047,-0.0631,-0.0181,-0.0153,0.0154,0.0096,0.0154,-0.0175,-0.0241,-0.0674,-0.137,-0.0807,-0.0881,-0.0756,-0.1609,-0.0578,0.0196,-0.0366,-0.0465,0.011,-0.0524,0.0555,-0.0193,-0.0123,0.0461,0.0379,-0.0354,-0.0085,-0.0141,-0.034,-0.0824,-0.0518,-0.0647,0.0257,-0.0573,-0.0428,0.0079,0.0237,0.0033,-0.0064,-0.0874,-0.0754,-0.0676,-0.0412,0.0228,0.1383,0.0201,0.0547,-0.0027,-0.0133,-0.0925,-0.0134,-0.0165,0.0359,-0.045,0.0267,0.1429,0.2462,0.1512,0.1816,-0.0208,-0.0085,-0.0519,-0.0433,-0.0299,0.0496,-0.0185,-0.0424,-0.0025,0.1196,0.0003,0.0226,0.0304,0.0122,0.0183,0.0605,-0.0902,0.2009,0.1766,-0.0008,-0.0727,0.0317,-0.0333,-0.0573,0.0526,0.0311,-0.0643,-0.0669,-0.0042,-0.0208,0.1264,0.1526,-0.045,0.004,-0.0623,-0.0864,-0.0564,-0.014,0.0164,0.0019,-0.0356,-0.1022,-0.0754,0.0148,-0.056,-0.0257,-0.1012,-0.0411,-0.0711,-0.0457,-0.044,-0.0288,-0.0573,-0.0131,-0.0008,-0.0395,-0.0492,0.0417,-0.015,0.082,0.0915,0.0677,0.0423,0.0484,0.0031,-0.0271,0.0907,0.0455,-0.0532,-0.0427,-0.0527,0.0361,-0.1214,-0.0926,-0.0806,-0.101,-0.0431,-0.0074,-0.0473,-0.045,-0.0828,0.0391,0.071,-0.0186,-0.0472,-0.0984,-0.0017,0.1362,-0.0329,0.0283,-0.0373,0.0567,0.0123,0.0833,-0.095,-0.1089,-0.052,0.0675,-0.0439,-0.0151,0.0347,0.0347,-0.0344,-0.0182,0.0116,-0.0079,0.0596,-0.1069,0.0707,0.1187,-0.0266,-0.0386,-0.0601,0.055,-0.0171,-0.0272,0.0305,-0.0087,0.0876,-0.0608,-0.0834,0.0401,0.0717,0.0103,-0.0339,0.0512,-0.0135,0.0092,-0.04,0.044,0.0268,-0.0402,-0.0024,-0.0269,-0.0316,-0.043,0.1197,-0.0074,-0.0627,0.2812,0.1919,0.1716,0.0315,0.2032,-0.0727,-0.0784,-0.0245,-0.0702,0.0512,-0.0079,0.0721,0.044,-0.0516,-0.0293,0.1558,0.0729,0.0046,-0.0192,0.0856,-0.0891,0.0308,0.0461,0.0145,0.1911,-0.0427,-0.0158,-0.0191,-0.0182,0.1149,0.1182,0.0534,0.0849,0.0431,0.011,0.1198,0.1245,-0.0689,-0.0249,0.0166,-0.093,0.0469,-0.0162,-0.0625,-0.0226,-0.0381,-0.0766,0.0256,-0.0057,0.1311,0.0259,-0.0331,-0.0138,-0.0074,0.0597,-0.1117,-0.1145,-0.0847,0.0242,0.011,0.0161,0.0096,0.0121,0.0586,0.0172,0.023,-0.0498,-0.0638,0.0065,-0.0054,-0.0198,0.043,0.0561,0.221,0.034,-0.0321,0.0171,-0.0328,0.0655,-0.0313,-0.0168,-0.0866,-0.0459,-0.0011,-0.0056,-0.0399,0.0587,-0.0099,-0.0158,0.1633,-0.1139,-0.0009,0.0803,0.0843,0.0707,-0.0142,0.0732,-0.0689,-0.0363,-0.0292,-0.0547,-0.0478,-0.0732,0.025,-0.0649,-0.1067,-0.0546,-0.0659,-0.0067,-0.0423,0.0416,0.0067,-0.0094,0.0758,0.0094,0.0102,0.0073,0.013,-0.0862,-0.0721,-0.0561,-0.0301,0.0048,0.0249,0.017,0.0152,0.0171,-0.0198,-0.0291,-0.0199,0.0578,-0.0008,0.059,0.0123,0.1373,0.2023,-0.0362,-0.0019,-0.0263,0.0162,0.0134,0.0358,-0.0377,0.0102,0.0284,-0.0412,0.0259,0.16,0.0268,0.0028,0.0655,-0.0249,0.0306,-0.0463,-0.0324,-0.032,-0.0174,-0.0598,0.061,-0.0846,0.0528,-0.0905,0.0005,0.0115,-0.0389,-0.0716,-0.0491,-0.0031,0.0261,0.0796,0.0197,-0.0141,-0.007,0.0269,0.0296,0.079,0.0843,0.0324,-0.0061,0.0529,-0.0196,-0.0328,-0.0854,0.1066,0.0687,0.0338,0.1037,0.1104,0.0282,0.0062,0.0012,0.009,0.1182,0.0205,-0.0151,-0.0664,0.0402,0.0522,0.1274,-0.0566,-0.0462,0.0291,0.1464,-0.0341,-0.0227,-0.0129,0.0493,-0.0247,0.032,-0.0507,0.0722,-0.0904,0.0358,-0.0136,0.0473,-0.0348,0.0745,-0.0029,0.0297,-0.0068,-0.0084,-0.0118,-0.0165,0.0145,0.0401,0.004,0.0021,0.0453,0.0147,0.0231,0.0181,0.073,-0.0034,0.0717,-0.0367,-0.0363,-0.0079,0.0051,0.0218,0.0113,-0.0822,0.0015,0.022,0.0443,-0.0,-0.0495,0.3209,-0.0202,-0.0384,0.0882,0.0187,0.001,-0.0129,0.0035,-0.0641,-0.0804,0.0092,0.0912,-0.0219,-0.0517,-0.1114,-0.053,-0.0737,-0.014,-0.0382,0.0037,-0.024,0.006,-0.0968,-0.0237,-0.0485,-0.0382,0.0336,0.0021,-0.0178,0.0238,0.0276,-0.019,-0.0071,-0.0349,-0.0048,-0.007,-0.04,0.0201,0.0064,0.0482,-0.0733,0.0447,0.0155,-0.069,-0.0698,-0.0599,0.0339,-0.0446,-0.0997,0.0055,-0.1127,-0.0174,0.0823,-0.0019,0.0687,0.0441,-0.0128,-0.0278,0.0003,0.0094,-0.0439,-0.0835,0.0402,0.0119,0.0552,0.0087,0.0342,-0.0442,-0.034,0.043,0.1138,0.0041,-0.054,0.0133,0.0394,-0.1105,-0.0142,-0.0327,-0.0435,-0.0301,0.2137,-0.0024,-0.0501,0.0068,-0.0053,0.0744,0.1205,0.0222,-0.1069,-0.079,-0.0261,-0.0548,-0.0807,-0.0165,-0.0294,-0.0452,0.0809,0.0725,0.1068,-0.0224,-0.039,-0.1001,-0.0746,-0.0913,-0.098,-0.0612,0.0757,-0.0278,-0.0259,0.0534,0.1002,0.1474,0.0743,0.061,0.0718,-0.0292,0.0138,-0.0561,-0.1183,0.0269,-0.0118,0.0299,0.0005,-0.0736,-0.0705,0.0549,-0.0121,-0.0013,0.0046,0.283,0.0308,0.0905,0.0723,0.2063,0.1422,0.0337,0.0178,-0.0085,0.0811,-0.0055,-0.0224,-0.0059,-0.0839,-0.0515,-0.0431,-0.0881,0.0019,-0.0623,-0.0861,0.0214,0.0318,0.0526,-0.0054,-0.0543,-0.0723,0.0033,0.0372,0.057,0.1413,0.0896,0.0121,0.0648,0.0909,0.1558,-0.0046,-0.0289,-0.0355,-0.0336,-0.0497,0.0143,-0.0954,-0.067,-0.0934,-0.0108,0.0914,-0.0715,-0.0213,-0.0278,-0.0154,-0.0693,0.0947,0.0109,-0.0543,-0.0618,0.0346,0.0089,-0.0178,0.0326,0.0516,0.0365,0.0306,0.0257,0.0358,0.0791,0.0046,-0.0157,-0.011,0.0003,-0.1256,-0.0545,-0.0082,-0.0514,-0.0745,0.0192,-0.1163,0.1646,0.0592,0.0037,-0.0236,-0.0056,-0.0257,0.189,-0.1044,-0.1851,-0.1062,-0.0393,-0.0927,-0.1083,-0.0705,-0.0987,-0.0933,-0.0208,0.0007,-0.0266,-0.049,-0.0369,-0.026,-0.036,-0.0256,0.0464,-0.0579,-0.0542,-0.0585,-0.0473,0.0497,0.0321,-0.0284,-0.0388,-0.0545,-0.0538,-0.0123,-0.0188,0.0339,-0.0434,-0.016,0.0474,-0.0284,-0.0331,-0.0436,0.0197,-0.0323,0.056,-0.0364,-0.0649,0.0854,-0.0151,0.0076,0.0279,0.1041,0.0504,0.0589,0.0006,-0.0095,0.0251,0.0084,0.0462,0.0196,-0.0004,0.0969,0.0826,0.0152,0.0301,-0.0256,-0.0294,-0.0007,0.0408,-0.016,0.0189,0.091,0.0112,-0.0787,-0.0728,-0.015,0.0713,0.0159,0.0097,0.0571,0.0109,0.0417,-0.1029,-0.0554,0.0158,0.0133,-0.0392,-0.0466,-0.018,-0.1005,-0.0122,0.2799,0.1181,0.3184,0.2324,0.1578,0.1617,-0.0222,0.1734,0.0625,0.0203,0.2352,0.2478,0.2672,0.2286,0.0426,-0.1073,0.0018,0.0308,-0.0145,-0.0003,-0.1,0.0437,-0.0017,0.0017,0.0419,0.1805,0.0335,-0.0333,0.2082,0.0577,0.1046,0.1038,-0.0359,-0.0945,0.0037,-0.0179,-0.0025,-0.0117,-0.0368,-0.083,0.0657,-0.0394,-0.0069,-0.0826,-0.0295,-0.1069,-0.0521,0.0237,-0.0837,-0.0646,-0.0336,-0.0651,-0.0315,-0.09,-0.0525,0.1928,0.18,0.0639,0.0632,-0.0095,0.0319,0.0721,0.0698,-0.0169,0.001,0.0512,0.0079,-0.0444,-0.0978,0.0267,-0.0437,0.0043,0.0901,0.0384,-0.0089,0.0337,0.104,-0.0155,-0.0907,0.0057,-0.0965,-0.083,-0.0748,-0.0581,-0.0094,-0.016,-0.0951,0.145,0.022,0.0424,0.0344,0.0459,0.0646,0.0563,-0.0361,-0.0226,0.0297,0.0575,0.0044,-0.0205,-0.0244,0.0229,-0.0401,-0.015,0.0239,0.1344,-0.0591,-0.0737,-0.0556,-0.0587,-0.0753,-0.0598,-0.0093,-0.0149,-0.0327,0.0219,0.003,-0.0536,0.1202,-0.0467,0.0053,-0.0166,0.0775,-0.0513,-0.0503,-0.0278,0.0438,-0.1071,-0.0812,-0.0863,-0.0657,-0.0705,-0.0978,-0.1083,-0.1014,-0.0602,0.0009,0.0193,0.0064,0.0835,0.0588,0.0928,-0.0875,0.0283,-0.0228,-0.0082,-0.027,-0.0325,-0.0536,0.0044,0.0073,0.1207,0.0038,-0.0104,-0.0642,0.1647,0.0282,0.142,-0.0111,0.0274,0.0533,-0.048,0.0037,-0.0459,0.0319,-0.0802,-0.112,-0.1069,0.0752,0.1137,0.0605,-0.0444,-0.0527,-0.0332,0.0627,-0.0803,-0.0773,0.063,-0.021,-0.0886,0.1657,-0.0326,0.0422,-0.0724,-0.0057,0.0197,0.1227,0.0734,0.076,0.0856,0.0796,0.1818,0.2009,0.1914,-0.0076,0.0188,-0.0622,0.0347,0.0385,-0.0445,-0.0104,-0.1083,-0.0697,-0.0668,-0.0269,0.0328,0.0606,-0.0217,0.0809,0.007,0.0325,0.0141,0.0541,0.0257,-0.0284,-0.0472,-0.0104,0.0608,-0.0034,0.0829,0.0665,-0.0601,-0.0279,-0.0142,0.0657,0.0505,0.0392,0.0529,0.0505,0.0453,0.0282,0.0619,0.0386,0.0012,0.0287,-0.0452,0.0712,-0.0482,0.0109,0.0816,0.1471,-0.0498,-0.017,-0.0789,0.0547,-0.0734,0.0097,-0.0373,0.0007,0.0003,0.0598,0.0443,0.0257,0.0981,-0.006,0.0754,0.1388,-0.0515,-0.0123,0.0299,0.051,0.0096,0.0857,-0.0339,0.0277,-0.0397,0.0074,0.0085,0.1167,-0.0057,0.0156,0.0457,0.0067,0.0686,0.085,0.0335,0.0035,-0.0428,-0.0796,-0.0906,-0.0632,-0.0343,-0.0172,-0.0404,-0.1191,0.0048,0.1216,-0.0122,0.087,0.1442,0.0403,-0.0242,-0.0647,0.1267,0.0047,-0.0969,-0.121,0.128,-0.0383,-0.0056,0.009,0.0568,0.1651,0.1633,0.0812,-0.0159,0.0418,-0.0064,0.0087,0.0035,0.0111,0.0013,-0.0613,-0.0381,0.0394,-0.015,-0.0224,-0.0203,-0.0542,-0.0771,-0.0031,-0.0597,-0.0089,-0.0367,-0.0107,0.0075,0.0477,0.0363,0.0515,-0.0541,-0.0046,0.0421,-0.049,-0.0484,-0.036,-0.0595,-0.0595,-0.002,0.0327,0.0112,0.0326,0.0257,0.2502,0.1891,0.0249,-0.0333,-0.033,-0.0282,0.1257,-0.0475,-0.0328,0.0551,0.085,0.0409,0.011,0.0148,0.0635,0.0641,0.0482,0.0227,0.0863,0.0796,-0.0097,-0.0353,-0.0036,-0.0257,0.2039,0.1235,0.0307,0.0135,-0.0245,0.0039,-0.0066,-0.039,-0.0529,-0.0681,0.0054,-0.0656,0.0011,0.037,-0.0186,-0.0403,-0.0516,0.0366,-0.186,-0.0433,-0.1697,-0.0901,-0.013,-0.0434,-0.0577,0.2457,0.2387,0.1332,0.0783,0.0853,0.0637,-0.0899,-0.0443,-0.0606,-0.0063,0.0525,0.0896,0.0587,0.0659,-0.0516,-0.0118,0.0681,-0.0382,-0.0754,0.0308,0.0081,0.3553,0.1448,0.3186,0.2239,0.2068,0.154,0.3133,-0.0882,0.0625,-0.0207,-0.039,0.0467,0.0441,-0.0421,-0.0561,-0.0118,-0.0382,0.0297,-0.0453,-0.0403,-0.0779,0.0552,0.0086,-0.0945,-0.0515,-0.086,-0.0702,-0.0094,0.1095,0.0614,0.0461,0.0745,0.114,-0.0083,-0.0214,-0.0104,-0.0431,0.0681,0.0519,0.0233,0.0178,0.0113,0.1127,0.097,-0.085,-0.0492,-0.0123,-0.029,-0.0097,-0.0014,0.0185,0.0111,-0.0205,-0.0222,0.038,0.0153,0.0215,0.0545,0.0599,-0.0563,-0.051,-0.0263,0.0006,0.0603,0.0312,-0.0184,-0.0229,0.0022,-0.0383,0.0282,-0.0569,0.0031,0.0143,0.1133,-0.0363,-0.0112,-0.0034,0.0424,-0.0836,0.0035,-0.0628,0.0323,0.0454,0.0713,0.0157,0.035,0.0552,-0.027,-0.0191,0.0629,-0.0045,0.0385,0.005,0.0614,-0.0157,0.0045,-0.0033,-0.0187,0.042,0.0856,-0.0104,-0.0279,-0.0129,-0.0055,-0.0484,-0.0422,-0.0844,-0.0595,-0.0066,0.0409,-0.0741,-0.026,-0.072,-0.0912,-0.0588,-0.0546,0.0131,-0.0334,0.0059,-0.0302,-0.0926,-0.0633,-0.0091,-0.0974,0.0137,-0.0372,-0.0527,0.0724,0.0468,0.0726,0.1499,0.0436,-0.003,0.0418,0.014,-0.0074,-0.0492,0.0231,-0.0477,0.006,-0.0222,0.0558,0.0103,0.0353,-0.0387,-0.0464,-0.0464,-0.0424,-0.0399,0.0173,0.0057,0.0195,-0.0387,0.0122,0.0466,-0.099,-0.0423,-0.0551,-0.0403,0.1559,0.0154,0.0144,-0.0845,0.0179,-0.0225,-0.0933,-0.0809,-0.0044,-0.0094,-0.0326,0.0014,-0.0154,-0.0205,0.0842,0.0725,0.0038,0.005,0.002,-0.0403,-0.0077,-0.065,-0.0169,-0.0192,-0.0218,-0.0668,-0.109,-0.0718,0.0695,0.1617,-0.0134,-0.0063,-0.036,0.0147,0.0079,0.1035,-0.029,-0.0606,-0.0412,0.0546,0.0157,0.1389,0.043,0.0364,-0.0411,-0.0376,0.0045,-0.0635,-0.0449,-0.0347,-0.0477,-0.0362,-0.0245,-0.0347,0.0089,-0.0417,-0.0105,0.0741,0.0739,0.0375,0.0239,-0.0272,-0.0068,-0.0277,-0.0662,-0.0033,-0.0371,-0.0362,0.0222,-0.0973,0.0058,-0.0427,-0.0294,0.0123,-0.0369,-0.0468,0.0067,-0.0389,-0.0811,-0.0265,0.0265,0.0298,0.0349,0.0591,0.0502,0.0397,0.0503,0.019,0.0141,-0.0012,0.0023,-0.1002,-0.0335,-0.0904,-0.0726,0.0029,0.0086,0.0613,-0.08,0.0317,-0.0041,-0.1057,-0.0534,-0.0441,-0.085,0.0863,-0.0296,-0.02,-0.1234,-0.0213,0.0128,0.0794,-0.0267,-0.0616,-0.0504,0.0473,-0.0535,-0.0269,-0.0079,-0.0222,-0.0693,-0.0506,0.0071,-0.0137,0.2822,-0.0234,-0.0044,-0.0232,-0.0414,0.007,-0.0622,-0.0838,-0.0053,0.1411,-0.0152,-0.0333,0.0524,-0.0763,0.0053,-0.0283,0.0284,0.0239,0.035,-0.0832,-0.0961,-0.0664,0.0348,0.0297,-0.0014,-0.0441,-0.0505,0.0349,0.0429,0.0014,-0.0569,-0.0099,0.2824,0.3016,-0.0297,0.0537,-0.0153,-0.0136,0.0975,-0.0258,0.0483,-0.0782,-0.0159,-0.0259,-0.0903,-0.0252,-0.0469,-0.0431,-0.0025,-0.0244,-0.0567,-0.0955,-0.0043,-0.0264,-0.0679,-0.0086,-0.0289,0.1674,0.142,0.0514,-0.0473,-0.0054,0.3079,0.2866,0.2229,-0.006,-0.0015,0.1892,-0.036,-0.0215,-0.0133,-0.0476,-0.0161,0.0664,0.0247,0.0387,0.0765,0.0081,0.149,0.0027,0.0271,-0.0663,0.0105,0.0297,0.0058,-0.0068,0.0025,-0.0604,0.0197,-0.0057,-0.003,-0.032,-0.0049,-0.0057,0.0254,-0.037,0.0454,-0.074,0.0053,-0.0345,-0.0426,-0.022,-0.0585,-0.0681,-0.0324,0.1362,-0.0884,0.0078,0.0569,0.0331,-0.002,0.026,-0.0079,0.0418,0.2559,0.0522,-0.0193,0.0381,0.0637,0.0441,0.031,-0.0295,-0.0456,0.106,0.043,0.0181,0.0248,0.2405,0.1024,0.0002,0.0254,0.0,0.1113,-0.0246,0.0731,0.0214,0.1495,0.0868,0.0775,0.0765,0.0957,0.0637,0.1409,0.0828,-0.0225,-0.0774,0.0072,-0.0795,0.0856,0.1174,0.1183,-0.0283,0.0276,0.0579,0.0129,0.1847,0.0269,-0.0154,0.0024,-0.0056,-0.0957,-0.0349,-0.0567,-0.0378,-0.0311,-0.0536,0.0399,-0.051,0.3937,0.3372,0.3212,-0.007,0.1285,0.1493,0.0713,0.0491,0.0071,-0.012,0.1361,0.0035,-0.0105,-0.0398,0.0286,0.1333,0.0262,0.0462,0.0453,0.0099,-0.0642,-0.0037,-0.0211,-0.0407,-0.0941,-0.0357,-0.0159,0.1268,-0.0467,-0.0292,-0.0657,0.1165,0.0824,0.1443,0.0752,0.0632,0.0147,0.133,0.0468,0.0419,0.0486,0.0517,-0.0584,0.0298,0.0228,0.0262,0.0531,0.0096,0.0309,0.0599,0.0158,0.0159,-0.0159,-0.0331,0.1103,0.1924,0.3167,0.1993,-0.0267,0.0212,0.045,-0.0435,-0.0197,-0.0117,-0.0254,-0.0345,-0.0113,-0.0809,-0.055,-0.0856,0.0191,0.0301,0.0864,-0.0071,-0.0432,-0.0241,-0.075,-0.0378,0.2093,-0.0041,-0.0406,0.0126,-0.0941,-0.0833,-0.0253,-0.0135,-0.0686,-0.0177,0.0058,0.0291,-0.0213,0.0377,0.0779,0.0491,0.0436,0.1118,0.0029,-0.0209,0.1417,-0.0272,0.0095,-0.0237,-0.0738,0.0026,-0.0058,-0.0396,-0.0515,0.0022,-0.045,-0.0469,0.0428,0.0843,-0.0167,0.0134,0.0266,-0.0668,-0.0477,-0.0784,-0.0613,0.0148,-0.0051,-0.0378,-0.0565,0.0574,0.0149,-0.024,-0.0314,0.0719,-0.0356,0.0746,0.0303,0.0509,0.0984,-0.0566,0.0424,0.119,0.0869,0.1044,0.2101,0.2234,-0.065,-0.0222,0.0101,0.0524,0.0254,0.1784,0.182,0.0661,0.04,0.0547,-0.0605,0.0078,-0.0457,-0.0822,-0.0112,-0.0069,-0.0508,0.0116,0.059,0.0095,-0.0127,0.0374,-0.015,-0.0167,-0.0194,-0.0259,0.312,-0.0325,-0.0729,0.1936,0.0122,0.0772,-0.013,0.0032,-0.0542,0.0135,-0.0562,-0.001,-0.0101,-0.0003,-0.0206,-0.0306,0.0007,-0.0196,-0.0317,0.0027,0.0176,-0.0055,0.029,-0.0441,0.0487,0.0639,-0.0159,-0.0546,-0.0007,-0.0014,0.0349,0.0448,0.044,-0.0904,-0.0131,-0.0166,-0.0051,-0.0572,0.0585,0.1633,0.0745,0.0101,0.0162,0.0193,-0.0028,-0.0246,-0.071,-0.0546,-0.0561,-0.0915,-0.0916,-0.0061,0.0478,-0.0803,-0.0392,0.058,-0.0399,0.0582,0.0667,-0.0466,-0.0724,-0.0068,-0.0141,0.0214,0.0387,-0.0249,-0.0679,0.0546,0.0437,-0.0511,-0.0281,-0.0725,-0.0537,0.0404,0.104,0.1126,0.1655,-0.0142,0.0629,-0.0009,-0.0417,0.0408,-0.0024,0.2108,0.0062,-0.0507,-0.0198,0.0983,0.0991,-0.0931,0.0565,0.0403,0.015,-0.0516,0.2852,-0.0334,-0.0416,0.0296,0.026,-0.0161,-0.0325,0.0351,-0.0146,0.0177,0.146,-0.0695,-0.0824,0.1845,0.2051,0.001,0.0328,-0.0323,-0.0405,-0.0643,-0.0549,-0.0357,0.0143,-0.0198,-0.0171,0.032,-0.0214,0.0216,-0.0911,0.05,0.0378,-0.0242,-0.0425,0.0391,-0.0102,-0.0456,-0.0468,0.0367,-0.0126,0.0259,-0.0078,-0.0606,-0.0118,-0.0218,-0.0076,-0.0329,-0.0359,0.0052,0.0307,-0.0152,0.0189,-0.0152,0.0041,0.0167,-0.0501,0.1498,0.0428,-0.022,-0.0334,0.0294,-0.0174,-0.0008,-0.0759,0.0098,0.0275,0.0073,-0.0943,0.1303,0.0414,0.1118,0.0681,-0.0366,-0.0009,0.0581,0.0049,0.0306,0.0216,0.0012,0.0952,0.0031,-0.0036,0.0217,-0.1157,-0.0271,-0.0882,-0.0391,-0.0377,-0.0136,0.0982,-0.0676,-0.0227,0.075,0.0728,-0.0231,0.0445,-0.0419,-0.0631,0.0869,-0.0439,0.0153,-0.0383,0.0326,-0.0209,0.0322,-0.0396,0.0133,-0.0658,-0.0338,-0.0562,0.0129,0.1541,-0.0666,-0.1004,-0.0642,-0.0807,-0.0709,-0.0601,-0.0137,-0.1148,-0.0124,-0.074,0.0509,-0.0188,-0.0934,-0.057,-0.0341,0.049,0.032,0.0072,-0.0537,-0.0993,-0.0646,-0.0133,-0.0306,-0.0331,-0.0689,-0.0268,0.0189,-0.0993,-0.053,-0.0586,-0.0343,0.0031,-0.0147,0.0324,-0.0797,-0.0804,-0.0108,-0.036,-0.0654,0.0544,-0.0344,0.0044,0.0443,-0.0327,0.056,-0.0043,-0.0312,0.1819,0.0294,-0.0451,-0.0134,-0.0369,0.1664,0.099,-0.0077,-0.0336,0.0548,0.0892,-0.0273,-0.0783,-0.005,-0.0145,0.0163,0.0121,0.0255,0.0156,0.0262,-0.0595,-0.0172,0.0366,-0.0702,-0.064,0.0212,-0.0024,0.0064,0.0076,0.0067,0.0585,-0.0471,0.0404,-0.0648,-0.0728,-0.0801,-0.0294,-0.0038,-0.054,0.0668,-0.1079,-0.1112,-0.0288,-0.0611,-0.0348,-0.0627,-0.054,0.0291,-0.0135,0.0159,-0.0669,-0.0567,-0.0324,-0.0008,-0.0072,0.0661,face maintenance
trm_557b4bb7cf05b,-0.1219,-0.1249,-0.1579,-0.1038,-0.0064,-0.0366,-0.1153,-0.0533,-0.0217,-0.0826,-0.0043,-0.027,-0.1209,-0.0688,-0.1216,-0.0581,-0.1233,-0.1279,-0.0626,-0.0602,-0.087,-0.0065,-0.0615,0.0365,-0.0518,-0.0122,-0.0166,-0.1108,-0.1446,-0.0826,-0.1344,-0.1185,-0.1459,-0.0896,-0.1612,-0.1557,-0.0876,-0.075,-0.1304,-0.0402,-0.148,-0.1228,-0.0909,0.0678,-0.0715,-0.0786,0.1107,-0.0861,0.0699,-0.0859,-0.0208,0.0516,0.0682,0.0913,-0.0212,-0.0634,-0.1286,-0.0505,0.017,-0.0635,-0.041,0.0009,-0.1574,0.1,0.0811,0.0739,-0.2368,-0.2683,-0.1306,-0.0394,0.1233,-0.0006,0.2221,-0.124,-0.0708,0.0691,-0.1404,0.0377,0.0798,-0.0857,-0.0095,0.1124,-0.051,-0.1455,0.0868,0.082,0.0411,-0.014,-0.0117,-0.2512,-0.1422,-0.0955,-0.0333,0.2283,0.1688,0.1842,0.1552,0.0632,0.2462,0.0847,0.0779,-0.0016,0.1246,0.0247,0.1115,-0.2073,-0.1907,0.197,-0.0245,-0.0135,0.0061,-0.1091,0.1386,0.1982,0.0415,0.0604,-0.083,0.0047,-0.0222,-0.1034,-0.105,-0.166,-0.1376,-0.0176,-0.0825,-0.1403,-0.0703,0.0458,0.0728,0.007,-0.07,-0.0803,-0.0497,-0.2575,-0.0176,-0.2249,-0.0142,-0.1246,-0.0523,-0.0589,-0.1145,-0.1061,0.0556,-0.0335,-0.0497,0.085,-0.0972,0.0596,-0.1027,0.1125,-0.0672,-0.1345,-0.1721,-0.1581,0.1894,-0.0576,0.0966,0.0223,0.0025,-0.1048,-0.0591,-0.127,-0.2273,-0.2537,-0.0194,0.0067,-0.0417,-0.1998,-0.1858,0.037,-0.1449,-0.1604,0.0191,-0.2095,-0.133,-0.2027,-0.146,-0.1116,-0.0733,-0.0378,-0.1675,0.0247,-0.1014,0.0457,-0.1346,-0.0673,-0.1556,-0.1005,-0.046,-0.0173,0.002,-0.117,-0.0581,-0.2112,-0.188,-0.1829,-0.1616,-0.0727,0.0062,-0.0728,-0.0302,0.2435,-0.1547,-0.1733,0.1287,-0.1137,-0.1401,-0.0665,-0.0818,-0.0106,-0.1904,-0.091,-0.0187,0.0002,0.0611,0.0343,0.0841,-0.1562,-0.1554,0.0125,0.0868,-0.129,-0.1858,-0.0959,0.0935,0.0076,-0.051,0.0984,-0.0315,0.2765,-0.1075,-0.1658,0.1552,-0.1718,-0.1653,0.0582,-0.0179,0.1236,0.0429,-0.0589,-0.0021,-0.1994,-0.0623,-0.0097,-0.0802,-0.098,-0.0673,-0.1485,-0.0529,-0.1132,0.0174,0.0332,-0.0213,0.0926,-0.0053,-0.1782,0.0245,-0.0599,0.1608,0.2446,0.1142,0.3126,-0.0992,0.159,0.2157,0.389,0.1928,-0.006,-0.0064,0.0113,-0.0464,-0.0723,-0.1049,0.0184,-0.0965,-0.0094,-0.1506,-0.2278,-0.1782,-0.0104,0.0151,-0.0606,-0.0352,-0.2127,-0.1639,-0.1215,0.0523,0.0761,-0.1339,-0.1131,-0.1227,-0.0772,-0.0533,-0.0767,-0.1188,-0.0109,-0.0291,0.1505,-0.0173,0.2167,0.0863,-0.1671,-0.1252,-0.167,-0.0488,-0.0358,-0.156,-0.0564,-0.0459,0.0191,0.0132,-0.0081,-0.0781,0.1277,0.0774,-0.0331,0.1784,0.0176,0.0912,-0.138,0.0303,0.0304,-0.0762,-0.0912,-0.1083,-0.0687,0.0053,-0.0617,-0.083,-0.1783,0.0523,-0.1017,-0.0187,0.0114,0.0484,0.103,0.1053,0.0214,-0.0298,-0.1117,-0.0983,-0.0383,-0.0076,-0.0159,0.0716,0.0551,-0.3082,-0.2224,-0.2111,-0.1468,-0.1205,0.0551,-0.1336,-0.046,-0.1008,-0.1144,-0.0672,-0.1395,-0.178,-0.1123,0.025,-0.001,0.0454,-0.0202,-0.0255,0.082,-0.1734,0.3255,0.0278,-0.1771,0.0193,0.1307,-0.021,0.1502,-0.1433,-0.0335,-0.1042,0.1143,0.1472,0.1158,0.1646,0.0092,-0.0636,0.0702,0.0586,0.1054,-0.0835,-0.0386,0.0584,-0.0294,-0.0336,-0.0512,-0.1,-0.0352,0.1015,0.0268,-0.1205,-0.2127,-0.1278,-0.0596,-0.0569,0.0362,0.0136,-0.0654,0.0371,0.1389,0.1046,0.0229,-0.1275,-0.059,-0.0218,-0.2023,-0.0491,0.2836,-0.1685,-0.0354,0.2917,0.0551,-0.0316,0.0319,0.0126,-0.2536,-0.162,-0.3174,-0.2725,-0.1086,-0.2102,-0.0832,-0.1395,-0.0849,-0.0592,0.056,0.0049,0.004,-0.0377,0.0807,0.0039,0.0395,-0.3194,-0.1493,0.0391,0.0728,-0.0509,0.0856,-0.1044,-0.1168,0.0674,0.1334,-0.0426,0.1049,0.1573,0.088,-0.1033,-0.0373,0.0654,-0.1302,0.0234,-0.0244,0.06,0.0225,0.0819,-0.0505,-0.0491,0.0643,-0.1511,-0.1298,0.0432,0.4047,-0.1456,-0.0825,0.0125,0.0056,0.1574,-0.0495,-0.0625,-0.0219,0.0282,0.041,-0.0363,-0.0465,0.0631,0.0065,-0.013,0.1018,0.1452,0.1598,-0.0187,-0.0166,-0.1008,-0.0398,0.0477,0.1379,-0.1006,-0.1619,0.0971,-0.0032,-0.0881,-0.0483,0.0538,-0.0636,-0.0465,0.0449,-0.0927,-0.1334,-0.1084,-0.128,0.0836,0.0473,-0.0353,0.1133,-0.1858,0.022,-0.0018,0.005,0.0637,0.1116,-0.1238,-0.1052,0.1035,-0.08,-0.0398,-0.0869,0.073,0.1836,0.2413,0.0358,0.1797,0.1736,0.045,0.0997,-0.0733,-0.0529,-0.1121,-0.2242,-0.0846,0.0354,-0.1674,-0.0749,-0.0499,-0.1751,-0.0228,0.0249,0.0369,-0.0643,-0.0785,-0.0298,0.0551,0.0571,0.0005,-0.0848,0.07,-0.0108,0.03,-0.0076,-0.0196,-0.1665,0.087,0.0871,0.0251,-0.0612,-0.0688,0.0011,-0.087,0.0366,-0.0869,0.0079,0.0695,-0.0196,0.0173,-0.0255,-0.0444,0.0298,-0.1424,-0.0075,-0.0659,-0.0451,0.0339,0.0608,0.0901,0.1135,0.0383,-0.1182,0.0025,-0.0541,0.1948,0.0834,0.1208,0.0795,0.0941,-0.0438,-0.1402,0.0934,0.1804,0.1675,0.0108,-0.0544,-0.251,-0.0261,0.1793,-0.0975,0.0292,0.06,0.0719,0.0668,0.0399,-0.0006,-0.0227,-0.1895,-0.1771,0.1613,-0.2143,-0.0719,0.1116,-0.0277,-0.2826,-0.0822,-0.0692,0.0793,0.0077,-0.2605,-0.0738,-0.229,0.0181,0.0045,-0.0796,0.0239,-0.0562,-0.144,-0.0451,0.0665,0.0572,0.0652,-0.0369,0.0604,0.1235,0.0557,0.1093,-0.0445,-0.0778,0.0307,-0.0631,0.0853,0.0029,-0.0929,-0.0833,-0.0444,-0.1776,-0.1509,0.1654,-0.2204,0.1083,-0.1612,0.1782,-0.1504,-0.0169,-0.0572,0.0391,-0.0847,-0.0532,-0.087,-0.1833,-0.031,0.1591,-0.0682,0.0802,0.1163,-0.1337,-0.2016,-0.041,-0.0301,-0.0624,-0.0835,-0.1054,-0.0646,-0.0288,-0.0985,0.1326,-0.1284,-0.0,-0.0453,0.0946,0.0566,0.0937,0.04,0.1299,-0.1504,-0.1304,0.0589,0.0399,0.003,0.0989,0.2147,0.188,0.1134,0.0214,-0.0138,0.0491,-0.0727,-0.0763,0.0657,0.0877,0.0529,-0.0684,-0.1142,-0.0964,-0.053,-0.1533,-0.156,-0.1743,0.0874,0.115,0.0815,0.0004,0.0565,0.074,0.0174,-0.0282,0.0013,-0.1716,0.0422,0.0978,-0.0859,-0.2853,-0.2912,-0.1888,-0.0256,-0.0097,-0.097,0.0833,-0.0445,0.0228,-0.0248,-0.0674,0.0757,0.1225,-0.0067,-0.1579,0.1549,0.1794,0.3625,-0.158,-0.0168,-0.0839,-0.0011,0.0015,-0.1681,0.1424,0.0582,-0.0339,0.0279,0.0296,0.0448,-0.1617,-0.2637,-0.2275,-0.1656,0.0374,0.1624,-0.0095,-0.1752,-0.0322,0.011,0.086,0.0213,0.0609,-0.0028,-0.0846,-0.0834,-0.0724,0.1624,0.1034,0.1236,-0.0894,-0.0165,0.0364,-0.1026,0.0413,-0.0915,-0.1478,-0.0167,-0.1783,-0.1563,-0.1029,0.11,0.1043,0.0414,0.0058,-0.0578,0.0549,0.1739,-0.035,-0.066,0.0536,-0.0018,0.0455,0.0105,0.14,-0.0482,0.2223,-0.208,-0.2071,0.0994,0.1206,0.1273,-0.0168,-0.0423,0.0904,0.016,0.0615,0.1853,-0.0097,0.1005,0.0903,0.1437,0.0359,0.0066,0.1811,0.1692,-0.1557,0.0421,0.0827,-0.2212,-0.1648,-0.0459,-0.1402,-0.0207,-0.2387,-0.0684,-0.1843,-0.1381,-0.2233,-0.0157,-0.0231,0.0586,-0.0821,-0.0754,0.0773,0.077,0.1314,0.0595,0.1096,0.144,0.0247,0.1124,0.058,0.0575,0.1282,0.1528,-0.1236,0.1752,0.0943,-0.0579,-0.0646,-0.1053,-0.0402,0.1458,0.1472,-0.2894,-0.1378,-0.01,0.1018,0.2056,0.1227,0.0836,0.0531,0.0123,-0.0464,-0.0888,0.1404,-0.0131,0.0806,-0.1413,0.0537,-0.0698,0.1421,0.2798,0.0983,0.2656,-0.1564,-0.1439,-0.1019,0.1988,-0.0726,-0.1072,-0.1133,0.091,-0.047,-0.152,-0.0707,-0.1657,0.0874,-0.081,0.0111,0.0915,0.0274,0.0666,-0.1637,-0.0775,-0.0489,0.0766,-0.1153,0.0391,0.0313,0.0495,0.1138,0.246,0.1262,-0.1292,-0.0747,-0.1037,-0.0602,-0.1696,-0.0429,0.0657,0.1831,0.0488,-0.0254,-0.1294,0.1425,0.2329,0.0797,-0.0101,-0.0122,-0.0522,-0.2057,-0.1116,-0.0867,-0.0368,0.0372,-0.1645,-0.0544,0.0937,0.0033,-0.0854,-0.045,0.0735,-0.1055,-0.0516,-0.0726,-0.1557,-0.1513,-0.2375,-0.1119,-0.2446,-0.0219,-0.0227,-0.0866,-0.1357,-0.0954,-0.1752,-0.1087,-0.2377,-0.1128,-0.0807,-0.0008,0.0825,0.1328,-0.0518,0.0754,-0.0214,0.0159,0.0553,0.1169,0.1549,0.0961,-0.0593,-0.0119,0.016,0.0176,0.1181,0.1251,0.1061,0.0058,0.1186,-0.0722,0.1028,-0.0723,-0.0682,-0.0471,0.0829,-0.0264,0.0586,-0.1814,-0.0692,-0.0736,-0.0725,-0.0628,0.0498,0.1354,0.0358,0.0988,0.1281,0.0729,0.0889,0.0887,-0.0413,0.0188,0.034,-0.028,-0.0561,-0.0909,-0.1513,-0.0388,0.134,0.1147,-0.1535,-0.1187,-0.0849,-0.1951,-0.0934,0.2038,0.0752,0.2042,0.0715,0.0534,-0.0495,0.0215,0.1174,-0.0053,-0.0524,-0.0381,0.0091,-0.0623,-0.1321,-0.021,0.1103,-0.0986,-0.0276,-0.1068,0.0686,-0.1558,0.0428,0.0438,0.188,0.2236,0.166,0.099,0.1225,-0.0037,0.0291,-0.0262,-0.0693,-0.0142,0.0026,0.017,0.0245,-0.0362,0.1054,-0.0314,-0.0715,-0.063,-0.1652,-0.1739,-0.154,-0.1131,0.219,0.0079,0.0471,-0.163,0.2048,0.109,-0.0151,-0.0282,-0.0211,0.06,-0.0236,0.0294,-0.1274,-0.0985,-0.0297,0.0009,-0.1229,-0.0606,-0.0962,-0.0257,-0.0376,-0.0591,-0.0874,-0.0699,0.0159,-0.0787,-0.0313,0.0136,0.0877,-0.1122,0.0632,-0.0895,0.0406,-0.0409,-0.1007,0.3348,0.1933,0.2475,0.1907,0.1985,0.0116,0.2095,0.0984,-0.1928,0.2234,0.2072,0.1457,0.1069,0.1507,-0.0482,-0.0144,-0.0469,0.0146,0.0493,0.0312,0.0693,0.0503,-0.1509,0.0428,0.0427,0.0186,0.0762,-0.0115,-0.0296,0.1541,0.0715,-0.0817,0.0142,-0.1048,0.1278,-0.0114,0.1667,-0.0361,-0.1804,-0.1403,-0.0737,-0.0256,0.1124,0.11,-0.0756,-0.1117,-0.2299,-0.1705,-0.0891,0.2241,-0.0966,0.1671,0.153,-0.0507,-0.008,-0.0585,0.0321,0.1107,0.0371,0.1216,0.0619,0.0545,0.121,0.1045,-0.1529,-0.1844,0.0573,-0.097,0.0504,0.0039,-0.0862,-0.0541,-0.137,-0.0703,-0.0771,-0.0847,-0.1767,-0.0311,0.1844,-0.0531,0.0116,0.0124,0.2144,0.0133,0.0344,-0.2189,-0.2064,-0.075,-0.0869,-0.1296,-0.211,-0.1067,-0.0291,-0.0064,0.2567,0.1603,0.1311,0.2358,-0.0003,0.089,0.0267,0.1526,0.019,0.2755,-0.0646,0.2967,0.4066,0.0839,-0.096,0.3427,0.2678,0.0236,-0.1258,-0.0153,-0.1782,-0.0795,-0.23,-0.0487,0.0953,-0.0733,-0.0613,0.0446,-0.0625,-0.0338,-0.0793,-0.0779,-0.0419,-0.0735,0.0702,0.0871,-0.024,0.2985,0.224,0.1993,0.2574,-0.099,-0.0291,-0.055,-0.0938,-0.0296,-0.1068,-0.0373,0.1242,-0.1297,-0.0818,0.1151,-0.0593,0.0048,0.1088,0.0432,0.0066,-0.0319,0.1053,-0.0376,-0.0638,0.0076,0.1349,0.0776,-0.0073,-0.0461,-0.0461,-0.186,0.1262,0.0611,0.0663,-0.075,0.0717,-0.087,0.2082,-0.3045,-0.2788,0.1321,-0.0476,-0.2608,-0.2616,-0.2202,-0.0335,-0.0975,-0.0482,-0.0005,-0.0022,0.1378,-0.0805,0.0652,-0.0635,0.0972,-0.0461,0.1031,0.0799,-0.0642,-0.034,0.0287,-0.0475,-0.0131,-0.0583,-0.0778,0.0216,0.0305,0.0408,-0.0095,0.0744,-0.0016,0.1031,-0.1467,-0.108,0.052,-0.1098,-0.0867,-0.1795,-0.2809,-0.0188,-0.079,-0.213,-0.0483,-0.0857,-0.1944,0.0113,-0.1064,0.0296,-0.2168,-0.0718,-0.1248,-0.1763,-0.0654,0.0949,-0.0873,0.1948,0.1086,0.0598,0.1341,-0.0842,0.003,-0.057,-0.2287,-0.2284,0.0338,-0.0965,0.0047,-0.0959,-0.0722,0.0409,0.0722,0.0092,-0.2074,-0.0896,0.0215,0.062,-0.0212,-0.008,-0.0712,0.0196,-0.0812,-0.1339,-0.1,-0.1989,-0.0991,-0.0668,-0.1871,-0.1884,-0.0187,-0.0204,-0.0496,-0.0262,0.033,-0.1291,-0.0879,0.0731,-0.196,-0.0014,0.0156,-0.0112,-0.1695,-0.1579,0.0448,0.1451,-0.0028,0.0029,-0.0239,-0.0459,0.2166,0.1068,0.0184,0.0006,-0.2183,0.0822,-0.0049,0.022,0.0688,0.0854,0.0256,-0.0851,-0.0098,0.1335,-0.105,-0.0115,-0.0968,0.0029,-0.104,-0.0938,0.0273,0.1384,0.0031,-0.0976,-0.0978,0.0025,-0.0251,0.0036,-0.0809,-0.1585,-0.0079,0.0285,-0.106,0.0676,-0.1206,-0.0571,-0.0719,-0.0557,-0.0927,-0.0951,-0.0257,-0.0492,-0.0074,-0.006,0.1537,-0.0354,-0.0013,-0.0644,0.0363,0.0166,-0.0228,-0.1903,0.0772,-0.1107,-0.0283,0.0416,0.0668,0.094,0.0607,0.0837,-0.0955,-0.0384,-0.1107,-0.0445,-0.2267,-0.0369,-0.227,-0.0573,-0.0935,-0.0912,-0.0081,-0.0996,-0.0574,0.2671,0.143,0.0408,0.2291,0.233,0.0929,0.0322,0.1775,0.0098,-0.0444,0.0303,0.2701,0.0511,0.0554,-0.0003,-0.0858,-0.0263,-0.098,0.0439,-0.008,-0.0138,0.0394,0.0841,-0.1048,-0.0866,-0.0346,0.0983,0.1223,0.104,-0.2614,-0.1079,-0.0215,-0.2344,-0.1864,0.0692,0.0856,0.0167,0.0517,-0.0008,0.0376,-0.1859,-0.0117,-0.018,-0.0714,-0.2609,-0.0249,0.0101,-0.0516,-0.0734,0.1583,-0.0459,-0.0083,-0.0406,0.0518,0.1075,0.3013,-0.0786,0.0807,-0.0035,0.0164,-0.1325,-0.0208,0.0355,0.0024,-0.0167,0.1595,0.098,0.036,-0.0866,-0.1214,0.0928,0.4606,0.4539,-0.1974,-0.1381,0.0722,-0.0899,-0.1333,-0.0354,-0.208,0.0396,-0.0293,-0.0728,0.0355,0.0157,0.2469,0.0185,0.1715,0.0905,0.012,0.1893,0.4158,-0.1203,-0.073,0.2836,0.0346,0.0694,0.0609,0.0597,-0.0988,0.1965,0.1422,-0.0067,-0.0668,0.1042,0.0276,0.174,0.1173,0.0404,0.0348,0.0042,0.1077,-0.131,0.014,0.1694,-0.0353,0.0006,-0.0169,-0.0174,-0.1558,-0.0488,0.0925,-0.0756,0.0702,-0.098,0.06,0.1389,-0.0052,-0.011,0.0364,-0.0019,-0.0315,0.0852,0.0717,0.0666,0.0078,0.2463,0.1266,0.0622,0.3645,-0.1148,-0.0628,0.1929,-0.1594,0.0449,0.054,0.147,-0.0968,0.0124,0.0275,-0.0412,-0.0038,0.0259,-0.0297,0.0442,0.0273,0.0626,0.041,0.1191,0.267,0.29,-0.1021,-0.1895,-0.1043,0.011,0.081,0.0312,-0.0142,0.0117,0.0539,0.0592,0.0881,-0.1021,-0.3125,-0.1222,-0.0187,0.1463,-0.0778,-0.0401,0.0615,0.0916,0.078,0.0549,-0.0204,-0.0391,0.0161,0.0327,0.0961,-0.1719,-0.1847,-0.2274,0.0417,-0.028,0.0218,0.3431,-0.0854,-0.0689,0.022,0.2012,0.1769,0.1871,-0.1312,-0.0474,-0.0296,-0.029,0.1206,0.1453,0.1813,-0.0629,0.0667,0.0922,0.0656,-0.1376,0.1064,-0.2803,-0.0287,-0.0606,-0.1662,-0.0296,0.0305,-0.0463,-0.0887,-0.0675,-0.0323,-0.0285,-0.0374,-0.159,-0.0117,-0.0252,-0.0093,-0.0524,0.1063,0.2183,0.1402,0.2951,-0.2332,-0.1244,-0.1773,-0.0725,0.1271,-0.0279,-0.1406,-0.1018,-0.1594,-0.0515,0.215,0.0731,0.2073,0.0974,0.02,0.0085,-0.0447,-0.0204,-0.0308,-0.0205,-0.2399,-0.0317,-0.1313,-0.0332,-0.0856,-0.0213,0.083,0.2957,0.189,0.155,0.1095,-0.1009,-0.3236,-0.1747,-0.2636,-0.1918,0.0222,-0.0437,0.0044,-0.1193,-0.1987,-0.1727,-0.0648,0.024,0.0113,-0.034,-0.1008,-0.0615,-0.091,-0.2154,-0.157,-0.1139,0.0978,0.0206,-0.0426,-0.2315,0.0308,-0.0943,-0.1536,-0.3024,0.0616,-0.0563,-0.1405,-0.0886,-0.0261,0.0003,-0.0059,-0.1319,-0.1707,-0.1303,0.2518,0.0616,0.2682,0.0723,0.1188,0.0006,0.1451,0.1723,0.3155,-0.111,-0.0492,0.0041,0.1232,-0.1497,-0.1984,-0.1275,-0.1022,-0.0854,-0.1483,-0.1369,-0.1089,-0.1459,-0.0228,0.0353,0.0554,-0.2989,0.0146,0.021,-0.0913,-0.0928,-0.1068,-0.0053,-0.1647,0.1185,0.044,0.0936,-0.0499,-0.0601,-0.2525,-0.1152,-0.1322,-0.0954,-0.1799,-0.1331,0.0249,0.0621,0.0612,-0.0394,-0.0807,0.0412,0.1173,0.1928,0.1919,-0.2719,-0.3039,-0.0689,0.0631,-0.0517,-0.0659,0.081,-0.074,0.044,-0.0381,-0.0536,-0.1392,-0.043,-0.1055,-0.1124,0.0107,-0.1268,0.0377,-0.0336,0.1356,0.1055,0.1052,-0.111,-0.1599,-0.1675,-0.1662,-0.1217,-0.2904,-0.1417,0.2307,-0.0438,-0.0928,0.0153,0.0223,-0.117,0.0294,-0.0255,-0.0152,0.2417,-0.0442,0.0917,0.0402,-0.0847,-0.0229,-0.0534,0.0719,0.1946,-0.1759,-0.0375,0.0466,0.2309,-0.0284,-0.0658,0.038,-0.074,0.0143,0.0697,0.0184,-0.0414,-0.0146,-0.1798,-0.1503,-0.1711,0.0078,-0.0864,0.0606,0.1189,0.2057,-0.0407,-0.0109,0.0617,0.1245,0.0293,0.0699,0.054,0.0236,0.0253,-0.2969,-0.1382,-0.1622,-0.1382,-0.0397,-0.1544,-0.1749,-0.1269,-0.0068,-0.0836,-0.2467,-0.1746,0.0957,-0.1163,-0.2981,0.1226,-0.052,0.0127,0.059,-0.1204,0.0262,-0.1617,-0.0862,0.0145,-0.1158,-0.0499,0.0648,-0.1619,0.0688,0.0868,0.0504,-0.0634,-0.1295,0.095,-0.0321,-0.1373,-0.0274,-0.0749,-0.0847,0.1089,0.0079,0.0092,-0.1573,-0.1038,-0.0341,0.0296,-0.1089,-0.1143,-0.1582,-0.0476,-0.0271,-0.0827,0.06,-0.1111,-0.0652,0.0947,0.0374,0.0133,0.0663,0.0166,-0.1723,-0.0132,-0.0924,-0.1415,0.2129,0.3424,0.2967,-0.0696,0.3878,0.191,-0.1578,-0.1244,0.3688,0.1646,0.0827,0.1282,0.1327,0.1067,-0.0684,-0.0604,-0.0837,-0.1092,0.3601,0.2971,0.2071,0.0064,0.1275,0.1857,0.3904,0.3909,0.3534,-0.0087,-0.0286,-0.0435,-0.0299,-0.0361,-0.0418,-0.1663,-0.1082,-0.0516,-0.0626,-0.0897,-0.0802,0.1192,0.0103,0.0233,-0.1396,0.016,0.1926,0.2905,-0.0445,-0.0129,-0.0975,-0.0533,-0.0392,-0.0374,0.0115,-0.1145,-0.0177,-0.0857,-0.1566,-0.2109,-0.1854,0.0553,-0.0698,-0.0071,0.1661,0.0941,0.2207,0.0405,0.1084,0.2904,-0.129,-0.1578,-0.1582,-0.0611,0.1148,-0.0799,0.1552,0.0948,0.1409,0.0311,-0.2178,-0.2104,-0.1482,-0.1302,0.0452,-0.2642,-0.1628,0.0175,-0.0311,0.1635,-0.0461,-0.0608,0.1459,0.0609,-0.1189,-0.0102,-0.1433,-0.1753,-0.2,0.0011,-0.0343,-0.1046,0.0729,-0.033,0.0972,0.3964,0.3716,0.1664,0.2532,-0.0463,0.0553,0.1166,0.2158,0.2282,0.3479,0.0131,0.0993,-0.0029,0.1183,0.0822,-0.0236,-0.0253,-0.0383,-0.0129,-0.0987,-0.0005,-0.0566,0.0123,0.0404,0.0065,0.067,-0.0028,0.1121,-0.0871,0.1267,0.069,-0.1148,-0.1844,-0.1035,-0.112,-0.1791,0.0549,-0.0896,-0.1145,-0.0209,0.1803,0.0091,-0.258,-0.064,-0.0818,-0.0764,0.0065,0.0001,0.0401,0.1345,0.0952,0.3388,0.2539,0.2772,0.0363,0.0014,0.1151,-0.1401,-0.1475,-0.0236,-0.0142,-0.0602,-0.092,-0.0597,-0.0911,-0.0738,-0.1584,-0.2015,-0.1857,-0.0719,-0.0454,-0.1726,0.0774,-0.0745,-0.0199,-0.0109,-0.0839,-0.0992,-0.0729,0.2231,-0.0085,-0.0404,-0.1645,0.1025,0.0334,-0.1449,0.0751,-0.1792,-0.0901,0.1971,-0.167,-0.1649,-0.0806,0.0353,0.0036,0.037,-0.032,-0.06,-0.0376,0.0093,0.0092,-0.2123,0.0174,0.0028,0.1226,0.0052,-0.227,-0.0829,0.0017,-0.0707,-0.0461,-0.0239,-0.1586,-0.0527,0.0318,0.032,0.0218,-0.3398,-0.1348,-0.1688,-0.245,-0.1788,-0.142,-0.1443,-0.1443,-0.0885,-0.0447,0.1041,-0.2344,-0.0671,-0.1821,-0.1852,-0.0339,-0.0586,-0.3404,0.1767,-0.2444,0.0892,0.0405,0.2728,0.0261,-0.0197,-0.1827,-0.0805,-0.0434,-0.0244,-0.0267,0.1896,-0.0151,0.1219,0.2912,0.2542,0.024,0.057,-0.0018,-0.0386,-0.0091,-0.1349,-0.099,-0.0704,-0.1238,-0.0225,0.0141,0.0201,0.0676,-0.0288,-0.0886,0.0706,0.0471,-0.0465,0.125,-0.0209,0.0455,0.0194,-0.0194,0.0198,0.0518,0.2452,-0.0842,0.1193,0.095,0.0095,0.1491,0.1601,-0.0798,0.1603,0.0164,0.2958,0.0906,0.0004,0.1088,-0.1237,0.0565,0.1575,0.0914,-0.0944,-0.0069,0.0833,-0.0131,-0.0,-0.1985,-0.2153,-0.1352,-0.1446,-0.0553,-0.1016,-0.1803,0.1384,0.0084,0.0298,0.0735,-0.0205,-0.001,0.0394,-0.0946,-0.1009,-0.0065,0.047,0.1658,0.0255,0.0715,-0.1422,0.043,0.1605,0.0667,0.2092,0.0841,0.0303,-0.1019,0.0167,-0.1039,-0.0557,-0.0548,0.0213,-0.0637,-0.0952,-0.0572,-0.1312,-0.0426,0.0359,-0.092,0.0528,-0.0593,0.0237,0.0765,0.1266,0.1303,0.0663,-0.0316,-0.1028,-0.0964,-0.0712,0.0719,0.0424,-0.0453,-0.0521,-0.0308,0.0535,-0.0423,-0.1453,-0.1101,-0.1568,-0.1427,-0.0564,-0.0112,0.0747,-0.1335,-0.1273,-0.1621,-0.0102,-0.0759,0.0091,0.017,-0.1218,0.1535,-0.1292,-0.1426,-0.0944,0.1019,-0.0521,-0.022,0.0866,0.0473,-0.2081,0.0474,-0.0347,-0.0783,0.0344,0.0837,0.0131,0.0451,-0.0959,-0.1732,-0.0804,-0.1994,-0.2272,-0.049,-0.1224,0.0136,0.0515,0.1603,0.1471,0.1464,-0.1339,-0.178,0.045,0.2142,0.2402,0.0559,-0.0641,-0.011,0.0207,-0.0228,0.1149,-0.08,-0.1247,-0.0563,0.0065,-0.1115,-0.1567,0.1955,0.0547,0.0442,0.1759,0.0067,0.085,-0.0686,-0.1283,-0.0914,-0.0489,-0.1152,0.0331,0.1878,0.0895,0.0306,-0.0795,-0.0367,-0.1213,-0.0332,-0.0661,-0.2145,-0.0372,-0.0413,-0.0402,-0.0116,0.0121,0.0476,0.0416,-0.0661,0.0927,-0.251,-0.147,-0.1726,-0.1943,0.017,-0.13,-0.1032,-0.257,-0.0794,-0.1186,0.2087,-0.1861,-0.038,-0.0527,0.0551,0.16,0.128,-0.1197,-0.1909,-0.0547,-0.0825,0.0224,0.133,-0.0651,-0.0739,-0.0338,0.0884,0.0688,0.0731,0.1566,0.0067,-0.0384,0.0731,-0.0162,0.0578,0.0357,-0.0173,-0.1065,-0.0216,0.0088,0.0757,0.0384,0.0838,0.1225,0.0043,0.0244,-0.0448,-0.1744,-0.1665,-0.0548,0.1185,0.251,0.0702,-0.004,0.0088,0.021,0.3308,0.2088,0.1616,0.1789,-0.1818,-0.02,-0.046,-0.0062,-0.108,0.0808,-0.0255,0.0156,0.0323,0.0392,0.0458,-0.0882,0.0598,0.1155,-0.1754,0.248,0.0849,0.0187,0.0492,0.114,0.0959,0.0335,-0.0094,0.0196,0.0859,0.1672,0.219,0.2619,-0.0975,0.0125,0.0167,-0.0541,-0.21,-0.3948,-0.3713,0.0034,0.0828,0.0769,-0.1016,0.0629,0.1004,-0.0359,-0.1115,-0.1517,0.0615,-0.1102,-0.0317,0.0425,0.0482,-0.0137,-0.1533,-0.0759,-0.1757,-0.0985,-0.0324,-0.1535,-0.012,-0.199,-0.0659,-0.0466,-0.0752,0.0182,0.1213,0.0517,-0.0248,-0.0868,0.2437,-0.1189,0.1727,0.1824,0.1809,-0.0027,0.0392,-0.1276,0.1874,0.1382,-0.1851,-0.0975,-0.0272,-0.0053,-0.1372,-0.1176,-0.2236,-0.2381,-0.1189,-0.0518,-0.0979,0.0624,-0.0249,-0.0674,-0.1197,-0.2421,0.0291,0.0273,-0.1688,-0.1249,0.0169,-0.126,-0.2252,0.1238,0.1563,-0.1207,0.0532,0.1166,0.1494,-0.1778,-0.1949,-0.1504,-0.2326,-0.0991,-0.1008,-0.0133,0.1228,0.05,0.1445,-0.0032,0.2271,0.2918,0.1984,0.1743,0.2287,-0.2876,-0.2093,-0.1605,0.0484,0.0151,-0.041,-0.0877,0.0015,0.104,-0.1612,-0.1645,-0.0545,0.1287,-0.1495,-0.1153,-0.1282,-0.0619,0.0756,0.1214,-0.0533,-0.0447,-0.0101,-0.0703,0.0872,0.1284,0.1052,0.0398,-0.0101,0.0718,0.1552,0.0931,0.1164,-0.0193,-0.1002,-0.0015,-0.0556,0.03,-0.0338,-0.0007,0.1927,0.0896,0.047,0.0466,-0.0475,-0.0371,-0.2214,-0.1817,-0.1059,-0.1196,0.3367,-0.0146,0.2383,0.1815,0.1202,-0.0149,-0.0218,0.1451,-0.055,0.2626,0.2146,0.0764,0.1599,0.0642,0.0326,-0.0937,-0.0993,-0.1412,0.0389,0.1163,0.137,-0.1286,-0.0308,-0.0029,0.0662,0.0062,-0.0605,-0.062,-0.122,-0.0072,-0.2018,-0.0216,-0.081,0.0965,0.0809,0.0921,0.1011,-0.069,-0.0549,-0.0879,-0.0798,0.1142,0.108,-0.0762,-0.0195,-0.0854,0.0223,-0.0003,0.0092,0.0187,0.123,0.0942,-0.0266,-0.1452,-0.0771,-0.1801,-0.1199,0.0555,0.1043,-0.1081,-0.0429,-0.107,-0.1467,-0.1776,-0.1179,-0.0995,-0.0965,-0.076,-0.0643,-0.125,0.1543,-0.2442,-0.2212,-0.1896,-0.0464,-0.081,-0.2119,-0.122,-0.0432,0.0763,0.0471,-0.1662,0.2879,0.2834,0.1512,0.0223,-0.0119,-0.0673,-0.1591,0.0017,-0.0811,0.0333,0.1631,0.2132,-0.0303,0.0407,0.0545,0.1043,-0.2173,-0.0952,-0.0603,-0.0364,-0.1984,-0.1527,-0.1544,-0.1419,0.007,-0.1908,-0.1632,0.1689,-0.0659,-0.2726,-0.0166,0.1118,0.1168,-0.0857,-0.0985,-0.4149,-0.3108,-0.1508,-0.295,0.1598,-0.1395,-0.0901,0.041,-0.1273,-0.095,-0.2102,-0.0992,0.1429,0.1456,0.2407,0.2074,0.2241,0.0392,0.0711,0.1986,0.0439,0.1368,0.1254,0.071,0.1863,0.1344,-0.1899,-0.2903,-0.1587,-0.0651,-0.1308,-0.0058,-0.1279,0.0604,0.01,0.0706,0.1563,0.1029,-0.256,-0.0674,-0.1861,-0.0586,-0.2005,-0.2852,-0.0037,-0.0432,-0.0093,-0.1049,-0.0226,-0.1798,-0.0955,-0.1889,-0.1071,-0.1585,-0.0309,-0.0434,-0.0237,-0.0521,-0.0782,0.0632,0.1193,0.0514,-0.0757,-0.1092,-0.1266,-0.0196,0.1349,0.0742,-0.0441,0.2915,0.0367,-0.004,0.0531,0.0639,-0.0286,-0.0384,-0.0035,0.062,0.01,-0.0299,0.153,0.2974,0.4099,-0.0195,-0.0214,0.0069,0.0233,0.0131,0.1991,-0.0662,0.2801,-0.1606,0.0681,0.05,0.1334,0.0577,0.0016,-0.0311,0.0085,-0.0012,0.0091,0.0371,0.0238,-0.0718,-0.1183,0.0889,0.2054,0.2009,-0.2278,-0.1688,-0.1931,0.0019,-0.2214,-0.0295,-0.0172,0.0795,0.033,-0.0429,-0.1568,-0.1873,-0.0184,0.03,-0.0916,0.0195,0.242,0.0234,-0.0719,0.1561,0.4547,0.1737,0.1605,0.2476,-0.0472,0.0533,0.2454,0.2251,-0.0913,0.2848,0.1146,0.14,0.0712,0.4239,0.0633,-0.1797,-0.1911,-0.0932,-0.1128,0.0737,-0.0982,-0.0085,-0.1222,-0.1329,0.0016,-0.1798,-0.1183,0.0895,-0.0596,-0.2091,-0.0711,-0.1649,-0.0454,-0.0314,-0.0791,-0.0746,-0.0595,-0.0504,-0.0475,-0.224,-0.1572,0.1694,0.2792,-0.032,-0.0721,0.0874,0.0608,-0.0693,-0.0761,-0.1741,-0.1943,0.0501,0.1064,-0.1451,-0.1801,-0.1269,-0.0642,-0.1797,-0.1302,-0.0198,-0.123,-0.0456,-0.1209,-0.0843,-0.0429,-0.122,-0.0767,-0.0552,-0.0632,0.1608,-0.1324,0.0526,0.2009,0.0469,-0.1917,-0.0654,-0.1354,-0.1799,-0.0994,-0.0963,-0.1276,0.0821,0.0883,0.1215,-0.0445,-0.1017,-0.0311,-0.0221,0.0063,0.1057,-0.1968,-0.1097,-0.1932,0.0092,0.0552,0.1232,-0.0525,-0.2354,-0.1826,-0.0495,-0.041,-0.0141,0.0748,0.1035,-0.0148,-0.1018,-0.1509,-0.076,-0.1591,-0.2924,-0.1242,-0.0727,0.1239,0.0065,0.2518,-0.0403,0.184,0.0111,0.0841,-0.0075,0.0877,0.1747,0.0842,0.0066,-0.0032,-0.0438,0.087,0.0211,0.0415,-0.0665,-0.0747,-0.0348,0.0328,-0.0926,-0.0558,-0.0633,-0.062,-0.1632,-0.0483,0.0163,0.142,-0.1187,0.0313,0.0032,0.0436,-0.0433,-0.0521,0.0614,-0.0135,-0.1862,-0.0782,0.1812,0.1839,-0.0398,-0.0697,-0.0864,-0.1729,-0.0946,-0.0199,-0.1373,0.1335,0.0767,-0.2198,-0.2091,-0.0001,-0.1524,-0.047,-0.0655,0.2498,0.2318,-0.2124,0.0968,-0.114,-0.0405,-0.0881,-0.1735,-0.2422,-0.1995,0.0074,-0.0234,-0.1221,0.0226,-0.1045,-0.0968,0.1813,0.0261,0.0388,-0.0026,0.0113,0.0357,-0.1619,-0.0555,0.0625,-0.15,0.1173,-0.2254,0.1353,-0.1701,0.269,0.1787,0.1775,-0.2387,-0.2111,0.0813,0.243,0.0211,0.2493,0.0226,0.0263,0.1449,0.0596,0.0834,0.0478,0.063,0.0658,0.0909,0.0924,0.1501,-0.0306,0.1132,0.2192,0.4403,0.194,0.155,0.2616,0.13,0.1549,0.1988,0.1925,0.2116,0.1387,0.2436,0.2427,0.1301,0.1609,0.2969,0.2888,0.2335,0.2831,0.1326,0.2426,-0.2306,-0.0279,-0.2039,-0.2124,-0.1079,-0.3059,-0.2405,-0.1398,-0.0134,-0.0886,-0.3413,-0.2742,-0.2014,-0.0784,0.0057,-0.1692,0.1273,-0.0235,-0.0499,0.0429,-0.1007,-0.1032,-0.0481,-0.0893,-0.1874,0.1144,-0.243,-0.2509,0.0209,-0.0105,-0.0119,-0.0184,-0.0142,-0.2126,0.2254,0.2011,-0.1347,0.2261,0.2673,0.0571,0.1004,0.1141,-0.1027,0.4381,0.4403,-0.0742,-0.0203,0.1126,-0.0648,-0.0128,-0.1755,-0.0269,0.1052,-0.0579,-0.086,0.0491,0.0046,-0.0266,-0.0095,word maintenance
trm_55b6b98b88f45,-0.1256,-0.1353,-0.1328,-0.1013,0.0063,-0.0255,-0.1094,-0.0744,-0.0321,-0.0925,-0.007,-0.0096,-0.1543,-0.0861,-0.1228,-0.0775,-0.1088,-0.0758,-0.0795,-0.0265,-0.0711,0.0351,-0.0634,0.052,-0.0547,-0.0139,-0.0166,-0.1079,-0.1597,-0.0987,-0.1181,-0.0759,-0.1358,-0.106,-0.1303,-0.1319,-0.0972,-0.0682,-0.1544,-0.03,-0.1404,-0.1303,-0.0759,0.0668,-0.0599,-0.0616,0.1262,-0.0934,0.0423,-0.1007,-0.0369,0.0171,0.0411,0.0465,-0.0053,-0.0716,-0.1195,-0.0164,0.0127,-0.0537,-0.0067,0.0201,-0.1414,0.112,0.0775,0.0265,-0.1909,-0.2386,-0.134,-0.0257,0.079,0.0305,0.2099,-0.1048,-0.1364,0.0846,-0.1695,0.0445,0.0684,-0.1113,0.009,0.1193,-0.0376,-0.1313,0.0873,0.0615,0.0174,-0.017,0.0256,-0.2531,-0.1104,-0.0892,-0.0044,0.1256,0.0988,0.1046,0.1135,-0.003,0.1805,0.0572,0.0646,0.0347,0.0923,-0.0293,0.0709,-0.166,-0.1517,0.1708,-0.0425,-0.0472,0.0092,-0.1021,0.1081,0.1606,0.0332,0.0401,-0.0674,0.0017,-0.0091,-0.0762,-0.0667,-0.138,-0.0862,-0.0002,-0.0588,-0.1088,-0.0311,0.0478,0.0746,0.0071,-0.0574,-0.0811,-0.0432,-0.2497,0.0087,-0.1583,-0.0221,-0.1133,-0.0291,-0.0597,-0.111,-0.1006,0.0733,-0.0309,0.0072,0.0664,-0.1086,0.0526,-0.0925,0.0931,-0.0566,-0.0834,-0.1388,-0.1144,0.1862,-0.0422,0.0859,0.0067,0.0313,-0.06,-0.0695,-0.0687,-0.1776,-0.2495,-0.027,0.0243,-0.009,-0.1487,-0.1377,0.0321,-0.0795,-0.1082,0.0148,-0.1796,-0.1389,-0.1688,-0.134,-0.093,-0.0563,-0.0365,-0.155,0.0484,-0.0695,0.0251,-0.1278,-0.0507,-0.1642,-0.0615,-0.0288,0.0053,0.0249,-0.0859,-0.0523,-0.195,-0.1725,-0.2291,-0.2035,0.0175,0.0252,-0.169,-0.0952,0.1542,-0.0829,-0.1627,0.1124,-0.0967,-0.0817,-0.0472,-0.092,0.0014,-0.1589,-0.0753,-0.004,0.0263,0.0748,0.0672,0.1196,-0.1733,-0.21,0.0239,0.0876,-0.1057,-0.1545,-0.0432,0.0714,0.023,-0.044,0.1121,-0.0061,0.2509,-0.1303,-0.1711,0.1313,-0.1668,-0.1622,0.0066,-0.0139,0.1196,0.0408,-0.0465,-0.0091,-0.1939,-0.0767,0.0059,-0.0665,-0.0757,-0.0338,-0.1392,-0.0853,-0.0492,0.0364,0.0299,0.0082,0.0897,-0.0275,-0.1389,0.0184,-0.0561,0.1463,0.2478,0.0942,0.2623,-0.0862,0.1277,0.1764,0.3492,0.1435,-0.0086,0.012,0.0168,-0.0635,-0.0809,-0.1102,0.0078,-0.1098,-0.0187,-0.1843,-0.2349,-0.2027,-0.0528,0.0102,-0.0421,-0.0156,-0.106,-0.0592,-0.1159,0.0439,0.0797,-0.1841,-0.126,-0.0888,-0.1086,-0.0555,-0.0663,-0.1281,-0.0274,0.0243,0.1107,-0.0154,0.1681,0.0716,-0.1231,-0.1386,-0.1174,-0.11,-0.0977,-0.1684,-0.0575,-0.0722,0.0179,0.0059,0.0018,-0.1026,0.1283,0.0688,-0.0499,0.1573,0.0076,0.1086,-0.1179,0.0233,0.0408,-0.0736,-0.074,-0.1052,-0.0538,0.0181,-0.0581,-0.0738,-0.1342,0.0391,-0.106,0.0246,0.0364,0.0859,0.0626,0.0928,0.0306,0.0041,-0.0847,-0.074,-0.011,-0.0398,-0.0502,0.0644,0.0442,-0.2978,-0.2032,-0.2058,-0.1424,-0.1576,-0.021,-0.1326,-0.0651,-0.0814,-0.1097,-0.0565,-0.1233,-0.1865,-0.0937,0.0081,-0.005,0.0016,-0.0351,-0.0586,0.0756,-0.1705,0.2704,0.0286,-0.1891,0.0237,0.0999,-0.0076,0.1084,-0.0951,-0.0617,-0.1005,0.1321,0.187,0.1352,0.19,-0.0108,-0.0588,0.0637,0.0284,0.0586,-0.0674,-0.0267,0.0587,-0.0334,-0.0753,-0.0385,-0.112,-0.0323,0.0727,-0.0242,-0.1568,-0.1928,-0.1234,-0.0364,-0.0356,0.0279,0.0295,-0.0456,0.03,0.1421,0.0858,-0.0012,-0.1159,-0.055,-0.0379,-0.1574,-0.0339,0.2425,-0.1108,-0.007,0.2799,0.0548,-0.0346,0.0195,0.0353,-0.2613,-0.1731,-0.3341,-0.2949,-0.1438,-0.2117,-0.1291,-0.1385,-0.1409,-0.0115,0.0405,0.0164,-0.0067,0.0281,0.0811,-0.0236,0.0131,-0.2835,-0.1378,0.0097,0.072,-0.0428,0.0892,-0.0989,-0.1209,0.0406,0.0768,-0.0194,0.0901,0.114,0.0711,-0.13,-0.0561,0.0409,-0.0873,0.0447,-0.0286,0.0456,0.0335,0.0937,-0.0715,-0.0454,0.0775,-0.1224,-0.116,0.0503,0.3696,-0.1582,-0.0903,0.018,0.0157,0.1047,-0.0241,-0.0573,-0.0474,-0.0038,0.0043,-0.0136,-0.032,0.0107,-0.0187,-0.0277,0.1012,0.1473,0.1505,-0.0207,0.0036,-0.0439,-0.0512,0.0482,0.116,-0.0929,-0.1222,0.089,0.0306,-0.0515,-0.0426,0.0509,-0.0633,-0.053,0.0546,-0.0667,-0.1134,-0.1047,-0.1109,0.0926,0.0742,-0.0236,0.0782,-0.1771,0.012,0.0283,0.0246,0.0626,0.096,-0.118,-0.1206,0.0465,-0.103,-0.0596,-0.0928,0.0865,0.1211,0.2095,0.0572,0.1307,0.1011,0.0267,0.0732,-0.0562,-0.0467,-0.1236,-0.2057,-0.0571,0.0033,-0.1284,-0.0815,-0.0184,-0.1268,-0.0287,0.0497,0.0067,-0.0724,-0.0646,-0.0441,0.0535,0.0636,0.0244,-0.0553,0.055,-0.0078,0.0145,-0.0559,-0.0173,-0.1332,0.112,0.0622,0.0754,-0.0701,-0.0235,0.0454,-0.0138,0.0089,-0.0646,0.0177,0.0814,0.0374,0.0204,0.0082,-0.0472,0.0813,-0.1434,0.0014,-0.1141,-0.0808,0.0167,0.0494,0.0736,0.1255,0.009,-0.1046,-0.0028,-0.0481,0.1567,0.0845,0.0349,0.0743,0.0549,-0.0358,-0.105,0.0608,0.1411,0.1652,-0.0359,-0.0525,-0.223,-0.0308,0.1452,-0.0781,0.0074,0.0599,0.0749,0.0539,0.0183,-0.0607,0.0054,-0.1963,-0.1891,0.1425,-0.1737,-0.0724,0.1234,-0.0356,-0.2664,-0.0371,-0.0797,0.0747,0.0118,-0.2277,-0.081,-0.1976,0.0233,0.0277,-0.0657,0.0276,-0.1124,-0.1402,-0.0879,0.0363,0.0385,0.0234,-0.0363,0.0266,0.0849,0.0086,0.0943,-0.0704,-0.0386,-0.025,-0.1057,0.0457,0.0021,-0.1004,-0.0682,-0.0273,-0.142,-0.1273,0.1158,-0.1813,0.117,-0.0968,0.1505,-0.0879,0.0082,-0.0707,-0.0139,-0.1026,-0.0261,-0.0894,-0.122,-0.0747,0.1479,-0.0792,-0.002,0.0924,-0.181,-0.1397,-0.0936,-0.026,-0.0615,-0.0719,-0.0788,-0.0763,-0.0544,-0.0779,0.1205,-0.1006,0.008,-0.0354,0.0737,0.033,0.0944,0.0106,0.0818,-0.1349,-0.1171,0.0397,0.0111,-0.0076,0.0789,0.1848,0.1544,0.1019,0.0453,0.0505,0.0683,-0.0715,-0.0899,0.0235,0.0755,0.0436,-0.0321,-0.0757,-0.0687,-0.047,-0.1254,-0.1251,-0.1392,0.0873,0.127,0.1217,0.0294,0.0815,0.1211,0.0289,-0.0098,0.0405,-0.116,0.0422,0.0896,-0.0818,-0.2165,-0.2288,-0.1252,-0.0188,-0.0169,-0.0862,0.067,-0.0812,0.0269,-0.0114,-0.0923,0.0737,0.1086,-0.0357,-0.1973,0.1588,0.1447,0.3154,-0.1173,-0.0163,-0.0937,-0.0205,0.0592,-0.1452,0.1318,0.0474,-0.0372,0.0397,0.0174,0.0296,-0.119,-0.2014,-0.1653,-0.12,0.0369,0.1952,0.0196,-0.1614,0.0049,-0.0338,0.0809,0.0498,0.0507,-0.0012,-0.0274,-0.0847,-0.072,0.1494,0.0769,0.1131,-0.0969,-0.0293,0.0244,-0.0904,0.0576,-0.0795,-0.1445,-0.0102,-0.1352,-0.1329,-0.0761,0.0609,0.1029,0.0404,0.0094,-0.0595,0.0251,0.165,-0.056,-0.0662,0.0701,-0.0162,0.0167,-0.0207,0.108,-0.0428,0.1799,-0.1995,-0.1999,0.1055,0.1379,0.1282,-0.0086,-0.0184,0.0625,-0.0053,0.0241,0.1614,-0.0315,0.0702,0.1058,0.1715,0.0366,-0.0083,0.1418,0.1766,-0.1518,0.0489,0.107,-0.1798,-0.1245,-0.0479,-0.1247,-0.0094,-0.2048,-0.0535,-0.143,-0.1146,-0.1702,0.0088,-0.0055,0.0495,-0.07,-0.0643,0.0758,0.0187,0.1127,0.0886,0.1023,0.1548,0.0385,0.0832,0.0308,0.0284,0.1187,0.1312,-0.115,0.1642,0.0868,-0.0467,-0.0552,-0.0959,-0.0376,0.1444,0.1018,-0.219,-0.0812,-0.0526,0.0864,0.2004,0.091,0.0904,0.0191,-0.0236,-0.0441,-0.0795,0.0872,-0.0333,0.078,-0.123,0.0056,-0.0549,0.1291,0.2288,0.0937,0.213,-0.1103,-0.0865,-0.0704,0.177,-0.0675,-0.0976,-0.1104,0.0851,-0.0291,-0.1551,-0.0437,-0.1583,0.057,-0.0883,-0.0029,0.049,0.0359,0.0591,-0.1567,-0.0749,-0.047,0.0621,-0.1051,0.0209,0.0905,0.0644,0.1132,0.2842,0.1022,-0.0992,-0.0528,-0.0599,-0.051,-0.1032,-0.011,0.0286,0.1338,0.0538,0.0103,-0.1271,0.1324,0.1996,0.0372,-0.0379,-0.0224,-0.0169,-0.2446,-0.0879,-0.0701,-0.0452,0.0494,-0.1343,-0.0771,0.1079,-0.0131,-0.1111,-0.0215,0.0813,-0.0541,-0.0346,-0.0658,-0.141,-0.1397,-0.2076,-0.105,-0.209,-0.0011,-0.0021,-0.075,-0.1249,-0.0631,-0.1499,-0.0647,-0.1951,-0.1337,-0.1306,0.0233,0.0702,0.0983,-0.0336,0.062,-0.0509,0.0482,0.0599,0.1854,0.2199,0.1422,-0.0366,-0.0508,0.0058,0.0277,0.1571,0.1136,0.0893,-0.025,0.1077,-0.0248,0.11,-0.0651,-0.0604,-0.0704,0.1127,-0.028,0.083,-0.1498,-0.0362,-0.0031,0.0353,0.0462,0.0195,0.1014,0.0189,0.1129,0.1666,0.1022,0.0304,0.0422,-0.0368,-0.016,0.026,-0.0204,-0.0343,-0.0643,-0.1359,-0.0327,0.1149,0.095,-0.1447,-0.098,-0.0434,-0.1643,-0.0672,0.1646,0.0358,0.142,0.0977,0.088,-0.0149,0.0237,0.0793,-0.0136,-0.0415,-0.0131,0.0376,-0.0805,-0.1548,-0.0143,0.115,-0.073,-0.0198,-0.077,0.0757,-0.1524,0.0119,0.0124,0.123,0.1925,0.1606,0.0891,0.0624,0.0049,0.0249,-0.0014,-0.0602,-0.0235,0.0058,0.0212,-0.0084,-0.0481,0.0731,-0.035,-0.0622,-0.0968,-0.1479,-0.1664,-0.1049,-0.0955,0.2068,0.0094,0.0416,-0.1156,0.1849,0.1009,0.0146,-0.0303,0.0145,0.1034,-0.0042,0.0377,-0.1042,-0.0799,0.0108,-0.0058,-0.0873,-0.0445,-0.0674,-0.0164,-0.0254,-0.0447,-0.088,-0.0758,0.023,-0.0876,-0.0243,0.0031,0.0416,-0.1088,0.055,-0.0567,0.0501,-0.043,-0.0635,0.3297,0.2253,0.2242,0.1524,0.1614,-0.0004,0.1935,0.126,-0.174,0.271,0.2516,0.1597,0.1238,0.2133,-0.0426,-0.0182,-0.0501,0.0377,0.0707,0.0597,0.0501,0.0292,-0.1375,0.0082,0.0153,0.0168,0.043,-0.0049,-0.0306,0.152,0.1084,-0.0456,-0.0024,-0.116,0.0889,-0.0244,0.1311,-0.0206,-0.1416,-0.1166,-0.0408,0.007,0.1141,0.1107,-0.1304,-0.1163,-0.2177,-0.1595,-0.0962,0.2583,-0.1234,0.1438,0.1294,-0.0323,-0.0081,-0.0877,-0.0254,0.0505,-0.0082,0.1274,0.0678,0.0376,0.0815,0.0799,-0.1375,-0.1383,0.0388,-0.0569,-0.003,-0.0166,-0.0799,-0.074,-0.1426,-0.0578,-0.056,-0.0647,-0.198,-0.0772,0.1609,-0.0147,0.0125,0.012,0.1686,-0.0096,0.0088,-0.191,-0.1906,-0.0498,-0.0783,-0.1396,-0.1861,-0.0575,-0.0119,0.0156,0.2015,0.1016,0.0815,0.1964,0.003,0.0518,0.044,0.1513,-0.0127,0.2401,-0.0562,0.2362,0.327,0.0597,-0.0696,0.284,0.2258,0.0186,-0.1291,-0.0133,-0.1354,-0.0692,-0.2002,-0.041,0.0347,-0.0785,-0.0771,0.025,-0.0767,-0.0317,-0.0894,-0.082,-0.0406,-0.037,0.0323,0.09,-0.0366,0.356,0.2476,0.2436,0.2924,-0.0655,-0.0409,-0.0598,-0.0637,-0.0372,-0.0666,-0.098,0.1275,-0.0956,-0.0505,0.0806,-0.0489,0.0337,0.1024,0.0382,0.001,-0.0104,0.0663,-0.0175,-0.0109,-0.0016,0.0873,0.0591,0.0095,-0.0662,-0.0662,-0.1636,0.1095,0.0329,0.0608,-0.067,0.1137,-0.0676,0.1381,-0.2812,-0.2427,0.1099,-0.0299,-0.2366,-0.2297,-0.2226,-0.0524,-0.0933,-0.0006,0.0137,-0.0115,0.0796,-0.0219,0.0844,-0.0912,0.104,-0.0272,0.0564,0.0273,-0.0901,-0.0144,0.0208,-0.0258,-0.0072,-0.0307,-0.1054,0.0255,0.0487,-0.024,-0.0473,0.0364,0.0002,0.038,-0.0999,-0.0724,0.0463,-0.0912,-0.0666,-0.1555,-0.276,0.0049,-0.0649,-0.1815,-0.0645,-0.0852,-0.173,-0.0014,-0.1329,0.0429,-0.2013,-0.1046,-0.1247,-0.241,-0.06,0.0654,-0.0508,0.1953,0.0568,0.0022,0.0819,-0.0708,0.0006,-0.0386,-0.2368,-0.238,0.0567,-0.0919,-0.0123,-0.067,-0.0623,0.0424,0.0656,0.0019,-0.1411,-0.0639,-0.0186,0.0481,-0.0797,-0.0171,-0.0379,0.0332,-0.062,-0.1261,0.0027,-0.0902,-0.0676,-0.0637,-0.1426,-0.1428,0.0053,0.0027,-0.0794,-0.0284,0.0122,-0.1121,-0.0788,0.0396,-0.1968,0.0416,0.0097,-0.0363,-0.1926,-0.118,0.0397,0.1313,0.0249,0.0008,0.001,-0.0192,0.2182,0.0617,-0.0037,-0.0258,-0.1762,0.0332,-0.0127,0.0404,0.0388,0.1205,0.0137,-0.0992,-0.0048,0.102,-0.0847,-0.0044,-0.0693,0.0184,-0.0653,-0.0609,0.032,0.1242,-0.022,-0.0608,-0.0709,0.0219,0.0165,-0.0005,-0.0333,-0.1582,-0.0249,0.0154,-0.119,0.0644,-0.0836,-0.0548,-0.0665,-0.0383,-0.0809,-0.0806,-0.0043,-0.0375,-0.0083,-0.013,0.0923,-0.0376,-0.0016,-0.0234,0.0391,-0.0221,0.0073,-0.15,0.0582,-0.1503,-0.0698,0.035,0.0838,0.0936,0.0421,0.0486,-0.0985,-0.0404,-0.0743,-0.0655,-0.1819,-0.0276,-0.254,-0.0301,-0.0858,-0.1048,-0.001,-0.0621,-0.0165,0.1725,0.0877,-0.0012,0.2531,0.117,0.0965,0.0088,0.1728,0.0086,-0.087,0.0606,0.2722,0.0138,0.0248,-0.0353,-0.1239,-0.0567,-0.0771,0.0655,-0.0206,-0.0572,-0.0144,0.0313,-0.0739,-0.0647,-0.0279,0.0707,0.1156,0.1127,-0.3337,-0.1757,-0.0847,-0.2957,-0.2439,0.0788,0.069,0.026,0.0556,-0.0193,0.0378,-0.1801,0.0055,-0.0413,-0.1179,-0.2928,-0.0157,0.0236,-0.0575,-0.098,0.1572,-0.0343,-0.0216,-0.0257,0.053,0.0787,0.218,-0.0542,0.1057,-0.0127,0.0303,-0.1476,-0.0422,0.013,0.0166,-0.0085,0.143,0.0762,0.0278,-0.0876,-0.1153,0.0485,0.3742,0.3713,-0.1672,-0.1368,0.0414,-0.0833,-0.1349,-0.0237,-0.1997,0.0386,-0.0229,-0.069,-0.0156,-0.0085,0.1797,0.0188,0.1242,0.0779,0.0246,0.094,0.3413,-0.1678,-0.0468,0.2757,-0.0042,0.0585,0.0639,0.0841,-0.0671,0.2173,0.1624,-0.0292,-0.0724,0.0875,0.034,0.2063,0.1272,0.0637,0.0181,0.0181,0.1013,-0.1079,0.0351,0.1947,-0.025,0.0318,0.0053,-0.0168,-0.163,-0.0397,0.0614,-0.0951,0.0583,-0.0705,0.0639,0.1132,-0.0193,0.0059,0.0432,0.034,-0.0105,0.1368,0.0625,0.102,0.0717,0.2208,0.0923,0.0643,0.3534,-0.099,-0.0412,0.1643,-0.1097,0.0217,0.0476,0.0976,-0.0941,-0.001,0.0164,-0.0313,0.0263,0.0354,-0.0092,0.0141,0.0114,0.0505,0.053,0.1099,0.2532,0.2386,-0.0976,-0.1812,-0.1135,0.0064,0.0723,0.0315,0.048,-0.0046,0.0941,0.0083,0.0684,-0.1423,-0.2867,-0.1086,-0.0577,0.1139,-0.0419,-0.0122,0.0535,0.1902,0.1249,0.0514,-0.004,-0.0135,0.0184,0.0283,0.097,-0.1692,-0.1751,-0.2251,0.0613,0.0001,0.0531,0.2869,-0.0126,0.0174,0.0727,0.1303,0.1011,0.1374,-0.0731,-0.0437,-0.0514,-0.0291,0.0761,0.1231,0.2101,-0.0669,0.0977,0.148,0.0323,-0.12,0.0917,-0.2363,-0.0306,-0.0442,-0.1319,-0.0351,0.0382,-0.0629,-0.0998,-0.0434,-0.0747,-0.0719,-0.0303,-0.1537,-0.0417,-0.0422,-0.0346,-0.0714,0.0721,0.1874,0.1332,0.2461,-0.1594,-0.1091,-0.1255,-0.0545,0.1265,0.0017,-0.1265,-0.0873,-0.1587,-0.0302,0.1795,0.092,0.1464,0.0847,0.0292,-0.0259,-0.0488,0.0027,-0.0246,-0.0362,-0.2449,-0.0552,-0.1096,-0.0233,-0.0698,0.0137,0.0875,0.3077,0.2267,0.1715,0.1279,-0.152,-0.2934,-0.1541,-0.2292,-0.1591,0.0295,-0.0598,0.0237,-0.0794,-0.157,-0.1676,-0.0723,0.0352,0.0131,-0.0536,-0.0945,-0.0186,-0.0573,-0.1977,-0.1535,-0.0769,0.0685,0.0045,-0.0317,-0.1361,0.0038,-0.0734,-0.1151,-0.238,0.0396,0.0564,-0.1414,-0.113,-0.0514,-0.0389,-0.0272,-0.097,-0.1469,-0.0276,0.3015,0.1303,0.2177,0.1138,0.1438,0.0256,0.1508,0.1588,0.2543,-0.1061,-0.0355,0.0353,0.1315,-0.1198,-0.1463,-0.0957,-0.0993,-0.0771,-0.1067,-0.0963,-0.079,-0.113,-0.044,0.0369,0.0469,-0.2431,0.0124,0.0147,-0.0879,-0.1239,-0.1116,-0.0022,-0.1686,0.0977,0.0308,0.155,-0.0367,-0.041,-0.2138,-0.0892,-0.0917,-0.11,-0.137,-0.0991,0.022,0.0149,0.0121,-0.0498,-0.0631,0.0372,0.0729,0.1654,0.1176,-0.2218,-0.242,-0.0789,0.0352,-0.0268,-0.0724,0.0662,-0.1016,0.0199,-0.0502,-0.065,-0.1175,-0.0458,-0.1095,-0.0965,0.0043,-0.0797,0.0042,-0.0439,0.0747,0.0543,0.0474,-0.0996,-0.1067,-0.145,-0.1505,-0.0962,-0.2396,-0.107,0.1894,-0.0497,-0.1037,-0.0554,-0.0262,-0.14,-0.0273,-0.0631,-0.0566,0.1649,-0.0646,0.041,0.0217,-0.1357,-0.064,-0.1059,0.0098,0.1277,-0.1358,-0.0366,0.027,0.1872,-0.0309,0.0305,0.0411,-0.0539,0.0304,0.0111,-0.036,-0.0059,0.0125,-0.2205,-0.151,-0.166,-0.0326,-0.0806,0.0951,0.1141,0.1798,-0.0013,0.0299,0.1217,0.2237,0.0488,0.0689,0.0406,0.0494,0.0355,-0.2437,-0.1265,-0.1316,-0.1095,-0.0376,-0.117,-0.1178,-0.0913,0.0321,-0.039,-0.2526,-0.2094,0.0344,-0.1099,-0.2324,0.0589,-0.0634,-0.0161,0.0457,-0.1056,-0.013,-0.1686,-0.0715,0.0377,-0.1107,-0.0239,0.046,-0.131,0.0244,0.0772,0.0389,-0.0639,-0.0907,0.1218,0.0167,-0.1197,0.0082,-0.0702,-0.0588,0.1172,0.0447,0.0361,-0.2133,-0.0964,-0.0288,0.0161,-0.0804,-0.1063,-0.1479,-0.033,-0.0192,-0.0655,0.0545,-0.1138,-0.0496,0.0635,0.0365,0.0095,0.0855,0.0187,-0.2353,-0.0387,-0.1003,-0.1291,0.1936,0.2936,0.2607,-0.0541,0.3864,0.2059,-0.1919,-0.0964,0.3878,0.0789,0.0615,0.0847,0.1163,0.0668,-0.0703,-0.0629,-0.0733,-0.0906,0.4101,0.3257,0.2455,0.0586,0.163,0.213,0.38,0.3772,0.3284,0.0245,-0.0313,-0.0419,-0.0541,-0.0624,-0.0404,-0.1342,-0.1055,-0.0305,-0.0009,-0.0392,-0.0321,0.1319,0.0139,0.0151,-0.1262,0.063,0.1731,0.2381,-0.0984,-0.0603,-0.165,-0.0436,-0.0411,-0.0465,0.0012,-0.0934,0.01,-0.0715,-0.1227,-0.1889,-0.169,0.0066,-0.1086,0.0117,0.1901,0.0999,0.1884,0.0477,0.1247,0.2434,-0.0828,-0.1477,-0.13,-0.0862,0.1075,-0.0566,0.1547,0.0801,0.1084,-0.0051,-0.2063,-0.2051,-0.1442,-0.1285,-0.0035,-0.3403,-0.2396,0.0189,-0.0234,0.1768,-0.0662,-0.0282,0.1386,0.0222,0.051,0.0996,-0.021,-0.1348,-0.1951,-0.0139,0.0074,-0.1006,0.0459,-0.0421,0.0823,0.2952,0.2863,0.137,0.2131,-0.0366,0.0166,0.0956,0.1481,0.1574,0.2914,0.0463,0.0957,0.0017,0.0916,0.0943,-0.0073,-0.0098,-0.0783,-0.0603,-0.0526,-0.0053,-0.0279,0.0122,0.0138,0.0021,0.0388,0.0173,0.0817,-0.1131,0.1037,0.0702,-0.0234,-0.1573,-0.0866,-0.1007,-0.1474,0.0354,-0.0827,-0.0782,-0.0395,0.1677,0.0018,-0.2367,-0.0568,-0.0796,-0.0505,0.0081,-0.0304,0.0248,0.1001,0.0565,0.3481,0.2019,0.2235,0.0316,-0.0047,0.0758,-0.1244,-0.1607,-0.0344,0.0078,-0.0704,-0.0839,-0.0695,-0.0815,-0.0505,-0.0986,-0.1595,-0.1351,-0.0498,-0.0371,-0.1524,0.0893,-0.0769,-0.0561,-0.0227,-0.0887,-0.122,-0.0978,0.1664,0.0345,-0.0572,-0.1614,0.1224,0.0436,-0.1682,0.143,-0.184,-0.1001,0.1635,-0.1902,-0.1871,-0.0659,0.0285,-0.001,0.01,-0.0761,-0.0525,-0.0277,-0.0049,0.0359,-0.1779,0.0207,-0.0137,0.0989,0.0477,-0.1783,-0.0519,0.001,-0.0335,-0.0349,-0.0135,-0.0987,-0.0361,0.0128,-0.0063,0.0117,-0.2825,-0.1219,-0.127,-0.2045,-0.1568,-0.1226,-0.1325,-0.1325,-0.0451,-0.0597,0.0529,-0.2007,-0.064,-0.1811,-0.1654,-0.032,-0.0229,-0.2774,0.1382,-0.264,0.097,0.0422,0.2163,-0.0241,-0.0329,-0.1372,-0.0792,-0.0058,0.0296,-0.0556,0.1581,-0.0126,0.0597,0.2137,0.1809,0.0171,0.0505,-0.053,-0.0621,-0.0044,-0.1023,-0.0745,-0.0806,-0.1032,-0.023,0.0192,0.0074,0.0408,-0.0257,-0.0574,0.0399,0.0882,-0.0273,0.1319,0.0015,0.062,0.018,0.0082,0.0413,0.0213,0.1821,-0.0541,0.0277,0.0125,-0.0412,0.1051,0.1091,-0.068,0.1476,0.0305,0.28,0.0925,0.0185,0.0889,-0.1688,0.0508,0.138,0.0857,-0.1006,0.017,0.0796,-0.0014,0.0203,-0.2324,-0.2266,-0.1532,-0.207,-0.0694,-0.1255,-0.2236,0.1869,-0.0217,0.0771,0.1111,-0.026,-0.0183,0.0726,-0.0912,-0.0991,-0.0064,0.0478,0.1398,0.0241,0.073,-0.1198,0.0087,0.1527,0.1042,0.1849,0.099,0.0245,-0.1118,-0.0129,-0.0999,-0.0518,-0.0585,0.0033,-0.064,-0.081,-0.0467,-0.1225,-0.0575,0.0323,-0.0843,0.0541,-0.0512,0.0176,0.054,0.1042,0.0869,0.0604,-0.0291,-0.094,-0.1132,-0.0674,0.0657,0.0538,-0.0485,-0.035,-0.0163,0.0144,-0.0709,-0.0979,-0.0739,-0.1416,-0.1408,-0.0643,-0.0292,0.069,-0.1148,-0.1133,-0.1368,-0.063,-0.0655,-0.0285,0.0237,-0.1749,0.1206,-0.0904,-0.1102,-0.0924,0.0822,-0.077,0.0133,0.0715,0.0167,-0.2013,0.0452,-0.0179,-0.0784,0.0106,0.066,-0.0169,0.083,-0.1123,-0.1621,-0.1045,-0.1723,-0.223,-0.0444,-0.0993,-0.0036,-0.0072,0.119,0.1221,0.1288,-0.1401,-0.1592,0.0685,0.2016,0.2459,0.0724,-0.0666,0.0482,0.0387,-0.0331,0.1277,-0.0435,-0.1029,-0.0668,0.0038,-0.0907,-0.1431,0.2249,0.0771,0.0809,0.1672,-0.0095,0.0753,-0.007,-0.0924,-0.0965,-0.0693,-0.0956,0.0381,0.1282,0.0841,0.0196,-0.0772,-0.0195,-0.0943,0.0088,-0.0329,-0.1686,-0.0405,-0.0255,-0.0043,0.0172,0.023,0.0443,0.0456,-0.0332,0.0905,-0.2114,-0.1293,-0.1405,-0.1503,-0.0298,-0.1098,-0.1077,-0.2328,-0.0994,-0.1369,0.1603,-0.1416,-0.0187,-0.0699,0.0438,0.1652,0.1352,-0.0928,-0.144,-0.0557,-0.0547,0.0654,0.1447,-0.0736,-0.0668,-0.0426,0.0708,0.0567,0.0613,0.1276,0.0145,-0.0312,0.0733,-0.0107,0.0797,0.0866,0.0646,-0.0843,-0.0364,0.0278,0.1123,0.0276,0.1155,0.1233,-0.009,0.0196,-0.0262,-0.1341,-0.1666,-0.0313,0.0986,0.2359,0.0775,0.013,0.0296,0.0079,0.3014,0.1984,0.1447,0.1913,-0.135,-0.0101,-0.0554,0.0367,-0.0739,0.0659,-0.0708,-0.0092,0.0166,0.0464,0.068,-0.0579,0.0678,0.0919,-0.1495,0.1972,0.0733,-0.0012,0.0763,0.0584,0.0739,0.0272,-0.0183,-0.0184,0.0208,0.1011,0.2054,0.2449,-0.0978,0.0141,0.0081,-0.061,-0.1776,-0.3342,-0.3074,0.02,0.0525,0.0419,-0.0672,0.0631,0.1497,0.0057,0.015,-0.0478,0.0707,-0.0886,-0.0434,0.0438,0.0227,-0.0053,-0.1314,-0.0484,-0.15,-0.0739,-0.0315,-0.0898,-0.005,-0.1572,-0.0603,-0.0139,-0.0876,0.0335,0.0851,0.0532,-0.0612,-0.0915,0.2228,-0.0938,0.127,0.1689,0.1557,-0.0139,0.026,-0.1815,0.1712,0.1337,-0.1387,-0.0714,-0.0243,0.0053,-0.0711,-0.1226,-0.2404,-0.204,-0.1109,-0.0116,-0.0154,0.0384,-0.0079,-0.0705,-0.1137,-0.2065,0.1499,0.1415,-0.1296,-0.1161,-0.0214,-0.1095,-0.1936,0.1302,0.1491,-0.103,0.0392,0.137,0.1195,-0.2603,-0.2833,-0.1349,-0.2177,-0.0762,-0.1141,-0.0165,0.0862,0.0271,0.1587,-0.0246,0.1987,0.3142,0.1781,0.1509,0.2654,-0.2392,-0.1612,-0.1067,0.0968,0.0334,0.0014,-0.0215,0.0304,0.1029,-0.2227,-0.2005,-0.0483,0.1552,-0.1329,-0.1509,-0.1313,-0.1108,0.0674,0.1128,-0.0857,-0.0223,-0.0104,-0.0519,0.0539,0.1162,0.0968,0.0454,0.0083,0.0105,0.1062,0.0299,0.0856,-0.0106,-0.0796,0.0042,-0.0641,0.0039,0.0028,0.0123,0.1792,0.0825,0.0274,0.0369,-0.0549,-0.0223,-0.202,-0.1689,-0.1196,-0.1008,0.3338,-0.0067,0.2007,0.16,0.0972,-0.0383,-0.0393,0.1381,-0.085,0.25,0.1817,0.056,0.1142,0.0698,0.0326,-0.0825,-0.1012,-0.1741,-0.0115,0.1341,0.0919,-0.1469,-0.0215,-0.0111,0.02,-0.0042,-0.0659,-0.071,-0.1125,-0.0224,-0.2568,-0.031,-0.0564,0.1035,0.0735,0.0414,0.0642,-0.0497,-0.0349,-0.1136,-0.0561,0.0689,0.1129,-0.0389,-0.0121,-0.0972,0.0006,0.0113,-0.0196,-0.0137,0.1233,0.0728,-0.0622,-0.2011,-0.1007,-0.1366,-0.1159,0.0391,0.0225,-0.094,-0.0251,-0.0934,-0.1338,-0.1405,-0.0932,-0.0666,-0.1083,-0.0694,-0.0479,-0.0951,0.1505,-0.3006,-0.2672,-0.262,-0.0417,-0.1163,-0.2172,-0.1063,-0.0063,0.1149,0.0451,-0.1666,0.2785,0.2508,0.1711,-0.0008,0.0107,-0.0374,-0.139,-0.0335,-0.071,0.0699,0.1393,0.1798,-0.0152,0.0488,0.0563,0.0783,-0.2002,-0.0646,-0.0432,-0.0265,-0.2002,-0.1469,-0.1537,-0.1392,0.0143,-0.1848,-0.1771,0.1274,-0.0524,-0.2177,0.02,0.1465,0.1052,-0.0684,-0.0944,-0.3547,-0.2678,-0.1299,-0.2594,0.074,-0.1271,-0.0454,0.0736,-0.1451,-0.1197,-0.2573,-0.0838,0.1025,0.118,0.1769,0.1645,0.1951,-0.0228,0.0152,0.1686,0.0475,0.1537,0.0952,0.0642,0.1708,0.102,-0.1673,-0.2506,-0.13,-0.076,-0.1294,-0.0053,-0.1249,0.0495,0.0392,0.0338,0.1161,0.0655,-0.2087,-0.036,-0.1591,-0.0452,-0.1835,-0.2744,-0.0062,-0.0587,0.002,-0.0748,-0.0288,-0.2082,-0.1159,-0.1829,-0.1063,-0.1423,-0.0588,-0.0338,0.034,-0.0303,-0.0625,0.0825,0.0948,0.0236,-0.0652,-0.0786,-0.1306,-0.0789,0.1217,0.0647,-0.0599,0.2471,0.0561,0.0089,0.0695,0.0383,-0.0454,0.0225,0.0325,0.0448,0.0177,-0.0099,0.158,0.223,0.3335,-0.0566,-0.0439,-0.0067,-0.0128,0.0254,0.1624,-0.1089,0.2359,-0.1763,-0.0166,-0.0291,0.127,0.0451,-0.014,-0.0085,0.015,-0.0851,-0.0736,0.0532,0.0425,-0.0576,-0.0892,0.063,0.1717,0.1671,-0.2052,-0.1447,-0.1619,0.0038,-0.2096,-0.0488,0.0103,0.0452,0.0268,-0.0279,-0.1419,-0.1707,-0.1061,0.0397,-0.0682,-0.0358,0.2136,0.0207,-0.0414,0.135,0.4085,0.1339,0.1138,0.2104,-0.0647,0.0467,0.2055,0.1956,-0.0744,0.2315,0.1115,0.1138,0.0756,0.3475,0.0672,-0.1611,-0.138,-0.1057,-0.0771,0.0708,-0.085,0.0127,-0.1205,-0.1255,-0.0383,-0.0788,-0.0536,0.1056,-0.0562,-0.1617,-0.0852,-0.1871,-0.0487,-0.0389,-0.0799,-0.0799,-0.0604,-0.0439,-0.0428,-0.2108,-0.1493,0.1918,0.3113,-0.0094,-0.07,0.1138,0.0444,-0.0693,-0.0604,-0.1806,-0.2286,0.0863,0.1224,-0.0974,-0.1328,-0.0974,-0.0421,-0.1243,-0.0739,-0.0551,-0.0785,-0.0113,-0.0796,-0.0944,-0.05,-0.1318,-0.0829,-0.0632,-0.08,0.1314,-0.1369,-0.0013,0.1899,0.0051,-0.1534,-0.0738,-0.0995,-0.1571,-0.0859,-0.1163,-0.139,0.0921,0.061,0.0894,-0.05,-0.1021,-0.0935,-0.0099,0.0421,0.0835,-0.2004,-0.0973,-0.1861,0.0339,0.043,0.1118,-0.0745,-0.1987,-0.1403,-0.0379,-0.035,-0.0042,0.0527,0.1224,-0.0103,-0.0807,-0.1144,-0.069,-0.1205,-0.2531,-0.1108,-0.0723,0.1005,0.0066,0.1947,-0.0566,0.1271,0.0316,0.0482,-0.0037,0.0897,0.1754,0.0784,-0.0052,-0.0037,-0.0562,0.0455,0.0268,0.0387,-0.0387,-0.0387,-0.0049,0.0323,-0.0857,-0.0618,-0.0579,-0.0532,-0.1394,-0.0335,-0.0212,0.1333,-0.1111,0.0301,0.0207,0.0567,-0.0107,-0.021,0.0504,-0.0351,-0.1934,-0.0544,0.1536,0.1747,-0.0563,-0.0563,-0.1064,-0.1271,-0.0756,-0.0157,-0.1168,0.0823,0.0434,-0.1809,-0.185,-0.0175,-0.1322,-0.0449,-0.0525,0.3044,0.1621,-0.1802,0.0995,-0.0663,-0.0269,-0.0954,-0.1225,-0.1852,-0.198,0.0298,-0.0057,-0.1106,0.023,-0.0705,-0.0622,0.1639,-0.0083,0.0288,0.0143,-0.012,0.0488,-0.1314,-0.0247,0.0758,-0.1249,0.1136,-0.1785,0.0612,-0.1522,0.3229,0.1586,0.1608,-0.1478,-0.1307,0.0765,0.2174,0.0068,0.1874,0.0153,-0.0009,0.1322,0.0899,0.0513,0.0152,0.0368,0.0533,0.1062,0.0862,0.152,-0.0581,0.1712,0.238,0.4405,0.18,0.1342,0.3043,0.1449,0.166,0.204,0.1456,0.1782,0.1098,0.2621,0.2378,0.1101,0.1921,0.2716,0.2582,0.2449,0.2399,0.095,0.2355,-0.2014,-0.0417,-0.1344,-0.2343,-0.0945,-0.2576,-0.2039,-0.108,-0.0695,-0.114,-0.28,-0.2246,-0.1749,-0.0874,0.0128,-0.1166,0.1001,-0.0199,-0.0566,0.0356,-0.0969,-0.0946,-0.0607,-0.0735,-0.1744,0.1056,-0.2227,-0.2374,0.0416,-0.0213,-0.0451,0.0062,0.0078,-0.1556,0.1812,0.1639,-0.1465,0.2195,0.2595,0.0876,0.0909,0.137,-0.1032,0.3652,0.3661,-0.0096,-0.0057,0.1112,-0.0189,0.0271,-0.1202,-0.02,0.0943,0.0145,-0.0479,0.0507,0.0469,0.0015,-0.0583,tongue response execution
trm_4a3fd79d0b665,-0.1402,-0.1051,-0.131,-0.1352,-0.0245,-0.0075,-0.1008,-0.1136,-0.0787,-0.1114,-0.0028,0.0117,-0.1247,-0.0634,-0.122,-0.065,-0.0826,-0.0678,-0.0896,0.0121,-0.0581,0.0456,-0.0252,0.067,-0.0278,-0.0007,-0.0047,-0.1101,-0.1608,-0.103,-0.1017,-0.0592,-0.1305,-0.1112,-0.1001,-0.0956,-0.0704,-0.07,-0.1278,-0.0387,-0.0872,-0.1097,-0.0631,0.0782,-0.0664,-0.0514,0.1921,-0.1352,0.025,-0.1158,-0.0669,-0.0326,0.026,-0.0177,-0.0286,-0.0875,-0.1193,0.0001,0.0225,-0.037,0.0209,0.04,-0.105,0.0588,0.0175,-0.0223,-0.1665,-0.2095,-0.1234,0.0176,0.0666,0.0388,0.1621,-0.0539,-0.1396,0.0862,-0.1456,0.0602,0.055,-0.0342,0.0393,0.0857,-0.0319,-0.1237,0.0331,0.0408,-0.0364,0.003,0.0181,-0.2204,-0.0748,-0.1065,0.0177,0.0778,0.1069,0.0957,0.0986,-0.0356,0.1036,0.0319,0.0725,0.0344,0.0595,-0.0432,0.0378,-0.1032,-0.1155,0.146,-0.0526,-0.0508,0.019,-0.0959,0.1084,0.1139,0.004,0.0556,-0.0771,0.0121,-0.0225,-0.0711,-0.0399,-0.1188,-0.0612,-0.0146,-0.0739,-0.0822,-0.0271,0.0511,0.0677,0.0164,-0.0164,-0.087,-0.0372,-0.1846,0.0271,-0.1493,-0.0554,-0.0951,0.0169,-0.0573,-0.1133,-0.1444,0.0836,0.0004,0.0002,0.0516,-0.1427,0.0297,-0.0706,0.0755,-0.0735,-0.0375,-0.1003,-0.1054,0.1803,-0.0459,0.0669,0.0202,0.0417,-0.0427,-0.0762,-0.0376,-0.1618,-0.2051,-0.0222,0.0477,0.0197,-0.1141,-0.1049,0.0149,0.0015,-0.0623,0.0535,-0.1283,-0.1167,-0.1219,-0.0914,-0.0815,-0.0529,-0.0461,-0.1202,0.0918,-0.0274,-0.0246,-0.1111,-0.0521,-0.1003,0.0006,-0.0041,0.0182,0.0291,-0.0536,-0.0372,-0.1662,-0.1505,-0.2161,-0.1886,0.0139,0.0578,-0.1939,-0.1343,0.1354,-0.0644,-0.1049,0.0377,-0.0791,-0.0304,-0.0459,-0.0918,-0.0054,-0.1138,-0.038,0.0021,0.0086,0.0788,0.0603,0.117,-0.1382,-0.2045,0.0499,0.1086,-0.0888,-0.0819,-0.0231,0.0352,0.0478,-0.0355,0.145,0.016,0.1901,-0.0882,-0.0992,0.1331,-0.1177,-0.1137,-0.0245,-0.0111,0.0647,0.0065,-0.055,-0.0161,-0.1638,-0.0757,-0.0358,-0.0787,-0.0645,-0.0085,-0.1116,-0.0991,-0.0462,0.0155,0.0307,0.0132,0.0469,-0.0191,-0.1291,0.0033,-0.0866,0.1417,0.2375,0.0484,0.2248,-0.0901,0.1271,0.1476,0.2909,0.1116,-0.0078,0.0787,0.0329,-0.0446,-0.0742,-0.0939,0.0229,-0.0965,0.0163,-0.1496,-0.1545,-0.166,-0.0328,0.0297,-0.0119,-0.0014,-0.0713,-0.026,-0.0933,0.0689,0.0907,-0.1674,-0.1106,-0.0569,-0.09,-0.043,-0.0318,-0.1131,-0.0328,0.0053,0.0573,-0.0309,0.1042,0.0361,-0.1076,-0.0992,-0.0515,-0.1387,-0.133,-0.1353,-0.0765,-0.0467,0.0005,-0.0179,-0.0226,-0.1301,0.0598,0.0643,-0.0765,0.0951,0.0018,0.0721,-0.126,-0.0067,0.0309,-0.0646,-0.0721,-0.081,-0.0658,0.0139,-0.0149,-0.0798,-0.0705,0.0146,-0.1174,-0.0013,0.043,0.0414,0.0337,0.0783,-0.0014,0.0203,-0.1062,-0.0914,0.0641,-0.0596,-0.0834,0.0707,-0.0026,-0.2481,-0.1538,-0.1701,-0.1212,-0.1143,0.0256,-0.1204,-0.0874,-0.0422,-0.0856,-0.0626,-0.1003,-0.1656,-0.1055,-0.0064,-0.0247,-0.0665,-0.0515,-0.0735,0.0285,-0.1419,0.1727,0.0919,-0.1742,0.0458,0.059,0.0115,0.0689,-0.0952,-0.065,-0.0726,0.1101,0.202,0.15,0.2133,-0.0227,-0.1026,-0.0079,0.0146,0.0424,-0.0592,-0.0481,0.0489,-0.0514,-0.0949,-0.0003,-0.0892,-0.0223,-0.0373,-0.1118,-0.1636,-0.1308,-0.0985,-0.0442,-0.0538,0.0199,0.0133,-0.0232,0.0385,0.074,0.0808,0.0009,-0.087,-0.0446,-0.0535,-0.1103,-0.0101,0.2448,-0.0577,0.0074,0.2577,0.0186,-0.0561,-0.0301,0.02,-0.2367,-0.1592,-0.2811,-0.2342,-0.135,-0.1749,-0.1259,-0.1517,-0.1563,-0.0003,0.0536,-0.0146,-0.0571,0.0457,0.0797,-0.0153,0.0331,-0.229,-0.1405,0.0358,0.0534,-0.0176,0.0806,-0.0345,-0.1057,0.0368,0.0762,-0.0457,-0.033,-0.0121,0.0584,-0.1098,-0.0796,-0.0116,-0.0819,0.0469,-0.0718,-0.0081,-0.0054,0.0669,-0.0426,-0.0106,0.1421,-0.0743,-0.0905,0.0599,0.3422,-0.1025,-0.0596,-0.0154,0.0178,0.0125,0.0055,-0.0327,-0.0517,-0.0177,0.0238,-0.0289,-0.0662,0.0087,-0.0458,-0.0153,0.0347,0.0868,0.099,-0.0281,-0.0068,-0.0275,-0.0685,0.0786,0.0492,-0.0177,-0.0558,0.1151,0.0775,-0.059,-0.0524,0.0671,-0.0802,-0.07,0.0528,-0.0505,-0.1131,-0.1263,-0.0592,0.075,0.0952,-0.0035,0.0695,-0.171,-0.017,-0.0003,0.0313,0.0805,0.0458,-0.1282,-0.1259,0.0317,-0.1045,-0.0921,-0.0765,0.1014,0.0387,0.1489,0.0623,0.0926,0.0835,0.0054,0.0607,-0.0623,-0.0425,-0.1016,-0.1597,-0.0335,0.0217,-0.0824,-0.0686,0.011,-0.0759,-0.0084,0.055,-0.0087,-0.0517,-0.0762,-0.0396,0.0175,0.0478,0.0256,-0.0154,0.0411,-0.0194,0.02,-0.0846,-0.0111,-0.0844,0.1088,0.0232,0.0907,-0.0529,0.0092,0.0538,-0.0126,-0.0015,-0.0483,0.0493,0.0954,0.0494,0.0019,-0.0042,-0.0552,0.0474,-0.1515,0.0036,-0.0788,-0.0739,0.0215,0.0105,0.0552,0.0715,0.0107,-0.0732,0.0001,-0.0612,0.064,0.064,-0.0693,0.0499,0.0094,-0.0125,-0.0673,-0.0078,0.0657,0.0835,-0.0938,-0.0768,-0.1857,-0.0158,0.1323,-0.0107,0.0502,0.0408,0.0517,0.0387,0.03,-0.0745,0.01,-0.1743,-0.1742,0.0608,-0.1715,-0.0608,0.0723,-0.0502,-0.2363,-0.0326,-0.0791,0.0373,0.057,-0.1461,-0.0886,-0.1591,0.0535,0.043,-0.0292,0.0273,-0.1122,-0.1076,-0.1194,0.0134,0.0329,-0.0609,-0.0327,-0.0097,-0.0211,-0.0088,0.0387,-0.0544,-0.0386,-0.0788,-0.0941,0.0431,-0.0091,-0.0842,-0.0555,-0.0118,-0.1119,-0.1069,0.0479,-0.1035,0.0067,-0.0518,0.1251,-0.031,-0.0075,-0.074,-0.0412,-0.1158,-0.0081,-0.0983,-0.0645,-0.0543,0.1348,-0.1043,-0.0339,0.0934,-0.1951,-0.061,-0.0934,-0.1025,-0.0659,-0.0538,-0.0547,0.0003,-0.0554,-0.0836,0.1146,-0.0611,0.0387,-0.0582,0.0463,0.0513,0.0764,0.0227,0.0893,-0.1297,-0.0952,0.046,0.0014,-0.0162,-0.0114,0.1368,0.1096,0.1027,0.1089,0.0521,0.0527,-0.0447,-0.1027,-0.0173,0.0283,0.0057,-0.0366,-0.0625,-0.0684,-0.0701,-0.0738,-0.0456,-0.0364,0.0435,0.1207,0.0695,0.0068,0.0726,0.0905,0.0376,-0.0154,0.036,-0.058,0.026,0.0661,-0.0781,-0.1266,-0.134,-0.0681,-0.0054,-0.0352,-0.0911,0.0288,-0.0751,0.0927,-0.0088,-0.0744,0.045,0.0677,0.0057,-0.168,0.1002,0.099,0.1918,-0.0904,-0.0039,-0.1238,-0.0095,0.0767,-0.108,0.0924,0.0395,-0.0075,0.0183,0.0222,0.0307,-0.1214,-0.1599,-0.1309,-0.1063,0.0586,0.2423,0.048,-0.1212,0.0193,-0.047,0.0571,0.0832,0.0365,0.017,-0.0337,-0.1004,-0.0576,0.0758,0.0946,0.1278,-0.08,-0.0524,0.0013,-0.0618,0.0714,-0.0685,-0.095,-0.0081,-0.1235,-0.0938,-0.0396,0.0792,0.1404,0.0746,-0.0061,-0.0571,-0.0161,0.1516,-0.0447,-0.0812,0.0993,0.0127,0.0165,-0.0119,0.0846,-0.0262,0.0927,-0.1703,-0.1751,0.0988,0.1682,0.1904,0.0036,-0.0071,0.0346,-0.0189,0.0317,0.1386,-0.025,0.0398,0.0941,0.1569,0.0697,0.0142,0.1366,0.151,-0.0843,0.049,0.0932,-0.1619,-0.0923,-0.0469,-0.0817,0.0642,-0.1868,-0.0682,-0.1165,-0.0784,-0.13,0.053,0.0132,0.1041,-0.0763,-0.0874,0.0146,-0.0033,0.0744,0.0896,0.103,0.1469,0.043,0.0723,-0.0068,-0.0067,0.0792,0.1102,-0.0847,0.1097,0.0599,-0.033,-0.0503,-0.0975,-0.0447,0.0679,-0.0194,-0.1322,-0.0862,-0.0496,0.0851,0.1518,0.0674,0.0329,0.0055,-0.0277,-0.0681,-0.0828,0.0562,-0.0497,0.082,-0.0852,-0.0177,-0.0735,0.1017,0.0379,0.0347,0.0389,-0.1127,-0.0787,-0.0493,0.1896,-0.0747,-0.0835,-0.0698,0.0663,-0.009,-0.1446,-0.0016,-0.13,0.0228,-0.0923,0.038,0.0345,0.0312,0.1208,-0.1602,-0.0808,-0.032,0.0396,-0.1073,-0.0088,0.1595,0.0483,0.0849,0.3756,0.091,-0.0643,-0.0632,-0.0371,-0.0497,-0.0368,-0.0129,0.0444,0.1241,0.0383,0.0252,-0.1185,0.1017,0.1515,-0.0166,-0.0473,-0.0412,0.0125,-0.1836,-0.0747,-0.0627,-0.0094,0.0562,-0.1055,-0.0855,0.1309,-0.0053,-0.1159,-0.0374,0.0932,-0.0087,-0.0103,-0.0417,-0.1066,-0.1066,-0.1489,-0.1117,-0.1421,0.0202,-0.0153,-0.0393,-0.1111,-0.0397,-0.1121,-0.0048,-0.1198,-0.0885,-0.1024,0.0104,0.0688,0.0836,-0.0249,0.05,-0.0424,0.069,0.0466,0.1953,0.1766,0.1286,-0.0408,-0.0603,-0.043,0.0028,0.1612,0.0751,0.0929,-0.0191,0.0828,0.0239,0.1406,-0.0208,-0.0591,-0.0589,0.1072,-0.0332,0.0888,-0.1551,-0.042,-0.0199,0.0542,0.0568,0.0178,0.044,-0.0101,0.12,0.2077,0.1578,-0.0375,-0.0127,-0.0129,-0.0524,0.0055,-0.022,-0.0468,-0.0717,-0.0931,-0.0328,0.0876,0.0773,-0.1121,-0.0938,-0.041,-0.1421,-0.0508,0.1368,0.0494,0.0739,0.1161,0.1126,-0.013,0.0188,0.0589,-0.0306,-0.0495,-0.0035,0.0378,-0.0638,-0.1069,-0.029,0.0756,-0.0881,0.0044,-0.0582,0.0472,-0.1451,-0.0082,0.005,0.0526,0.0377,0.0677,0.0238,-0.0257,-0.0037,-0.0067,-0.0121,-0.0557,-0.0097,-0.0101,0.0202,-0.0393,-0.0568,-0.0018,-0.0211,-0.0213,-0.0949,-0.066,-0.1293,-0.0678,-0.0942,0.1486,0.0189,0.0734,-0.0961,0.1852,0.0955,-0.0203,0.008,0.0342,0.1152,-0.0006,0.0435,-0.1193,-0.0729,0.0352,-0.0434,-0.0606,0.0207,-0.0627,0.0292,0.0184,-0.0611,-0.0406,-0.0505,0.0353,-0.0481,-0.0054,0.0153,0.0249,-0.0975,-0.0028,-0.0324,0.0746,-0.0201,-0.0203,0.3646,0.2528,0.1767,0.0749,0.1109,0.005,0.1601,0.1621,-0.1588,0.2994,0.3008,0.204,0.1534,0.2511,0.0163,0.0502,-0.0032,0.0528,0.0706,0.0243,0.0258,0.03,-0.091,0.0207,0.0426,0.036,0.0677,-0.0193,-0.0608,0.1562,0.1129,-0.0535,-0.03,-0.1041,0.0373,0.0123,0.1087,-0.0237,-0.0883,-0.0613,-0.0057,0.0354,0.1487,0.1526,-0.1195,-0.077,-0.1404,-0.1039,-0.0904,0.2922,-0.1336,0.1321,0.131,-0.0379,0.0181,-0.0678,-0.0618,-0.0337,-0.0534,0.1468,0.0693,-0.0109,0.03,0.0304,-0.0614,-0.0739,-0.019,-0.0548,0.0274,0.0121,-0.0805,-0.0836,-0.1005,-0.0412,-0.0433,-0.0152,-0.1655,-0.0877,0.2037,-0.0132,0.0195,0.0143,0.162,0.0265,-0.016,-0.1558,-0.1647,0.0179,-0.1026,-0.1047,-0.1043,-0.027,-0.0292,0.0008,0.0619,0.0293,0.0113,0.1199,-0.0354,-0.0307,-0.0165,0.0943,-0.0518,0.1239,-0.0621,0.1244,0.2319,-0.0024,-0.0794,0.1882,0.1664,-0.0147,-0.1275,-0.0051,-0.1272,-0.0725,-0.161,0.0019,-0.0026,-0.0645,-0.036,-0.0045,-0.0375,-0.0177,-0.1059,-0.0368,-0.0147,-0.0451,-0.0699,0.0671,-0.0208,0.3968,0.2756,0.2723,0.3405,-0.0745,-0.0409,-0.0648,-0.0619,-0.0776,-0.0137,-0.1337,0.1614,-0.0744,-0.0516,0.0746,0.0213,0.0221,0.1095,0.0557,-0.0214,0.0009,0.0271,-0.0269,-0.0228,-0.0375,0.1137,0.0029,0.0417,-0.0901,-0.0901,-0.151,0.11,0.0335,0.0533,-0.085,0.1034,-0.037,0.157,-0.2503,-0.2165,0.0826,-0.0351,-0.2068,-0.1983,-0.1944,-0.0867,-0.0722,0.0027,-0.0165,-0.0339,0.0602,0.0138,0.0817,-0.0713,0.1007,-0.0422,-0.001,0.0306,-0.0795,-0.0266,-0.019,-0.026,0.0064,-0.0181,-0.0859,0.0308,0.0451,-0.0148,-0.0279,-0.0214,0.0062,0.0319,-0.0659,-0.039,0.0045,-0.0853,-0.0136,-0.1244,-0.2753,-0.0158,-0.0496,-0.1479,-0.077,-0.0865,-0.1446,-0.021,-0.1277,0.008,-0.2001,-0.0714,-0.108,-0.235,-0.0157,0.0174,-0.0422,0.2376,0.0316,-0.043,0.0122,-0.0306,0.0459,-0.0237,-0.1653,-0.1632,0.0552,-0.07,-0.0078,-0.0406,0.0027,0.0565,0.0389,0.0322,-0.1058,-0.0576,-0.0169,0.0133,-0.0636,-0.0252,-0.0004,0.0425,-0.0134,-0.0802,-0.0071,-0.0711,-0.0822,-0.0292,-0.0908,-0.1,0.0382,0.0359,-0.0059,-0.0239,-0.0097,-0.0915,-0.0846,0.0039,-0.158,0.0566,0.0042,-0.0578,-0.1438,-0.0432,0.0393,0.1088,0.0918,0.0688,0.0314,-0.0061,0.2154,0.0013,-0.0396,-0.0601,-0.1338,0.096,-0.0249,0.0834,0.0169,0.1462,-0.0071,-0.1127,-0.0414,0.0885,-0.0568,-0.0002,-0.0704,-0.0044,-0.0865,-0.0407,0.0321,0.0528,-0.0498,-0.0327,-0.0751,0.0286,0.0433,0.003,0.0145,-0.1563,-0.0111,0.0107,-0.0993,0.0431,-0.0528,-0.0614,-0.0117,-0.0487,-0.0841,-0.081,-0.0055,-0.0433,-0.0078,-0.0121,0.0504,-0.0436,-0.0126,-0.0263,-0.0052,-0.0365,0.0342,-0.0656,0.0554,-0.1414,-0.0595,0.0055,0.0925,0.0889,0.0021,0.0384,-0.0943,-0.0259,-0.0425,-0.0529,-0.1485,-0.0076,-0.191,-0.0141,-0.0123,-0.0606,-0.0305,-0.0607,-0.0269,0.0776,0.0207,-0.0309,0.3294,0.0055,0.0704,-0.0044,0.2295,0.0072,-0.0459,0.0769,0.2279,-0.0248,-0.0044,-0.0894,-0.1471,-0.0907,-0.065,0.0423,-0.0536,-0.1159,0.0291,0.0881,-0.0452,-0.0671,-0.013,0.0076,0.0677,0.0949,-0.2905,-0.1596,-0.0753,-0.2767,-0.2341,0.107,0.074,0.0377,0.0366,0.0176,0.0524,-0.1814,-0.0344,-0.0244,-0.0904,-0.228,-0.0114,-0.0011,-0.0479,-0.0869,0.1477,-0.0156,-0.0277,0.0057,0.0219,0.1127,0.1061,-0.0589,0.1074,-0.0418,-0.0084,-0.0955,-0.0297,0.0233,-0.0092,0.0289,0.1227,0.0219,-0.0165,-0.0575,-0.0938,0.0158,0.3335,0.3279,-0.089,-0.0851,-0.0164,-0.0881,-0.0809,-0.0091,-0.1737,0.0565,-0.0448,-0.0323,-0.0519,0.0037,0.0999,-0.0225,0.0436,0.0677,0.0039,0.0391,0.2965,-0.1466,-0.0534,0.2483,0.0035,0.0398,0.0876,0.0891,-0.0492,0.1748,0.1311,-0.0784,-0.0289,0.0592,0.0632,0.1915,0.1148,0.0614,0.0113,0.0161,0.1109,-0.0995,0.0498,0.1899,0.0118,0.0666,0.0043,-0.0204,-0.1289,-0.0052,0.0425,-0.0963,0.0193,-0.0655,0.0629,0.1075,0.0042,0.0379,0.0292,0.0694,0.003,0.1569,0.0445,0.1093,0.0651,0.1714,0.0014,0.0289,0.4369,-0.0823,-0.0072,0.0346,-0.0793,-0.0025,0.0317,0.055,-0.0581,-0.0062,-0.0033,-0.0425,0.0202,-0.0144,-0.0253,-0.0291,-0.0123,0.0424,0.0806,0.0925,0.2365,0.2215,-0.0915,-0.16,-0.0791,-0.0202,0.0517,0.056,0.0699,0.0135,0.0782,-0.0093,0.0533,-0.1328,-0.2149,-0.0713,-0.0174,0.1147,-0.0235,0.052,0.018,0.2143,0.1477,0.0002,-0.0019,-0.0504,-0.0076,0.0309,0.0591,-0.128,-0.1415,-0.198,0.0807,-0.0054,0.0232,0.1389,-0.04,-0.0029,0.0646,0.0519,0.0419,0.0478,0.0086,0.0302,-0.0519,-0.0116,0.0889,0.1397,0.1793,-0.0848,0.077,0.1159,-0.0164,-0.1219,0.0257,-0.1669,-0.0467,-0.012,-0.0672,-0.0044,0.0959,-0.1071,-0.0857,-0.0275,-0.0876,-0.0837,-0.0377,-0.0816,-0.0304,-0.026,-0.0389,-0.1122,-0.0102,0.1457,0.0464,0.105,-0.1451,-0.1016,-0.1162,-0.0297,0.0765,-0.0061,-0.1119,-0.0464,-0.143,-0.0194,0.1492,0.0532,0.1224,0.1038,0.0293,0.0077,-0.0132,0.0359,-0.0543,-0.0613,-0.1834,-0.0635,-0.0926,-0.0658,-0.0647,0.0459,0.0793,0.3281,0.2509,0.1179,0.0907,-0.1388,-0.2674,-0.1377,-0.2047,-0.1261,0.0363,-0.0433,0.0479,-0.062,-0.1297,-0.162,-0.0875,0.0541,0.0478,-0.0494,-0.0629,0.0123,-0.0305,-0.1869,-0.1109,-0.039,0.0524,-0.0309,-0.0404,-0.1134,-0.0514,-0.0849,-0.0882,-0.1707,0.0392,0.0309,-0.0861,-0.0722,-0.082,-0.0608,-0.0477,-0.1201,-0.0721,0.0002,0.1729,0.1534,0.0772,0.1072,0.0849,0.0025,0.0529,0.036,0.1199,-0.0979,-0.0368,0.022,0.1112,-0.0991,-0.0939,-0.0583,-0.0919,-0.0577,-0.0959,-0.0533,-0.0691,-0.0451,-0.0487,0.0297,0.0298,-0.2062,0.0106,-0.0352,-0.0979,-0.1116,-0.1183,-0.0176,-0.1214,0.0057,-0.0138,0.2018,-0.0266,-0.0169,-0.1254,-0.0975,-0.0731,-0.0966,-0.1137,-0.0783,0.0475,0.0271,0.0246,-0.0007,-0.0674,0.027,0.073,0.1677,0.1,-0.1295,-0.1467,-0.1034,0.0244,-0.0048,-0.1,0.0573,-0.0584,0.0455,-0.061,-0.0707,-0.1011,-0.0319,-0.101,-0.0827,-0.0031,-0.0438,-0.035,-0.0478,0.0138,0.0618,0.0412,-0.1275,-0.1106,-0.0928,-0.1409,-0.0843,-0.2004,-0.0961,0.2604,-0.0681,-0.1035,-0.0923,-0.0516,-0.13,-0.0692,-0.0819,-0.0832,0.092,-0.0906,-0.0082,-0.0518,-0.1591,-0.0839,-0.1154,-0.0178,0.1354,-0.1044,-0.0549,0.026,0.2544,-0.0222,0.0164,0.0542,-0.0112,0.0122,-0.0606,0.0483,0.0201,0.0204,-0.1819,-0.1617,-0.1764,-0.0814,-0.0851,0.0911,0.1376,0.177,0.0607,0.0495,0.1203,0.1726,0.0802,0.0965,0.0228,0.0352,0.0532,-0.1845,-0.0947,-0.1062,-0.085,-0.0068,-0.1018,-0.0953,-0.0651,0.0455,-0.0463,-0.2189,-0.1628,-0.0,-0.0581,-0.1503,0.0008,-0.081,-0.043,0.0657,-0.1101,-0.018,-0.1389,-0.061,0.0337,-0.1034,-0.0298,0.0313,-0.1409,0.0338,0.0414,0.0659,-0.0336,-0.0725,0.0736,0.031,-0.0428,0.043,-0.0205,-0.0355,0.0961,0.0516,0.0119,-0.2071,-0.0827,-0.0129,-0.0026,-0.0542,-0.0704,-0.1076,-0.0556,-0.058,-0.0585,0.0891,-0.0985,-0.0463,0.027,0.0278,-0.0271,0.0846,0.0476,-0.2439,-0.076,-0.1394,-0.122,0.1386,0.192,0.1974,-0.0763,0.4313,0.2683,-0.1829,-0.0941,0.4231,0.089,0.0506,0.1103,0.1582,0.0614,-0.0867,-0.0824,-0.0641,-0.1066,0.5052,0.3992,0.3125,0.0931,0.1982,0.2375,0.4323,0.4188,0.3551,0.0195,-0.0152,-0.0626,-0.0353,-0.0871,0.0119,-0.105,-0.0749,-0.0111,0.0344,-0.0536,-0.0403,0.1367,-0.0014,-0.0069,-0.102,0.1138,0.1212,0.1641,-0.0861,-0.0756,-0.1694,0.0008,0.0145,-0.0274,-0.0552,-0.0784,0.0192,-0.0617,-0.1025,-0.1695,-0.157,-0.0465,-0.0828,0.0296,0.2188,0.0658,0.1447,0.0681,0.1004,0.2306,-0.0285,-0.1248,-0.122,-0.1024,0.1021,-0.013,0.1568,0.0591,0.0778,-0.0533,-0.165,-0.1703,-0.1261,-0.112,-0.0476,-0.2891,-0.2098,0.0366,0.0057,0.1718,-0.0901,0.029,0.0809,0.0091,0.0351,0.0768,-0.0264,-0.1113,-0.1572,0.014,-0.0012,-0.0701,-0.0513,-0.1018,0.0553,0.1997,0.1786,0.0771,0.1626,-0.0279,0.0092,0.0556,0.0999,0.0971,0.2046,0.0932,0.0492,-0.013,0.1022,0.1614,-0.0275,-0.0297,-0.0945,-0.0756,-0.0281,0.0166,0.0072,-0.0119,-0.0593,0.0365,0.0216,0.0432,0.0849,-0.0545,0.1368,0.1232,-0.0415,-0.1337,-0.1188,-0.1212,-0.1296,0.0794,-0.0456,-0.0463,-0.0572,0.1164,0.0008,-0.1325,-0.0425,-0.0011,-0.0046,-0.012,-0.0048,0.0449,0.1239,0.1106,0.3513,0.0997,0.0868,-0.0214,-0.0446,0.0442,-0.0986,-0.151,-0.0749,0.0263,-0.0736,-0.049,-0.0656,-0.0813,-0.0151,-0.0879,-0.1309,-0.1024,-0.0521,-0.0438,-0.1351,0.0065,-0.0966,-0.0522,-0.0399,-0.0453,-0.1002,-0.1191,0.0987,0.0796,-0.0192,-0.1143,0.1396,0.0975,-0.1584,0.1117,-0.1689,-0.099,0.0711,-0.1485,-0.1501,-0.0164,0.0448,0.0185,0.029,-0.0951,-0.0479,-0.0052,-0.0148,0.0424,-0.1239,0.0319,0.0096,0.0879,0.0455,-0.141,-0.0611,-0.0118,-0.0638,-0.05,-0.0277,-0.0556,-0.0046,0.0123,-0.0077,0.019,-0.2056,-0.1073,-0.1053,-0.1498,-0.1405,-0.1078,-0.1005,-0.1005,-0.0148,-0.0485,0.0193,-0.1816,-0.0259,-0.1141,-0.0964,0.037,0.0176,-0.1763,0.1163,-0.1838,0.0624,0.0259,0.1814,-0.0057,-0.0081,-0.0935,-0.0584,0.0259,0.1103,-0.0178,0.1254,-0.0142,-0.0384,0.0661,0.0889,-0.0062,0.0329,-0.0968,-0.1041,-0.0383,-0.0293,-0.04,-0.0619,-0.0972,-0.0382,-0.0238,-0.0457,0.0289,-0.0514,-0.023,0.0015,0.126,-0.0106,0.1201,0.0473,-0.0569,0.0207,-0.088,-0.0191,-0.0568,0.0268,-0.0539,-0.0321,-0.0337,-0.0661,0.0687,0.1034,-0.0222,0.0979,0.0279,0.2916,0.125,0.0367,0.0378,-0.1654,0.0333,0.0892,0.0807,-0.0604,0.0177,0.0415,-0.0092,0.034,-0.1618,-0.1574,-0.1318,-0.1609,-0.0642,-0.046,-0.1687,0.2651,-0.0258,0.0952,0.1184,-0.0123,0.0001,0.0379,-0.0528,-0.1055,-0.022,0.0711,0.086,0.012,0.0375,-0.0877,-0.033,0.1191,0.1193,0.124,0.0776,0.0106,-0.0954,-0.0013,-0.0747,-0.0196,-0.0598,-0.0438,-0.0455,-0.0699,-0.0805,-0.1106,-0.0298,0.0162,-0.0841,0.0469,-0.0321,0.0611,0.033,0.0658,0.0887,0.0214,-0.0513,-0.0262,-0.0991,-0.0705,-0.0007,0.0454,-0.0248,-0.0095,-0.0144,0.0362,-0.0567,-0.0836,-0.0645,-0.1452,-0.0963,0.011,-0.0309,0.0268,-0.0872,-0.0771,-0.094,-0.0771,-0.0823,-0.0185,0.0556,-0.1817,0.113,-0.0528,-0.0824,-0.0728,0.0379,-0.1187,0.0035,0.0655,-0.0064,-0.1672,0.0805,0.0236,-0.0429,0.0378,0.0527,-0.0061,0.0776,-0.1147,-0.0937,-0.1125,-0.1314,-0.1799,-0.0792,-0.09,0.0004,-0.0063,0.0748,0.068,0.083,-0.1247,-0.1042,0.0762,0.177,0.2459,0.0896,-0.0293,0.0575,-0.0151,-0.0796,0.0846,-0.0783,-0.0737,-0.0679,-0.0278,-0.0899,-0.1404,0.2442,0.0767,0.0767,0.1924,0.0645,0.0651,-0.0034,-0.0171,-0.0513,-0.0481,-0.0804,0.0065,0.0481,0.0498,-0.0118,-0.0547,-0.0418,-0.0781,-0.0112,0.0134,-0.0894,-0.0359,-0.0256,0.0003,0.0252,0.0055,0.0288,0.0807,-0.0197,0.0669,-0.1722,-0.0829,-0.1225,-0.101,-0.0521,-0.1295,-0.1094,-0.2127,-0.1167,-0.1201,0.0156,-0.1007,-0.0192,-0.0644,0.0529,0.1062,0.1293,-0.0964,-0.1035,-0.043,0.0086,0.0948,0.1313,-0.0809,-0.0313,-0.0563,0.0636,0.0546,0.0454,0.131,0.0094,-0.037,0.062,-0.0325,0.0551,0.0871,0.0578,-0.0645,-0.0568,0.0129,0.1151,0.0008,0.1283,0.1378,-0.0516,0.0246,0.001,-0.1358,-0.1128,-0.0084,0.1238,0.2315,0.0646,0.0226,0.0566,0.0055,0.1971,0.1703,0.115,0.1221,-0.0939,-0.0081,-0.0687,0.0596,-0.0589,0.0049,-0.0807,-0.0493,0.0197,0.0366,0.0819,-0.05,0.1094,0.0211,-0.1096,0.1409,0.0965,0.0255,0.0439,0.041,0.0979,0.0089,-0.0312,-0.0169,-0.0479,0.0102,0.1778,0.1742,-0.0551,-0.0038,0.0678,-0.0673,-0.1125,-0.2343,-0.2128,0.0347,0.0573,-0.0033,-0.0333,0.0243,0.1185,0.0057,0.0296,-0.0247,0.0603,-0.0766,-0.0205,0.014,0.0244,-0.0074,-0.1217,-0.0343,-0.1194,-0.0741,-0.0704,-0.0477,0.0112,-0.1398,-0.05,0.0042,-0.0996,0.0179,0.0642,0.0279,-0.1112,-0.0745,0.215,-0.0474,0.0925,0.111,0.0959,0.0098,0.0685,-0.1545,0.1052,0.0805,-0.0952,-0.0272,-0.0101,0.0239,-0.0376,-0.1231,-0.1713,-0.1342,-0.0625,0.0055,0.0155,0.0376,-0.0144,-0.0867,-0.1252,-0.1737,0.1595,0.1543,-0.0993,-0.0695,-0.1009,-0.0956,-0.1679,0.1846,0.1061,-0.102,0.0236,0.1094,0.0667,-0.2241,-0.2325,-0.1297,-0.1635,-0.0588,-0.0956,0.0039,0.0318,0.0224,0.1143,-0.0516,0.1046,0.3625,0.1942,0.1301,0.3066,-0.1864,-0.0832,-0.1095,0.0827,0.0232,0.0126,-0.0389,0.0121,0.0571,-0.1946,-0.1774,-0.0042,0.2103,-0.0977,-0.1228,-0.0996,-0.0395,0.0646,0.1381,-0.0612,-0.0552,-0.029,-0.0644,0.0198,0.0993,0.0968,0.0464,0.0334,-0.0563,0.0003,-0.0541,-0.0004,-0.0043,-0.0853,-0.014,-0.0605,-0.0059,-0.0037,0.0104,0.1437,0.0539,-0.0003,0.0127,-0.0512,-0.0072,-0.1643,-0.1493,-0.0666,-0.1134,0.3851,0.0402,0.2406,0.1071,0.0573,-0.0512,-0.0442,0.1191,-0.0794,0.2032,0.1346,0.0446,0.0492,0.0332,0.0218,-0.0772,-0.064,-0.1466,-0.0751,0.2128,0.0822,-0.1291,-0.003,-0.0153,-0.0185,-0.0128,-0.0023,-0.0467,-0.0929,-0.0428,-0.2064,0.0167,-0.0304,0.1178,0.0986,0.0311,0.0297,-0.0005,-0.013,-0.0911,-0.0307,0.0431,0.1189,-0.0146,0.0254,-0.0914,0.0244,-0.0203,-0.0422,-0.0519,0.1528,0.0427,-0.0636,-0.2078,-0.1025,-0.1074,-0.1104,-0.0073,-0.0657,-0.0482,-0.0313,-0.0409,-0.0789,-0.0944,-0.0684,-0.0544,-0.0804,-0.026,-0.0096,-0.0914,0.0988,-0.221,-0.2027,-0.2052,-0.0485,-0.0634,-0.1706,-0.066,0.0475,0.1362,0.0383,-0.1,0.247,0.2189,0.1415,-0.0352,0.0603,-0.0348,-0.1127,-0.0196,-0.0401,0.0858,0.1562,0.1905,0.0085,0.0617,0.0604,0.0643,-0.1343,-0.047,-0.0122,-0.0405,-0.1729,-0.1388,-0.1012,-0.1361,-0.0193,-0.1331,-0.1551,0.1031,-0.0526,-0.1416,0.0515,0.0949,0.0977,-0.056,-0.0844,-0.2621,-0.196,-0.0897,-0.1929,0.1068,-0.076,-0.0265,0.0646,-0.1128,-0.0689,-0.2018,-0.0474,0.1612,0.1049,0.1889,0.1133,0.1171,-0.0719,-0.0445,0.0501,0.0765,0.1057,0.0052,0.0126,0.2027,0.1028,-0.1341,-0.2031,-0.0901,-0.1205,-0.1366,0.0403,-0.1188,0.0545,0.052,0.0436,0.0574,0.0168,-0.1653,-0.0065,-0.1336,-0.0377,-0.1418,-0.2222,-0.0266,-0.021,-0.0219,-0.0249,-0.0601,-0.2112,-0.1008,-0.1524,-0.0825,-0.0899,-0.09,0.0035,0.0293,-0.0097,-0.0696,0.0502,0.0267,0.0108,-0.0694,-0.0626,-0.1145,-0.0533,0.1023,0.0291,-0.099,0.1559,0.0039,0.0027,0.0678,0.0129,0.0303,0.0495,0.0309,0.0246,-0.0127,-0.0184,0.1532,0.2314,0.2838,-0.0445,-0.0104,0.0113,-0.0052,-0.0295,0.1005,-0.1025,0.2012,-0.1233,-0.0808,-0.0919,0.0801,0.0037,-0.0388,0.0235,0.0283,-0.0736,-0.0597,0.0886,0.0697,-0.0272,-0.075,0.0318,0.115,0.116,-0.1763,-0.1284,-0.1423,-0.0037,-0.1653,-0.0901,0.0189,0.0193,0.008,-0.0304,-0.135,-0.1381,-0.0476,0.0218,-0.0893,-0.0863,0.1912,0.0465,-0.0313,0.0982,0.2412,0.0629,0.0412,0.1531,-0.1048,0.0465,0.1749,0.1153,-0.0447,0.1793,0.0582,0.0503,0.0723,0.2065,0.0538,-0.1357,-0.0733,-0.0875,-0.0247,0.1267,-0.0367,0.0595,-0.0901,-0.0801,-0.0585,-0.0741,-0.0021,0.1267,-0.0402,-0.1265,-0.0365,-0.1501,-0.0361,-0.0213,-0.0647,-0.0463,-0.0363,-0.0739,-0.0465,-0.1816,-0.1194,0.1314,0.2341,-0.0189,-0.0694,0.0873,0.0446,-0.0608,-0.0961,-0.1371,-0.2187,0.0989,0.0725,-0.0839,-0.1011,-0.0815,-0.0103,-0.0648,-0.0537,-0.0597,-0.0687,-0.0291,-0.0729,-0.0759,-0.0433,-0.1341,-0.0589,-0.0301,-0.0056,0.1068,-0.0981,-0.037,0.1242,-0.0491,-0.1186,-0.0676,-0.077,-0.1074,-0.0808,-0.1263,-0.1359,0.0873,0.0803,0.1228,-0.0473,-0.1086,-0.0185,0.0029,0.0106,0.0685,-0.198,-0.0922,-0.1598,0.0524,0.0314,0.0804,-0.0934,-0.1697,-0.1281,-0.0459,-0.0411,-0.0073,0.0462,0.1095,-0.0071,-0.0734,-0.0661,-0.0766,-0.0908,-0.2212,-0.1105,-0.0666,0.0542,0.0058,0.082,-0.0128,0.089,0.0209,-0.0119,-0.018,0.0772,0.1667,0.0613,-0.0025,-0.0018,-0.1025,-0.0042,-0.0246,-0.0107,-0.0336,-0.0287,0.0135,0.0047,-0.0963,-0.0376,-0.0644,-0.0158,-0.0807,-0.0217,-0.0218,0.1512,-0.0767,0.0695,0.0239,0.0398,0.012,0.0138,0.0087,-0.0473,-0.1676,-0.0211,0.1343,0.0808,-0.0693,-0.0397,-0.0886,-0.0678,-0.0597,-0.0335,-0.0817,0.0346,0.0497,-0.1142,-0.1531,-0.0237,-0.0992,-0.0796,-0.0429,0.3974,0.2168,-0.1125,0.0534,-0.03,-0.0293,-0.0836,-0.0614,-0.1487,-0.1729,0.0381,0.0185,-0.0915,-0.0058,-0.0735,-0.0363,0.1344,0.009,-0.0084,0.0218,-0.0266,0.0349,-0.1244,-0.0064,0.1432,-0.0804,0.0938,-0.0788,0.0447,-0.1214,0.3758,0.0556,0.0778,-0.1022,-0.0807,0.0178,0.0662,-0.0335,0.0394,0.0058,-0.0577,0.0286,0.0938,-0.0239,0.0535,0.07,0.1128,0.153,0.1664,0.213,-0.069,0.1166,0.3286,0.5038,0.2137,0.1578,0.3676,0.2304,0.2271,0.2448,0.1342,0.2162,0.1638,0.215,0.276,0.1306,0.2243,0.3087,0.258,0.2599,0.2382,0.0908,0.2012,-0.1764,-0.1022,-0.0707,-0.2155,-0.0838,-0.2175,-0.178,-0.0985,-0.0764,-0.1116,-0.2203,-0.1891,-0.1459,-0.0514,0.0327,-0.1096,0.1258,0.0028,-0.0938,0.0138,-0.0803,-0.0884,-0.0842,-0.0398,-0.1487,0.0796,-0.1969,-0.2103,0.0488,-0.0128,-0.091,0.0325,0.0263,-0.1205,0.0617,0.1015,-0.1195,0.1963,0.2991,0.0963,0.1154,0.1373,-0.0684,0.1644,0.1668,0.0163,-0.0021,0.1206,0.003,0.0362,-0.1077,-0.0316,0.1402,-0.0247,-0.0759,0.014,0.0594,0.0201,-0.0937,emotion recognition
trm_4a3fd79d0b392,0.1062,0.0196,0.0844,0.0136,0.0313,-0.0212,0.0982,0.066,0.1072,0.0602,0.0348,-0.0012,0.092,0.0452,-0.0049,-0.0472,-0.0058,-0.001,0.0707,-0.0475,0.0125,-0.0268,-0.0091,0.0228,-0.0043,-0.0093,-0.0034,0.0315,0.0547,0.0563,0.0199,-0.0207,0.0466,0.046,0.0176,0.0073,0.0472,0.0068,0.0466,-0.0393,0.0095,0.0439,0.0387,-0.0158,-0.0296,-0.0067,-0.1036,0.082,-0.0298,-0.0,0.008,0.0827,0.05,0.0492,0.0066,0.0543,0.0498,0.0162,0.0024,-0.019,0.0136,-0.0434,-0.0495,0.0064,-0.0417,0.031,0.0124,0.0482,0.0468,0.0046,-0.0241,-0.0378,-0.0233,0.018,0.065,-0.0098,0.0725,-0.0423,0.0054,-0.0212,0.0433,-0.0145,0.0107,0.0047,0.0068,0.0054,-0.0188,0.0238,-0.0161,-0.0164,-0.0036,0.127,-0.0337,0.0567,0.0101,0.0527,0.0168,0.0765,0.0983,0.0372,-0.0271,-0.0536,0.0252,0.0705,0.0288,-0.0009,-0.007,-0.0605,0.021,0.0223,-0.0029,0.0156,-0.0463,-0.0214,-0.0091,-0.05,0.0112,0.0385,0.0196,0.0433,-0.044,0.0065,-0.0292,0.0185,0.0017,0.0026,-0.0347,-0.0003,0.0074,0.0224,0.0019,0.0359,0.0349,0.0743,-0.0751,0.0189,0.0636,0.0033,-0.0168,0.0372,0.0452,0.0685,-0.0395,-0.0085,-0.0084,-0.0421,0.084,-0.0148,-0.035,-0.0297,0.0008,-0.0284,0.0193,-0.0018,-0.0633,-0.0141,0.0141,-0.0056,-0.0651,0.0095,0.0263,-0.0471,0.01,0.0282,0.0263,-0.0595,-0.0277,0.0339,0.0278,-0.0018,-0.0434,-0.0442,-0.0154,0.0678,0.0731,0.0326,0.0591,0.0383,0.0377,0.0517,0.029,-0.0433,-0.0371,0.0174,0.1012,0.0,0.056,-0.0061,-0.016,-0.0741,-0.0836,-0.0079,0.0483,0.0886,0.0845,0.0384,0.0472,-0.0172,-0.0715,0.0726,0.1118,0.028,0.0071,-0.0176,-0.0686,-0.0094,-0.0042,-0.0122,0.0053,-0.0173,0.0368,0.0548,0.0548,0.0093,-0.0665,-0.019,-0.0521,0.07,0.1312,-0.0294,-0.0216,0.0138,-0.001,0.0071,-0.0404,0.0108,-0.0638,-0.0065,-0.0473,-0.0839,0.0298,0.0224,-0.0164,0.0013,0.0036,0.0608,-0.0195,-0.001,-0.0153,-0.0152,0.0282,0.0613,0.0081,0.042,0.046,0.0222,-0.0098,-0.0171,0.0453,-0.0231,0.0565,0.0019,-0.0061,0.0075,-0.0008,0.0448,-0.0114,0.026,-0.0469,-0.0576,-0.0238,-0.113,0.0043,-0.0597,-0.0632,-0.1094,-0.0585,-0.0076,-0.0444,-0.0248,-0.0291,0.0745,-0.0199,-0.0023,0.017,-0.0697,-0.0425,-0.073,-0.007,-0.0799,-0.0606,-0.0192,-0.0145,-0.0292,-0.0758,0.0207,-0.0237,-0.0536,0.087,0.0823,0.0029,0.0539,0.012,-0.0403,0.0677,-0.0461,-0.0055,-0.0028,-0.0281,-0.0252,0.0537,-0.018,-0.0259,-0.0005,0.0927,0.0935,0.0452,0.0412,0.0081,-0.0041,-0.0219,0.0045,-0.0437,-0.0392,-0.0665,0.0532,-0.0201,0.0555,-0.0394,-0.0176,0.0146,0.0248,-0.0437,-0.0737,0.0313,0.002,-0.0596,-0.0287,0.0784,-0.0296,-0.0461,0.0205,-0.0292,-0.007,-0.0301,-0.0212,0.0057,-0.0575,-0.0335,0.0082,0.0046,-0.0307,0.0635,0.0703,-0.0161,0.0198,0.085,0.0558,0.0728,0.0065,0.0612,0.0261,0.0355,0.0557,-0.0075,-0.0049,-0.0119,0.0295,0.0359,0.019,0.0421,-0.0259,0.0841,0.0889,0.1073,0.0698,0.0492,-0.058,-0.0703,0.1169,-0.0292,0.027,-0.0767,0.057,-0.0061,0.0274,-0.0429,0.0089,-0.0458,-0.0849,-0.0482,0.0638,-0.0096,-0.0561,-0.0029,-0.0086,-0.0092,0.0514,-0.0237,0.0014,0.0676,-0.0472,-0.0153,-0.0727,0.0774,0.1316,0.1309,0.0293,0.0368,-0.0179,-0.0253,0.0368,0.0134,-0.0121,-0.0286,-0.0583,0.0111,-0.0337,0.0417,0.0359,0.0334,0.0245,-0.0149,-0.0402,-0.0047,-0.0572,-0.0322,-0.0515,-0.0305,0.043,0.0047,0.0724,0.0681,0.0467,0.0295,0.0519,0.0443,0.1311,0.0649,0.0846,-0.0163,0.0312,0.0193,0.0163,-0.0065,-0.0097,0.0169,-0.0109,0.0597,0.0575,-0.0426,0.0091,-0.047,-0.047,0.0496,0.0977,-0.0419,0.0329,-0.0446,-0.0413,-0.0301,0.0107,-0.0138,0.0162,0.0242,0.0072,-0.0097,-0.0154,-0.0689,-0.002,-0.0369,0.0241,-0.0168,-0.1562,0.0492,-0.0392,-0.0215,-0.1045,0.0016,0.0285,0.0045,0.0039,0.0665,-0.0075,-0.0295,-0.0026,0.089,-0.0577,0.0115,0.0099,-0.0165,0.0383,0.0191,0.0244,-0.0363,-0.0481,0.0049,-0.0462,-0.0612,0.0494,-0.0303,0.0162,-0.1391,-0.0933,-0.0717,-0.0299,-0.0584,0.0256,-0.0789,-0.018,-0.0196,-0.0535,-0.0357,0.0389,0.0729,-0.0281,-0.0231,-0.007,-0.0396,0.0439,0.0456,-0.0066,0.0635,-0.0379,-0.0211,-0.0147,0.0362,0.0534,0.029,0.0248,0.0599,0.0112,-0.0528,-0.0155,0.0005,-0.0188,-0.0571,0.0297,0.0364,-0.0178,0.0225,0.0337,0.0714,0.0157,0.0212,-0.0218,-0.0255,-0.0339,-0.0209,0.0149,-0.0023,-0.0308,-0.0452,0.0176,-0.0053,0.0329,-0.023,0.0183,-0.0286,0.0038,0.079,-0.0138,-0.0441,0.0894,-0.0331,0.0052,0.0007,-0.0247,-0.0209,0.0447,-0.04,-0.0942,-0.0461,-0.008,-0.0622,-0.0218,-0.0774,-0.0862,0.0071,0.0008,-0.0291,-0.0527,0.0304,-0.0171,0.135,0.0877,0.0285,0.029,-0.0072,-0.0157,0.0326,-0.0017,-0.0103,0.0471,-0.0259,-0.0323,0.0573,-0.0566,0.0065,0.0216,0.0093,-0.0413,0.0009,-0.0516,0.0071,0.0361,0.0308,0.0051,0.0481,-0.0582,-0.0659,0.0259,0.0095,-0.0294,-0.0071,0.1827,-0.0438,0.1103,0.1169,-0.0304,0.0704,0.016,-0.0483,0.0019,0.059,-0.0036,0.0344,-0.0019,-0.0541,-0.0223,0.0223,0.0242,-0.0258,-0.0009,-0.0075,0.0114,0.054,0.0635,0.0602,-0.0145,-0.0305,0.0999,-0.0105,-0.0255,0.0077,0.0512,-0.0096,-0.0055,0.0243,0.0815,0.0445,0.0561,0.0256,0.0949,-0.0337,-0.0022,0.0146,0.0378,0.0495,-0.0058,0.0389,-0.0101,-0.0762,-0.0975,-0.0103,0.0561,0.0818,0.0536,0.0432,0.0246,0.0175,0.0687,-0.0248,0.1363,0.0869,-0.0445,0.1336,-0.0639,0.0573,0.1034,0.0285,0.0644,0.0129,-0.0335,-0.0114,0.0331,0.0437,0.0054,-0.0773,0.0267,-0.036,0.0021,-0.0651,-0.0307,-0.0185,0.015,0.081,-0.0325,-0.0217,0.0083,0.0054,-0.0821,-0.0357,-0.113,-0.0795,-0.0844,-0.0248,-0.0001,0.0336,-0.0172,-0.0499,-0.0668,0.0566,0.0143,0.0278,0.0832,0.009,-0.0396,-0.0414,-0.0334,-0.0713,-0.0618,-0.0705,0.0288,-0.1014,0.0001,0.0368,-0.0521,-0.0273,-0.013,0.0105,0.0412,-0.0847,-0.0851,-0.0379,-0.025,-0.0073,0.0089,-0.0077,0.0277,-0.0624,0.0056,0.0068,0.0093,0.0076,-0.0168,0.0255,0.0175,-0.0276,-0.0372,0.0508,-0.0246,0.0406,-0.0025,-0.0523,0.0498,-0.0487,0.0245,-0.0379,0.0287,-0.0409,0.0347,0.0579,0.0218,-0.0082,0.0016,-0.032,-0.1046,-0.0149,-0.0024,-0.0202,0.0797,0.0151,-0.0627,-0.021,-0.0234,0.0788,0.0188,0.0018,-0.04,-0.0754,-0.0368,0.0529,0.0419,0.0379,-0.018,-0.0302,0.0239,-0.0204,-0.0333,0.0389,0.0301,-0.0307,0.0061,-0.1007,-0.0804,-0.034,0.0212,-0.0095,-0.0604,0.0407,0.0341,-0.048,-0.0056,0.0185,0.0462,-0.0148,-0.0515,-0.017,0.0787,0.0901,-0.0218,-0.0839,-0.0695,-0.0023,0.0221,-0.0148,-0.0048,-0.0346,-0.0159,0.0163,0.0098,0.0119,-0.022,0.0211,-0.0392,-0.0085,-0.0181,0.0006,0.0197,-0.049,0.0539,-0.0103,0.0132,0.0061,0.0118,0.0084,0.0138,0.0021,0.0399,0.0473,-0.0517,-0.005,-0.0289,0.0032,0.0635,-0.0307,0.0504,-0.0317,-0.0439,-0.0476,-0.0852,0.0051,-0.0541,-0.0033,-0.0095,-0.0197,-0.0072,-0.0042,0.0179,-0.0069,-0.0301,0.0371,0.0855,-0.0239,-0.0045,0.0188,-0.056,-0.0051,0.0353,-0.0443,-0.0809,-0.0747,-0.0084,0.0183,0.0581,0.0045,0.0105,-0.0213,-0.0257,-0.0489,-0.007,0.0845,-0.0153,-0.0064,0.0001,0.004,0.0033,-0.0154,-0.0414,-0.003,-0.088,0.0081,0.0416,-0.0112,-0.0527,-0.0464,0.0454,-0.0446,0.0665,0.026,0.0303,-0.0185,0.0191,-0.0134,-0.0257,0.0803,0.0025,0.0076,0.0118,0.0812,0.0334,-0.0772,-0.0037,-0.0394,-0.1298,-0.0284,0.0679,0.0156,-0.0618,-0.0399,-0.0296,0.0164,0.0148,-0.0002,0.0353,0.0217,0.0429,-0.0141,0.0054,0.0344,0.03,-0.0113,-0.0023,0.0783,0.0351,0.0197,0.0214,-0.0386,0.041,0.0502,-0.0075,0.0083,0.0147,0.0159,-0.0729,-0.0074,0.0282,0.011,0.0379,0.0344,0.0212,0.0214,0.0361,0.006,0.0341,-0.0102,0.0283,0.0148,0.0411,-0.0095,0.0127,0.0309,0.0421,0.0011,-0.0089,-0.0229,-0.0334,-0.0151,-0.0279,-0.0842,0.0015,-0.0916,-0.0172,-0.0341,0.0068,0.0367,0.0283,0.0243,-0.0718,0.0079,-0.0194,0.0467,-0.0089,0.0249,-0.0273,-0.0222,0.0688,0.0189,-0.1306,-0.099,-0.1156,0.0693,-0.014,-0.0572,-0.0578,-0.0509,0.0526,0.011,0.0598,-0.0311,-0.0806,-0.0323,-0.0292,0.0095,0.0096,0.0384,0.0408,0.025,0.0174,0.0076,0.0033,0.023,-0.0157,-0.0301,0.0324,0.0588,-0.0121,0.0404,-0.0189,-0.0057,0.0125,0.039,-0.0388,-0.0291,-0.0829,-0.0714,-0.0476,0.0102,0.0254,0.0038,0.0049,0.0208,0.063,0.0503,-0.0723,0.0188,0.0243,-0.0143,-0.0484,0.0637,0.0591,0.0906,0.0955,-0.0343,-0.0314,-0.0086,-0.0283,-0.0282,0.0451,-0.0141,0.0341,0.0101,0.0387,-0.0093,-0.0028,0.0167,-0.0093,-0.0065,-0.0067,0.0857,-0.005,0.0156,-0.0198,0.0487,-0.0299,-0.0376,-0.0357,-0.0026,-0.0132,-0.0082,0.0034,-0.0309,-0.0436,-0.0415,-0.0111,0.0219,0.0053,-0.0248,-0.0347,0.0155,-0.0245,-0.0184,0.0148,0.0253,0.0467,0.0081,-0.0511,-0.0126,0.0265,0.0556,-0.0174,-0.0058,0.036,-0.0021,0.0576,0.0277,-0.034,0.0056,-0.0115,-0.0831,-0.0445,-0.0263,0.0021,-0.007,0.0163,-0.0064,-0.0923,0.0865,-0.0684,-0.0812,-0.0388,-0.0203,-0.0684,0.0252,0.0135,0.0281,-0.087,-0.0464,-0.0023,0.0217,-0.0366,0.0271,0.0659,0.0344,0.0081,0.0231,-0.0132,0.0167,0.0019,-0.0234,-0.0118,0.0251,0.0594,-0.0192,0.0008,-0.0203,-0.032,-0.036,0.0201,0.0268,-0.0055,-0.095,-0.0863,0.0917,-0.0107,0.001,0.0244,0.0432,-0.0836,0.0978,0.0012,-0.0209,-0.0075,0.0327,0.0664,0.2244,0.2007,0.1965,-0.0316,-0.0386,-0.0198,0.0093,0.0076,0.0028,-0.0447,0.0966,0.0463,0.0212,-0.0147,0.023,0.0693,0.0196,-0.001,0.0543,0.0645,-0.0238,0.1314,-0.0646,0.0253,-0.0327,-0.0879,-0.0377,-0.0097,0.0494,0.0696,0.0872,-0.0264,0.0496,0.0666,0.0004,-0.0269,0.0485,-0.0145,0.0305,0.0316,0.0139,0.0004,0.0349,0.0385,-0.0198,-0.0145,0.0543,-0.0635,0.0185,-0.0425,-0.052,-0.0095,-0.0124,-0.1503,-0.1136,-0.0282,0.0544,0.0116,0.028,0.0355,0.0103,0.0244,0.0293,-0.0622,-0.0351,0.0132,-0.0213,0.0395,0.068,-0.0198,-0.016,-0.037,0.0327,-0.0169,-0.0151,-0.0839,-0.064,-0.0721,-0.071,0.0282,0.004,-0.0399,0.0031,-0.0432,-0.005,0.0914,-0.0758,-0.018,-0.0217,-0.0082,0.0154,-0.0044,-0.0306,-0.0046,0.011,0.0258,0.1026,-0.049,-0.0419,0.0007,0.0042,-0.0425,-0.0716,0.084,0.084,0.0384,-0.0813,-0.0336,-0.052,0.0617,-0.0318,-0.0108,0.0506,0.025,0.0186,0.031,-0.0217,0.0658,0.0544,0.0509,-0.0148,0.0494,-0.0198,0.0,0.0213,0.0508,-0.0011,-0.0301,0.0121,-0.0354,0.0258,0.035,0.0456,0.0584,-0.0083,-0.0099,-0.0377,-0.0383,-0.0666,-0.0063,-0.039,0.012,0.1289,0.1041,0.1582,-0.0029,0.0998,0.0451,0.0475,0.0278,0.0307,0.0168,-0.0009,0.1004,0.0128,0.0207,-0.0362,0.1033,0.0273,0.0351,0.007,0.0918,0.0281,0.0064,-0.0224,0.0358,0.1116,-0.0172,0.0136,0.0278,-0.0679,0.0806,0.0932,0.0575,-0.0278,-0.0477,-0.0464,-0.0541,-0.0555,0.0206,-0.0288,-0.089,-0.0512,0.0003,-0.0391,0.0064,-0.0394,0.0165,-0.0377,0.0068,-0.0232,0.0505,-0.0141,0.0032,0.0139,-0.039,0.0101,-0.0089,0.004,0.0176,-0.0101,-0.0569,-0.0508,-0.0384,-0.0366,-0.042,0.0483,0.0162,0.0202,0.0049,0.0269,0.0304,-0.0622,0.0275,0.0649,0.0507,-0.1096,-0.0175,-0.005,-0.0686,-0.1307,-0.0341,-0.0099,-0.0611,0.0217,0.0353,0.0627,-0.0074,-0.0683,-0.0031,0.0164,0.0902,-0.0141,-0.0072,0.0811,0.0353,0.0223,-0.0083,0.0444,0.0284,0.0356,0.0201,-0.0133,-0.0359,-0.025,0.0539,-0.0174,0.0474,-0.0201,-0.0525,-0.0524,-0.0245,0.0265,0.0061,-0.0618,0.039,0.0278,0.0098,0.017,-0.0639,-0.0348,0.0043,-0.0055,-0.003,0.0068,0.0493,-0.0071,0.0186,0.0284,0.0096,-0.015,0.0184,0.034,-0.1017,-0.1272,0.0277,0.1573,0.1487,-0.0112,-0.0284,-0.0479,0.0516,0.0349,0.0181,-0.0333,-0.0272,0.0223,-0.0033,0.0122,0.0756,-0.0047,-0.0009,-0.0167,-0.0201,-0.0554,-0.044,0.0366,0.031,0.019,-0.158,0.0702,-0.0224,0.053,-0.0224,-0.0139,-0.0044,-0.0303,-0.1326,-0.0251,0.0258,0.0193,0.0839,0.042,0.0247,-0.0063,0.0788,0.045,0.0293,0.0287,-0.0072,-0.0089,-0.0346,0.019,-0.0423,-0.0206,0.1451,0.1214,0.0427,0.1443,0.1458,-0.0585,-0.0556,-0.0695,-0.0333,-0.0474,-0.029,0.0695,-0.0028,-0.0415,0.0507,0.1124,-0.0442,-0.0438,-0.0327,-0.0194,-0.0834,0.0132,0.0131,-0.0121,-0.0576,-0.0147,0.0282,0.0787,-0.0912,0.0529,0.0213,0.0336,-0.0211,0.0318,0.0083,-0.0538,0.0332,0.045,0.046,0.0395,0.0189,-0.0292,-0.0848,-0.0954,-0.0712,-0.0493,0.0137,0.0415,0.0499,0.0139,0.0294,-0.0601,0.0069,0.0164,0.0484,0.0077,0.0499,-0.0152,0.0349,-0.017,0.0102,0.0157,-0.0917,0.1494,-0.0165,-0.1022,0.0335,0.0013,-0.0068,-0.006,0.0398,-0.089,-0.0457,0.0202,-0.0296,-0.0639,-0.0542,-0.0881,-0.0501,-0.0648,-0.1029,-0.0945,-0.0189,0.017,-0.0324,-0.0603,-0.0088,-0.0643,0.0182,0.0192,0.0329,-0.0567,0.0204,0.0634,0.0068,-0.0525,-0.0586,-0.0061,-0.0373,-0.0475,-0.0252,0.0015,0.0068,-0.0433,0.0238,-0.0042,-0.0077,-0.0057,0.0237,0.0151,-0.1288,0.0377,-0.0793,-0.0026,0.008,0.0267,-0.0285,0.0414,-0.0058,-0.0588,0.0169,0.0225,-0.029,0.0372,0.0278,0.0202,-0.0222,0.0188,-0.0228,0.0245,-0.0381,-0.0316,0.0002,0.0561,0.041,-0.0013,0.0396,0.0506,-0.1273,0.0115,-0.0194,0.0122,0.0297,0.0614,0.0685,-0.0102,0.0319,-0.0362,0.0414,-0.0073,-0.0115,-0.1011,-0.08,-0.0281,0.0118,0.0255,0.0059,0.0016,0.0079,-0.0388,-0.0226,-0.029,-0.0089,0.0172,-0.0003,-0.0114,-0.0018,0.0258,-0.0171,0.0279,0.0196,0.0294,-0.0073,-0.0649,0.0588,0.0483,0.0167,-0.0826,-0.0639,0.0298,-0.0197,-0.0751,0.0506,0.1376,0.0297,0.017,-0.0211,-0.0709,-0.046,-0.0326,-0.0835,-0.0126,0.1207,-0.0165,0.0406,0.0336,0.0532,0.0027,0.0032,0.0604,0.0681,0.069,0.0077,-0.0443,-0.0681,0.0104,0.0408,0.0428,0.0082,0.0297,-0.0916,-0.0854,-0.0132,-0.0077,0.0287,-0.0437,-0.09,-0.0443,0.0232,-0.0241,-0.0549,0.0669,-0.0176,-0.0366,0.042,0.0379,0.0273,0.0204,0.0368,-0.0049,0.0405,-0.0629,-0.0212,-0.0934,-0.096,-0.0084,-0.0247,0.1115,0.0642,0.0261,0.0301,0.0277,-0.0561,0.0346,0.0283,-0.0022,0.013,0.0541,0.0467,-0.0573,-0.0514,0.0097,-0.0033,-0.019,-0.0046,0.0769,-0.006,-0.0383,-0.0043,0.0298,0.0461,-0.0132,0.0275,0.0569,0.0016,-0.0139,-0.081,0.0126,0.028,0.0156,0.0536,0.0181,0.062,0.0084,-0.021,-0.019,-0.0666,-0.0198,-0.0141,-0.0505,0.0082,-0.0708,-0.0525,-0.0015,0.0129,0.0708,0.0471,-0.0594,0.0061,-0.0188,-0.0487,-0.0528,0.0696,-0.0081,0.0082,0.0078,-0.0227,-0.0194,-0.0004,-0.0366,-0.0541,0.0415,-0.0009,-0.0015,0.0276,0.0534,0.0397,-0.0083,0.0222,-0.0172,0.0518,-0.0879,-0.0299,-0.0223,-0.0659,0.0096,-0.0121,0.0257,-0.0389,-0.0793,-0.0546,0.0734,0.0464,-0.0532,0.0098,0.0098,-0.0188,-0.0725,-0.0388,-0.0817,-0.073,0.0613,-0.0075,0.0296,0.0176,-0.0264,0.0132,-0.0554,0.0459,-0.0166,0.0445,0.0038,0.0338,-0.0148,-0.0202,-0.0218,0.0017,0.0213,-0.0355,0.0695,0.0378,0.1197,0.0476,-0.0089,0.025,0.0029,0.0292,0.005,-0.0832,0.0086,0.0151,0.1749,0.1176,0.1623,0.1315,0.0747,0.1199,0.0337,0.1242,0.0042,0.0699,0.1304,0.178,0.1607,0.141,-0.0237,0.0079,0.028,0.0291,-0.0398,-0.0429,0.0369,0.0231,-0.0569,0.0099,0.1264,-0.05,-0.0424,-0.0093,0.0943,-0.0089,0.0193,0.0406,0.0657,0.0139,0.074,-0.0056,-0.0645,-0.0478,-0.0577,-0.1532,-0.0551,-0.0587,-0.055,-0.0226,-0.0244,0.0335,0.0229,-0.002,0.0155,-0.0067,0.0335,0.0114,-0.0136,-0.0004,0.0095,0.0797,0.0945,-0.0638,-0.0465,-0.0448,0.0514,-0.0355,0.0251,-0.0085,0.0525,0.0166,0.0302,0.0029,-0.0565,0.053,-0.0441,0.0125,0.0886,0.035,0.0393,-0.0047,0.0379,0.0366,-0.0275,-0.0431,0.0329,0.0116,0.0219,0.0112,-0.0044,-0.038,-0.0275,0.0705,-0.0123,0.0136,-0.007,-0.0569,0.0599,0.068,-0.0059,0.0321,0.0265,-0.0314,-0.0006,-0.0337,0.0203,-0.01,0.0699,-0.0883,-0.0252,0.1197,0.0279,-0.0001,0.0027,-0.0362,-0.0325,-0.0555,0.0767,-0.0932,-0.0842,0.046,-0.0125,-0.0595,0.0205,-0.0043,-0.0343,-0.0706,0.0483,-0.0152,-0.0179,0.0123,0.0224,-0.1792,-0.1024,-0.1407,-0.0473,-0.1252,-0.0727,-0.0755,-0.0794,-0.0226,0.001,0.0093,0.0312,-0.0148,0.0576,-0.051,0.0263,0.0298,-0.0261,-0.0775,0.0364,0.0269,-0.0381,0.003,-0.0312,0.0341,-0.1159,-0.0014,-0.0609,0.0528,0.0891,0.1308,-0.0238,-0.0125,-0.0167,-0.0019,0.0339,-0.0772,0.0971,0.0395,0.062,0.0637,0.0578,-0.0034,-0.042,-0.0617,0.0076,-0.1242,-0.0025,-0.0801,0.0034,-0.0023,-0.0258,-0.0255,0.1102,-0.0795,-0.0328,-0.0411,0.0002,0.0193,0.1401,0.0672,0.0712,0.0087,0.0066,0.1353,0.1502,0.1199,-0.0105,-0.0577,-0.0713,0.084,-0.0061,-0.0522,-0.04,-0.0013,-0.0285,0.0136,0.0212,0.0539,0.0255,0.0259,0.0381,0.0132,0.0374,-0.037,-0.0641,-0.0522,-0.035,-0.0652,-0.0893,-0.038,-0.0039,-0.0085,0.0738,-0.0755,-0.0478,-0.0266,-0.0021,-0.069,-0.1373,0.0056,0.0082,0.1148,0.0891,-0.0101,-0.0062,-0.0616,-0.0249,0.0484,-0.0177,0.0239,-0.0212,0.0013,-0.004,-0.0226,-0.0445,-0.0403,-0.0008,0.0127,0.0329,-0.0065,-0.0048,0.0312,0.0293,0.0252,0.0202,0.0416,-0.0193,0.0022,0.0156,-0.0284,0.037,-0.0082,-0.0156,-0.0504,-0.0122,-0.1134,0.0628,0.0034,0.0142,0.0148,0.0315,0.008,0.0401,0.0392,-0.0306,-0.0325,0.0105,0.0378,0.0189,-0.0526,-0.0079,0.034,0.0661,-0.0196,-0.0052,0.0746,0.0005,0.0565,0.0557,0.0407,-0.0031,-0.0174,0.0096,0.0381,-0.0452,0.0507,0.0544,0.0063,0.0106,-0.0046,-0.027,0.075,0.0471,-0.0056,-0.0162,-0.0156,0.0036,-0.0273,0.014,-0.0135,0.0406,0.0196,-0.0277,0.0004,-0.039,0.0741,0.014,-0.0166,-0.0694,-0.0325,0.0214,-0.0181,0.0195,0.0362,-0.0003,0.0028,-0.0119,-0.0001,0.0224,-0.0255,-0.0188,0.0121,0.0235,0.0139,0.0354,0.0207,-0.0028,0.0384,0.0384,-0.0151,0.0305,0.013,0.0339,-0.011,0.1042,0.0842,-0.0731,-0.0354,-0.0374,-0.0159,0.0841,-0.0081,-0.0069,-0.0679,-0.042,-0.0061,-0.0119,-0.0104,0.0225,-0.0532,-0.0457,-0.0701,0.0596,0.1015,0.1025,0.0189,-0.0077,0.0318,0.1611,0.1139,0.0204,-0.1905,-0.0692,0.0043,-0.0005,-0.0267,-0.0148,0.0099,-0.0327,0.0451,-0.011,0.0355,-0.0873,-0.0317,-0.0036,-0.0076,-0.0083,-0.0668,-0.0111,0.0185,0.0002,0.0443,-0.0261,0.1687,0.1593,0.1037,0.0403,-0.0202,0.0306,-0.0588,-0.0366,-0.1138,-0.0351,-0.0253,0.0891,0.0751,-0.0076,-0.0498,-0.0134,0.0667,-0.064,0.0113,0.0231,-0.0612,0.1449,-0.0297,0.1619,0.1352,0.0839,-0.0038,0.1005,-0.059,-0.0087,-0.0199,-0.0416,0.0073,0.0137,-0.0044,0.0053,-0.0361,-0.0156,0.0269,-0.0212,-0.0488,-0.0261,0.0568,0.002,-0.0959,-0.0645,-0.0521,-0.0413,0.011,0.0666,0.0619,0.0039,0.0096,0.1119,0.0198,-0.0021,0.0291,0.0669,0.0864,0.036,0.0477,0.0251,0.025,0.0717,0.0229,-0.0099,-0.0512,-0.0102,0.0053,-0.008,0.0017,0.0188,-0.0003,0.0268,-0.0313,-0.0013,-0.0487,0.0409,0.059,-0.0123,0.001,0.0094,-0.0068,-0.0338,0.0144,0.0301,-0.0025,-0.0364,0.0172,0.0468,0.06,-0.0169,-0.0247,-0.0402,0.1338,-0.061,-0.0106,0.0561,0.0618,-0.0436,0.0044,-0.0164,-0.0083,0.0357,0.0035,-0.0611,0.0257,0.007,-0.0075,-0.0181,-0.011,-0.0554,0.068,0.0386,0.0369,0.0358,0.0511,0.0352,-0.0184,-0.0146,0.0273,0.015,0.0259,-0.0038,0.0182,-0.0014,-0.0634,-0.0327,-0.034,-0.0929,0.0209,-0.1121,-0.0845,0.0022,-0.0791,0.0029,0.0086,-0.006,-0.0336,0.0124,0.0019,-0.0795,-0.0488,-0.0501,-0.0541,-0.0373,-0.0401,-0.0461,-0.0929,-0.0197,0.0206,0.0593,-0.008,-0.0201,-0.0329,-0.007,0.0141,0.047,0.001,0.0321,-0.0537,-0.0185,0.0268,0.027,-0.0181,-0.0484,-0.0321,-0.0556,-0.0597,0.0016,-0.0078,0.0537,0.0423,-0.0075,-0.0543,0.0578,0.0561,0.0537,0.045,0.0502,0.0458,0.1058,-0.0532,0.0041,-0.0386,0.0065,-0.0223,-0.0772,0.0153,0.0071,-0.023,-0.0617,-0.0999,-0.0766,0.0449,0.022,0.0507,-0.0089,-0.0148,0.0032,-0.0528,-0.0164,-0.0041,-0.053,0.0449,-0.0112,-0.0507,-0.0382,-0.0053,0.097,-0.0303,0.0294,-0.0228,0.0269,0.003,0.0644,-0.0283,-0.0337,0.0378,0.0611,0.0106,0.0136,0.0021,0.0419,-0.0015,-0.0346,-0.0424,-0.0732,-0.0457,-0.0448,-0.0735,-0.0491,-0.0271,0.0341,-0.0139,0.0171,0.0109,0.0341,0.0617,-0.0204,-0.005,-0.0866,-0.0007,-0.0276,0.0012,-0.0084,-0.0438,-0.0346,-0.0143,0.0161,-0.0216,-0.0589,-0.0277,0.065,-0.0159,0.0052,0.05,-0.0467,-0.0651,0.0044,-0.0123,-0.0614,0.0244,0.0434,-0.0323,-0.0535,0.0206,-0.0525,0.0507,-0.0355,0.0156,-0.0681,-0.0454,-0.0743,-0.0497,0.0016,0.04,0.0376,-0.0444,0.0179,-0.0012,0.0019,-0.009,0.0322,-0.0251,0.0827,0.0171,-0.0021,-0.0363,-0.0491,-0.0276,0.083,0.0113,-0.0257,-0.0531,0.0613,0.0291,-0.0863,-0.0696,-0.0219,-0.0652,-0.0363,0.0245,0.0213,0.1209,-0.0141,0.0103,0.0065,-0.0743,-0.0578,-0.0144,-0.0178,0.0754,0.0755,-0.0071,-0.007,-0.0265,-0.066,0.0378,-0.0234,-0.022,0.049,0.0334,-0.066,-0.0532,-0.0691,-0.0069,0.1319,0.0222,0.0538,-0.084,0.0091,0.0575,0.0356,-0.0179,0.0004,0.1709,0.1568,0.015,0.0283,0.0209,0.0273,0.0741,0.0004,-0.0244,-0.0901,-0.025,-0.0379,-0.1213,-0.0608,-0.0513,-0.0857,0.0495,-0.0244,0.056,-0.0075,-0.0363,0.0064,0.0232,-0.0062,0.0223,0.0793,0.066,-0.0261,-0.1021,0.0019,0.1491,0.1563,0.0205,-0.0103,-0.0763,0.0748,-0.0472,-0.0442,-0.0392,0.0097,-0.012,-0.0723,0.0071,-0.0211,0.1496,0.059,0.1892,0.0204,-0.0242,0.0603,0.0157,0.0683,-0.0167,0.0279,0.0397,-0.1252,-0.0483,-0.0234,0.0649,0.0017,-0.0157,0.0206,0.0418,-0.0118,0.0278,-0.0933,-0.013,-0.045,0.0031,-0.026,0.041,0.0353,-0.085,0.0166,-0.1408,-0.0733,0.0108,0.0273,0.0133,-0.0327,-0.0067,0.0275,0.0832,0.1092,-0.0797,0.0248,0.0041,0.0096,0.0411,-0.036,-0.0085,-0.0478,0.0045,-0.0094,0.0451,0.1064,0.0307,-0.0336,0.0176,-0.0356,0.0425,0.0304,-0.0802,0.0013,0.0351,-0.0185,0.0404,-0.0309,-0.0312,-0.0586,0.0549,0.0077,-0.0726,-0.0254,0.0339,-0.0665,0.0136,0.0659,0.0914,0.0252,0.0146,0.0145,0.0169,0.1607,-0.0004,0.0223,-0.0049,0.0103,-0.0492,-0.0235,-0.043,-0.0568,-0.042,-0.008,0.006,-0.0742,0.1566,0.1529,0.126,-0.0081,-0.0544,-0.0528,-0.0506,-0.0831,-0.1054,-0.008,0.0342,-0.1201,-0.0814,-0.1324,0.0154,-0.0777,0.0524,-0.0249,0.0347,0.0056,-0.0392,-0.0423,-0.042,-0.0113,-0.058,0.0215,-0.0344,-0.0678,-0.0135,-0.0258,0.0062,0.0248,-0.0039,0.0992,-0.0501,0.0436,0.0124,0.0549,-0.0207,-0.0005,-0.0281,-0.0746,-0.0591,-0.0297,-0.0011,0.0332,-0.0313,-0.046,-0.0444,-0.0206,0.0266,0.0336,0.0001,-0.0315,-0.0192,0.0252,0.0911,0.0113,-0.0259,-0.0083,-0.0452,-0.087,-0.0319,-0.0217,-0.0148,0.0399,-0.1163,-0.0828,0.0084,-0.0286,-0.0582,-0.0371,0.0163,0.0725,0.0482,0.036,0.0159,-0.0645,0.091,-0.0264,-0.0093,-0.018,0.0042,0.0164,0.0588,-0.0037,0.0361,-0.0111,-0.0031,0.0978,0.0181,-0.0298,0.0474,0.0079,0.0062,0.0978,0.0481,0.0801,0.0351,-0.0012,0.0527,0.011,0.0128,-0.0269,0.0139,0.0172,-0.0303,-0.0095,0.0088,0.0293,0.0257,0.0731,-0.0284,0.0135,0.0522,-0.0333,-0.0159,-0.0289,-0.0252,0.0215,-0.0004,-0.0626,-0.0439,0.0113,-0.0294,0.0019,-0.0362,-0.1247,-0.0802,-0.0121,-0.019,0.0174,-0.0662,0.0206,0.0492,0.0319,-0.0683,-0.0457,0.1265,0.1419,-0.0059,-0.0321,0.0211,0.0065,0.0152,0.0442,0.0223,-0.0355,-0.0675,0.0098,-0.0099,-0.0005,-0.0394,-0.0317,0.0707,0.0372,-0.0016,-0.0167,0.0964,0.0101,-0.0274,-0.009,0.0263,0.0134,0.0466,0.0465,0.1348,-0.0108,-0.0166,0.1857,-0.0643,-0.0625,0.0109,-0.0598,-0.0201,0.0417,0.046,-0.0353,0.0786,-0.0576,-0.0507,-0.0505,0.0015,-0.0796,-0.046,-0.0028,0.0131,0.0287,-0.003,0.118,0.0083,0.0367,-0.0333,-0.0485,-0.0363,-0.0682,0.0012,-0.0163,0.0394,0.0163,-0.0156,-0.0109,-0.0278,0.0322,-0.0727,-0.0156,-0.0252,-0.0805,-0.0861,-0.0898,-0.0971,0.0649,-0.0248,0.0852,0.059,-0.0339,-0.0535,-0.0006,0.0758,-0.0477,0.032,0.0157,0.0298,0.0216,0.0775,-0.0106,-0.0318,-0.0602,-0.0748,0.0286,-0.013,-0.0597,-0.0113,0.0683,-0.0161,-0.0115,-0.0459,0.0229,0.0221,0.128,0.0222,0.0316,-0.0303,-0.0175,0.0133,0.0649,-0.0082,0.072,-0.0167,0.0416,-0.0765,0.0311,0.0727,-0.0081,-0.0005,-0.0294,0.0195,0.037,0.0357,0.0427,0.0881,-0.1007,-0.0599,-0.0334,0.141,0.0258,0.0884,-0.023,-0.0044,0.0254,0.0877,0.0197,0.0735,0.0414,0.0514,0.0133,0.0213,-0.0908,-0.0345,0.0224,0.0219,0.0254,-0.0221,0.067,0.0332,-0.0003,-0.1008,-0.0425,-0.0714,-0.0371,0.0127,-0.0314,0.0417,0.0492,-0.0484,-0.0761,-0.0112,0.0183,0.025,0.0456,-0.0043,-0.0278,-0.0334,0.0379,0.0284,-0.0169,0.0118,0.0161,-0.0289,0.0074,-0.0199,0.0264,0.0118,-0.0337,-0.0205,0.0404,-0.0342,0.0111,0.0035,0.0035,0.0454,-0.0448,0.02,0.0981,-0.0325,-0.0433,-0.065,0.0498,-0.0454,0.0727,-0.0547,-0.0279,0.0905,0.0134,0.0369,0.0183,-0.0468,0.0315,0.0513,0.0507,0.0572,0.0158,-0.1337,-0.0195,0.0534,-0.0769,0.0102,-0.0202,0.0428,-0.0175,0.0234,0.0235,0.0452,-0.0601,0.0194,0.0222,-0.0306,-0.0169,-0.0745,0.0123,-0.0051,-0.0833,0.0329,-0.0419,0.021,-0.0069,-0.0176,0.0059,-0.01,-0.0029,0.1332,-0.0125,-0.1049,0.0112,-0.0332,0.0072,0.008,0.0536,0.0435,0.0581,0.0622,0.0402,0.0471,-0.044,-0.0512,0.0357,-0.0448,-0.044,-0.0477,-0.0662,-0.0098,-0.0271,0.0132,-0.1587,-0.1801,-0.1176,-0.1106,-0.0862,-0.0993,-0.0716,-0.1037,-0.0705,0.0354,-0.0302,-0.0212,-0.0663,-0.0943,-0.0683,-0.0291,-0.07,-0.0005,-0.047,-0.0614,0.0091,-0.0743,0.0488,0.0274,-0.0046,0.1112,-0.0542,0.0198,0.0264,-0.0034,0.0167,0.0937,0.0313,0.0218,0.0143,0.0549,-0.064,0.0078,-0.0255,-0.0282,0.0242,-0.0043,0.0288,0.0521,0.0237,0.0361,0.0748,-0.0365,0.0731,0.0884,0.0307,0.0279,0.0523,-0.0385,-0.0306,-0.0159,0.053,-0.0415,0.0582,-0.0282,-0.0636,-0.1075,-0.0342,0.006,-0.0086,-0.0128,-0.012,-0.1078,-0.0439,-0.0139,-0.0389,-0.0583,0.0332,0.0219,-0.024,0.036,0.0353,-0.0033,-0.0395,-0.0535,0.0923,theory of mind
trm_55ce70b20186b,-0.0498,-0.0849,-0.0783,-0.1415,0.0097,-0.0469,-0.0629,-0.0309,-0.0241,-0.0762,0.0016,0.0133,-0.0883,-0.0881,-0.1274,-0.0557,-0.0729,-0.1766,-0.0669,-0.0864,-0.0677,0.0197,-0.0166,-0.0069,0.0018,0.0367,0.0324,-0.1383,-0.148,-0.0438,-0.1174,-0.144,-0.1339,-0.0443,-0.1789,-0.1284,0.0112,-0.0677,-0.146,-0.0424,-0.1088,-0.116,-0.0483,0.0615,-0.1135,-0.1339,0.225,-0.0524,0.0722,-0.0882,-0.0437,0.0873,0.0608,0.0231,-0.078,-0.0755,-0.0898,-0.044,0.0315,-0.0226,0.0325,0.0663,-0.1896,0.1031,-0.0137,0.149,-0.2424,-0.2818,-0.1439,0.0061,0.057,0.0534,0.1349,-0.092,-0.1364,0.0216,-0.1141,0.0586,0.0107,-0.0033,0.0023,0.0932,-0.1097,-0.1617,0.0447,0.1028,-0.01,0.0363,-0.0275,-0.1073,-0.0799,0.0198,-0.0371,0.2524,0.2435,0.2281,0.1761,0.0589,0.3233,0.1755,0.0993,-0.0014,0.1335,0.1623,0.141,-0.1527,-0.2243,0.1617,-0.0134,-0.0394,-0.0105,-0.1332,0.0915,0.2141,0.0327,-0.0121,-0.1068,0.1088,-0.057,-0.0679,-0.139,-0.2015,-0.1799,-0.0379,-0.1269,-0.1798,-0.1436,0.0811,0.0989,0.0788,-0.1214,-0.0742,-0.0165,-0.2606,-0.0357,-0.249,0.0097,-0.1504,-0.0683,-0.0051,-0.1178,-0.12,0.0033,-0.0421,-0.0743,0.084,-0.0185,0.0275,-0.1078,0.057,-0.0957,-0.1277,-0.1786,-0.1914,0.1563,0.0445,0.081,0.0329,0.0338,-0.0576,-0.0741,-0.0987,-0.2552,-0.1999,-0.0182,-0.0158,-0.0228,-0.2402,-0.2308,-0.0218,-0.0043,-0.157,0.1219,-0.2575,-0.1461,-0.2162,-0.1423,-0.1607,-0.1112,-0.0123,-0.1811,0.083,-0.0679,0.0127,-0.0354,-0.0545,-0.0616,-0.1155,-0.0988,-0.1098,-0.1045,-0.0366,-0.007,-0.1893,-0.1778,-0.2419,-0.2261,-0.0642,-0.0661,-0.0577,0.0251,0.329,-0.2369,-0.1594,-0.0285,-0.0461,-0.2082,-0.0439,-0.0546,-0.0098,-0.2123,-0.0857,-0.0195,0.0326,0.0374,0.0034,0.1201,-0.1414,-0.0347,0.0345,0.1353,-0.1318,-0.1715,-0.0759,0.0999,0.0301,-0.1054,0.1475,-0.0318,0.1237,0.0341,-0.1573,0.224,-0.1191,-0.1058,0.1232,-0.0542,0.0076,0.0491,-0.0891,0.0461,-0.2039,-0.0644,0.018,-0.0817,-0.1264,-0.1173,-0.1659,-0.054,-0.1703,0.0339,0.0251,-0.043,0.0364,0.0544,-0.2189,0.0083,-0.0965,0.1396,0.2747,0.1006,0.3257,-0.1138,0.1285,0.225,0.3398,0.1147,-0.0387,0.0269,-0.057,-0.0611,0.0081,-0.1577,-0.0028,-0.0069,0.1126,0.0069,-0.075,-0.0327,0.0778,0.1133,-0.0849,-0.0635,-0.3009,-0.2492,-0.0864,0.043,0.0575,-0.0771,-0.1222,-0.1125,-0.0852,-0.0079,-0.0808,-0.0706,0.0469,-0.0394,0.0782,-0.0569,0.1511,0.0905,-0.2201,-0.1038,-0.0921,0.0575,0.0807,-0.1125,-0.0063,0.0463,-0.043,-0.0115,-0.0088,-0.1368,0.0359,0.0573,-0.0485,0.1171,0.036,0.049,-0.1677,-0.0201,0.0197,-0.1683,-0.2116,-0.0904,-0.0841,-0.0314,-0.0733,-0.0697,-0.0948,0.0359,-0.075,-0.0125,-0.0071,0.0051,0.2076,0.0122,-0.0377,-0.024,-0.1942,-0.163,0.0464,0.1053,0.047,0.0931,0.0619,-0.206,-0.1546,-0.1208,-0.097,-0.0594,0.1415,0.0033,0.0154,-0.047,-0.0101,-0.0564,-0.1613,-0.0897,-0.1339,-0.0056,-0.0351,-0.0138,0.0095,0.0183,0.1204,-0.1134,0.1994,0.0253,-0.1415,-0.0166,0.0853,-0.0074,0.1626,-0.1772,-0.0422,-0.1169,0.097,0.1145,0.1516,0.1708,0.1156,-0.1019,0.0307,0.0045,0.0505,-0.1221,-0.0315,0.0205,-0.039,0.0147,-0.0419,0.0368,-0.0665,0.2162,0.1833,0.023,-0.1467,-0.0718,-0.0867,-0.0971,0.031,0.0217,-0.005,0.1042,0.0477,0.0559,0.0197,-0.1044,-0.0147,0.0333,-0.2104,-0.0507,0.1963,-0.1568,-0.0671,0.1784,-0.0702,-0.1491,-0.0731,0.0413,-0.2147,-0.1242,-0.3655,-0.3418,-0.1034,-0.1562,-0.0119,-0.1541,-0.0764,-0.0508,0.067,-0.0323,-0.013,-0.0387,0.0732,0.034,0.0398,-0.2571,-0.1598,0.0676,0.0643,0.0521,0.0234,0.013,-0.0793,0.0489,0.1839,-0.2065,-0.1298,-0.0216,0.0906,-0.1215,-0.086,0.0392,-0.2151,0.0201,-0.0938,-0.0798,0.0031,0.0642,-0.0502,-0.0851,0.0209,-0.1341,-0.1293,0.0112,0.3465,-0.1076,-0.0175,0.047,0.0877,0.1108,-0.061,-0.1102,-0.0626,0.0636,0.0828,-0.0428,-0.034,0.1577,0.0662,0.0197,0.0618,0.0691,0.114,-0.0134,0.0105,-0.1317,-0.0399,0.1188,0.1509,-0.1454,-0.1953,0.1217,0.0342,-0.1627,-0.0062,0.034,-0.1521,-0.1352,0.0007,-0.0463,-0.1316,-0.1021,-0.1553,-0.0503,-0.0576,-0.0622,0.166,-0.1732,0.0729,-0.0827,-0.0003,0.1419,0.0622,-0.1085,-0.0684,0.2171,-0.0738,-0.0793,-0.0178,0.0795,0.0987,0.1549,0.0273,0.1731,0.1932,0.0882,0.0563,-0.1156,-0.0335,-0.0594,-0.278,-0.1077,0.0154,-0.1831,-0.1121,-0.0501,-0.1518,-0.0602,0.031,0.0434,-0.0072,-0.1098,-0.0138,-0.0288,0.0144,0.0215,-0.0248,0.1226,-0.0758,-0.0733,0.0517,-0.0141,-0.1614,0.1396,0.0283,0.0704,-0.0211,-0.101,-0.0226,-0.1616,0.0909,-0.1056,0.0717,0.1135,-0.1255,-0.0088,-0.1007,-0.1116,-0.0721,-0.0659,0.0456,0.1755,0.1383,0.073,0.052,0.1076,0.0587,0.0109,-0.0958,-0.0389,-0.0433,0.1435,0.0272,0.0727,0.0198,0.0929,-0.0639,-0.1128,0.0005,0.0884,0.0664,-0.0014,0.0091,-0.2377,-0.0681,0.1897,-0.0533,0.0194,0.0804,0.0707,0.0748,0.086,0.1753,-0.0614,-0.145,-0.1415,0.0384,-0.1564,-0.044,0.0301,-0.1034,-0.2707,-0.0781,-0.0789,0.0008,0.0143,-0.2613,-0.0646,-0.2035,0.0886,0.0089,-0.0229,0.0891,-0.1052,-0.1738,-0.0621,0.0377,0.0963,0.1385,-0.1293,-0.0366,-0.0398,0.0882,0.0443,-0.0122,-0.0838,-0.033,-0.0676,0.1201,0.0355,0.0565,-0.1326,-0.022,-0.3209,-0.2098,0.1478,-0.2433,-0.0487,-0.2105,0.2411,-0.1457,-0.0871,-0.0392,0.1637,-0.0531,-0.0479,-0.1158,-0.2266,0.159,0.2287,0.0424,0.1234,0.134,-0.0094,-0.1436,0.0636,0.0051,-0.0557,-0.0977,-0.0624,-0.0015,-0.0625,-0.1318,0.2526,-0.0993,0.0354,-0.0534,0.0306,0.0807,0.0724,0.0712,0.2327,-0.1981,-0.0978,0.0248,0.025,0.039,0.126,0.1673,0.1746,0.1249,0.1924,-0.1298,0.0389,-0.0609,-0.0813,-0.0384,0.0207,-0.0154,-0.0322,-0.1382,-0.1072,-0.0708,-0.1534,-0.1193,-0.078,0.0256,0.107,-0.0614,-0.0987,0.0218,-0.0907,-0.0526,-0.011,0.0324,-0.1354,0.0382,0.1212,-0.0605,-0.3694,-0.352,-0.2788,-0.0275,-0.0371,-0.1196,-0.0169,-0.0227,0.0522,-0.0414,-0.0022,0.1258,0.1054,0.025,-0.0509,0.0747,0.1112,0.1899,-0.214,-0.0429,-0.0812,-0.0217,-0.0302,-0.1108,0.0801,0.0732,-0.0403,-0.0076,-0.0212,0.1064,-0.2411,-0.3368,-0.2874,-0.2103,0.0764,0.1973,0.0072,-0.0875,-0.0545,0.1276,0.0841,0.0944,0.0755,0.0363,-0.1366,-0.1026,0.0025,0.1179,0.1389,0.1897,0.0069,0.0038,0.0562,-0.0755,0.0763,-0.0763,-0.127,-0.0678,-0.2007,-0.1695,-0.1258,0.0827,0.0584,0.0088,-0.0371,-0.0288,0.0176,0.1185,0.0421,-0.1613,0.0598,-0.0024,0.0475,0.0535,0.0881,-0.1314,0.1123,-0.1892,-0.188,0.1152,0.0968,0.2027,-0.0338,-0.0223,0.0569,0.0128,0.0276,0.3041,0.0748,0.1102,0.1106,0.1497,0.0823,0.011,0.2584,0.2188,-0.0853,-0.0044,0.0219,-0.2353,-0.206,-0.0233,-0.1214,-0.0211,-0.321,-0.0934,-0.204,-0.1154,-0.2427,0.047,0.0028,0.0694,-0.0731,0.0021,-0.0341,0.0968,0.1285,0.002,0.0573,0.1555,0.0493,0.0425,0.06,-0.0255,0.1428,0.1793,-0.1208,0.1809,0.0568,0.0034,-0.0677,-0.1326,-0.0916,0.0789,-0.0454,-0.3563,-0.2363,-0.0524,0.0882,0.1233,-0.0093,-0.0163,0.0403,0.1133,-0.0606,-0.1134,0.1558,-0.103,0.0338,-0.2302,0.2284,-0.0831,0.1497,0.0141,-0.0566,0.0309,-0.3095,-0.2931,-0.1071,0.2821,-0.094,-0.1148,-0.1043,0.1092,0.0198,-0.1722,-0.0769,-0.1507,0.049,-0.0478,0.0338,0.0735,-0.0156,0.1549,-0.2196,-0.1261,-0.0577,0.0641,-0.1432,0.0647,0.1348,0.0962,0.1158,0.3392,0.1503,-0.1241,-0.0851,-0.151,-0.113,-0.0893,-0.081,0.0312,0.1463,0.0979,0.0073,-0.1011,0.1007,0.2101,0.1094,0.0319,-0.0497,-0.0578,-0.0378,-0.0384,-0.035,0.0993,0.0149,-0.1239,0.0015,0.1309,0.0367,-0.0831,-0.0315,0.0667,-0.0652,-0.0376,-0.0604,-0.1287,-0.1258,-0.3116,-0.218,-0.3212,-0.0335,-0.0404,-0.1033,-0.1672,-0.1325,-0.2086,-0.1525,-0.2617,-0.1149,-0.112,0.0085,0.0575,0.1211,-0.0516,0.0458,0.0215,0.0473,0.1245,0.0505,0.1089,0.0497,-0.0658,0.0253,0.0373,-0.0392,0.0705,0.0902,0.1347,-0.0023,0.0444,-0.0349,0.1159,-0.0452,-0.0544,0.014,0.0986,-0.0224,0.0997,-0.1972,-0.1287,-0.1173,-0.1954,-0.1515,0.0792,0.1166,0.0794,0.0644,0.1385,0.1275,0.0254,0.0159,0.0026,0.0037,0.0573,0.0143,-0.0035,-0.0572,-0.0879,-0.065,0.0839,0.0595,-0.1104,-0.0997,-0.1252,-0.2553,-0.1675,0.1952,0.1445,0.1652,0.0811,0.0405,-0.1212,-0.0599,0.0549,-0.032,-0.0398,-0.0255,0.0042,-0.0441,0.0588,0.0045,0.0376,-0.1374,-0.0044,-0.1255,0.0297,-0.1331,0.0765,0.2086,0.3154,0.0025,0.0044,-0.0217,-0.0132,-0.0312,-0.0627,-0.0835,-0.118,0.0423,-0.0034,0.1187,-0.0303,-0.0198,0.0185,0.009,-0.0625,0.0478,-0.1413,-0.1845,-0.2124,-0.139,0.2067,0.0276,0.1188,-0.1822,0.2565,0.1198,-0.0225,-0.0459,-0.0168,0.0016,-0.0506,0.1453,-0.1208,-0.1695,-0.0594,-0.0342,-0.189,-0.0698,-0.0994,-0.0054,-0.0656,-0.0651,-0.0665,-0.0474,0.0152,0.0678,0.0247,0.0379,0.0431,-0.084,0.0259,-0.1103,0.0737,-0.0214,-0.077,0.4386,0.3418,0.4017,0.2649,0.2892,0.1222,0.3815,0.206,-0.1797,0.1491,0.1608,0.0998,0.0994,0.0742,-0.0681,0.0251,-0.0622,-0.0574,0.015,-0.0121,0.0728,0.028,-0.1281,0.0954,0.1042,-0.0023,0.1089,-0.0582,-0.1455,0.0704,-0.0055,-0.1219,-0.0195,-0.0564,0.0991,0.0703,0.2248,-0.0541,-0.2061,-0.1594,-0.1026,-0.0398,0.114,0.1025,0.0518,-0.0772,-0.2402,-0.1813,-0.085,0.1669,-0.0469,0.3453,0.3017,-0.1057,0.0508,0.0608,0.2538,0.2573,0.2123,0.2404,0.1292,-0.0024,0.0818,0.0558,-0.0436,-0.1845,0.0589,-0.0947,0.1508,0.016,-0.0777,0.0099,-0.1416,-0.0693,0.0023,-0.0639,-0.0983,0.1444,0.1329,-0.0635,-0.0161,-0.072,0.1208,0.1124,0.0626,-0.1834,-0.188,-0.1089,-0.1017,0.0227,-0.0939,-0.0622,-0.0756,-0.07,0.1121,0.0481,0.1146,0.3061,-0.014,-0.0384,-0.1089,0.0864,0.0306,0.173,-0.1417,0.1678,0.3254,0.0417,-0.1895,0.2296,0.2068,-0.1185,-0.1975,0.0564,-0.2287,-0.0888,-0.2941,-0.0597,0.1896,-0.0572,-0.073,0.0834,-0.0635,0.0087,-0.0779,-0.0453,-0.0534,-0.1076,-0.0152,0.1023,-0.0024,0.258,0.1554,0.23,0.2237,-0.1643,-0.007,-0.1118,-0.1459,-0.1284,-0.0366,0.0784,0.1968,-0.1872,-0.1219,0.0963,0.1099,-0.0503,0.0832,0.0666,0.0318,-0.0048,0.167,-0.1302,-0.1381,-0.0594,0.1564,0.0358,-0.0311,0.0081,0.0081,-0.2053,0.0514,0.0142,0.0343,-0.0062,0.0293,-0.047,0.3517,-0.3169,-0.304,0.0391,-0.0716,-0.2201,-0.232,-0.1821,-0.0028,-0.0274,-0.1111,-0.0066,-0.0156,0.2572,0.0035,0.0608,-0.0555,0.0698,0.0175,0.0443,0.0555,-0.0249,-0.1107,-0.0546,-0.1094,-0.0777,-0.0764,0.0349,0.0926,-0.0066,0.2548,0.1696,0.2355,0.0231,0.2717,-0.1663,-0.0764,-0.0027,-0.1808,0.0346,-0.2125,-0.2563,-0.0373,-0.1258,-0.2409,0.0706,-0.0313,-0.2182,-0.0041,0.0057,0.0289,-0.1641,-0.0177,-0.0805,-0.1142,-0.0562,0.0726,-0.065,0.2639,0.1895,0.1992,0.1665,0.0333,0.1317,-0.061,-0.0963,-0.0933,-0.019,-0.1169,-0.0267,-0.1225,-0.007,0.069,0.0441,-0.0231,-0.1526,-0.1482,-0.0007,0.0355,0.0492,-0.0235,-0.0568,0.0854,-0.0641,-0.1299,-0.1489,-0.2369,-0.1437,-0.037,-0.1725,-0.1895,0.0095,0.0145,0.087,0.0884,0.0142,-0.1241,-0.1122,0.0891,-0.1739,-0.0043,0.0273,0.0302,-0.0127,-0.1985,-0.0211,0.1816,-0.0225,0.0024,0.012,-0.0589,0.1353,0.0425,0.0607,0.0505,-0.2461,0.1135,-0.0024,0.1308,0.2254,0.0954,0.0309,-0.061,0.021,0.2214,-0.0729,0.0528,-0.1345,-0.0682,-0.189,-0.1396,-0.0629,0.1221,-0.0278,-0.0669,-0.1847,-0.0235,-0.0601,-0.0119,-0.0749,-0.1454,-0.0098,-0.009,-0.0463,0.067,-0.0615,-0.0424,-0.061,-0.1222,-0.0899,-0.0788,-0.1045,-0.0384,0.035,-0.02,0.1202,-0.0683,-0.0445,-0.043,0.0586,0.0521,-0.1053,-0.2309,0.0866,0.0225,0.1714,-0.0132,0.0281,0.0247,0.0628,0.0768,-0.083,-0.088,-0.1408,-0.0108,-0.2897,0.0259,-0.0758,-0.0221,-0.0171,-0.0415,-0.0677,-0.1533,-0.1639,0.1448,0.0571,-0.0185,0.2256,0.1203,0.0154,0.0929,0.131,-0.0184,-0.046,0.0206,0.2369,0.0053,0.0246,-0.0299,-0.0667,-0.0599,-0.0787,0.0125,0.0688,0.0191,0.195,0.2001,-0.053,-0.0865,-0.0344,0.0652,0.1129,0.0563,-0.1663,-0.0644,0.0241,-0.1306,-0.0899,0.0147,0.1784,0.0531,0.0101,0.0833,-0.0092,-0.1947,-0.0949,-0.0302,-0.0751,-0.1513,-0.126,-0.0759,-0.1443,-0.0725,0.1478,-0.0415,-0.0579,-0.0357,0.0154,0.1423,0.2345,-0.0329,0.0473,0.041,-0.0564,-0.072,-0.0869,0.0758,0.0174,-0.0233,0.1865,0.156,0.1048,-0.0618,-0.1025,0.0215,0.4742,0.4678,-0.2054,-0.1618,0.0829,-0.093,-0.0306,-0.055,-0.1936,0.0476,-0.056,-0.0803,0.0294,0.0152,0.2831,-0.0923,0.2059,0.0495,-0.0015,0.1176,0.4101,0.0913,-0.0965,0.2872,0.0856,0.0699,0.0652,0.0421,-0.0772,0.0641,0.0169,0.0093,-0.0047,-0.0404,0.0037,0.0006,0.0556,-0.1351,-0.0632,-0.0815,0.1494,-0.1565,0.0485,0.1043,-0.1243,-0.0968,0.0198,0.0249,-0.1196,-0.038,0.0732,-0.0367,-0.0061,-0.1451,0.0328,0.0784,-0.0456,-0.0713,0.0455,0.0087,0.0257,0.1398,0.1606,0.1632,-0.0219,0.128,0.0303,0.0297,0.4066,-0.181,-0.201,0.0,-0.1805,0.081,0.0761,0.1355,-0.0575,0.0297,0.0265,-0.0267,0.0429,0.0638,-0.0492,0.0375,0.0119,0.0637,0.0554,0.1303,0.2334,0.2481,-0.0439,-0.1079,-0.1081,-0.0337,0.0444,0.0247,-0.0833,0.0568,0.0358,0.0022,0.1446,0.05,-0.2746,-0.1359,0.0245,0.1097,0.0495,0.1097,0.0423,0.2549,0.2063,-0.004,-0.045,-0.1563,0.0035,0.0331,0.0917,-0.0734,-0.1243,-0.137,0.0174,-0.0211,-0.0106,0.2162,-0.1175,-0.1195,0.0069,0.2268,0.0875,0.2556,-0.0287,0.0245,0.0612,0.0617,0.2014,0.2513,0.2251,-0.0293,0.0255,-0.016,0.0845,-0.1035,0.1056,-0.2422,-0.113,-0.0712,-0.1329,-0.0035,0.0876,-0.0285,0.0841,-0.0834,0.0968,0.0952,0.064,-0.0208,-0.0352,0.0041,-0.0011,-0.0319,0.0641,0.2262,0.1269,0.1959,-0.2794,-0.168,-0.2269,-0.04,-0.002,-0.128,-0.1304,-0.0956,-0.1401,-0.0855,0.0976,-0.0074,0.2024,0.0769,0.0088,0.1126,0.0015,0.0145,0.0482,-0.0068,-0.1994,0.05,-0.156,-0.0428,-0.1134,-0.0151,0.0772,0.2259,0.0979,0.0458,0.0233,-0.0612,-0.338,-0.186,-0.2511,-0.1879,0.0172,-0.0014,0.0919,-0.1628,-0.2227,-0.1502,-0.0852,-0.04,0.0124,-0.0026,-0.0505,-0.0315,-0.0113,-0.1892,-0.108,-0.1151,0.0978,0.0362,-0.0178,-0.3871,-0.1173,-0.1791,-0.1993,-0.4615,0.0536,-0.0841,0.0081,-0.0689,-0.0584,-0.0235,-0.0074,-0.184,-0.0464,-0.2189,0.0114,0.0207,0.1229,-0.0336,0.0837,-0.2007,-0.0333,0.0507,0.2097,-0.0741,-0.0462,-0.0724,0.1889,-0.2374,-0.2745,-0.2207,-0.0436,-0.0825,-0.1706,-0.1327,-0.1046,-0.0797,-0.0331,-0.0213,-0.0085,-0.2853,-0.0006,-0.0863,-0.1098,-0.0813,-0.0692,-0.0829,-0.1456,-0.0204,-0.0125,0.1779,-0.0213,-0.122,-0.2683,-0.116,-0.19,-0.0463,-0.3085,-0.223,0.0268,0.1621,0.1211,-0.0315,-0.0744,0.0096,0.2486,0.2476,0.2411,-0.3272,-0.3447,0.0197,0.1006,0.0092,-0.0556,0.0292,-0.0524,0.0031,-0.0383,-0.0943,-0.1212,0.0344,-0.0879,-0.1099,0.0086,-0.1317,0.0362,0.0094,0.0318,0.198,0.1765,-0.0699,-0.2094,-0.2533,-0.1732,-0.1327,-0.298,-0.1799,0.3351,-0.0945,-0.1257,0.2366,0.1459,0.1019,0.1737,0.1028,0.1484,0.1756,0.0533,0.1486,0.0547,0.0495,0.1437,0.196,0.3041,0.3327,-0.3158,0.075,0.0958,0.359,-0.0592,-0.1096,0.0663,-0.0125,0.0284,0.1149,0.2145,-0.0309,-0.0063,-0.0267,-0.0649,-0.0972,0.0936,-0.0846,0.0393,0.1461,0.1748,0.0212,0.0123,0.0437,0.153,0.1168,0.0464,0.0059,0.0126,0.0452,-0.3909,-0.1632,-0.2052,-0.1913,-0.1326,-0.2167,-0.2048,-0.1265,-0.0471,-0.0941,-0.1308,-0.0226,0.0335,-0.1084,-0.3623,0.1217,-0.1076,0.0057,0.0414,-0.1238,0.0678,-0.1705,-0.1193,-0.0614,-0.0803,-0.0803,0.0373,-0.1215,0.1113,0.1566,0.1544,0.066,-0.1624,-0.0148,-0.0882,-0.1742,-0.0504,-0.1059,-0.1073,0.0983,0.0016,-0.0586,-0.0782,-0.1071,-0.0349,0.0427,0.0254,-0.0415,-0.1202,-0.1215,0.0207,-0.0694,0.0946,-0.1658,-0.069,0.0694,-0.01,-0.012,0.0061,0.0707,-0.1436,0.0554,-0.0759,-0.1592,0.1797,0.2719,0.2432,-0.0403,0.4245,0.2157,-0.161,-0.1166,0.3641,0.26,0.0631,0.1419,0.111,0.1517,-0.1578,-0.1504,-0.0851,-0.0872,0.4676,0.4035,0.2616,0.0626,0.1757,0.1905,0.4108,0.3938,0.3322,-0.0372,0.0054,-0.0351,0.0416,-0.013,0.0727,-0.2374,-0.1072,0.0034,-0.0654,-0.16,-0.1441,0.0926,-0.0244,0.0414,-0.0301,0.0678,0.1662,0.2276,0.063,-0.015,0.0045,0.0202,0.0121,-0.0167,-0.0398,-0.1013,-0.0829,0.0138,-0.1923,-0.3029,-0.2744,0.0822,-0.0147,-0.0256,0.2071,0.0288,0.2366,0.1121,0.0839,0.23,-0.0039,-0.2147,-0.2551,0.0604,0.0731,-0.071,0.1625,0.117,0.2043,0.1168,-0.1273,-0.1193,-0.1033,-0.0861,0.2144,-0.1601,-0.0828,0.038,-0.0797,0.0818,0.0081,-0.0042,0.0954,0.0284,-0.0879,0.0025,-0.1202,-0.1525,-0.191,0.0468,0.0278,-0.0339,0.0092,-0.0414,0.0695,0.3508,0.2845,0.1137,0.266,-0.1139,0.103,0.0867,0.2002,0.288,0.2572,0.0716,0.0698,-0.0022,0.2245,0.1876,0.0044,-0.0092,-0.0302,-0.015,-0.1076,0.0344,-0.0391,0.0112,0.0442,0.0478,0.0714,-0.0023,0.2202,-0.0059,0.1111,0.1366,-0.2376,-0.1866,-0.1109,-0.1497,-0.2154,0.1801,0.0039,-0.1239,-0.0722,0.2067,0.049,-0.2667,-0.04,0.0577,-0.1884,0.0301,0.0363,0.0998,0.1474,0.2411,0.4105,0.2655,0.1579,-0.0358,0.0389,0.1527,-0.1238,-0.1312,-0.0046,0.0143,-0.0196,0.0818,-0.0333,-0.0734,-0.1687,-0.2747,-0.295,-0.227,-0.1405,-0.0739,-0.1222,-0.1567,-0.0861,0.0571,0.0221,-0.0398,-0.0127,-0.0296,0.1812,-0.0112,0.0484,-0.0493,0.0465,-0.0578,-0.0205,0.0699,-0.1921,-0.0891,0.1951,-0.0187,-0.025,-0.0004,0.0081,0.0221,0.0343,-0.0411,-0.0548,-0.0494,0.0195,0.0048,-0.1705,0.1088,0.006,0.1388,-0.0026,-0.2816,-0.1491,-0.0309,-0.1251,-0.0793,-0.055,-0.1544,-0.0422,0.0728,-0.0029,0.1203,-0.3889,-0.1653,-0.1702,-0.3193,-0.2316,-0.1637,-0.1193,-0.1193,-0.1009,-0.0355,0.1222,-0.2331,-0.0331,-0.0212,-0.0545,-0.0217,-0.0643,-0.4089,0.1485,-0.1121,0.01,-0.0419,0.3008,0.0438,-0.0367,-0.1826,-0.086,0.0058,0.0548,-0.0422,0.241,0.0824,0.1373,0.252,0.194,-0.0093,0.0373,0.1055,0.0251,-0.0113,-0.1507,-0.1708,-0.0518,-0.1261,-0.0329,-0.0169,-0.0098,0.0884,-0.0359,-0.0237,0.1282,0.0992,-0.0921,0.1161,0.0004,-0.2868,-0.0538,-0.3317,-0.0435,-0.0663,0.0613,-0.1199,0.305,0.303,0.0884,0.2462,0.2036,0.0156,0.1376,0.0058,0.2914,0.1327,-0.0086,0.1754,-0.1012,0.1013,0.059,0.0668,0.0239,-0.093,0.0196,-0.0435,-0.0013,0.0838,-0.0744,0.0718,0.0307,0.1082,0.0345,-0.0083,0.3219,0.0599,0.0231,0.0114,0.0187,0.0239,-0.0182,-0.0417,-0.1888,-0.0842,0.13,0.108,-0.0598,-0.0203,-0.0873,0.0329,0.0432,0.091,0.0608,0.0249,0.048,-0.0401,0.1393,-0.0764,-0.0226,0.0699,-0.0169,-0.0301,-0.0736,-0.1107,-0.0661,0.0281,0.0814,-0.1102,0.1373,0.0245,0.1237,0.0476,0.0367,0.1543,0.0633,-0.0868,-0.0288,-0.0928,-0.0728,0.04,0.072,-0.0458,-0.0846,-0.0206,0.085,-0.0451,-0.1995,-0.1577,-0.2061,-0.1741,0.0444,-0.0255,-0.0022,-0.1655,-0.1247,-0.1472,-0.0364,-0.1124,0.0609,0.038,0.0317,0.1651,-0.1453,-0.1324,-0.0386,0.0085,-0.1051,-0.1064,0.1591,0.1233,-0.1816,0.0354,0.0348,-0.054,0.1249,0.0936,0.0612,0.0545,-0.0198,-0.1806,-0.0279,-0.1975,-0.2176,0.0627,-0.1551,0.1142,0.1593,0.1699,0.1599,0.1585,-0.1276,-0.1763,-0.0407,0.1113,0.1812,0.0072,-0.012,-0.0353,-0.0235,-0.1509,-0.057,-0.1552,-0.1547,-0.0453,-0.0382,-0.0936,-0.1714,0.0579,-0.0512,-0.0265,0.1127,-0.0107,0.0088,-0.202,0.005,0.0036,0.0948,-0.061,-0.0029,0.0919,0.0733,-0.0638,-0.0773,-0.0932,-0.1284,-0.0534,-0.0582,-0.3117,-0.054,-0.0374,-0.0347,-0.0898,0.0553,0.0243,0.0276,-0.1081,0.115,-0.1966,-0.0846,-0.1808,-0.1888,0.0288,-0.2055,-0.1566,-0.3441,-0.1626,-0.0012,0.1989,-0.1909,-0.0588,-0.0672,0.0796,0.0506,0.0563,-0.1454,-0.2132,-0.0973,-0.0427,0.0073,0.0989,-0.0534,-0.0427,-0.0822,0.0927,0.0881,0.0591,0.1777,-0.0173,-0.051,0.0752,-0.0243,-0.0294,-0.0253,-0.0943,-0.0756,0.058,0.0071,0.1286,0.0069,0.1309,0.1369,0.0818,-0.0118,-0.0411,-0.2357,-0.0626,-0.0157,0.2182,0.2604,0.0998,-0.0162,-0.01,0.0355,0.2841,0.1829,0.1488,0.1539,-0.2929,-0.0369,-0.0446,0.0933,-0.0952,0.0818,0.1006,0.0331,0.0467,0.0674,0.0784,-0.0565,0.0828,0.04,-0.1297,0.2009,0.1289,0.0362,-0.0256,0.0909,0.0761,0.0022,0.0244,0.0745,0.0172,0.1661,0.1842,0.2132,-0.0568,0.0325,0.0411,-0.054,-0.1308,-0.396,-0.3908,0.0749,0.1045,0.1436,-0.025,0.007,-0.1022,-0.1454,-0.1318,-0.1741,0.0386,-0.037,0.0052,-0.045,0.1007,-0.0155,-0.1927,-0.0373,-0.158,-0.1483,0.087,-0.1483,0.0394,-0.2759,-0.1253,-0.0315,0.0113,-0.0256,0.1215,-0.0142,-0.0305,-0.133,0.2741,-0.1504,0.1444,0.0855,0.0718,0.0205,0.0977,0.0166,0.2786,0.2718,-0.1926,-0.1418,-0.0882,-0.0298,-0.1779,-0.1392,-0.1171,-0.2601,-0.1019,-0.0109,-0.1336,0.0706,-0.0701,0.0057,-0.104,-0.1848,0.0723,0.0386,-0.2324,-0.0966,0.0473,-0.11,-0.2487,0.0884,0.206,-0.1133,0.0716,0.1221,0.0894,0.0042,-0.023,-0.1981,-0.2474,-0.1087,-0.0908,0.0769,0.0961,0.0551,0.0563,-0.0215,0.1681,0.314,0.2548,0.1039,0.2719,-0.334,-0.3049,-0.1912,-0.1064,-0.0585,-0.0957,-0.1929,-0.0512,0.0149,-0.0623,-0.0969,-0.0373,0.18,-0.1573,0.113,0.0909,0.1826,0.1349,0.1338,0.0759,-0.155,-0.0865,-0.1292,0.0575,0.1762,0.1914,0.0585,0.0227,0.1883,0.1916,0.2201,0.0975,-0.0041,-0.1418,0.0231,0.0331,0.0376,-0.0096,0.0431,0.0838,0.0261,0.0543,0.0461,-0.0145,-0.0291,-0.213,-0.1647,-0.1145,-0.1338,0.3724,0.0078,0.2418,0.1476,0.1131,0.0088,0.0183,0.1535,0.0165,0.2046,0.2355,0.0883,0.1467,0.1025,0.0388,-0.0804,-0.0425,0.0138,0.0941,0.2425,0.1557,-0.0157,0.0095,0.0221,-0.0275,0.023,0.0406,-0.0919,-0.0898,0.0257,-0.0338,0.0541,-0.1101,0.0823,0.0773,0.2252,0.0675,-0.0394,-0.0299,0.0748,-0.0064,0.1473,0.217,0.0445,0.0935,-0.0063,0.1482,-0.1058,-0.1491,0.0039,0.1337,0.1335,0.0393,-0.0902,-0.07,-0.1305,-0.1104,0.0495,0.2062,-0.0399,-0.0088,-0.1061,-0.1586,-0.3115,-0.1994,-0.2081,-0.1509,-0.1376,-0.0942,-0.0789,0.0352,-0.0023,-0.029,-0.0071,-0.0918,0.0556,-0.0802,-0.0928,0.0633,0.1544,0.0514,-0.0143,0.3739,0.3658,0.212,0.0003,0.095,0.0076,-0.1194,0.0275,-0.0394,-0.0126,0.2038,0.2055,-0.0436,-0.0247,0.0829,0.1407,-0.1139,-0.1218,-0.0663,-0.0508,-0.0864,-0.0583,-0.0173,-0.0949,0.0577,-0.14,-0.0577,0.2242,-0.0033,-0.2489,-0.0263,0.1287,0.1725,-0.0746,-0.1135,-0.4402,-0.3559,-0.1578,-0.2972,0.2138,-0.0944,-0.1301,0.0753,-0.0107,0.0611,0.0241,0.0206,0.232,0.169,0.3748,0.1892,0.201,-0.0479,-0.0227,0.124,-0.0159,0.026,0.0241,-0.0105,0.2998,0.2024,-0.1374,-0.2534,-0.1358,-0.0548,-0.1404,-0.0807,0.0017,0.0443,0.035,0.0109,0.0744,0.0424,-0.2146,-0.0232,-0.1595,-0.0301,-0.191,-0.1993,0.0067,0.0239,-0.0293,-0.0888,-0.0079,-0.0393,-0.063,-0.2148,-0.0253,-0.1671,-0.0374,-0.0852,-0.1042,-0.0692,-0.0901,0.0193,0.0711,0.0621,-0.1131,-0.0946,-0.1258,0.0548,0.0885,0.1027,-0.0816,0.2254,-0.1147,-0.1362,0.0624,0.0993,-0.0046,-0.0197,-0.0518,0.0388,-0.0455,-0.0414,0.1813,0.3627,0.4017,-0.0176,0.0401,0.015,0.1347,-0.0732,0.2543,0.0212,0.3575,-0.0477,0.2141,0.1872,0.0798,-0.0262,0.0003,0.0026,0.0474,0.085,0.0919,0.1154,0.0306,-0.0225,-0.1345,0.133,0.1451,0.1361,-0.2178,-0.1836,-0.2169,0.0125,-0.146,-0.1209,-0.0336,0.025,0.0296,-0.0427,-0.1299,-0.1449,0.1844,-0.0254,-0.156,0.1987,0.338,0.093,-0.0804,0.2119,0.3153,0.1753,0.0791,0.1496,-0.0875,0.0076,0.2631,0.165,-0.1128,0.2661,0.0848,0.0457,0.0516,0.3538,0.1135,-0.1497,-0.1231,-0.0733,-0.1018,0.0364,-0.1304,0.0222,-0.0525,-0.0968,-0.0223,-0.2197,-0.0939,0.12,-0.1296,-0.2521,-0.0433,-0.025,-0.0691,-0.0406,-0.0954,-0.136,-0.1458,-0.0869,-0.0935,-0.2064,-0.1439,0.0952,0.1853,-0.0545,-0.0018,-0.0363,0.0226,-0.036,-0.1085,-0.0628,-0.0825,-0.0148,0.0232,-0.2728,-0.3077,-0.0936,-0.0607,-0.1349,-0.2427,0.0458,-0.1397,-0.125,-0.1964,-0.1046,-0.0887,-0.0475,0.0396,0.0469,-0.0074,0.1672,-0.0735,0.0994,0.183,0.1867,-0.1736,0.0614,-0.2251,-0.1523,-0.0915,0.0054,0.0177,0.0317,0.1477,0.1685,-0.0006,-0.0725,0.1544,-0.108,-0.0355,0.1864,-0.1403,-0.0873,-0.1459,0.0492,0.0313,0.1636,0.0609,-0.3148,-0.2758,0.0336,0.0616,0.0196,0.2214,0.1192,0.0183,-0.1329,-0.1594,-0.0595,-0.1791,-0.3264,-0.1322,-0.1116,0.1178,0.0059,0.1634,0.0067,0.1818,-0.0373,0.0413,0.0161,0.0899,0.123,0.0323,-0.0252,0.0198,-0.079,0.0363,-0.0647,-0.0502,-0.0669,-0.046,-0.0603,-0.0305,-0.0822,-0.0299,-0.0897,-0.0576,-0.1783,-0.0184,0.0363,0.0732,0.0237,0.1003,0.0177,0.0438,-0.0536,0.0069,-0.0086,-0.0649,-0.1568,-0.1219,0.2295,0.1198,0.0857,-0.0908,-0.0298,-0.1534,-0.0998,0.0155,-0.0433,0.1276,0.1488,-0.226,-0.1849,0.0328,-0.162,-0.0462,-0.0381,0.4029,0.3425,-0.2645,0.0709,-0.1023,-0.016,-0.0395,-0.2314,-0.2304,-0.1436,0.0785,-0.0081,-0.0987,-0.0261,-0.1527,-0.0591,0.1574,0.0466,0.0627,0.0247,-0.0042,0.0137,-0.1987,-0.0506,0.0752,-0.1518,0.0488,-0.2441,0.2963,-0.2079,0.259,0.0471,0.054,-0.3299,-0.2905,0.02,0.1355,-0.012,0.1736,-0.0042,0.1575,0.0293,0.0053,0.1532,0.1308,0.0977,0.1044,0.0653,0.0845,0.1427,-0.0912,0.104,0.3401,0.5921,0.252,0.2252,0.4179,0.2306,0.2397,0.3338,0.2596,0.3106,0.2117,0.2272,0.284,0.2192,0.2562,0.2176,0.414,0.2285,0.3608,0.2827,0.2692,-0.2271,-0.1176,-0.2547,-0.0817,-0.075,-0.2598,-0.2515,-0.1108,0.1335,0.0534,-0.3221,-0.2884,-0.1676,0.0006,-0.0298,-0.2071,0.1556,-0.056,-0.1129,0.0056,-0.1086,-0.0754,-0.0462,-0.0566,-0.1292,0.0999,-0.2187,-0.2284,0.1053,-0.0072,-0.0405,0.0047,0.0143,-0.1636,0.123,0.0935,-0.1473,0.0915,0.2024,-0.0636,0.0519,0.0232,-0.0908,0.2486,0.2533,-0.0694,-0.1125,0.0845,-0.0771,-0.0021,-0.1301,-0.0468,0.1567,-0.0884,-0.1069,0.028,-0.0395,-0.0808,0.0039,detection
trm_4a3fd79d0b46f,-0.0923,-0.0784,-0.1014,-0.0936,0.0168,-0.0234,-0.1029,-0.0787,-0.1063,-0.1075,-0.0079,0.0038,-0.102,-0.0733,-0.0868,-0.0465,-0.0135,-0.0547,-0.0773,-0.0248,-0.029,0.081,-0.048,0.0074,0.0302,0.0602,0.0528,-0.0938,-0.1493,-0.0753,-0.0888,-0.0834,-0.1298,-0.0302,-0.154,-0.0462,-0.054,-0.0663,-0.1268,0.0165,-0.089,-0.1068,-0.0628,0.0716,-0.0583,-0.0582,0.168,-0.083,0.0433,-0.0583,-0.0329,0.0511,0.0399,0.0189,-0.0185,-0.0491,-0.0984,-0.0352,-0.0195,-0.0201,0.0422,0.0745,-0.0932,0.0974,0.0421,0.0413,-0.1309,-0.1676,-0.1278,-0.0029,0.0189,0.0609,0.1512,-0.0778,-0.1408,0.0471,-0.1368,0.0874,0.0298,-0.0316,-0.0114,0.0506,-0.0485,-0.1428,0.0568,0.061,0.0032,0.0087,0.021,-0.1575,-0.0395,-0.0443,0.0052,0.1208,0.1286,0.1226,0.1023,-0.015,0.1745,0.1036,0.078,0.0678,0.089,0.0571,0.0731,-0.1211,-0.1113,0.0739,-0.0124,-0.0754,0.0212,-0.0992,0.0761,0.1346,0.0475,0.009,-0.0704,0.0506,-0.053,-0.0808,-0.0246,-0.1316,-0.0709,-0.0295,-0.065,-0.0964,-0.0299,0.0553,0.06,0.0143,-0.1287,-0.0722,-0.0512,-0.2704,0.0376,-0.1124,0.0013,-0.1247,-0.0002,-0.0662,-0.0849,-0.0974,0.0244,0.0284,0.0368,0.0818,-0.0692,0.0415,-0.0775,0.078,-0.0863,-0.0129,-0.1241,-0.116,0.135,0.049,0.0457,0.0378,0.0531,-0.0144,-0.0502,-0.0359,-0.1452,-0.1651,-0.0356,-0.0105,-0.0001,-0.1342,-0.1247,-0.0327,0.0096,-0.0287,0.0959,-0.252,-0.171,-0.1862,-0.1492,-0.1287,-0.094,-0.0253,-0.1354,0.0605,0.0098,-0.0021,-0.0448,-0.0188,-0.0705,-0.0939,-0.1258,0.0289,0.032,-0.0117,-0.0016,-0.1672,-0.1646,-0.2206,-0.1905,0.0225,-0.0172,-0.1705,-0.0747,0.1911,-0.0812,-0.0917,0.0762,-0.0838,-0.1571,0.0088,-0.0651,0.0103,-0.1885,-0.1026,-0.0294,0.0234,0.0419,0.0198,0.092,-0.1391,-0.1028,0.0805,0.0705,-0.083,-0.1026,-0.0256,0.0736,-0.0023,-0.0102,0.1122,-0.0241,0.1645,-0.0302,-0.1558,0.1329,-0.0792,-0.0731,0.043,-0.0531,0.0376,0.0316,-0.0719,0.0325,-0.165,-0.057,0.0185,-0.0627,-0.0827,-0.0782,-0.0779,-0.0609,-0.0554,0.029,-0.0148,0.0224,0.0189,0.0339,-0.1632,-0.0025,-0.0639,0.0538,0.2253,0.0708,0.2614,-0.0828,0.1207,0.1771,0.2647,0.0988,-0.0287,0.0207,-0.0209,-0.0577,-0.0047,-0.1496,-0.0097,-0.0599,0.0284,-0.0693,-0.1241,-0.1,0.0395,0.0566,-0.0706,-0.0438,-0.1162,-0.0812,-0.056,0.0272,0.0102,-0.1185,-0.1093,-0.1018,-0.143,-0.0137,-0.044,-0.0774,0.0483,0.0084,0.0801,-0.0141,0.1166,0.0895,-0.1187,-0.0914,-0.0489,-0.0647,-0.0443,-0.1124,0.004,-0.0598,-0.0319,-0.0071,-0.0448,-0.0933,0.0281,0.0692,-0.0801,0.1163,-0.0053,0.0457,-0.1022,-0.0479,0.0093,-0.1105,-0.1099,-0.1065,-0.0116,0.0063,-0.0485,-0.0749,-0.0476,0.0655,-0.0574,0.0106,0.0196,0.0467,0.1207,0.0479,0.0292,-0.0378,-0.1312,-0.1143,0.0752,0.0286,-0.03,0.0647,0.0273,-0.2364,-0.1639,-0.1462,-0.1168,-0.1044,-0.0305,-0.0551,-0.0562,-0.0736,-0.0222,-0.0313,-0.1032,-0.1171,-0.1071,-0.0137,-0.0278,-0.0102,-0.0102,-0.0163,0.0666,-0.0794,0.1962,0.0556,-0.1537,0.0522,0.0723,0.0429,0.066,-0.1082,-0.0222,-0.0714,0.0912,0.0895,0.1258,0.1525,0.0557,-0.0551,0.0616,-0.0177,-0.0085,-0.0742,-0.0565,0.0209,-0.0262,-0.0771,0.0199,0.0352,0.003,0.1463,0.0661,-0.0674,-0.1459,-0.0759,-0.0203,-0.0568,0.0213,0.0071,-0.0193,0.0874,0.0616,0.0213,-0.0054,-0.0914,-0.0297,0.0193,-0.1403,-0.0019,0.1391,-0.0743,-0.0053,0.1701,0.0022,-0.0987,-0.0374,0.0373,-0.1999,-0.1255,-0.2641,-0.245,-0.1192,-0.115,-0.0958,-0.1461,-0.0922,0.0105,0.0374,-0.0122,-0.0242,-0.0106,0.0557,-0.0258,0.0112,-0.1944,-0.1535,0.0352,0.0302,0.0756,0.0335,-0.0243,-0.0657,0.0137,0.0635,-0.0913,0.0137,0.0308,0.0644,-0.0881,-0.0439,0.0384,-0.1164,0.0269,-0.0343,-0.0204,0.0602,0.1067,-0.0352,-0.0467,0.1014,-0.1045,-0.0385,0.0529,0.3275,-0.1122,-0.0532,0.0138,0.0394,0.0846,-0.0274,-0.116,-0.0593,0.0256,0.07,-0.0282,-0.0323,0.0622,0.0351,0.0264,0.0259,0.1251,0.1266,-0.0078,0.0437,-0.0435,-0.0228,0.0614,0.1019,-0.0069,-0.039,0.1605,0.0315,-0.0639,0.0015,0.0743,-0.077,-0.0677,0.0305,0.0075,-0.0666,-0.1131,-0.1141,0.0208,-0.025,-0.0238,0.0999,-0.1151,0.0246,-0.01,0.0186,0.0927,0.0683,-0.1027,-0.0914,0.0951,-0.0929,-0.1098,-0.0189,0.0841,0.0884,0.1311,0.0219,0.1573,0.0558,0.0344,0.0424,-0.0583,-0.0318,-0.0724,-0.1574,-0.1082,-0.0058,-0.0779,-0.0379,0.0169,-0.0751,-0.0467,0.0487,0.011,-0.0451,-0.0727,-0.0372,0.0326,-0.0055,0.0141,0.0422,0.0682,-0.0069,-0.0128,-0.0386,-0.0201,-0.114,0.1041,-0.0063,0.0931,-0.0295,-0.0064,0.0612,-0.0236,0.0474,-0.0708,0.0517,0.1131,-0.0162,0.0086,-0.0542,-0.0513,0.0106,-0.0433,0.0423,-0.0152,-0.033,0.0356,0.0155,0.0777,0.0948,-0.0114,-0.0658,-0.0105,-0.0411,0.1448,0.0644,0.0131,0.0507,0.0548,-0.0321,-0.0458,0.0398,0.0866,0.0736,-0.006,0.0066,-0.1578,-0.0872,0.1295,-0.0025,-0.0046,0.061,0.032,0.0288,0.0707,0.0272,-0.0192,-0.1493,-0.1537,0.0834,-0.1239,-0.0316,0.0405,-0.0989,-0.2279,-0.0366,-0.0697,0.0408,0.0527,-0.1344,-0.058,-0.1311,0.0511,0.0227,0.0008,0.0385,-0.1117,-0.1735,-0.1052,0.0273,0.1009,0.0516,-0.0863,-0.0374,0.0192,0.0269,0.0754,-0.0296,-0.0388,-0.0993,-0.1132,0.0615,-0.0089,-0.0432,-0.0286,-0.0123,-0.1774,-0.1861,0.0921,-0.0812,0.0163,-0.0887,0.1721,-0.0039,-0.0661,-0.0065,0.0257,-0.0802,-0.0377,-0.0605,-0.1138,0.0326,0.1457,-0.0478,0.0001,0.121,-0.1369,-0.0442,-0.0342,0.0157,-0.0555,-0.0941,-0.048,-0.018,-0.0364,-0.0919,0.1435,-0.0457,0.0441,-0.0288,0.0439,0.0344,0.0841,0.0533,0.1422,-0.1204,-0.1002,-0.0009,-0.0052,-0.0054,0.1195,0.1506,0.1385,0.1099,0.2882,-0.0204,0.063,-0.0574,-0.1155,-0.0438,0.0552,0.0338,-0.0016,-0.0854,-0.0823,-0.0804,-0.0732,-0.0097,-0.0148,0.0423,0.0835,0.0386,-0.0078,0.07,0.0409,-0.0234,0.0031,0.0231,-0.0633,0.0554,0.0819,-0.0754,-0.1155,-0.1135,-0.097,0.0183,-0.0348,-0.0898,-0.0238,-0.0722,0.0266,-0.0335,-0.0339,0.1472,0.1209,0.0009,-0.137,0.1058,0.0999,0.1998,-0.1464,-0.0494,-0.0804,-0.0633,0.0284,-0.0733,0.099,0.0242,-0.0248,0.0124,-0.0248,0.0287,-0.1618,-0.2082,-0.1697,-0.1261,0.0621,0.1721,0.0627,-0.0893,-0.0051,0.0367,0.0671,0.1135,0.0587,0.0401,-0.075,-0.1043,-0.0106,0.0748,0.0779,0.1461,-0.021,-0.0469,0.0071,-0.0694,0.0982,-0.0663,-0.0829,0.0169,-0.1416,-0.1464,-0.0666,0.0118,0.0791,0.0082,-0.0346,-0.0319,-0.0132,0.1347,-0.0152,-0.1242,0.0597,0.0163,0.0229,0.0016,0.0831,-0.0592,0.1026,-0.1798,-0.1823,0.1083,0.0933,0.1722,-0.0174,-0.0441,0.0331,-0.0117,0.0312,0.2081,0.0422,0.0714,0.0587,0.1352,0.0245,0.0181,0.1256,0.1265,-0.1014,0.0021,0.0455,-0.144,-0.092,-0.0359,-0.0866,-0.0661,-0.2132,-0.0694,-0.1217,-0.0689,-0.1775,0.0164,0.0087,0.0081,-0.0299,0.0122,0.0229,0.0095,0.1219,0.0622,0.0857,0.1449,0.0215,0.0779,0.0439,-0.0293,0.1166,0.1177,-0.0918,0.1448,0.0594,-0.0276,-0.0511,-0.1038,-0.0464,0.0745,0.0133,-0.1462,-0.0956,-0.0806,0.0696,0.1821,0.0536,0.0129,-0.0129,-0.0033,-0.0289,-0.0785,0.1338,-0.0561,0.0763,-0.1516,0.0959,-0.0699,0.1394,0.081,0.0294,0.0784,-0.1633,-0.1479,-0.0704,0.2209,-0.047,-0.0916,-0.0819,0.0978,0.0177,-0.1603,-0.0195,-0.1339,0.0631,-0.0799,-0.0444,0.0191,-0.0118,0.1489,-0.1325,-0.1128,-0.0625,0.0391,-0.1267,0.0315,0.1453,0.0713,0.1132,0.3486,0.1077,-0.1161,-0.0549,-0.0966,-0.0502,-0.0632,-0.0584,-0.03,0.0788,0.0838,-0.0014,-0.1169,0.0938,0.1511,0.0684,-0.0107,-0.0312,0.0056,-0.1439,-0.0288,-0.0302,0.0111,0.087,-0.1067,-0.0534,0.0868,0.0148,-0.0746,-0.0044,0.0897,-0.0186,-0.0148,-0.0671,-0.113,-0.1101,-0.2591,-0.1484,-0.2815,-0.0379,-0.0511,-0.0897,-0.11,-0.1303,-0.1755,-0.1351,-0.2092,-0.1584,-0.1746,-0.0022,0.0312,0.0915,-0.0103,0.0276,0.0303,0.0987,0.0955,0.1432,0.1498,0.1252,-0.0274,-0.0256,0.016,-0.0017,0.1298,0.0633,0.1305,-0.0409,0.0797,-0.0543,0.0658,-0.0406,-0.0736,-0.0281,0.1248,-0.0135,0.1106,-0.1433,-0.0411,0.0228,0.0271,0.0416,-0.0317,0.0874,0.0415,0.076,0.1239,0.1,0.0227,0.0063,-0.0273,-0.0191,0.0391,0.0187,0.0002,-0.0266,-0.0776,-0.0429,0.0885,0.0804,-0.1057,-0.0748,-0.074,-0.1829,-0.0978,0.1512,0.0848,0.0865,0.0869,0.0401,-0.0309,-0.0114,0.0466,-0.0216,-0.0478,-0.0293,0.0222,-0.0885,-0.0747,0.0155,0.0869,-0.0598,-0.0161,-0.0694,0.0562,-0.1179,0.0528,0.097,0.1429,0.1198,0.0877,0.0468,0.0331,-0.0365,-0.0529,-0.0636,-0.0876,0.0155,0.002,0.105,-0.0109,-0.0228,-0.0021,-0.0163,-0.0629,-0.0004,-0.1237,-0.1761,-0.118,-0.1244,0.1474,0.0568,0.1225,-0.1013,0.1731,0.0934,-0.0091,-0.0094,0.0443,0.0399,-0.0167,0.0984,-0.0803,-0.0923,-0.0045,-0.041,-0.1047,-0.0036,-0.0925,-0.0508,-0.1217,-0.028,-0.0786,-0.0347,-0.0225,-0.0149,0.0239,-0.0063,0.0171,-0.0577,0.011,-0.0896,0.0668,-0.03,-0.0346,0.3138,0.2683,0.3038,0.2116,0.2273,0.1061,0.2834,0.191,-0.1661,0.0602,0.0939,0.025,0.0245,0.025,-0.1382,-0.056,-0.1161,-0.0082,0.0075,0.0134,-0.0183,0.0489,-0.1034,0.0041,0.0351,0.0061,0.0456,-0.0445,-0.0925,0.0297,0.0606,-0.0492,-0.0052,-0.0748,0.0262,0.0101,0.1249,0.0166,-0.0852,-0.1643,-0.1249,-0.0547,0.0799,0.0606,-0.0638,-0.0755,-0.2212,-0.1652,-0.1004,0.0923,-0.0779,0.2678,0.224,-0.051,-0.0089,-0.0071,0.0343,0.0743,0.0327,0.2081,0.0956,0.0366,0.0757,0.0351,-0.0497,-0.0584,0.0732,-0.065,0.0625,0.0108,-0.0598,-0.0111,-0.1221,-0.0617,-0.0296,-0.0823,-0.1434,-0.0313,0.1098,-0.0319,0.0023,0.0055,0.0686,0.036,0.018,-0.1428,-0.1681,-0.0412,-0.0249,-0.0077,-0.0647,0.0191,-0.0627,-0.022,0.1237,0.0145,0.0419,0.2339,-0.0002,-0.0275,-0.035,0.1042,-0.0307,0.197,-0.0927,0.1792,0.2563,0.0536,-0.1035,0.2393,0.219,-0.0388,-0.179,0.0393,-0.1424,-0.0399,-0.155,-0.0327,0.0603,0.005,-0.0215,0.0078,-0.0357,-0.019,-0.0863,-0.0188,-0.013,-0.0427,0.0195,0.1023,-0.0128,0.1963,0.0725,0.1935,0.1647,-0.0831,-0.0421,-0.0893,-0.0885,-0.0627,0.0095,-0.045,0.1381,-0.1216,-0.0762,0.0859,0.0758,-0.0137,0.0649,0.1179,0.0037,0.0042,0.1312,-0.0272,-0.0667,-0.0004,0.0465,-0.0084,0.0338,-0.026,-0.026,-0.1576,0.0875,0.0367,0.0555,-0.0063,0.0943,0.0096,0.1936,-0.2267,-0.2015,0.0428,-0.0508,-0.1993,-0.1903,-0.135,-0.0078,-0.0509,-0.0263,-0.0154,-0.0199,0.1347,0.0241,0.0622,-0.0824,0.066,0.0501,0.0045,-0.0148,-0.0799,-0.0644,-0.0191,-0.0559,-0.0089,0.0231,-0.0522,0.0723,-0.0072,0.0744,0.0251,0.0805,0.0552,0.0887,-0.1744,-0.0996,0.0272,-0.1485,0.0337,-0.1362,-0.2366,-0.0237,-0.1043,-0.1512,0.0054,-0.0612,-0.1508,-0.0429,-0.0753,0.0194,-0.1598,-0.0747,-0.0894,-0.2038,-0.0612,0.0694,-0.0506,0.204,0.0676,0.0978,0.11,0.0013,0.1163,-0.0654,-0.1286,-0.1246,0.0097,-0.0661,-0.0333,-0.0505,-0.0161,0.0623,0.0464,0.0156,-0.1033,-0.0767,-0.0269,-0.0039,-0.0404,-0.0382,-0.0212,0.0999,-0.0508,-0.0799,-0.0232,-0.0958,-0.1021,-0.0549,-0.0715,-0.0855,0.0611,0.065,-0.0224,0.024,0.0078,-0.1203,-0.0813,0.0175,-0.1575,0.0654,-0.0112,-0.0076,-0.1154,-0.0297,-0.0244,0.1093,-0.0159,0.0497,0.0315,-0.0499,0.0967,0.0166,0.0221,-0.0159,-0.1487,0.0343,-0.0009,0.091,0.1443,0.0343,-0.0096,-0.0756,0.0325,0.1441,-0.0464,0.0353,-0.1014,-0.0261,-0.0993,-0.0837,-0.0155,0.1214,-0.0401,-0.0339,-0.1346,-0.0205,-0.0006,0.0218,-0.0406,-0.1402,-0.0251,0.0132,-0.0665,0.0376,-0.0565,-0.0311,-0.0125,-0.0617,-0.0938,-0.0629,-0.0566,-0.0072,-0.0003,-0.0375,0.0466,-0.0486,-0.0276,0.0131,0.0841,0.0022,0.0352,-0.0376,0.024,-0.1006,-0.0107,-0.028,0.0283,0.0522,0.0104,0.0301,-0.0698,-0.0534,-0.0783,-0.0539,-0.1897,0.0195,-0.1507,-0.0026,-0.057,-0.064,-0.0265,-0.0757,-0.0788,0.0702,0.0178,-0.0311,0.1919,0.0349,0.068,0.0522,0.1116,-0.025,-0.0543,0.0127,0.2182,-0.0005,0.0053,-0.0645,-0.1227,-0.0703,-0.0724,0.0118,0.0296,-0.0579,0.0234,0.0485,-0.0152,-0.0092,-0.0237,0.0634,0.145,0.0834,-0.2917,-0.1624,-0.0843,-0.2239,-0.1943,0.0136,0.1483,0.038,0.0251,0.0125,-0.0047,-0.1522,-0.0251,-0.0283,-0.1097,-0.2103,-0.0257,-0.0065,-0.1052,-0.0401,0.1079,-0.0339,-0.0787,-0.0573,0.0114,0.0668,0.1446,-0.0402,0.0708,0.0254,-0.0159,-0.0848,-0.0764,0.0249,0.0244,-0.0071,0.1098,0.1163,0.0654,-0.0584,-0.0788,0.0446,0.3488,0.3503,-0.0713,-0.0627,0.043,-0.0812,-0.0346,-0.0233,-0.1643,0.0646,-0.0024,-0.0912,-0.0045,0.014,0.1676,-0.0407,0.1776,-0.0157,0.0241,0.0394,0.3016,-0.0861,-0.0555,0.2138,0.0257,0.0585,0.0366,0.0536,-0.0347,0.1627,0.1135,-0.0052,-0.0352,-0.0279,0.0286,0.1044,0.0911,0.0037,-0.0155,-0.0257,0.1065,-0.1028,0.0627,0.1389,-0.0596,0.0074,0.03,0.0176,-0.0977,0.0067,-0.0037,-0.0801,0.0069,-0.0842,0.0665,0.0715,0.0041,0.0054,0.0476,0.0122,0.02,0.1515,0.0791,0.122,0.0267,0.1016,0.0521,0.0483,0.274,-0.1501,-0.0484,0.0569,-0.1091,0.0368,0.071,0.062,-0.0558,-0.0003,-0.0123,0.0034,0.0609,0.0416,-0.0241,-0.0219,0.026,0.0282,0.0338,0.0685,0.2271,0.1746,-0.0668,-0.1374,-0.1189,-0.0038,0.0495,0.0006,0.0281,0.03,0.0332,-0.0115,0.0582,-0.0412,-0.2442,-0.0528,-0.0398,0.0863,0.0554,0.0721,0.0139,0.3452,0.2762,-0.0027,-0.0213,-0.0969,-0.0087,0.0459,0.1221,-0.0849,-0.1459,-0.174,0.0325,0.0432,0.0568,0.2073,-0.0315,-0.0129,0.0653,0.1445,0.0394,0.1967,-0.0079,-0.0013,-0.0512,0.0282,0.1052,0.2281,0.2191,-0.016,0.0378,0.0523,0.0487,-0.102,0.0898,-0.1978,-0.067,0.0234,-0.0309,0.0182,0.0846,-0.0068,-0.0457,-0.0537,-0.016,-0.0165,-0.0222,-0.0287,-0.0841,-0.0282,-0.0498,-0.0746,0.0842,0.1913,0.1876,0.1912,-0.1693,-0.0994,-0.1351,-0.048,0.0765,-0.0156,-0.141,-0.0952,-0.1236,-0.0154,0.0624,0.018,0.1341,0.0816,0.0256,0.0279,0.0133,0.065,0.0471,-0.0025,-0.1535,0.0143,-0.094,-0.0105,-0.0963,0.0068,0.0965,0.2092,0.1158,0.1003,0.0747,-0.1397,-0.2566,-0.146,-0.1869,-0.1194,0.0434,-0.0578,0.0585,-0.0955,-0.1411,-0.1321,-0.0811,0.001,0.0145,-0.0345,-0.0586,0.006,-0.0096,-0.1855,-0.0888,-0.0793,0.0479,0.0152,-0.0358,-0.1641,-0.054,-0.1096,-0.1364,-0.2619,0.0669,0.0241,-0.0589,-0.0592,-0.0374,-0.0228,-0.0526,-0.093,-0.0385,-0.0467,0.197,0.0694,0.1294,0.0367,0.1046,-0.0377,0.074,0.0885,0.1998,-0.0764,-0.0234,0.0577,0.1606,-0.1164,-0.1408,-0.1163,-0.0559,-0.0878,-0.1054,-0.0528,-0.0273,-0.0431,-0.0337,0.0062,0.0201,-0.2017,-0.0106,-0.0386,-0.0934,-0.122,-0.0908,-0.0165,-0.1271,0.0397,-0.0268,0.1995,-0.0451,-0.0525,-0.1166,-0.0713,-0.0948,-0.0828,-0.1719,-0.1066,0.0554,0.0391,0.0157,0.0033,-0.071,0.0125,0.1537,0.1914,0.1473,-0.1091,-0.1198,-0.0022,0.0469,0.0324,-0.08,0.0252,-0.0922,-0.0136,-0.0498,-0.0684,-0.1181,-0.0234,-0.1048,-0.0794,-0.0015,-0.0527,0.0055,0.0171,0.0395,0.0944,0.0438,-0.0968,-0.1506,-0.161,-0.1218,-0.0908,-0.2152,-0.1245,0.2152,-0.0762,-0.1165,0.0438,0.0064,-0.0585,0.0379,-0.0189,0.0125,0.0831,-0.0432,0.0678,0.002,-0.0688,-0.024,0.0182,0.0991,0.1792,-0.1675,0.0312,0.0271,0.2546,-0.0622,0.0027,0.0272,-0.0067,0.0337,-0.0189,0.0711,0.0083,-0.0251,-0.1535,-0.117,-0.1295,-0.0138,-0.0694,0.1101,0.1208,0.1351,0.0148,0.026,0.1162,0.2833,0.0985,0.0365,0.0317,0.0301,0.0114,-0.273,-0.1355,-0.1262,-0.1559,-0.1301,-0.1293,-0.1285,-0.0869,-0.0257,-0.0279,-0.1911,-0.0885,0.0806,0.0119,-0.1598,0.0459,0.0012,-0.0056,0.0252,-0.0539,-0.0197,-0.1462,-0.0869,-0.0008,-0.0965,-0.0349,0.0565,-0.1055,0.0178,0.0621,0.0728,0.0232,-0.1087,0.0353,-0.0196,-0.1984,-0.0569,-0.1111,-0.1015,0.1051,0.0671,-0.0013,-0.1668,-0.0458,-0.004,0.0083,-0.0181,-0.0812,-0.1471,-0.0672,0.0231,-0.0565,0.0799,-0.0956,-0.0265,0.0244,0.0431,0.0291,0.0468,0.0266,-0.2194,0.0295,-0.0654,-0.142,0.1396,0.2143,0.1753,-0.0458,0.3249,0.173,-0.1645,-0.0653,0.2651,0.0985,0.0377,0.0816,0.0611,0.0304,-0.0869,-0.08,-0.0793,-0.0417,0.4141,0.3197,0.244,0.1175,0.2438,0.1422,0.2859,0.2648,0.2109,-0.0379,-0.0081,-0.0389,-0.018,-0.0617,0.0431,-0.1929,-0.0877,0.0643,0.0665,-0.0432,-0.0347,0.0809,-0.0118,0.0582,-0.0358,0.1274,0.1494,0.2208,-0.0296,-0.0971,-0.1197,0.0285,0.0593,-0.009,-0.0471,-0.0738,0.0079,-0.0394,-0.1451,-0.256,-0.2402,0.0263,-0.0431,-0.0041,0.1945,0.0532,0.2065,0.0626,0.1195,0.1672,0.0299,-0.1649,-0.1398,-0.0417,0.1006,-0.0386,0.1488,0.0655,0.1508,0.0386,-0.1458,-0.1455,-0.1216,-0.1042,0.0467,-0.2765,-0.1964,0.0607,-0.0399,0.103,-0.026,0.0314,0.1036,0.0114,0.0481,0.0683,0.0097,-0.1088,-0.1623,0.0699,0.0282,-0.0373,-0.0155,-0.0523,0.0463,0.2727,0.2163,0.1178,0.193,-0.0658,0.0664,0.0847,0.1287,0.1702,0.2652,0.1132,0.08,0.0127,0.222,0.229,0.01,0.0015,-0.0955,-0.0971,-0.0578,0.0024,0.0102,0.0094,-0.0224,0.0192,0.0295,0.0045,0.1244,-0.0846,0.035,0.0575,-0.0655,-0.1293,-0.0595,-0.1276,-0.1433,0.0991,-0.0505,-0.1,-0.0881,0.127,0.0347,-0.0838,-0.038,0.012,-0.1336,-0.0193,-0.0474,0.0454,0.0753,0.0272,0.2831,0.1892,0.1852,-0.0139,0.0762,0.0973,-0.1095,-0.1484,-0.0153,0.0577,0.0033,0.0447,-0.0451,-0.0945,-0.0727,-0.1264,-0.1933,-0.135,-0.087,0.0068,-0.0957,-0.0427,-0.0761,-0.0186,0.01,-0.0633,-0.0735,-0.0686,0.1214,0.0205,-0.047,-0.1197,0.0423,-0.0673,-0.0834,0.1056,-0.1947,-0.1056,0.1883,-0.1074,-0.1099,-0.0212,0.0436,-0.0222,0.0452,-0.0863,-0.0589,-0.0586,0.0034,-0.003,-0.1981,0.0579,-0.0062,0.1436,0.0325,-0.1949,-0.0729,0.0084,-0.0341,-0.0519,-0.04,-0.1004,0.0122,0.0054,-0.0308,0.0868,-0.2675,-0.1274,-0.0966,-0.2122,-0.1745,-0.1264,-0.1071,-0.1071,-0.047,-0.0364,0.0469,-0.1856,-0.0526,-0.0887,-0.0799,0.0387,-0.0259,-0.1763,0.1025,-0.1917,0.0825,-0.0059,0.2266,-0.0605,-0.0504,-0.1161,-0.0445,-0.0167,0.0719,-0.0366,0.1726,0.0186,0.0399,0.1353,0.1231,-0.017,0.0261,-0.0111,-0.0321,-0.0105,0.0613,-0.0407,-0.045,-0.0786,0.0042,0.0016,-0.0002,0.0598,-0.0346,-0.0019,0.0671,0.0809,-0.0564,0.0641,-0.0317,-0.0972,0.031,-0.121,0.0191,-0.0581,0.0268,-0.0828,0.0913,0.0932,-0.0087,0.1286,0.1379,0.0046,0.0948,0.0106,0.2215,0.0913,0.0147,0.1179,-0.1783,0.0429,0.0826,0.0493,0.0089,-0.0466,0.0317,-0.0217,0.05,-0.0837,-0.1118,-0.0748,-0.1205,0.001,-0.0214,-0.138,0.2889,-0.0277,0.0349,0.0078,0.0273,-0.0346,0.0351,-0.0004,-0.144,-0.0611,0.1059,0.0957,-0.0214,0.0247,-0.0892,-0.0008,0.0725,0.0906,0.1173,0.0433,0.0042,-0.0654,0.0483,-0.0771,-0.0344,0.021,-0.038,-0.014,-0.0627,-0.0943,-0.1093,-0.0164,0.0431,-0.1055,0.0753,-0.0345,0.0525,0.0539,0.07,0.0909,0.0894,-0.0427,-0.0308,-0.0613,-0.0317,0.0542,0.0571,-0.0519,-0.0407,-0.0015,0.009,-0.1093,-0.1116,-0.1091,-0.1141,-0.1048,-0.0376,-0.0691,-0.0281,-0.0749,-0.1028,-0.0907,-0.0458,-0.0868,-0.0166,0.0909,-0.1008,0.1117,-0.1112,-0.111,-0.0565,0.0411,-0.0725,-0.0513,0.1122,0.051,-0.1731,-0.0003,0.0227,-0.0013,0.0289,0.0251,0.0236,0.0862,-0.0832,-0.1692,-0.0445,-0.1412,-0.2334,0.0779,-0.0972,0.1011,0.0979,0.1,0.1081,0.1096,-0.1127,-0.1462,0.0128,0.1045,0.1679,0.0568,-0.0478,0.0479,0.0468,-0.0813,0.0663,-0.037,-0.1395,-0.0353,-0.0477,-0.0686,-0.1345,0.0904,0.0176,0.0592,0.0706,-0.0164,0.0012,-0.0039,0.021,-0.0161,0.0369,-0.0715,-0.0082,0.0811,0.0648,-0.0174,-0.0623,-0.0624,-0.124,-0.0596,0.0564,-0.1643,-0.0471,-0.0085,0.0185,-0.0368,0.0619,0.0229,0.0536,-0.0403,0.0813,-0.1509,-0.1111,-0.1173,-0.0797,-0.0453,-0.1436,-0.1351,-0.2651,-0.1383,-0.0628,0.1197,-0.0852,-0.0527,-0.0142,0.0273,0.1087,0.1166,-0.0585,-0.1201,-0.0791,0.0087,0.0274,0.0984,-0.0594,-0.0772,-0.0814,0.0665,0.0728,0.0774,0.1888,0.0072,0.0043,0.1192,-0.0482,0.0839,0.0639,0.046,-0.0603,-0.027,0.0287,0.0713,0.0322,0.0646,0.0869,-0.0007,0.0214,0.0188,-0.1467,-0.0735,-0.0309,0.0965,0.2065,0.0607,-0.0024,0.0145,0.0196,0.2801,0.1453,0.1232,0.2,-0.179,0.0025,-0.035,0.0821,-0.0704,0.0931,-0.0162,-0.0285,-0.0,0.0426,0.0616,-0.054,0.0526,0.0506,-0.1001,0.1595,0.1014,0.0392,0.0161,-0.004,0.0074,-0.0295,-0.0498,-0.0399,-0.0356,0.0773,0.14,0.1538,-0.132,0.0171,-0.0311,-0.0882,-0.0538,-0.1814,-0.1587,0.0408,0.0497,0.0808,-0.019,0.0475,0.0935,-0.0075,0.047,-0.0128,0.0452,-0.029,-0.0135,-0.0066,0.0764,0.0124,-0.1523,-0.0256,-0.133,-0.087,-0.0079,-0.0779,0.0193,-0.1217,-0.0808,-0.0063,-0.0222,0.0156,0.1086,0.0238,-0.0516,-0.0982,0.2056,-0.0287,0.0881,0.1475,0.122,-0.0061,0.0267,-0.1315,0.2435,0.2324,-0.1703,-0.0616,-0.0223,-0.038,-0.0645,-0.1068,-0.1726,-0.1581,-0.0654,-0.0033,-0.0373,0.027,-0.0064,-0.0166,-0.093,-0.1339,0.152,0.0859,-0.0943,-0.0582,-0.0627,-0.0892,-0.1787,0.0282,0.1445,-0.118,0.0457,0.1254,0.056,-0.1779,-0.1856,-0.1204,-0.1395,-0.0656,-0.0695,-0.0101,0.0674,0.0434,0.1252,0.0132,0.179,0.2202,0.1945,0.0701,0.1844,-0.2062,-0.1587,-0.1274,0.0179,-0.0068,-0.0219,-0.0573,0.0015,0.0389,-0.1431,-0.1552,-0.0282,0.1467,-0.1425,-0.0341,-0.0358,0.0224,0.091,0.0823,-0.007,-0.0694,-0.0197,-0.0858,-0.0241,0.1512,0.1519,0.0553,-0.0039,0.1017,0.1047,0.0718,0.0692,0.0051,-0.1149,0.0182,-0.0192,0.0198,-0.0096,0.042,0.1573,0.0353,0.0258,0.0375,0.0104,-0.0235,-0.134,-0.1235,-0.1195,-0.0953,0.3119,0.0439,0.1671,0.1394,0.0968,0.0135,0.0122,0.1336,-0.0355,0.2681,0.1456,0.0197,0.0689,0.0881,0.0297,-0.0407,-0.0357,-0.1088,0.0191,0.2471,0.0489,-0.0673,-0.0115,-0.0333,-0.0695,-0.005,-0.018,-0.0837,-0.0733,-0.0277,-0.1652,-0.0143,-0.0557,0.0586,0.079,0.0931,0.0362,-0.0037,-0.003,-0.0302,-0.0221,0.0461,0.1779,-0.0113,0.0605,-0.0747,0.0417,-0.016,-0.1037,-0.028,0.1223,0.0687,-0.0273,-0.1774,-0.0911,-0.0964,-0.0916,0.0037,0.0319,-0.0388,-0.0087,-0.0369,-0.091,-0.2249,-0.1405,-0.1355,-0.1373,-0.1009,-0.0948,-0.037,0.1045,-0.1619,-0.1818,-0.1477,-0.0514,-0.0123,-0.1256,-0.0189,0.0649,0.1806,0.0704,-0.0428,0.3513,0.267,0.2317,0.0164,0.1025,0.0063,-0.136,0.0036,-0.0417,0.0191,0.1011,0.1182,-0.0456,0.0161,0.0879,0.1189,-0.1189,-0.0863,-0.0274,-0.0452,-0.1324,-0.0916,-0.0618,-0.0818,0.0387,-0.0976,-0.1292,0.1617,-0.0443,-0.1394,0.0347,0.1251,0.1163,-0.062,-0.0836,-0.2179,-0.1643,-0.0402,-0.188,0.0143,-0.095,-0.0793,0.0615,-0.08,-0.0513,-0.1373,-0.0556,0.0473,0.0828,0.2026,0.116,0.1809,-0.0933,-0.08,0.1293,0.021,0.1147,0.0461,0.0483,0.2149,0.1381,-0.0952,-0.185,-0.0803,-0.0677,-0.1256,-0.0353,-0.0563,0.0149,0.032,-0.0,0.0813,0.0245,-0.172,-0.0076,-0.1324,-0.0382,-0.1265,-0.1862,0.0048,-0.0837,-0.0007,-0.0647,0.0025,-0.1373,-0.1014,-0.1927,-0.062,-0.1222,-0.0425,-0.0346,-0.0427,-0.0128,-0.0377,0.0543,0.0894,0.0541,-0.0728,-0.0683,-0.1199,-0.0371,0.0484,0.1245,-0.1096,0.1661,-0.0385,-0.0613,0.071,0.0217,-0.0927,0.038,0.0438,0.0411,0.0084,-0.0158,0.1248,0.2221,0.283,-0.0933,-0.0784,-0.0022,0.0645,-0.0157,0.1563,0.0182,0.2903,-0.119,0.0393,0.0146,0.0753,0.0027,0.0137,-0.0018,0.0241,-0.002,0.001,0.0727,0.0525,-0.0299,-0.0888,0.0851,0.1452,0.175,-0.1739,-0.1311,-0.1551,0.0188,-0.1577,-0.0887,0.0151,0.0005,0.0076,-0.0317,-0.1367,-0.1386,-0.0141,-0.0416,-0.0757,0.0264,0.2494,0.0505,-0.0336,0.1542,0.3023,0.1191,0.0505,0.1419,-0.0837,0.0369,0.1486,0.1644,-0.0728,0.1856,0.0992,0.0144,0.0498,0.2798,0.1087,-0.1551,-0.0705,-0.0774,-0.0887,0.0011,-0.0833,0.0163,-0.0877,-0.108,-0.039,-0.1194,-0.0433,0.0893,-0.0826,-0.1963,-0.1052,-0.1099,-0.0278,-0.0311,-0.0529,-0.0622,-0.0606,-0.0395,-0.0528,-0.1884,-0.1375,0.109,0.2001,-0.0123,-0.0095,0.0476,-0.0113,-0.0164,-0.0776,-0.0541,-0.1346,0.0394,0.0431,-0.1442,-0.1769,-0.0718,-0.0642,-0.035,-0.1099,0.0089,-0.0883,-0.017,-0.0407,-0.0847,-0.086,-0.1108,0.0053,-0.0198,-0.024,0.1294,-0.0563,0.0129,0.1163,0.0709,-0.1303,-0.0476,-0.109,-0.1232,-0.0779,-0.0467,-0.0347,0.0522,0.1019,0.1128,0.0092,-0.0294,0.0022,-0.0404,0.027,0.1343,-0.1702,-0.0967,-0.1482,0.029,0.0169,0.1053,-0.015,-0.1992,-0.1733,-0.0309,-0.0264,0.015,0.1398,0.0989,0.0201,-0.1007,-0.0908,-0.057,-0.1248,-0.2705,-0.1101,-0.0651,0.1093,0.0057,0.1473,-0.0365,0.0552,0.0378,-0.0115,0.0346,0.089,0.1264,-0.0021,-0.0476,0.0002,-0.0685,-0.0173,-0.0209,0.0004,-0.0404,-0.0034,-0.0066,-0.0229,-0.0766,-0.0429,-0.066,-0.053,-0.1325,-0.0113,0.021,0.0267,-0.0428,0.0422,0.0203,0.0649,-0.022,-0.024,-0.005,-0.0688,-0.2038,-0.0747,0.1533,0.1465,0.0127,-0.0569,-0.0982,-0.0644,-0.0412,-0.0257,-0.0231,0.0757,0.0563,-0.0969,-0.156,0.008,-0.1359,-0.0519,-0.0298,0.3917,0.1928,-0.2233,0.0764,-0.0548,0.0007,-0.045,-0.1613,-0.1438,-0.1388,0.0477,0.0163,-0.0757,-0.0429,-0.0941,-0.0143,0.1324,-0.0145,0.071,0.0284,-0.0214,0.0372,-0.1512,-0.0303,0.0355,-0.0833,0.052,-0.1238,0.0926,-0.164,0.2042,0.0655,0.0933,-0.187,-0.1538,0.06,0.1784,0.0311,0.1645,0.0079,0.1048,0.0797,0.0534,0.1205,0.0737,0.0497,0.0409,0.0745,0.01,0.0262,-0.0881,0.2003,0.2996,0.4564,0.2462,0.1627,0.3463,0.1717,0.2385,0.2541,0.1537,0.1946,0.1072,0.2318,0.2141,0.1899,0.177,0.1707,0.2746,0.2014,0.2538,0.1594,0.2257,-0.1896,-0.0621,-0.1192,-0.1612,-0.0894,-0.1958,-0.1917,-0.0648,0.0203,-0.0598,-0.227,-0.2037,-0.1403,-0.0269,-0.0093,-0.1382,0.0833,-0.0094,-0.0728,0.0364,-0.07,-0.087,-0.0574,-0.0591,-0.1433,0.0577,-0.1822,-0.1947,0.0965,-0.0149,-0.0962,0.0495,0.0577,-0.118,0.1255,0.1364,-0.1614,0.1279,0.1755,0.0532,0.0276,0.0771,-0.056,0.2501,0.253,0.0216,-0.0217,0.0511,-0.0143,0.0512,-0.0912,-0.0646,0.0817,0.028,-0.0461,0.0827,0.0522,0.0047,-0.0525,visual attention
trm_557b4b27dfd5e,-0.0885,-0.0114,-0.0921,-0.0699,-0.0712,-0.0182,-0.0779,-0.0782,-0.0434,-0.0778,-0.1178,-0.0851,-0.0146,-0.0898,-0.0835,-0.0082,-0.0119,-0.1318,-0.0814,-0.0793,-0.0755,-0.0437,0.0322,-0.026,-0.0305,-0.0598,-0.0545,0.0247,0.0468,-0.0175,-0.045,-0.0868,-0.0555,-0.0561,-0.0074,0.004,-0.0318,-0.0206,-0.083,0.0068,-0.0401,-0.0042,-0.0348,0.0035,-0.0362,0.0117,-0.0753,-0.0322,-0.0207,0.0864,0.0912,0.0265,0.0182,-0.1058,0.0128,0.0148,0.0907,-0.0813,-0.0478,-0.064,-0.0586,-0.048,-0.0258,-0.0098,-0.0184,0.0635,-0.0735,-0.0907,-0.0563,0.0314,-0.0531,0.0085,0.0015,-0.0556,-0.0854,0.1068,0.0655,-0.0782,-0.0938,0.097,-0.0277,-0.029,-0.0249,-0.045,-0.0004,0.0653,0.051,0.0579,-0.0201,0.6932,0.0403,0.1313,0.0224,-0.1543,-0.0825,-0.1079,-0.0252,0.0118,-0.0,0.0282,0.0343,-0.0035,0.0055,-0.0444,-0.0619,-0.0449,-0.0148,0.077,0.0808,-0.0473,-0.068,-0.0606,-0.0358,0.0254,-0.0087,0.0236,-0.0757,0.0723,-0.0994,-0.062,-0.065,-0.0256,-0.081,0.0071,0.0024,-0.0375,-0.0188,-0.056,-0.0352,0.2082,-0.0027,-0.0385,-0.0055,0.0166,0.0611,-0.0642,-0.0325,-0.0354,-0.0082,-0.0141,-0.0619,0.0005,-0.0606,0.039,-0.0557,0.0081,-0.0033,-0.0715,0.0152,0.0095,-0.0245,-0.0513,-0.0176,-0.0733,-0.0007,0.013,-0.0404,-0.0364,-0.0294,0.0141,-0.0484,0.062,-0.0623,-0.0524,0.0121,0.0103,0.005,-0.0223,-0.0399,0.0623,0.063,-0.0826,0.0102,-0.0533,0.0011,-0.013,-0.0092,-0.0749,-0.0168,-0.0052,0.1123,0.002,0.0094,-0.0297,0.078,0.0747,0.0612,0.0371,-0.0324,-0.0157,-0.0218,-0.0085,-0.0359,-0.0444,-0.0499,-0.0547,-0.1084,-0.0348,-0.0487,0.0275,0.0188,-0.0871,-0.0541,0.04,-0.1027,0.3454,0.1222,-0.0475,-0.1141,-0.0742,-0.0961,-0.0808,0.0885,0.0207,0.0016,0.0333,0.0194,-0.0836,0.0369,-0.0505,-0.0645,-0.0352,0.0004,0.0248,-0.0168,-0.015,0.0027,0.0911,0.1931,-0.124,-0.0252,-0.0348,-0.0575,-0.0471,-0.0324,0.2181,-0.0126,-0.0584,0.1145,0.0898,-0.0528,-0.049,-0.0477,-0.0096,-0.0823,-0.0223,-0.0058,0.0083,0.1209,-0.0345,0.0135,0.0049,0.0619,0.0022,0.1724,-0.0359,0.0611,-0.0283,-0.0229,0.0023,0.0806,-0.0736,-0.0892,-0.0735,-0.063,-0.0868,-0.0613,-0.108,-0.0567,-0.0453,-0.0096,0.0303,-0.0147,-0.0518,0.4245,0.5002,0.7866,0.7701,0.5434,0.4906,0.4151,-0.0028,-0.0085,0.015,0.0181,0.0093,0.0498,0.0618,-0.0698,0.0123,-0.0336,-0.1129,0.0075,-0.0785,-0.0143,-0.0461,-0.0118,0.0048,-0.0843,-0.0172,0.0365,-0.1087,0.0422,0.0687,-0.0603,-0.0657,-0.0272,0.1008,0.152,-0.0574,0.1107,0.025,-0.1433,-0.0749,-0.047,0.0068,-0.0686,-0.0734,0.0096,-0.0739,-0.0609,-0.0557,-0.0079,-0.0308,-0.0282,-0.0669,0.0327,0.0623,-0.0495,0.0101,0.0582,-0.0263,-0.0943,-0.0553,-0.0206,0.0884,0.0627,-0.0141,-0.0242,-0.0877,-0.0835,-0.0679,-0.0125,0.0145,-0.0658,0.026,-0.0016,-0.0144,-0.0036,0.0376,-0.0505,-0.1457,0.0594,0.0996,-0.0074,0.0014,-0.0125,0.0052,0.0345,0.0037,-0.1038,0.0003,0.1992,-0.0255,0.0095,-0.0213,0.0193,-0.1027,0.0258,-0.0489,-0.0425,-0.1046,0.022,0.0228,-0.0692,-0.0067,0.0278,-0.0321,0.0464,0.1418,0.0908,-0.0628,-0.1202,-0.1028,-0.0772,-0.0292,-0.0273,-0.0501,-0.0472,-0.024,0.0879,0.0265,-0.1047,-0.0698,-0.1009,-0.065,-0.0019,-0.0185,0.0633,0.0395,-0.0516,0.0093,0.0679,0.0658,0.0015,-0.008,-0.0792,-0.0264,0.0107,-0.0267,-0.0605,-0.1193,-0.0591,-0.0662,-0.011,0.0962,-0.0512,-0.1161,-0.0857,-0.1043,-0.0257,-0.0683,-0.0668,-0.1265,-0.1152,-0.0726,0.0026,-0.1046,-0.0924,-0.0955,-0.0288,0.0624,0.0151,0.0518,0.0614,-0.0673,0.0936,0.16,-0.0456,-0.0783,-0.0253,-0.0644,-0.0224,-0.0223,0.0254,-0.0098,0.1615,0.0947,-0.0804,-0.1222,-0.1214,-0.0214,-0.0089,0.0425,-0.0499,-0.0359,0.1747,-0.0761,0.0189,-0.0301,-0.1121,-0.0513,0.0753,-0.0197,-0.0709,0.0699,-0.0908,-0.1661,0.0466,0.1955,0.0631,0.0732,-0.0693,0.044,0.1627,0.0026,-0.0242,0.0203,0.0931,-0.0809,0.0795,0.0575,0.0503,-0.0686,-0.0578,-0.0091,0.0285,-0.0283,-0.0897,-0.0371,0.1527,0.1656,0.0193,0.0434,0.029,0.0198,0.3386,-0.0415,0.033,-0.0899,-0.0928,0.0108,0.0961,-0.0192,-0.0265,-0.0456,0.0051,0.0576,-0.0372,-0.0675,-0.0282,0.0544,-0.0013,0.0203,-0.0723,-0.0382,-0.0734,-0.0833,0.1172,-0.0536,0.0372,0.1095,-0.0862,-0.1347,-0.0628,-0.0947,0.0911,0.0842,0.1557,-0.0435,0.0197,0.0155,0.0239,-0.0847,-0.0808,0.0565,-0.0619,-0.0273,-0.0149,-0.0414,-0.0421,-0.0412,0.1415,0.0887,-0.0371,0.0358,-0.066,0.0056,0.0838,-0.075,-0.0245,-0.0316,-0.0282,0.0834,0.0513,0.0013,0.0079,-0.0219,0.0319,0.0881,-0.0513,-0.0411,-0.0464,0.028,0.1307,0.193,0.1036,0.1031,0.0219,0.0421,-0.0124,-0.0484,0.1343,0.0503,-0.0164,0.0072,0.0484,0.0254,0.0828,0.0244,0.0987,-0.1195,-0.0396,-0.0238,-0.016,-0.0801,-0.1367,0.0158,0.0668,-0.038,0.0746,-0.0751,-0.0997,0.0136,0.0332,-0.0113,-0.0912,-0.0674,0.0049,0.1109,0.0713,0.0509,-0.0741,0.1364,-0.0812,-0.0636,0.0658,-0.0436,-0.0489,-0.1076,-0.0243,0.0312,-0.0394,-0.0147,-0.1064,-0.1089,-0.0785,0.0277,0.0359,-0.0481,-0.0234,-0.0281,0.0116,0.0161,0.092,0.0264,-0.0674,-0.0647,-0.0332,-0.0137,-0.0326,-0.0541,-0.0063,-0.1,-0.138,-0.0376,-0.0927,0.0488,-0.0143,0.0259,-0.0105,-0.068,0.0171,-0.0678,-0.0745,0.0267,-0.0815,-0.0697,-0.1002,-0.0873,-0.1008,-0.0211,-0.0726,-0.0223,-0.016,0.0766,-0.0816,-0.0313,-0.065,-0.0358,-0.0668,0.0538,-0.0215,-0.0513,-0.0351,0.002,-0.0237,0.0005,0.086,-0.1247,-0.0336,-0.0797,-0.0015,0.1021,-0.0332,-0.0566,0.1236,-0.0576,0.0521,-0.0215,-0.0675,-0.0567,-0.0601,0.1269,0.235,0.0236,-0.0195,-0.0006,-0.0262,0.036,-0.0828,-0.1416,-0.1077,0.019,-0.0397,0.0145,-0.0007,0.0927,-0.0177,-0.1039,-0.0622,-0.0034,-0.0031,-0.0079,-0.0176,-0.0624,-0.0394,-0.0199,0.0212,0.0623,-0.0082,-0.0877,-0.1801,0.0935,-0.1557,0.0008,-0.0789,0.3181,-0.0396,-0.0278,0.1043,0.0034,-0.0584,-0.0435,-0.0477,-0.0526,-0.0546,-0.0907,-0.0595,-0.0414,0.0384,0.0504,0.022,-0.1353,-0.1066,0.0218,0.0107,-0.0665,-0.1108,-0.0554,-0.0067,-0.0151,-0.0635,-0.0241,-0.0658,-0.0632,-0.0381,0.066,-0.004,0.0072,0.0468,-0.0649,-0.0846,-0.0999,-0.0802,-0.0581,-0.0001,-0.0592,-0.0396,0.0519,-0.0009,0.0608,-0.0098,0.0937,-0.0104,-0.0316,-0.0282,-0.0402,0.0057,0.0537,0.0984,0.0037,0.1143,-0.0136,-0.0549,0.0103,-0.0674,0.0349,-0.0453,0.0259,-0.0368,-0.0308,-0.0407,-0.0817,-0.0858,0.0043,0.0485,-0.008,-0.042,-0.0513,-0.0152,0.0072,-0.088,0.041,0.0648,-0.0192,-0.0353,0.0446,-0.0384,-0.0097,-0.0083,-0.0884,-0.0678,-0.0847,-0.026,0.0199,-0.0169,0.0757,-0.0908,-0.0276,-0.0208,-0.0281,-0.0535,-0.0194,0.0003,0.0242,0.1293,0.0453,0.0375,0.0448,0.0732,-0.0729,-0.0552,-0.0203,-0.0407,-0.0989,-0.1427,-0.0849,-0.0331,-0.0609,-0.0793,0.0302,-0.0491,-0.0224,-0.0186,-0.0585,-0.0591,0.0404,-0.0001,-0.0388,0.0461,-0.0199,0.1082,-0.0533,0.0003,-0.0102,-0.0637,-0.0772,0.0262,-0.0497,-0.0423,0.1308,-0.0347,-0.0397,0.013,-0.099,-0.1468,-0.0427,-0.068,-0.0446,0.0742,0.1015,0.0958,0.0355,0.1608,0.0958,-0.1036,-0.0644,-0.1217,-0.1108,-0.0511,-0.0544,-0.0194,-0.0258,-0.0131,-0.1982,-0.1009,-0.2032,-0.0319,-0.0442,-0.1131,-0.0609,-0.0732,-0.1149,-0.0087,0.0226,-0.0172,-0.1313,-0.0552,0.0477,0.1073,0.0547,0.0497,-0.0348,0.0346,-0.0363,-0.1275,-0.0399,-0.0201,0.104,-0.0733,0.0213,-0.0378,-0.0766,-0.0475,-0.0897,-0.054,-0.0833,0.005,-0.0409,-0.0848,0.06,-0.0138,-0.0756,-0.0984,-0.0437,0.0286,-0.0061,-0.1026,-0.0089,0.0364,0.1011,0.004,-0.058,-0.0001,0.0321,0.0346,-0.0078,-0.0547,-0.0195,0.0891,0.0223,-0.0362,0.0034,-0.0416,0.0771,0.0318,-0.033,-0.0703,-0.0678,-0.0645,0.0075,-0.0658,-0.0208,-0.0228,0.0064,0.0891,0.04,-0.022,0.0562,-0.0008,0.0313,-0.0113,-0.0229,0.0414,-0.0449,-0.0672,0.0588,-0.0669,0.0546,0.0216,-0.0004,-0.066,-0.0908,-0.0359,0.0786,0.094,-0.0798,0.0316,0.0228,-0.024,0.0076,-0.0006,0.2031,0.0691,0.0075,0.073,-0.0084,0.0015,0.0637,0.2679,0.0127,-0.0011,-0.0626,-0.0849,-0.0949,-0.0918,-0.0414,0.0559,-0.0059,-0.008,-0.0129,-0.0332,-0.1171,-0.108,-0.0053,0.0095,-0.083,-0.038,-0.0102,-0.0062,0.0135,-0.0132,-0.0009,0.0084,0.0295,-0.0129,-0.0421,-0.0148,-0.0488,-0.0412,0.0092,-0.1184,0.0191,-0.047,-0.0092,0.0296,0.0454,-0.0131,-0.0025,0.0852,-0.0766,0.0083,0.1252,0.0211,-0.1151,-0.0071,-0.0024,0.0182,-0.0197,-0.0678,-0.0289,-0.0524,-0.1088,-0.1374,-0.0869,-0.0733,-0.0583,-0.0298,-0.0212,0.0259,-0.027,0.008,-0.0008,0.1284,0.0277,-0.0245,-0.0328,-0.0035,0.0056,-0.0129,0.0041,0.0336,-0.0479,-0.0194,0.0741,-0.0173,0.0095,0.0173,-0.0536,-0.0234,0.0162,-0.0221,-0.0812,0.0464,-0.0279,0.0565,-0.0176,-0.011,0.0443,0.1157,-0.0013,-0.0315,0.0653,-0.0338,-0.0211,0.0242,0.0838,0.1123,0.0273,-0.0486,0.0819,0.0071,-0.0261,0.0574,-0.0588,-0.0141,-0.0342,0.0756,0.0659,-0.151,-0.0885,-0.0822,-0.0743,-0.0794,0.0031,-0.0594,-0.0493,-0.0481,-0.0587,-0.058,-0.0689,-0.0421,-0.0715,-0.0108,0.0193,-0.048,0.0394,0.0844,0.0287,0.0455,-0.046,-0.0399,0.1009,0.043,0.0561,0.021,-0.0418,0.0034,-0.0567,-0.0372,-0.0483,-0.0131,-0.0001,0.0731,0.0865,-0.024,-0.0083,-0.0705,-0.052,-0.0391,-0.0346,0.0445,0.2011,0.0567,-0.0209,0.0051,-0.0257,-0.0359,-0.0637,-0.0153,-0.1374,-0.0041,0.0512,0.0787,0.1058,-0.0769,-0.1123,-0.0404,-0.0863,0.0762,-0.063,-0.0891,-0.0372,-0.0639,-0.105,0.0146,0.0024,-0.0127,0.0024,0.0686,-0.0155,-0.0328,-0.0191,-0.1129,-0.0911,-0.0513,-0.0739,0.0415,-0.0485,0.0234,-0.0371,0.0554,0.1516,0.0497,-0.0616,-0.0449,0.0549,-0.0133,0.1034,0.1711,-0.0739,0.0077,-0.0574,0.043,-0.0384,0.1004,-0.0716,0.0485,0.1602,-0.045,-0.0235,0.0325,-0.0863,0.0773,-0.1082,-0.1261,-0.0567,0.1921,-0.1073,-0.0598,-0.0807,0.1156,0.0008,-0.0895,-0.0083,-0.1202,-0.1015,-0.0071,0.0429,0.0372,0.1439,0.0637,0.1521,0.0698,0.0877,0.0263,-0.0281,-0.0518,-0.0229,-0.0009,-0.0438,-0.0628,-0.0492,0.001,-0.1132,-0.0771,-0.0379,-0.0573,-0.0974,0.0464,-0.0649,-0.0433,-0.0214,-0.1022,0.0304,0.0269,-0.1197,-0.0472,-0.0277,0.064,-0.0444,-0.0106,-0.132,-0.1,0.0712,0.0741,-0.0182,-0.0033,-0.0862,-0.0862,0.0191,-0.1441,-0.0919,-0.0836,-0.0153,-0.0462,-0.0285,-0.1052,-0.0086,-0.0086,0.0459,0.1037,-0.0454,-0.034,-0.0306,-0.0337,0.006,-0.094,-0.0238,0.0579,-0.1185,0.1807,0.3522,0.0439,0.0827,-0.0415,0.1262,0.0301,0.0486,-0.0081,-0.0296,0.1465,0.0164,-0.0602,0.6095,0.2421,-0.006,-0.1219,-0.06,-0.0354,-0.0178,-0.1057,0.0035,-0.0252,-0.0945,-0.0886,0.0389,-0.0038,-0.1894,-0.0068,-0.1012,-0.094,-0.0352,-0.0773,-0.0135,0.0024,-0.0127,-0.0483,0.47,0.4636,-0.0162,-0.0074,-0.0474,-0.0407,-0.0711,-0.0698,0.1785,0.0752,0.1553,0.1187,0.0888,0.0562,0.6838,0.6728,-0.0819,0.036,0.3391,-0.1168,0.0542,0.0253,-0.0545,-0.0129,-0.0289,-0.0577,0.0093,0.1824,0.1832,0.0307,0.0783,-0.06,-0.0164,0.0531,-0.0753,-0.0638,-0.0985,0.0434,-0.0372,-0.036,-0.0673,-0.0676,0.0632,-0.1374,-0.0498,-0.112,-0.0883,0.051,-0.0614,-0.0356,0.0239,-0.0101,0.0756,0.0477,0.0185,0.0647,0.0511,0.0143,0.0752,0.0472,0.0311,0.1264,0.0206,0.067,-0.0364,0.0374,0.0853,-0.0051,-0.0389,-0.1856,0.0098,-0.014,-0.0641,-0.1029,-0.0476,0.0329,-0.0681,-0.0728,-0.075,-0.0139,-0.029,-0.094,0.0389,-0.0509,-0.0817,0.0647,-0.0167,0.0693,0.0519,0.039,-0.0504,-0.0223,-0.0039,-0.0872,0.0634,-0.0404,0.0745,-0.0989,-0.0935,-0.0815,-0.0332,-0.0107,-0.0077,0.0806,0.1257,-0.0711,0.0313,-0.0517,0.0526,0.0522,0.014,0.0425,0.0512,-0.083,-0.0593,-0.0173,-0.0459,-0.0517,-0.0943,-0.0361,0.0964,0.038,-0.0794,0.0197,-0.0878,0.0004,-0.0332,0.0118,-0.0317,0.0039,-0.0129,0.0325,0.0116,0.113,0.202,0.0825,-0.0147,-0.0915,-0.0256,-0.1025,0.0071,-0.0127,0.0064,-0.0258,0.1437,-0.0777,-0.0414,-0.0977,-0.0389,-0.0606,0.0492,0.0052,-0.0841,0.005,0.1798,0.0922,-0.0761,-0.0669,-0.0101,0.0117,-0.0244,-0.0542,0.0231,-0.0527,0.0811,0.0105,0.004,-0.0332,0.041,0.165,0.0118,0.3431,0.0067,-0.0336,-0.0777,0.0498,-0.0816,0.0443,-0.065,-0.0496,-0.04,0.0587,0.0088,-0.0163,0.0028,0.05,0.0188,-0.0139,-0.1149,-0.0105,0.0262,-0.0478,-0.0599,-0.0531,-0.0426,0.0461,0.0518,0.108,0.0003,-0.0907,0.0116,-0.0486,-0.0411,0.0171,-0.153,-0.1423,0.0352,-0.0487,-0.0699,0.0331,0.0469,-0.0264,0.0022,0.0639,-0.0305,0.013,-0.0445,-0.0288,0.0188,-0.011,0.0307,0.0637,-0.0523,-0.059,-0.1082,-0.0509,-0.0213,-0.0084,0.0856,-0.0268,0.0907,0.0213,-0.0399,-0.0568,-0.1238,-0.0629,0.0043,-0.0353,-0.0177,0.0018,0.0074,-0.042,-0.0079,-0.0236,0.0451,-0.0898,-0.0384,-0.0613,-0.0412,0.0117,-0.0828,0.0378,-0.0292,-0.0303,-0.0318,0.0049,0.3461,0.2913,0.1993,0.1849,-0.0498,-0.0246,0.0235,0.022,-0.0379,-0.0558,0.0813,-0.0009,-0.0424,-0.1859,-0.0992,-0.0345,-0.151,-0.0957,-0.0716,-0.1756,0.149,0.1233,0.2423,0.1942,-0.0049,0.0242,-0.0214,0.0567,0.0121,-0.0885,-0.1037,0.0277,0.0959,-0.0225,-0.0239,-0.0197,-0.0422,0.0081,0.1172,-0.0008,-0.0521,0.0523,0.2295,0.098,0.0007,0.0085,0.076,-0.0223,-0.0766,-0.0357,-0.038,-0.0523,-0.0507,0.0217,-0.0342,0.0246,-0.0809,-0.0422,-0.0291,0.3859,-0.0844,-0.0661,0.0066,-0.0569,0.0599,0.6359,0.5038,0.7443,-0.0619,-0.0605,-0.1078,-0.0955,0.0389,-0.075,0.0799,-0.1078,-0.0671,-0.1146,-0.0445,0.0887,0.2433,0.0365,0.0223,-0.0079,-0.0851,-0.0609,-0.001,-0.0218,0.0123,-0.09,-0.0049,0.0389,-0.0709,-0.0083,-0.02,-0.0507,0.2039,-0.0546,-0.0643,-0.0205,-0.0534,-0.0403,-0.0159,0.1492,-0.0307,-0.082,-0.0785,0.0287,-0.0355,-0.0265,-0.033,-0.0778,-0.0407,-0.0646,-0.0581,-0.0164,-0.085,-0.1644,0.0045,0.0557,0.0127,-0.0408,0.0934,0.0445,-0.0626,0.0675,-0.0394,0.0062,0.0233,-0.0676,-0.0478,0.0568,0.0994,-0.0123,-0.041,-0.0552,0.0637,-0.0569,-0.0466,-0.0324,-0.0478,-0.0089,-0.0153,-0.009,-0.0312,0.0358,-0.0137,-0.0378,-0.0456,-0.0153,-0.0312,-0.0244,-0.0433,-0.0198,0.0024,0.2657,0.0855,0.0238,-0.0618,-0.03,0.0168,-0.0736,0.0785,-0.1341,-0.0099,0.0408,-0.0252,-0.1464,-0.121,-0.0584,-0.0793,-0.0729,0.0159,-0.0547,0.0097,-0.0052,-0.0837,-0.0301,-0.0112,-0.0309,0.1823,-0.0534,-0.134,-0.0629,-0.0742,-0.0889,-0.0746,-0.0792,-0.0757,-0.001,-0.12,-0.0827,-0.0788,-0.0649,-0.0331,0.0013,0.0558,-0.0189,-0.0746,-0.0479,-0.0651,-0.0569,-0.0239,0.1115,0.0447,-0.1093,-0.0831,-0.1088,-0.046,-0.0399,-0.0769,0.0945,-0.0521,0.2083,-0.0261,0.0387,-0.016,-0.051,0.2436,0.2225,-0.0134,0.0186,-0.0052,0.04,0.0187,0.0203,0.0104,-0.0537,-0.0644,-0.0044,-0.0534,-0.0647,0.2363,0.2134,0.2941,-0.0447,-0.0368,0.0317,0.0178,0.0472,0.0041,-0.0583,-0.0217,0.062,-0.0118,0.0137,0.0026,0.1738,-0.0188,-0.0993,-0.0872,-0.061,0.1085,-0.0113,-0.0583,-0.081,-0.0599,-0.0259,-0.0453,-0.0463,0.0167,0.0728,-0.0277,-0.0214,-0.0406,-0.101,-0.1082,-0.0436,-0.0244,-0.0242,-0.0726,-0.0696,-0.0774,-0.0652,-0.0442,0.0015,-0.0158,-0.042,-0.0847,-0.0291,-0.0656,-0.0911,-0.0852,-0.0176,0.0161,-0.089,0.2412,-0.0813,0.0058,0.189,-0.0112,-0.0175,0.2373,0.0524,0.1783,-0.0366,0.5521,0.4895,0.2805,-0.1153,0.0078,0.0297,0.1576,0.2549,0.2091,0.0404,-0.0833,-0.0562,-0.0698,-0.0674,-0.0728,-0.0351,-0.122,-0.0203,-0.037,-0.0384,-0.0463,-0.0491,-0.1316,-0.0754,-0.0023,-0.0078,-0.0186,-0.0171,0.0016,-0.0221,-0.0338,-0.025,-0.0691,-0.0076,-0.0582,0.0588,0.142,-0.0527,-0.0035,-0.0287,0.0051,-0.0547,-0.0504,-0.022,-0.0783,-0.11,0.0103,0.0443,-0.0538,-0.0922,0.0696,-0.0328,-0.0585,-0.0761,0.0665,-0.0628,-0.0307,-0.0454,-0.0309,-0.0035,-0.0616,-0.0516,0.5235,0.0874,0.0312,-0.0285,-0.0095,-0.0201,0.0352,0.0242,-0.0403,0.0146,0.0534,0.0758,0.0608,0.0597,-0.067,-0.0653,-0.1026,-0.0469,-0.1402,-0.1068,-0.0685,0.0145,-0.1102,-0.0753,-0.0566,0.0141,-0.1047,-0.0862,-0.0462,-0.1067,-0.0699,-0.0225,-0.0849,-0.0845,-0.0195,0.021,-0.1714,-0.1188,-0.0625,-0.0318,-0.0632,-0.0658,-0.1147,-0.0988,-0.0678,-0.0537,0.0395,-0.01,0.1003,0.0345,0.1707,-0.0842,-0.0094,-0.0792,0.0117,-0.0457,-0.0669,0.0126,-0.0114,0.0066,0.1072,0.0229,-0.1126,-0.0657,0.1119,0.0935,0.0735,0.016,-0.0167,-0.0712,0.0306,0.0199,-0.0534,0.0991,-0.0358,-0.1252,-0.1146,0.1382,0.1444,0.014,-0.1475,-0.1126,0.0121,-0.0532,0.051,0.0246,-0.0769,-0.0752,-0.1012,0.1022,-0.0262,0.1102,-0.0095,-0.0574,0.0014,0.1381,-0.0026,-0.0039,0.0357,0.0092,0.0218,-0.07,-0.0531,0.0358,0.0291,0.0777,-0.0862,0.0404,0.0847,0.0085,-0.0772,-0.0245,-0.0788,0.0539,0.0324,-0.087,-0.0713,0.0288,-0.0381,-0.0049,0.0784,-0.1722,-0.1604,-0.1112,-0.0347,0.0326,-0.0467,-0.0143,-0.0927,-0.0944,-0.0962,-0.0993,-0.039,0.0149,-0.0423,-0.0769,-0.0523,-0.0516,0.1331,0.0935,-0.0215,0.0392,-0.0248,-0.0003,-0.0167,0.052,0.0089,-0.1045,-0.0048,0.2757,-0.0744,0.1271,-0.0321,0.0042,-0.0361,-0.0366,-0.0735,0.0754,-0.0308,-0.0294,-0.0633,-0.04,0.0063,-0.0859,-0.0367,0.1117,-0.048,0.0571,0.1263,0.0807,0.168,0.2775,0.0865,-0.1038,-0.1444,-0.0255,-0.0358,-0.0249,-0.0302,-0.0447,-0.0147,-0.0561,0.0893,-0.0375,0.1385,0.0172,-0.0954,-0.0309,-0.0908,-0.0626,0.0461,-0.1276,0.0039,-0.1381,-0.0367,-0.0406,-0.0206,-0.0072,0.1101,0.3981,0.2573,-0.0654,0.0531,-0.047,-0.0305,-0.1281,0.5869,-0.0015,-0.116,-0.0711,-0.0947,0.654,0.6607,0.0141,-0.0748,-0.0066,-0.0695,0.0273,0.054,-0.0184,-0.007,-0.0057,0.0748,0.0162,-0.1177,-0.0787,-0.0156,0.0247,-0.0836,-0.0939,0.0052,-0.0757,-0.0934,-0.0304,-0.0132,0.1334,0.0624,0.002,-0.0574,-0.0039,0.0442,-0.0611,-0.1202,-0.0533,-0.0695,-0.0695,0.0413,-0.0086,0.0439,-0.0149,0.0461,0.016,0.0087,0.1148,0.1776,-0.0779,0.0605,0.0674,-0.0625,0.1867,-0.1347,0.3634,0.1964,-0.025,0.0059,-0.0086,-0.034,0.0513,-0.0768,-0.0058,-0.0648,-0.0967,-0.0897,-0.0323,-0.0074,0.0246,0.0216,0.0034,-0.0989,-0.0917,-0.0324,-0.0254,-0.017,-0.0498,-0.077,0.0724,-0.0651,0.0898,0.0406,0.0737,-0.019,-0.0203,-0.0046,-0.2418,-0.0802,-0.2146,-0.0836,-0.0727,-0.141,-0.0421,-0.0412,-0.01,0.0515,-0.1081,-0.0793,0.0627,0.1298,0.0015,0.147,0.0404,0.054,-0.0181,0.0253,0.0543,0.0624,-0.0285,-0.0122,0.0091,-0.0277,0.0584,-0.0029,0.0695,0.6606,-0.0266,0.0061,-0.0643,0.1158,-0.0411,-0.0765,-0.0303,0.0363,0.0689,-0.0584,0.0732,0.0189,-0.0395,-0.028,-0.0323,-0.035,-0.0201,0.0472,-0.0673,-0.007,0.0062,-0.0016,0.1698,-0.0318,-0.0298,0.0346,0.0954,0.1382,0.0582,0.1081,0.3353,0.0353,0.1385,-0.0387,-0.0487,0.0003,-0.0183,-0.0061,0.0453,-0.0085,0.0663,0.1635,-0.0922,-0.114,-0.0077,-0.043,-0.0835,0.0554,-0.0435,-0.0382,-0.0391,-0.0798,0.039,0.0126,-0.0003,0.1683,0.1911,-0.1186,-0.0638,-0.078,-0.008,0.0338,-0.0493,-0.07,-0.0263,-0.0319,-0.0674,0.006,-0.0427,0.2146,0.0089,-0.0642,-0.1114,0.0586,-0.0155,-0.0256,0.0381,-0.0519,0.0208,0.0066,0.0458,0.0746,0.044,-0.0186,-0.0154,0.0453,0.0163,-0.0093,-0.0518,-0.0332,0.0191,0.0023,-0.0162,-0.0354,0.0163,-0.0523,-0.1066,-0.059,-0.1509,-0.1376,-0.0889,-0.0466,-0.0728,0.0763,0.0143,0.1274,0.011,0.0418,0.0112,-0.0591,-0.0037,-0.1094,0.0576,0.0106,-0.0972,-0.0166,-0.0286,-0.0815,-0.0224,-0.0981,0.0143,-0.0805,-0.0212,0.0744,-0.0711,0.0716,-0.0283,0.0699,-0.0205,0.0577,0.0482,0.0239,0.076,-0.0478,-0.0899,-0.0537,-0.0469,-0.0322,-0.0488,0.0878,0.0098,-0.0335,0.0073,0.1022,0.0179,-0.0083,-0.0191,0.0719,-0.0544,-0.0198,-0.0246,-0.0431,0.0953,-0.0603,-0.0731,-0.0737,-0.0218,0.025,0.0311,-0.0379,-0.1155,0.0509,-0.0336,-0.0762,-0.066,-0.109,-0.0161,0.0284,-0.0384,0.0678,-0.0764,0.0152,0.03,0.0356,0.021,-0.0126,0.0613,0.0476,-0.0121,0.0436,-0.0393,-0.0048,-0.0782,-0.0835,-0.0386,0.0182,0.0076,-0.0676,0.0066,-0.0137,0.1835,0.0801,-0.0076,-0.0111,-0.0614,-0.0582,0.0209,-0.0647,0.0282,0.0174,-0.0249,0.0391,-0.0363,0.0378,-0.0492,-0.0738,0.0056,-0.0897,-0.0298,-0.0449,0.0222,-0.0434,-0.009,-0.0447,-0.039,-0.0051,0.0753,-0.0448,0.0925,-0.0385,-0.1124,-0.083,0.0078,-0.0146,0.0707,0.037,-0.0787,0.08,0.1131,0.0392,0.1033,0.0058,-0.0773,-0.0614,-0.0357,-0.0497,0.0798,0.0462,0.0024,0.0205,-0.0661,-0.0818,-0.0831,0.014,0.042,-0.0014,0.0735,-0.066,-0.0841,-0.0115,-0.0503,-0.0482,-0.0142,0.0736,0.0593,-0.0505,-0.0181,0.0604,-0.1078,-0.061,-0.0435,-0.0973,0.0863,0.0839,-0.0526,-0.1389,-0.067,-0.0517,0.0638,-0.0225,-0.0744,0.0497,-0.1303,-0.0514,-0.0913,-0.0351,-0.1128,-0.0821,-0.0799,-0.0495,-0.0354,-0.0067,-0.1133,-0.0739,0.0496,-0.0821,-0.0588,-0.0232,-0.133,-0.0674,0.2345,-0.0474,-0.0241,-0.0353,0.0181,-0.0031,-0.0156,0.0766,0.047,-0.0473,-0.0371,-0.0712,-0.0026,0.1123,-0.0324,-0.0483,-0.0515,0.0071,-0.0498,0.0545,-0.0586,-0.025,0.0678,-0.0144,-0.0092,0.0236,-0.0639,-0.0146,-0.0645,-0.0544,-0.0248,0.0891,-0.0776,-0.0443,-0.0447,0.0486,0.0309,0.0026,0.0359,-0.1087,-0.0509,-0.0504,0.1718,0.0808,0.0647,0.0153,0.1404,0.0657,-0.0196,-0.0129,0.0001,0.1588,0.0223,-0.0187,-0.0543,0.2244,0.0426,0.1641,0.0067,0.3057,0.1997,0.3982,-0.0249,0.0032,-0.0451,-0.0398,0.0798,-0.0142,0.1318,-0.0363,0.0415,0.1005,-0.1172,-0.0104,0.0521,0.0358,-0.0208,-0.0947,-0.0211,0.0256,-0.0538,-0.0598,0.0078,-0.052,-0.0542,-0.0424,-0.0593,-0.0709,-0.166,0.0334,-0.0905,-0.049,0.0632,-0.0039,-0.0347,0.0732,0.1737,-0.0702,0.0092,0.138,0.0538,-0.0283,0.1352,-0.0196,0.0334,0.0072,-0.0027,-0.0055,0.1032,0.095,0.0623,0.0648,0.0073,-0.0869,0.1009,0.1454,0.0137,0.0237,0.0353,0.3116,0.0232,0.0744,-0.0101,0.0085,-0.072,-0.038,0.0237,0.1149,0.0219,0.02,0.065,0.1646,0.0328,0.0704,0.0377,-0.0073,-0.0419,-0.0288,-0.1299,0.0007,0.094,-0.0421,-0.0533,0.0019,0.0547,-0.0089,-0.0589,-0.018,0.0077,-0.104,-0.0903,-0.0437,0.0031,0.0081,0.0481,-0.0126,-0.0035,0.0207,-0.0928,-0.0064,-0.0443,0.0102,-0.0474,0.6504,0.7735,0.0653,0.1957,-0.0284,0.1136,0.2963,-0.0924,-0.0757,0.0228,-0.0281,0.1147,0.0093,0.5194,0.2246,0.3569,0.0096,0.1168,-0.0083,-0.0122,0.009,0.0489,0.0149,0.5309,0.0197,-0.0205,0.0044,0.7034,0.5722,0.3606,0.5081,-0.076,-0.0305,-0.0522,-0.1035,0.6036,-0.0752,0.005,0.0005,0.1202,0.0651,-0.0103,-0.044,-0.1175,-0.0485,-0.001,-0.0195,0.0699,0.0008,0.0129,0.6636,0.0309,0.0715,0.0411,0.183,0.1322,0.1592,0.0412,-0.0672,0.0435,-0.0046,-0.0616,0.1093,-0.0343,-0.0884,-0.0292,0.1975,0.218,0.019,-0.0599,-0.0616,-0.109,-0.1239,-0.0104,0.022,0.0806,0.1052,-0.0523,-0.1198,-0.0899,-0.0085,-0.0025,-0.0653,0.138,0.1264,-0.0499,0.0381,0.4901,-0.0758,-0.0279,0.0457,-0.0141,0.0223,-0.0726,0.1048,-0.1346,0.012,-0.0134,-0.0618,-0.0326,0.0213,-0.0543,-0.0548,-0.0357,-0.0791,-0.066,0.0128,-0.0484,-0.022,0.0991,-0.0094,0.0303,-0.0382,-0.0117,-0.0055,0.1509,-0.0857,0.0475,0.008,-0.0264,0.0318,-0.0245,0.0561,0.226,-0.1002,0.1668,0.3933,-0.03,0.5386,-0.1128,-0.0776,0.2245,-0.1152,0.6876,-0.0524,-0.0411,-0.0127,0.0436,0.0563,0.0172,0.084,0.1961,0.1633,-0.0036,0.0383,0.1117,-0.0223,-0.0829,-0.0933,-0.1064,-0.0747,-0.0444,-0.0962,0.0141,-0.059,0.2733,0.0264,0.0352,0.0213,-0.0087,0.0118,0.0048,-0.0144,0.0058,-0.0602,-0.0058,0.0084,0.1238,0.0052,-0.0276,-0.169,-0.0739,0.0208,-0.088,-0.0161,-0.0495,0.0064,-0.1006,-0.0073,-0.0175,-0.0755,-0.0817,-0.0015,-0.0759,-0.0256,-0.0455,0.0496,0.03,0.4902,0.2869,0.1316,0.2511,0.3528,0.5465,0.1409,0.1451,0.1741,-0.027,0.0538,0.0471,0.4913,0.6607,0.0324,0.1235,0.1153,0.018,-0.0101,-0.0737,-0.0534,-0.0023,0.0238,-0.0082,-0.0009,0.0151,-0.0497,-0.0994,-0.0286,0.0356,-0.0006,-0.0188,-0.0676,-0.0522,-0.0422,-0.0113,0.0267,-0.0132,-0.0566,0.0028,-0.0014,-0.0156,-0.0497,-0.0908,-0.0152,-0.0646,-0.0705,-0.0318,-0.0245,0.0358,0.0894,-0.0943,0.0159,-0.076,-0.06,0.1425,0.065,0.1075,0.0159,-0.0693,-0.0326,0.3885,0.5218,-0.0425,0.0325,-0.0352,-0.0566,-0.0826,-0.0038,-0.0276,0.0042,-0.0594,-0.0196,0.0357,0.0323,0.0102,0.0048,-0.0249,0.0643,-0.0852,-0.0933,-0.0267,-0.0125,-0.0391,0.076,-0.009,0.0082,-0.0784,-0.0889,-0.0479,-0.0312,-0.104,-0.0268,-0.005,-0.0272,-0.0766,-0.1008,0.0109,-0.0259,0.019,-0.039,-0.0506,0.0312,0.0521,-0.0441,0.0203,0.0679,-0.0585,-0.037,-0.0641,-0.0824,-0.0757,-0.0335,-0.0857,-0.0269,0.0206,-0.0231,-0.0336,-0.0345,-0.0001,-0.0498,0.0887,0.0077,0.0249,0.2455,0.0072,0.0108,0.0407,-0.0066,0.0639,-0.0863,0.0282,0.0879,-0.0328,-0.0649,-0.0082,0.0228,0.0327,0.0918,-0.0323,0.0009,0.0739,-0.1033,0.0388,-0.0444,0.0191,-0.0371,-0.0502,0.0013,0.043,-0.0866,-0.0402,-0.0164,-0.0061,0.0231,-0.0261,0.0403,-0.0873,-0.0582,0.1208,0.0259,-0.0416,-0.0228,-0.002,0.0326,0.0704,0.1236,0.0026,-0.0203,0.021,0.0008,0.1697,-0.0286,-0.0072,-0.11,-0.0082,-0.0559,-0.014,-0.0134,-0.0874,-0.0494,-0.0771,-0.0751,-0.0458,-0.0529,0.0779,0.1014,0.0226,-0.0059,0.0874,-0.0348,-0.0298,-0.087,-0.0761,-0.0165,-0.0359,0.0203,0.012,-0.1347,-0.1257,0.0488,-0.073,0.0375,-0.0632,-0.0462,0.3324,-0.06,-0.0417,0.0078,-0.1098,-0.0521,-0.0508,-0.0209,-0.093,0.0103,0.0774,0.0123,-0.0011,-0.0813,0.0356,-0.0565,-0.1264,-0.1116,-0.0347,-0.0219,-0.085,0.4739,0.5902,-0.0261,-0.0267,-0.0595,0.0059,0.0097,-0.0245,-0.0278,0.0588,0.0065,0.0156,-0.0581,-0.0124,0.0144,0.029,0.0109,0.0014,-0.0377,-0.0932,-0.0783,-0.0139,-0.0432,0.0018,-0.0353,-0.0329,-0.0241,0.0198,-0.0573,-0.0561,0.0918,-0.1352,-0.0956,-0.1159,0.1296,0.018,0.0101,0.091,0.215,0.0995,-0.0864,-0.086,0.0716,-0.0614,0.1135,0.0208,0.074,0.014,0.0142,-0.0064,-0.0946,-0.0832,-0.0743,-0.0041,-0.0256,-0.0163,visual form discrimination
trm_4a3fd79d0b043,0.1274,0.1123,0.1451,0.1599,0.0497,0.0559,0.1018,0.0765,0.038,0.1103,0.0375,0.0469,0.1064,0.0583,0.1283,0.0768,0.1175,0.1436,0.0892,0.007,0.1006,0.0201,0.0274,-0.0466,0.0424,0.0191,0.0198,0.1117,0.1592,0.0802,0.0802,0.1148,0.1136,0.1152,0.1033,0.113,0.0619,0.0752,0.1178,0.039,0.0997,0.0959,0.0583,-0.0511,0.1028,0.0672,-0.136,0.0851,-0.0201,0.1053,0.0479,-0.0148,-0.0227,0.02,0.0528,0.1006,0.1069,0.0272,-0.0291,0.0334,0.0223,-0.0154,0.126,-0.1178,0.0317,-0.0376,0.2114,0.2361,0.114,-0.0055,-0.0339,0.0229,-0.1535,0.0762,0.1191,-0.0921,0.0921,0.0205,-0.0526,0.0055,-0.0432,-0.0612,0.0195,0.1328,-0.0354,-0.0515,0.0109,-0.0088,0.0079,0.1359,0.0974,0.0774,-0.0017,-0.0968,-0.1307,-0.0953,-0.1401,-0.0127,-0.1819,-0.0537,-0.0474,-0.0207,-0.0707,-0.0085,-0.0514,0.1349,0.1222,-0.2045,0.0219,0.0292,0.0001,0.108,-0.1157,-0.1533,-0.0298,-0.0458,0.1237,-0.0418,0.0152,0.0842,0.0957,0.1571,0.111,0.0253,0.0835,0.1084,0.0694,-0.0643,-0.0759,-0.0643,-0.0016,0.0732,-0.0195,0.1793,0.0138,0.1772,0.0376,0.0861,0.0024,0.0203,0.1118,0.1335,-0.0391,0.033,0.0461,-0.0187,0.1309,0.0032,0.0669,-0.0827,0.0609,0.0971,0.1214,0.1557,-0.182,0.0473,-0.0559,-0.0051,0.0336,0.0794,0.0813,0.0821,0.2122,0.2168,-0.0001,-0.0514,0.0197,0.1215,0.1152,-0.0265,0.0593,0.1287,-0.0243,0.1192,0.0913,0.1201,0.0871,0.1133,0.0601,0.057,0.0919,-0.0894,0.069,0.0035,0.1,0.0687,0.0513,0.0107,0.0003,0.0614,0.0499,0.0802,0.0378,0.1676,0.1468,0.1972,0.1924,0.0213,0.0008,0.1102,0.0761,-0.1386,0.1109,0.1018,0.0126,0.0416,0.0183,0.0834,0.0871,0.0202,0.1269,0.0505,-0.0177,-0.0165,-0.0702,-0.0368,-0.1094,0.122,0.1771,-0.0384,-0.1058,0.0885,0.1082,0.0599,-0.0096,-0.0232,0.0648,-0.1455,0.0054,-0.1739,0.0693,0.083,-0.1589,0.158,0.151,-0.0816,0.0121,-0.0767,-0.0193,0.0578,0.0353,0.1686,0.0757,0.001,0.1087,0.0521,0.0514,0.1118,0.0472,0.0667,-0.0449,-0.056,0.0147,-0.0636,0.0088,0.1509,-0.0093,0.0855,-0.158,-0.2368,-0.0188,-0.2332,0.1384,-0.1395,-0.1788,-0.2928,-0.1185,0.0149,-0.0506,-0.02,0.0494,0.0482,0.0631,-0.0467,0.0471,-0.1024,0.0566,0.0739,0.0903,-0.0157,-0.0796,0.016,0.0086,0.1212,0.0932,0.0913,-0.0999,-0.1032,0.1074,0.1066,0.0928,0.0824,0.0361,0.0648,0.1153,0.042,-0.0014,-0.0619,0.0485,-0.0941,-0.0575,0.1559,0.0954,0.0921,0.1049,0.0983,0.1032,0.0439,-0.0136,-0.0208,0.019,-0.0017,0.1556,-0.0725,-0.0527,0.0567,-0.1172,-0.0505,-0.0509,0.1469,0.0156,-0.0328,0.0671,0.1087,0.072,0.0808,0.0052,-0.0141,0.0962,0.1278,-0.0215,0.1182,0.0326,-0.0201,-0.0236,-0.0499,-0.1019,0.0396,-0.0167,0.1225,0.1177,-0.0285,-0.0,0.0505,-0.0897,-0.026,0.2168,0.1609,0.1546,0.0835,0.0863,-0.0665,0.0805,0.0292,0.0327,0.0886,0.072,0.1051,0.1473,0.0935,-0.016,0.0355,0.0317,0.0707,0.0642,-0.0495,0.1334,-0.1723,-0.0564,0.1339,-0.0013,-0.0765,0.0132,-0.1038,0.1567,0.0593,0.0882,-0.1111,-0.2497,-0.199,-0.2701,0.0447,0.1368,0.0348,-0.0161,-0.0779,0.0919,0.0266,-0.0234,0.065,0.0523,0.0478,0.1096,0.0357,0.0215,0.0717,0.0883,0.1502,0.0877,0.0772,0.0614,-0.0207,-0.0039,0.0359,-0.0317,-0.0669,-0.1326,0.0031,0.1005,0.0452,0.0531,0.1189,0.0438,-0.3126,0.096,0.0061,-0.3079,0.0243,0.0891,0.0483,-0.0008,0.2075,0.1389,0.2914,0.2414,0.1176,0.155,0.1152,0.1522,0.1445,0.0239,-0.0663,0.0193,0.0503,-0.0155,-0.0504,-0.0583,-0.0154,0.2663,0.138,-0.0062,-0.0777,0.0504,-0.0841,0.0354,0.0971,-0.0593,-0.1113,0.0666,0.0539,0.0121,-0.0742,0.0975,0.0775,0.0342,0.0969,-0.0685,0.0586,-0.0029,-0.0311,-0.0406,0.0672,0.0271,-0.0889,0.1027,0.1104,-0.0328,-0.3386,0.1096,0.0018,-0.0007,-0.0075,-0.0426,0.0055,0.0117,0.0333,-0.0201,-0.0398,0.0233,0.0444,-0.058,0.0147,0.0105,-0.0574,-0.0641,-0.1241,-0.0014,0.0457,0.0619,0.0365,-0.0885,-0.0555,0.0932,0.1225,-0.0747,-0.0784,0.0754,0.0797,-0.0482,0.1218,0.1142,-0.0675,0.0865,0.122,0.107,0.0509,-0.0762,-0.0803,0.0229,-0.0911,0.2002,0.0105,0.0243,-0.0095,-0.0596,-0.0535,0.1601,0.1489,-0.0745,0.1018,0.093,0.0799,-0.0577,-0.0427,-0.1461,-0.0446,-0.1118,-0.1644,-0.0622,-0.097,0.0538,0.0059,0.0875,0.1869,0.0492,-0.0414,0.127,0.0964,0.035,0.1142,0.0161,-0.0404,-0.0204,0.0027,0.0726,0.0214,-0.0002,-0.079,-0.0167,0.0544,-0.0755,0.0007,0.0221,0.0174,0.0274,0.0944,-0.0839,-0.0395,-0.1061,0.0349,0.0391,-0.0086,0.0593,-0.0173,0.0288,-0.0748,-0.0871,-0.0238,0.0069,0.0509,0.1017,0.0128,0.1736,0.0202,0.0367,0.0408,-0.0708,-0.0331,-0.0836,-0.0697,-0.0295,0.1039,0.0096,0.0647,-0.012,-0.0059,0.0639,-0.0187,-0.0428,0.0767,0.094,0.0084,-0.076,-0.0789,0.093,0.0834,0.2199,0.0199,-0.157,0.0328,-0.0713,-0.0637,-0.0491,-0.0489,-0.0306,0.0166,-0.02,0.1394,0.1339,-0.0188,0.2008,0.0331,-0.0574,0.0233,0.2238,0.0518,0.0631,-0.054,-0.0252,0.1927,0.1113,0.2056,-0.0509,-0.0268,0.0385,-0.0338,0.1053,0.1054,0.0788,-0.0383,-0.0223,0.0264,0.0115,-0.0123,0.0519,-0.0546,-0.0213,0.0667,0.0608,0.0642,0.0729,-0.0548,-0.0197,0.0959,0.0948,0.0301,0.1413,0.1084,-0.0569,0.151,0.0397,0.0874,-0.1246,0.0712,0.0176,0.0672,0.0308,0.0835,0.0434,0.079,0.1208,0.03,-0.1076,0.0515,-0.0376,-0.0877,0.1265,0.1095,0.0669,0.0897,0.055,0.0584,0.0443,0.0337,0.0414,0.0944,-0.1656,0.095,-0.019,0.0397,-0.0186,-0.0744,-0.0533,-0.0339,-0.1303,0.1484,0.0794,-0.0571,-0.0201,0.0157,0.0273,-0.128,-0.0879,-0.0672,-0.0449,0.0075,-0.0645,0.0181,0.0636,-0.0003,-0.0004,0.0284,0.0407,0.0967,0.0785,0.0762,0.081,0.044,0.0769,-0.0407,-0.1299,-0.0373,0.0559,-0.1063,-0.0194,-0.0156,0.0608,-0.0361,0.0978,-0.028,-0.0865,0.0741,0.1906,0.1991,0.0982,0.0302,0.0655,0.1283,-0.0401,0.0246,-0.0822,0.0068,0.0838,-0.0014,-0.038,-0.0511,0.1529,-0.1213,-0.133,-0.2239,0.0956,0.0313,0.1,-0.0379,-0.0148,0.1513,-0.0937,-0.1185,0.0366,0.0136,-0.0288,-0.0195,0.1615,0.2276,0.1948,0.153,-0.0518,-0.1936,0.0187,0.1127,0.0231,-0.0033,-0.0364,-0.0711,-0.0323,0.0126,0.0345,0.0852,0.0848,-0.0822,-0.0882,-0.1453,0.0469,0.0368,-0.0297,0.0689,-0.0185,0.066,0.1154,0.0092,0.1284,0.0982,0.0679,-0.1237,-0.1251,-0.0836,0.0106,0.0505,-0.0161,-0.1209,0.0408,0.0823,-0.0723,-0.0214,-0.0354,-0.0364,-0.1164,0.0246,-0.1465,0.1698,0.1715,-0.0794,-0.1525,-0.1389,0.0012,-0.0278,-0.0557,0.0148,-0.0134,-0.1342,0.0097,-0.0567,-0.089,-0.1553,-0.0588,0.0203,-0.1672,-0.1549,0.0956,-0.0486,-0.1037,0.1945,0.1053,0.0666,0.0996,-0.0765,0.2371,0.1109,0.1595,0.1072,0.1668,-0.0525,0.0093,-0.1177,0.0737,0.1074,0.0057,-0.0569,-0.1078,-0.0599,-0.0975,-0.1125,-0.0437,-0.0246,0.0007,-0.0253,-0.0912,-0.1462,0.0558,-0.0951,-0.0628,0.0134,0.0612,0.0818,0.0418,-0.0808,0.0629,0.1908,0.1363,0.0218,-0.084,-0.1474,-0.0397,-0.0378,-0.0531,0.0097,0.1007,0.113,-0.0252,0.0607,-0.0462,0.1253,0.0142,0.0825,-0.0907,0.0108,0.0122,0.0023,0.1619,0.1328,0.0795,-0.1638,0.0811,0.0784,0.0993,-0.0641,0.0092,0.1515,0.0563,0.1236,-0.0681,0.0691,-0.0878,-0.0666,-0.0186,-0.0798,0.1765,0.0725,0.0368,-0.0975,0.1172,0.0075,-0.0723,-0.0016,-0.0756,-0.2692,-0.0572,0.0438,0.0989,0.0583,0.063,0.0844,0.0035,-0.0586,-0.1377,-0.0332,-0.0439,0.1152,-0.1044,-0.2129,-0.0112,0.0172,0.0285,0.0338,0.1635,0.083,0.0769,0.043,-0.0388,0.1107,0.0269,-0.1526,-0.0092,0.0992,0.059,-0.0729,0.0318,0.0584,0.0521,0.1591,0.1644,0.1551,0.1305,0.1359,-0.0321,-0.017,0.0302,0.1245,0.0366,0.0992,0.0248,0.1226,0.0699,0.0507,-0.0171,-0.0999,-0.0932,0.0188,-0.0499,0.0255,-0.0483,-0.0853,-0.1171,-0.1711,-0.094,0.0384,0.0357,0.0035,-0.0334,-0.1393,-0.112,-0.0775,-0.0197,-0.1328,-0.0541,-0.1283,0.0022,0.03,0.02,-0.0715,0.0513,-0.0576,0.1566,0.066,0.0784,0.053,0.0415,-0.0359,-0.0327,0.0001,-0.1228,-0.1455,-0.1392,0.0569,0.0096,-0.0038,0.0291,-0.0133,0.0077,0.0402,0.0956,0.1267,0.0427,-0.0925,-0.0835,0.1036,0.1398,0.0562,0.1731,0.0735,-0.153,-0.0707,-0.1142,-0.0805,-0.0925,0.0633,-0.0092,-0.0663,-0.0022,0.0114,0.0047,-0.0275,0.0312,0.0576,0.0283,-0.0449,0.1032,0.0093,0.0511,-0.0349,0.1481,0.013,-0.0303,-0.0806,0.0054,-0.0628,-0.0048,0.0456,0.0089,0.0073,0.0048,0.0718,-0.0032,-0.0102,-0.0282,0.0521,0.0743,-0.0152,0.0198,0.01,0.0939,0.0597,0.1368,0.0981,0.0833,-0.1831,0.0029,-0.0294,0.1184,-0.1851,-0.1279,0.0164,-0.0041,0.0129,-0.0684,0.0126,-0.0595,0.1202,0.085,0.0006,0.0478,0.106,0.014,0.0509,-0.0682,-0.0545,0.0545,-0.0143,0.069,-0.0518,0.0628,-0.0216,-0.0505,-0.0754,0.0977,0.0249,0.0563,-0.0039,0.0227,0.0438,-0.3692,-0.2518,-0.1603,-0.0776,-0.1087,0.0121,-0.1426,-0.1273,0.1518,-0.379,-0.3595,-0.2818,-0.1931,-0.3043,-0.072,-0.1109,-0.036,-0.0369,-0.1004,-0.012,-0.1152,-0.0421,0.126,-0.0705,-0.055,-0.0384,-0.0837,0.017,0.0509,-0.2166,-0.1085,0.1084,0.0083,0.0958,-0.0975,-0.0297,-0.1489,0.0562,0.1368,0.0762,-0.0184,-0.0454,-0.1349,-0.1749,0.0943,0.0892,0.1137,0.0641,0.076,-0.3628,0.1186,-0.1161,-0.1337,0.069,-0.0624,0.0604,0.0264,-0.0207,0.0193,-0.1242,-0.0582,0.0202,-0.0351,-0.0594,0.1114,0.1503,-0.0238,0.0584,-0.0267,0.009,0.0981,0.0546,0.0856,0.0175,0.0388,0.0328,0.1367,0.0609,-0.2448,0.0154,-0.004,0.0176,-0.1964,-0.0407,-0.0287,0.1694,0.164,-0.0275,0.1078,0.1124,0.1175,0.0697,-0.0084,0.0284,-0.0788,-0.0741,-0.0535,-0.1282,0.0221,-0.0019,0.0406,-0.0931,0.0157,-0.0996,0.069,-0.108,-0.2238,0.0198,0.0777,-0.1727,-0.1201,0.047,0.0844,0.0009,0.1583,0.0904,0.1993,0.0303,-0.0452,0.0758,0.0153,-0.0372,0.0617,-0.0147,0.0926,0.0281,0.0298,0.0739,0.0781,-0.0845,0.0321,-0.4768,-0.3594,-0.3266,-0.4159,0.0807,0.0586,0.088,0.0868,0.1154,0.0558,0.1007,-0.158,0.0771,0.1149,-0.1232,-0.0291,0.0246,-0.146,-0.0537,-0.012,-0.0116,-0.0859,0.1003,0.1095,0.046,-0.1355,-0.0313,-0.0,0.0942,0.0942,0.1809,-0.0606,-0.0047,-0.0021,0.0833,-0.0682,0.0385,-0.1643,0.2696,0.2496,-0.1296,0.0136,0.2146,0.218,0.221,0.0877,0.0729,0.0212,0.0201,-0.0012,-0.0759,-0.0487,-0.1412,0.0603,-0.1142,0.0716,-0.0446,-0.1081,0.0327,0.0227,0.0319,0.0153,-0.0163,0.037,-0.0109,-0.0386,-0.0456,0.0074,0.0528,-0.027,0.0215,-0.0611,0.0476,0.0435,0.0258,0.1093,0.0328,0.1519,0.2944,0.0207,0.0718,0.1892,0.07,0.0909,0.1505,0.0012,0.1036,0.0033,0.1429,0.0076,0.1008,0.1445,0.0132,-0.0268,0.0573,-0.2513,-0.1032,-0.0119,-0.057,0.0328,-0.0178,0.0107,0.0973,0.0958,-0.0026,0.0643,-0.0139,0.1022,0.002,-0.0499,-0.0252,-0.0359,0.1414,0.102,0.0102,-0.0264,0.0128,0.0251,0.0182,-0.0256,0.0182,0.0834,0.0407,0.1313,0.1222,-0.0038,0.1675,0.1744,0.0163,0.0117,-0.014,0.0335,0.0178,0.1272,0.124,-0.0275,0.1297,-0.0153,-0.0093,0.0611,0.1403,0.1278,-0.0882,-0.1132,-0.0888,-0.0459,-0.0108,0.011,-0.2588,-0.0449,-0.0152,-0.0053,0.1651,-0.1067,0.013,-0.0819,-0.0296,-0.1661,-0.0246,0.1082,0.0594,-0.0985,0.0933,0.0029,0.0965,0.0246,0.0886,0.0377,-0.0154,-0.0608,0.0135,0.0947,0.0876,-0.0515,-0.0292,0.0261,-0.0182,0.1401,-0.0383,-0.0067,0.068,-0.0705,0.0565,0.0807,0.0242,0.0964,0.0911,0.1023,0.0328,0.0668,-0.0133,0.0177,-0.1167,0.0382,0.0274,0.0617,0.0236,0.0127,0.0184,0.1545,-0.0767,0.1301,0.0656,-0.0224,-0.0981,-0.0784,-0.0015,-0.0261,0.0677,0.0163,0.0745,0.0513,0.1674,0.0191,0.1509,0.0336,0.0028,0.0359,0.0436,0.0681,0.065,-0.1378,-0.0906,0.0117,-0.3291,-0.0397,-0.0714,-0.0284,-0.2246,0.0154,0.0543,-0.0593,-0.2157,0.0512,-0.0086,0.0755,0.1078,0.069,0.0801,-0.0689,0.0736,0.0705,-0.0805,-0.1457,0.0602,0.0806,0.0223,-0.0134,-0.0418,-0.0598,0.2114,0.1089,0.018,0.2141,0.1603,-0.1249,-0.0513,-0.048,-0.0564,-0.0852,-0.0443,0.1843,0.0699,0.0416,0.0594,0.1864,0.044,0.0455,0.0664,0.083,-0.1183,0.0109,0.0211,-0.0215,0.0059,-0.1087,-0.1718,0.0775,-0.0392,0.0297,0.0386,0.1083,0.0429,-0.0489,0.0251,-0.0075,-0.156,-0.0126,0.0033,0.0758,0.0918,0.0085,-0.3246,-0.3087,0.1364,0.1281,-0.0208,0.0528,0.0974,0.0489,0.1439,-0.0446,0.0134,-0.0047,0.0128,-0.0287,-0.1405,0.064,-0.0616,-0.1107,0.0355,-0.0517,-0.2972,0.0997,0.06,-0.2899,-0.0432,-0.0309,-0.1157,-0.108,0.0709,-0.1731,-0.1088,0.0882,0.0253,-0.0563,-0.0175,-0.1499,-0.0715,-0.0046,0.0029,0.0487,-0.1258,0.1292,-0.007,-0.1864,-0.0051,0.0052,0.0141,0.0006,0.1376,0.0327,-0.0911,0.0657,-0.0782,0.0777,-0.0852,-0.1731,0.0406,0.0075,0.0011,-0.0553,-0.0036,-0.1015,-0.0707,-0.1067,-0.0233,-0.1661,0.0134,-0.0429,-0.4188,0.1059,0.0779,0.0197,0.0367,-0.0315,-0.0709,-0.1199,0.0604,0.0159,-0.0345,0.0415,-0.0008,0.0108,0.0422,0.0097,-0.0234,-0.0414,-0.0923,-0.1156,-0.297,-0.2978,0.0848,0.1179,0.0536,0.0317,-0.1319,-0.1153,0.0026,-0.0411,-0.0814,-0.0126,-0.0747,0.1067,0.1831,0.1015,-0.021,-0.1261,0.0482,-0.039,-0.0476,-0.1483,-0.0957,-0.0459,-0.0041,0.0807,0.0063,-0.0189,-0.0719,0.0883,0.0949,0.1209,-0.0943,0.0406,0.0131,-0.1688,0.0564,0.0476,-0.0673,-0.0608,-0.0438,-0.0668,0.036,0.0124,-0.0418,0.008,-0.0912,-0.1015,-0.1311,0.0563,-0.0536,-0.0724,-0.0134,0.1243,-0.0038,0.1811,0.0778,0.0466,0.1009,0.0304,-0.0926,0.1248,0.0789,0.0705,0.0708,0.0567,0.0596,0.0982,-0.0082,0.0251,0.0274,0.0543,0.0134,-0.1179,-0.0013,-0.081,0.2029,0.1365,0.1681,0.0173,-0.0317,0.0848,0.0746,0.0189,0.1206,0.0555,-0.1546,-0.0234,-0.1405,-0.093,-0.0092,-0.0472,0.0314,0.0117,0.0382,0.0352,0.1871,0.0566,0.1066,0.0995,0.0591,-0.0125,-0.0727,-0.3258,-0.2492,-0.0926,-0.0928,0.0892,0.288,0.1645,0.2241,0.1531,-0.0074,0.033,0.0215,0.0573,0.1734,0.1452,0.0568,-0.0584,-0.05,0.0515,0.0395,0.0329,0.0977,0.1782,0.1107,0.0513,-0.0827,0.0131,0.004,0.1735,0.0577,0.0912,0.101,0.2139,-0.0139,0.0076,0.0519,0.0623,0.0595,0.0644,0.0151,0.1723,0.0953,0.0511,-0.1002,-0.1124,-0.0948,-0.0822,-0.0516,0.0558,-0.049,-0.0219,-0.1425,0.1131,0.0558,0.0162,-0.0913,0.117,0.1243,0.0659,0.0936,0.0655,0.1151,0.1052,0.1122,0.0366,0.0366,-0.042,-0.0309,0.2464,-0.0294,0.041,0.0809,0.053,0.0984,0.0052,0.1081,0.0191,-0.0013,-0.1614,-0.002,0.0108,0.1506,0.0907,0.0849,0.0897,0.1304,0.1047,-0.0217,-0.0661,-0.0521,-0.0176,0.1026,-0.0289,-0.1145,-0.1853,-0.1438,0.1875,0.2089,0.0806,-0.0703,-0.0178,0.0995,-0.0462,0.0533,-0.0582,0.0118,0.0832,0.072,0.0253,0.0765,0.1021,0.0055,0.0958,0.0183,0.0588,-0.0058,-0.0467,-0.1036,0.0952,0.1198,0.1159,0.1403,0.1032,0.227,0.1202,-0.2366,0.068,0.0889,0.0263,0.0184,0.0851,0.0109,0.0541,0.0757,-0.1442,0.0515,-0.0099,-0.0086,0.0795,0.0527,0.0829,-0.0205,-0.1145,0.1406,0.073,-0.0275,-0.1891,-0.0197,0.0362,-0.0618,0.0173,0.0026,-0.0031,-0.1033,-0.0212,-0.0306,0.1254,0.1105,0.1287,0.0383,0.0992,-0.0561,-0.1815,-0.2438,-0.0368,-0.0531,-0.0879,-0.0936,-0.0367,-0.065,-0.0227,-0.0013,-0.0516,0.2187,0.1027,0.1326,0.082,-0.0342,0.1011,0.1126,0.065,-0.0185,0.0555,0.196,0.0851,-0.0319,0.1052,0.2009,-0.0474,0.0964,0.0152,-0.0598,0.1201,-0.0196,0.1382,0.0721,-0.0141,0.0954,0.0886,-0.0396,0.1213,-0.0569,-0.0457,-0.0437,0.0258,0.092,-0.0423,-0.0102,0.0427,-0.0615,0.0334,0.0449,-0.0733,-0.0015,0.035,0.1617,0.1022,0.0314,0.0275,0.0055,0.014,0.0925,0.085,0.0853,0.0795,-0.0875,0.1077,0.061,-0.0289,-0.0232,0.002,-0.0617,-0.0278,0.1816,0.1052,0.1533,0.1303,-0.1197,-0.2104,-0.2348,0.0623,-0.4091,-0.2478,0.1579,0.1,-0.4419,-0.1171,-0.0588,-0.1116,-0.1648,-0.0954,0.1277,0.1238,0.0832,0.136,-0.458,-0.3492,-0.2757,-0.0597,-0.1277,-0.2494,-0.467,-0.461,-0.4214,-0.0521,0.0074,0.0577,0.003,0.0686,0.0006,0.1123,0.0509,0.042,0.0103,0.0932,0.0866,-0.1378,0.0326,0.0301,0.1086,-0.0607,-0.1008,-0.1539,0.0223,0.014,0.096,0.0122,0.0235,0.0027,0.05,0.0755,0.0565,0.0144,0.1206,0.1861,0.1707,0.0206,0.0693,-0.0311,-0.159,-0.0467,-0.1371,-0.0636,-0.0555,-0.3405,0.0714,0.1553,0.1804,0.038,-0.0781,-0.0047,-0.1679,-0.0402,-0.123,-0.029,0.1545,0.1541,0.0872,0.0786,-0.023,0.2095,0.1512,-0.0342,-0.0089,-0.1869,0.0942,-0.0082,-0.0904,0.0142,0.0365,-0.0161,0.0732,0.1332,0.1338,0.0423,0.0264,0.0828,0.0296,0.0862,-0.1168,-0.1939,-0.1802,-0.0256,-0.1646,0.0443,-0.0264,-0.0807,-0.0969,-0.172,-0.1622,-0.0344,-0.047,0.0251,-0.0723,-0.0837,0.0766,0.0743,0.0382,0.014,0.0407,-0.0331,0.0413,0.0112,0.0539,-0.0603,-0.0489,-0.0372,-0.0691,0.0087,-0.1553,-0.1443,0.111,0.1559,0.1347,0.1204,0.1803,-0.1008,0.0254,0.0598,0.0413,-0.1762,-0.0025,0.1794,0.0775,-0.0152,0.0305,-0.018,-0.0381,-0.0601,-0.1511,-0.2007,-0.3993,-0.1181,-0.0848,0.0435,0.0495,-0.0567,0.1221,0.1089,0.0784,0.0106,0.0796,0.029,0.042,0.0878,0.0592,0.1265,0.1721,0.1407,0.0765,0.1005,0.1443,0.0487,0.073,-0.0084,0.0157,0.0146,0.0556,0.0757,-0.206,-0.0569,-0.0505,0.0939,-0.1418,-0.1185,0.0666,-0.0787,0.1412,0.0873,-0.0347,0.0433,0.0526,0.0241,-0.0332,-0.0894,-0.0162,0.0733,0.0571,-0.0368,-0.0022,-0.0426,0.1213,-0.042,0.0128,-0.0348,-0.0296,0.158,0.1183,0.0676,0.0759,0.0713,0.0425,0.0807,0.0002,-0.0597,-0.0293,-0.0148,0.235,0.1379,0.1295,0.1537,0.1479,0.1164,0.154,0.154,0.0328,0.0353,-0.0574,0.1778,-0.0081,0.088,0.0835,-0.0455,-0.0562,0.2165,-0.1453,0.1334,-0.0309,-0.0357,-0.1539,-0.073,-0.0129,0.1261,0.0887,-0.0162,-0.0673,-0.0096,-0.1253,-0.0386,-0.0023,-0.1342,-0.1043,-0.0266,-0.0366,0.0221,0.037,0.0091,0.0942,0.0566,0.0508,0.0825,0.0699,0.0541,0.0532,-0.0302,0.025,0.0318,-0.0223,-0.1229,0.0091,-0.1542,-0.0493,0.1321,0.0562,0.1695,0.073,0.0792,-0.046,0.0688,-0.0278,-0.0134,0.0396,-0.0882,-0.1046,0.0414,-0.1487,-0.0239,-0.318,-0.1092,-0.0011,-0.0748,0.1024,-0.056,-0.0995,-0.0811,0.0396,0.0138,-0.0657,0.0031,0.0027,0.1142,0.0923,0.0929,0.0727,0.0539,0.0311,0.1381,-0.1984,-0.0007,-0.105,-0.1653,-0.0077,-0.0344,-0.0096,0.0825,0.1105,0.0639,-0.0926,-0.0916,-0.0061,0.0053,0.1124,-0.011,-0.098,-0.1021,-0.1239,-0.013,-0.0311,0.0634,-0.0772,0.0674,-0.0383,-0.0247,0.0294,0.0489,0.0481,0.0697,0.0819,0.0318,0.0002,0.0907,-0.0549,-0.0012,-0.1201,0.0029,-0.0689,-0.0621,-0.0032,0.0766,0.0873,0.0815,0.0562,0.008,-0.0347,-0.0232,0.0141,0.0118,-0.1315,0.011,0.1307,0.0798,0.1645,0.1159,-0.014,0.0253,-0.0194,0.0972,0.0738,0.127,0.0198,0.0871,-0.0275,-0.0187,0.1311,-0.1249,0.0746,0.0813,0.052,-0.0272,0.1175,-0.0132,-0.0361,-0.0053,0.1437,-0.1078,0.0151,0.0699,-0.1097,-0.0661,-0.0132,-0.0693,0.0941,0.089,0.0953,0.1704,0.1795,0.0988,0.1072,0.0401,0.0073,-0.1211,-0.1142,-0.0962,0.1361,0.1572,-0.0875,-0.2354,-0.3234,-0.0735,0.0376,0.0079,0.0547,0.0951,-0.0254,0.0842,0.0783,0.0828,0.0172,0.0817,0.1761,-0.241,-0.0314,-0.0343,-0.2037,-0.0668,-0.0769,0.0866,0.0523,0.086,0.0495,0.0984,-0.0072,-0.0521,-0.0498,-0.0038,0.0534,0.0357,0.0843,0.0023,0.0522,0.1358,0.0005,0.0212,0.022,0.0051,-0.0145,0.011,-0.015,0.0625,-0.0873,0.208,0.1061,0.1438,0.1742,-0.0337,0.1449,0.1132,0.2334,0.103,0.0919,-0.0722,0.175,0.0144,0.0536,-0.0436,-0.0635,-0.057,0.1115,0.147,0.0353,0.0139,-0.0739,-0.09,0.0652,-0.0045,0.0213,-0.0882,-0.0259,-0.0366,-0.0875,0.0162,0.0785,-0.0049,0.0259,-0.0077,-0.0451,-0.0057,0.0637,0.0344,0.011,-0.1646,0.0338,-0.187,-0.1876,0.0772,-0.0094,0.0349,0.1449,0.0992,0.0251,-0.1599,-0.2429,-0.1046,-0.046,-0.0259,-0.01,-0.1404,-0.1428,-0.1355,-0.0972,0.1403,0.0628,0.0795,-0.0536,0.0554,0.009,0.0515,0.0117,-0.0655,-0.0169,-0.0563,0.0798,-0.101,-0.0074,0.1596,-0.1808,-0.0876,-0.0311,-0.0344,-0.0833,-0.1266,-0.0233,-0.0271,-0.0301,0.0239,-0.056,-0.2095,-0.1668,-0.0118,0.0182,-0.1124,0.0289,0.1632,0.3119,0.3017,-0.0218,-0.0588,-0.0204,0.0528,-0.0099,-0.0526,0.0395,0.0633,0.103,-0.0884,0.045,-0.0082,0.0137,-0.0412,0.009,0.1391,0.0347,0.1358,0.1027,0.046,0.052,-0.0002,0.2305,0.0595,0.0049,0.0694,0.0034,-0.0834,0.0114,0.1395,0.0856,-0.2062,0.1049,-0.1157,-0.038,-0.0696,-0.0111,-0.0576,0.1049,-0.0944,-0.0698,0.0795,0.036,0.0067,-0.0347,0.0917,0.1056,0.1103,0.1883,0.0741,0.0289,0.0147,-0.0819,0.0111,0.095,0.1365,0.2153,-0.0709,-0.0828,0.1504,0.0361,0.0402,0.1085,0.1688,-0.23,-0.0855,0.0754,-0.0088,-0.1167,-0.0793,0.1276,0.1237,0.1484,0.1772,0.1046,0.0997,-0.0681,-0.0347,-0.0447,-0.0435,0.0657,-0.0616,-0.3708,-0.1953,-0.1518,-0.3191,0.2269,0.1324,0.1244,-0.0867,0.0097,0.0195,0.0651,-0.0277,-0.0693,0.1643,0.1133,0.0305,-0.2018,0.0824,0.0651,0.0772,-0.0071,-0.0966,-0.1574,0.0476,0.0668,0.0524,0.0544,-0.0455,-0.1009,-0.0901,-0.0539,-0.0562,0.0345,-0.0194,-0.0539,-0.0654,-0.0173,0.1203,0.0016,0.0313,-0.0048,0.0013,0.0422,-0.1247,-0.0779,-0.0173,-0.0218,0.0835,0.0392,0.1904,0.1569,0.063,0.1483,-0.3248,0.0146,-0.2667,-0.1242,-0.0681,0.0241,0.0147,-0.1048,0.0366,-0.1192,-0.1537,-0.0685,-0.1166,-0.0237,-0.0173,0.0847,0.0867,0.1137,0.0157,-0.127,-0.1569,0.111,-0.0034,-0.0459,-0.0021,0.0155,-0.0048,0.0247,0.0875,0.0122,0.148,-0.0646,0.0445,-0.1846,-0.0659,-0.0492,-0.0404,0.0279,0.0133,0.0356,0.0608,-0.0978,-0.1523,0.0358,-0.0152,0.0529,-0.044,0.0417,0.0846,0.0318,-0.0998,-0.0887,-0.0013,0.1647,0.099,0.1138,0.1008,-0.0243,-0.0288,0.0782,0.0519,0.0812,0.1226,0.0998,0.0696,0.071,0.0849,0.0532,0.0096,0.1086,-0.0551,0.1437,0.1378,0.1173,0.0529,-0.0222,0.0862,0.1064,-0.053,-0.0398,-0.0683,0.0756,-0.2131,-0.2342,-0.0881,0.0598,-0.049,0.0499,0.0551,-0.0601,0.0128,-0.0751,-0.1973,-0.2158,0.0026,-0.0475,-0.0638,-0.0626,0.1095,0.0595,0.0354,0.0449,0.0782,0.0777,0.0219,0.1009,-0.0171,0.1719,0.1422,-0.0962,-0.0299,0.1916,-0.0129,-0.0659,-0.117,0.0633,0.0904,0.3202,0.2722,0.1488,0.2199,-0.1873,0.0592,0.0353,-0.0351,0.027,0.0738,0.1532,0.0528,-0.2429,-0.1426,-0.2493,-0.1377,-0.1059,0.0381,0.0142,-0.0825,-0.0653,-0.0585,-0.0058,0.0072,-0.2315,-0.1366,0.1115,0.2321,0.1211,0.1298,0.1574,-0.0201,0.1112,-0.0836,-0.0601,-0.0439,-0.0742,-0.0618,0.1989,0.0371,0.1683,0.0182,0.1466,0.1847,0.0276,-0.0649,0.0369,0.0199,0.0695,0.1645,0.0749,0.15,0.0709,0.1365,0.0726,-0.0089,-0.0377,0.036,0.075,-0.0407,-0.0163,-0.0012,0.0971,0.0883,0.0827,-0.0086,-0.1082,-0.0349,0.0724,-0.1843,0.0424,0.0373,-0.0345,-0.0401,-0.0365,0.0243,0.0076,-0.0018,-0.0284,0.0071,-0.197,-0.2604,-0.3014,-0.0008,-0.0604,-0.0146,-0.0636,0.0508,-0.1113,0.0646,-0.1885,0.0298,0.0106,0.0148,-0.1018,-0.0115,0.025,-0.0276,-0.0655,0.0107,0.0009,-0.0489,-0.0728,0.0516,0.12,-0.055,-0.0961,-0.0994,0.1905,0.1195,0.1864,0.0197,0.1317,0.0651,0.0109,-0.0579,0.0075,0.0618,0.1401,0.1342,-0.0119,-0.0469,0.1158,0.056,-0.1909,-0.0372,0.0699,-0.1048,-0.2489,-0.0855,-0.0886,-0.1872,0.0829,0.0006,-0.2426,-0.092,0.0482,-0.2303,-0.0209,-0.064,-0.071,-0.2568,-0.0631,0.125,0.1513,0.1108,-0.0289,-0.1842,0.0406,-0.084,0.0481,0.0159,0.035,0.0877,0.0004,-0.1278,0.0413,0.1327,-0.0342,0.0526,0.0729,0.0033,0.0521,0.0451,0.0463,0.0899,0.0541,0.1813,0.1173,-0.1382,-0.231,0.0006,0.0594,-0.0463,-0.0506,0.0411,0.1003,0.1395,0.1963,-0.0898,-0.0471,0.0972,0.126,0.1015,0.0388,0.1226,0.0746,0.0186,0.0822,0.0522,0.1324,0.0867,0.0412,0.1105,0.0328,0.0059,0.035,-0.1314,0.0891,-0.0011,-0.1586,0.0075,0.1245,0.047,0.1075,0.17,0.0984,0.0773,0.098,-0.0577,-0.0527,-0.094,0.0757,0.1551,-0.0216,0.0493,0.0383,-0.0246,0.165,0.0923,0.1386,-0.0607,-0.0314,-0.0998,0.0491,0.2016,0.1766,0.0735,0.0616,0.01,-0.0366,-0.1014,0.052,0.1171,0.0911,0.0887,0.1182,0.2464,0.1129,0.087,-0.0585,-0.023,-0.0897,0.0209,-0.1371,-0.0016,-0.0462,0.0137,-0.0962,-0.1496,-0.0889,-0.0394,-0.0253,0.1028,-0.0044,0.0818,0.0218,0.0636,0.044,-0.0013,-0.0009,0.0919,0.0701,0.0562,0.022,0.0908,0.0307,0.0148,-0.2115,0.0477,-0.1205,-0.0447,-0.0598,-0.0117,-0.0252,-0.0235,0.0493,0.144,0.0223,-0.1616,-0.0482,0.0451,0.0459,0.066,0.1047,0.0898,0.0244,0.0811,-0.0677,-0.0838,0.1776,0.1465,0.0326,0.1048,0.0968,0.0589,-0.2641,-0.1986,0.1176,-0.0291,0.0903,0.0571,0.09,0.0916,0.1824,0.1441,-0.0633,0.0176,0.095,-0.0038,0.1265,0.0193,-0.1681,0.0294,0.0004,0.0096,-0.0337,-0.0328,0.137,0.0195,-0.1277,0.1188,-0.0725,0.1181,-0.0937,0.1489,-0.4138,-0.0265,-0.0443,0.1666,0.1433,-0.0298,-0.101,-0.0106,-0.0812,-0.0338,0.0544,-0.0172,-0.0625,0.026,-0.0212,-0.0303,-0.0949,-0.1725,-0.1701,-0.2394,0.0218,-0.0281,-0.2124,-0.518,-0.204,-0.2158,-0.3406,-0.1869,-0.2016,-0.2669,-0.1508,-0.1929,-0.2109,-0.2048,-0.2748,-0.0942,-0.2842,-0.3876,-0.2719,-0.2692,-0.1881,-0.0798,-0.1728,0.1729,0.1039,0.1301,0.0904,0.0019,0.2472,0.2111,0.1147,0.0622,0.1017,0.2492,0.2172,0.138,0.0289,-0.0287,0.1295,-0.1182,0.0291,0.0823,0.0046,0.0695,0.0737,0.0985,0.0519,0.1398,-0.1169,0.197,0.2101,-0.0519,0.0342,0.0479,0.0074,0.0106,0.1314,-0.0764,-0.0854,0.1096,-0.2481,-0.3544,-0.0423,-0.1727,-0.1997,0.0946,-0.1692,-0.1699,0.0548,0.0568,-0.1728,0.0057,-0.0452,0.1387,0.0261,-0.1691,0.083,0.1046,0.0383,-0.0387,0.0069,0.0566,selective attention
trm_558c7b337080f,-0.0361,-0.0212,-0.0466,-0.1238,-0.0639,-0.0767,-0.0237,-0.0885,-0.049,-0.0283,0.0116,-0.0233,-0.0312,0.0262,-0.0744,-0.0488,-0.0252,-0.0334,-0.0453,0.0724,-0.0243,-0.0195,-0.02,0.0222,-0.0195,-0.0224,-0.0234,0.0341,-0.0091,-0.0072,0.0092,-0.0348,0.0127,-0.0146,0.0521,-0.0344,-0.0247,-0.0543,-0.0498,-0.0457,-0.0236,-0.0213,0.0168,0.0589,-0.0113,0.066,-0.0119,-0.0299,-0.036,0.0048,-0.0067,0.0728,0.0519,-0.0447,0.0471,0.017,0.0085,0.0043,0.0196,-0.0073,-0.0051,-0.0735,-0.0215,-0.002,0.0168,-0.0228,-0.0643,-0.0374,-0.0346,-0.0178,-0.0306,-0.0565,0.1154,0.0294,-0.1229,0.1523,-0.0222,-0.0445,-0.0262,0.0337,0.0643,-0.0004,0.0398,-0.0036,-0.0341,-0.0192,0.0153,-0.0563,0.0135,0.0096,-0.0328,-0.0352,0.0026,-0.0874,0.0128,-0.0399,0.0295,-0.0049,-0.0717,-0.1108,-0.009,-0.0096,-0.0322,-0.1362,-0.0029,-0.0521,0.0482,0.134,-0.0134,-0.0258,-0.0383,-0.0404,-0.0101,0.0131,-0.0144,0.0967,-0.0412,-0.1099,0.038,-0.0208,0.005,-0.0015,-0.0095,0.0682,0.0188,0.0601,0.0015,-0.0681,-0.0262,0.0033,0.1175,-0.0408,0.0241,0.0623,0.0281,0.0145,-0.0195,0.0244,-0.0043,-0.0195,-0.022,-0.0418,0.0946,0.0298,0.0102,-0.0814,-0.0582,-0.0261,-0.0395,0.052,-0.016,-0.0174,-0.0378,0.016,0.0222,-0.0232,-0.0257,-0.0445,-0.0419,-0.0417,-0.0277,-0.0413,-0.0391,-0.0562,-0.0211,0.0005,-0.0307,0.0547,0.0566,0.1324,-0.0794,-0.0304,-0.1231,0.1465,0.0498,0.0664,0.077,0.0715,0.0649,-0.0435,0.0553,-0.0054,-0.0697,-0.0299,-0.0023,-0.0276,-0.0258,0.1294,0.133,0.063,0.0851,0.0471,0.0587,0.0114,0.018,-0.0752,-0.1192,0.0898,0.1203,-0.0631,-0.0988,-0.1429,0.0867,0.001,-0.1121,0.0416,0.2225,-0.1049,-0.0894,-0.0455,0.0041,-0.0013,0.07,-0.0294,0.0751,0.0503,-0.0033,-0.0483,-0.1759,-0.0165,-0.0064,0.0011,-0.0364,-0.0293,-0.0353,-0.0127,0.0091,0.043,0.0515,-0.0158,-0.1715,0.0178,-0.0225,-0.0757,-0.0866,-0.0303,0.0781,0.072,-0.0251,0.0927,-0.1036,-0.0001,-0.1018,0.01,-0.0016,0.0275,0.0172,-0.0095,-0.0102,0.0499,0.0565,0.0165,0.0344,-0.0067,-0.0058,0.0485,-0.0045,-0.052,0.1058,0.0286,-0.04,-0.1158,-0.0406,-0.0471,-0.1202,-0.0933,-0.0642,0.0479,-0.0037,0.0838,-0.0231,0.0032,0.1629,0.0764,0.0127,0.0759,-0.0287,-0.0242,-0.075,-0.0275,0.0658,0.0929,0.0554,0.142,0.1469,-0.0061,0.0518,0.0845,-0.0678,-0.0117,-0.0226,0.0116,-0.0817,0.0003,-0.0042,-0.1051,0.0578,0.016,-0.0707,0.0018,0.0849,0.0013,-0.037,-0.0463,-0.1257,-0.1369,-0.0478,0.0397,-0.0143,0.0377,-0.0123,-0.0044,-0.11,0.0379,0.0202,-0.0382,-0.0165,0.0054,-0.031,0.0289,0.0448,-0.012,0.0684,0.0806,-0.045,-0.0587,0.0116,0.0251,-0.0676,-0.0789,0.0322,0.019,-0.0079,0.0116,-0.0144,-0.0327,0.0555,0.0598,0.1481,0.015,0.0136,-0.0253,-0.0605,-0.029,0.0437,-0.0004,-0.1059,-0.09,-0.0786,-0.0595,0.0219,0.0104,-0.1432,-0.023,-0.0166,-0.1387,-0.069,0.0566,-0.0355,0.0013,0.0176,0.0221,0.0421,-0.0992,-0.0535,-0.0891,-0.0694,-0.0658,-0.0033,-0.0284,0.0498,-0.0354,-0.0208,-0.0487,-0.0159,0.0138,0.0038,0.0445,0.2046,0.0093,0.1757,-0.1322,-0.0528,-0.0985,-0.0028,0.0263,0.0189,0.026,-0.0539,-0.0166,-0.1002,-0.0417,-0.1527,-0.0012,-0.0006,-0.0403,-0.1134,-0.0766,-0.0687,-0.0439,-0.0006,0.0244,0.0064,-0.0292,-0.0396,-0.045,0.1423,-0.0238,-0.034,0.0064,-0.0335,0.0086,-0.0042,0.16,0.0467,0.0641,0.1204,-0.0795,-0.0728,-0.0681,-0.0358,-0.0766,-0.0717,-0.1175,-0.0992,-0.0818,-0.0274,-0.0767,-0.0638,-0.1119,-0.0028,0.0666,0.0679,0.024,0.0604,0.0172,0.0192,0.0118,-0.0912,-0.0306,0.1185,-0.0578,-0.0878,0.028,-0.008,-0.059,0.0298,-0.0423,0.1014,-0.0194,-0.1072,-0.0021,-0.0047,0.0159,-0.0343,0.0295,0.0791,-0.0174,0.0007,-0.001,-0.0436,-0.0566,-0.0122,0.0353,0.0406,-0.0203,-0.0371,0.0471,-0.0358,-0.0267,-0.0457,-0.0215,-0.0516,0.0829,0.1891,-0.0285,-0.0158,0.0261,-0.0097,-0.0457,-0.1284,-0.0895,-0.1145,-0.0144,-0.0333,0.0011,-0.0207,-0.1067,-0.01,-0.0238,0.0741,-0.0549,-0.0481,-0.0686,-0.0496,0.0777,0.2093,-0.1328,-0.0011,-0.0276,-0.0161,0.0027,-0.0673,-0.0707,-0.0013,0.0271,0.1544,0.2071,-0.0093,-0.0948,-0.0064,-0.0393,0.1216,-0.0923,-0.0026,0.0025,0.0275,-0.0051,-0.0692,-0.037,0.0093,-0.0096,-0.0036,-0.1175,0.04,-0.0181,0.0075,-0.0021,0.0307,-0.0272,-0.0064,0.0035,-0.093,-0.0049,0.0893,0.0596,0.0169,-0.0531,-0.0096,0.0427,0.0114,0.0417,0.0307,-0.007,0.0003,0.0005,-0.0024,0.0353,0.0197,-0.0373,-0.0008,0.0574,0.0418,-0.0565,-0.0129,0.0425,0.0287,0.0132,0.0205,-0.0048,0.0608,-0.0018,0.0999,-0.0073,0.0669,0.0421,0.0103,0.1759,0.0576,0.0759,0.0269,0.1002,-0.1213,-0.0342,-0.2079,-0.1648,-0.004,0.0014,0.0617,0.0772,0.0736,-0.0055,0.0479,-0.0708,-0.0318,-0.0195,-0.2055,-0.0041,-0.0991,-0.0332,-0.0161,-0.037,-0.0764,0.0338,-0.1004,-0.0737,-0.0294,0.0046,-0.0004,-0.0281,0.026,0.0306,-0.0512,0.0299,-0.0622,-0.1591,0.0673,-0.0242,-0.0284,-0.0597,-0.0327,-0.0319,-0.015,-0.0022,-0.0394,0.028,0.002,-0.0289,0.0181,-0.0283,-0.0474,-0.068,-0.075,0.0009,-0.043,-0.0902,-0.0944,0.042,-0.0583,-0.0283,-0.0715,-0.0949,0.0456,-0.0126,-0.1375,-0.1275,-0.0537,-0.0893,0.0038,0.0214,-0.0437,-0.0915,-0.0918,-0.1773,-0.0033,-0.0031,0.0249,0.0371,-0.0686,0.0053,-0.0759,0.0234,-0.2117,0.0644,0.0351,-0.0728,-0.1595,-0.06,-0.0602,-0.006,0.0225,-0.1811,-0.0195,-0.1282,-0.0533,-0.0492,-0.0498,-0.0412,-0.1462,-0.0583,-0.1023,0.0165,-0.0179,-0.0661,0.0089,-0.0345,-0.0589,0.0154,0.0211,0.0227,0.0219,-0.0424,0.0304,-0.0236,-0.0172,-0.0131,-0.0264,0.0646,-0.0008,-0.0604,0.081,-0.1109,-0.0577,-0.006,-0.1389,0.0341,0.005,-0.0296,-0.0159,-0.0255,0.0207,0.0156,0.0682,0.0433,0.0551,-0.0213,0.0151,-0.0455,-0.0968,0.0414,0.0465,-0.0325,-0.1219,0.1339,0.0424,0.0559,-0.033,0.0642,-0.0255,0.0261,0.0624,0.0644,0.0122,-0.0093,0.062,-0.0075,0.0397,-0.0422,0.0644,-0.0304,-0.0406,0.0438,-0.1016,-0.1208,-0.0852,0.0033,-0.0755,-0.0456,-0.0189,0.0577,0.0932,-0.0005,-0.0366,0.0243,0.0514,0.0323,0.0194,0.0368,-0.0257,-0.0235,-0.0246,0.0651,0.0164,0.0163,0.0381,0.013,-0.0015,0.0126,0.0154,-0.0505,0.0927,-0.0958,-0.0294,-0.0296,-0.0002,-0.0371,0.0917,-0.0104,-0.1316,-0.0056,-0.0576,-0.0001,-0.0682,-0.0534,-0.0105,0.0009,-0.0278,-0.037,0.0198,0.0172,0.0045,0.0293,0.0008,0.0247,0.0421,0.0222,-0.0184,0.0091,-0.0358,-0.0246,-0.0149,0.0166,0.0412,0.037,0.0105,-0.0443,0.0317,0.0617,0.0158,0.022,0.0122,-0.0873,0.0571,-0.0978,0.0541,0.041,0.0409,0.0118,-0.1099,-0.129,-0.0803,-0.0462,-0.0028,0.0141,0.0129,-0.0439,-0.0149,-0.0048,-0.0548,-0.0226,0.0434,-0.0528,0.0413,-0.0932,-0.0226,0.0825,-0.0065,-0.0353,0.0081,-0.0139,-0.0041,-0.0049,-0.0404,0.0692,0.0119,-0.0268,0.0193,-0.0505,0.0253,0.0119,0.0561,-0.0392,0.044,0.0068,-0.0525,0.0266,-0.0103,-0.023,0.0556,-0.0031,0.0412,-0.0383,0.0158,0.0033,0.0348,-0.0009,-0.1494,0.0107,0.0446,-0.0155,0.0452,0.0561,0.0208,0.0484,0.0503,-0.081,-0.0953,-0.04,-0.2246,-0.0598,-0.0496,0.0197,-0.2591,0.0016,0.0061,-0.1516,-0.012,-0.1604,0.0872,0.118,0.0379,-0.1068,-0.0052,0.0025,-0.0092,-0.0454,-0.0498,-0.0501,-0.012,0.02,0.0464,-0.04,0.0944,-0.0114,0.1043,-0.0687,-0.068,0.0386,-0.0161,0.0651,-0.0066,-0.0278,-0.0278,-0.0309,-0.0154,0.0059,-0.1139,0.0248,-0.0024,0.013,-0.0149,-0.1004,0.052,0.0399,0.0298,-0.0516,0.0354,-0.0153,-0.028,0.016,-0.0706,0.0029,-0.0077,0.0225,-0.1246,-0.1056,-0.0698,-0.0452,0.0248,0.0073,-0.0442,0.0755,0.0197,-0.0418,0.0116,0.0581,0.0092,0.0124,-0.006,-0.0086,-0.0189,0.1487,0.0736,0.153,0.045,0.0794,0.0575,0.018,0.0537,0.1025,0.1247,0.1228,0.0905,0.1632,-0.0109,0.0197,-0.0436,-0.0077,-0.0236,-0.1019,0.0186,-0.0052,0.0164,0.0899,0.0574,-0.001,-0.0747,-0.0702,0.0884,0.1294,0.0874,0.0112,0.0357,0.1213,0.0512,0.0653,0.0456,0.0265,-0.0372,0.0168,0.0157,-0.0046,0.0151,0.0651,0.0086,0.1377,0.1239,0.01,-0.0058,-0.045,0.0283,-0.0242,-0.0013,-0.148,-0.0718,-0.0159,0.0046,-0.0302,0.0359,-0.0503,-0.0586,-0.0884,-0.0574,0.036,0.051,-0.0682,-0.0378,0.0693,0.0225,0.0557,-0.0076,-0.0568,0.0246,-0.0066,0.0162,0.0796,0.1068,0.0228,0.0486,0.0678,0.0421,0.0483,0.0425,-0.0746,-0.0442,0.0346,-0.0772,0.026,-0.0522,-0.0025,-0.0872,-0.0756,-0.1497,-0.2179,-0.1117,0.0034,-0.055,-0.1198,-0.019,0.0303,0.0358,0.0323,0.0385,-0.0131,-0.0104,-0.077,-0.0909,-0.051,-0.0819,0.0161,-0.0954,0.1075,0.0074,0.0886,0.0539,0.0358,-0.0946,-0.0696,0.0231,-0.0024,0.0591,0.0339,0.0413,0.0077,0.08,0.0311,-0.0586,-0.0351,-0.0058,0.0152,0.0059,0.0687,0.0396,0.0622,0.131,0.2171,0.0624,0.026,0.0584,0.0368,-0.1624,0.0085,-0.0137,0.0171,-0.0581,-0.0917,0.0178,0.0426,-0.0203,0.0744,0.0723,-0.0096,-0.1735,-0.192,-0.1872,-0.1338,-0.1591,0.0104,0.0165,0.3359,0.2787,0.214,0.1178,0.2928,0.2202,0.1069,0.197,0.1371,0.0908,0.0225,0.0106,0.0014,0.0266,-0.007,-0.0051,0.0517,-0.0022,0.0059,0.0845,0.1906,0.1147,0.0131,-0.0336,0.0362,-0.0121,-0.0534,-0.0502,-0.0184,0.011,0.1096,0.1128,0.062,0.0036,0.09,-0.1469,0.0093,0.0594,0.0547,-0.0102,0.2889,0.0455,-0.1555,-0.1706,0.0776,0.0551,-0.066,-0.2149,-0.2004,-0.137,-0.0848,-0.0493,-0.0237,0.0041,-0.0249,-0.1087,-0.0427,0.0553,0.0585,-0.1182,0.0041,-0.0302,-0.0286,0.0122,0.0194,-0.0508,0.0199,-0.1434,-0.1144,0.2041,0.1005,0.0249,-0.001,0.0688,-0.0351,-0.0369,-0.0104,0.0121,0.085,-0.0445,-0.1214,-0.0807,0.0111,-0.0171,0.0361,-0.0201,-0.0559,-0.0416,-0.2062,0.0504,0.1218,0.0268,-0.0078,-0.0281,-0.1358,0.0536,-0.0719,-0.1248,-0.0934,0.1673,-0.1355,-0.1408,-0.0613,0.0896,0.0453,-0.0411,-0.0215,-0.0023,-0.0188,-0.1183,-0.0179,-0.0746,0.0099,-0.052,0.058,0.0056,-0.0225,-0.0348,0.0057,-0.0935,0.0207,-0.0244,0.3281,0.2815,0.1528,0.3065,-0.0146,-0.0956,-0.0265,-0.0379,-0.0724,-0.0356,-0.1363,-0.0091,0.0724,-0.0109,0.0039,-0.1073,-0.0024,0.0098,0.0372,-0.0494,-0.0389,-0.059,-0.0144,0.0089,0.0629,0.1222,0.0063,-0.0038,-0.0921,-0.0921,0.0617,-0.0647,-0.0721,-0.0511,-0.0456,-0.0312,-0.0183,-0.1231,0.015,0.0184,0.0941,0.008,0.0056,0.0131,-0.0425,0.0062,-0.0257,-0.013,-0.03,-0.0339,-0.1855,0.116,0.2052,0.0337,0.1218,0.0153,0.1091,0.0905,0.0279,0.0213,-0.0147,0.0804,0.062,0.0277,0.0134,0.0018,0.1203,-0.1935,-0.1093,-0.1229,-0.0476,-0.1024,0.1124,0.0166,-0.0231,-0.0102,-0.0848,-0.0309,-0.0943,-0.0805,-0.0083,-0.033,-0.0937,-0.0261,0.0041,0.0521,-0.0721,0.0139,0.0494,0.0649,-0.0307,-0.1012,0.0169,-0.0417,-0.0478,-0.0376,0.0768,-0.0429,0.0341,-0.051,-0.0628,0.0616,-0.0174,-0.0148,0.0124,0.0132,0.0124,0.0218,-0.0252,-0.0158,0.0337,0.0461,0.0563,0.0358,-0.0775,0.0539,-0.0582,-0.0426,0.0368,-0.0291,0.0467,0.0161,0.1258,0.1191,-0.0235,0.0147,-0.0661,-0.0584,-0.0261,-0.0279,0.0273,-0.0703,-0.0113,-0.0654,-0.0424,0.0065,0.0397,-0.0437,0.008,-0.1272,-0.1509,-0.0604,0.0523,-0.0305,0.1316,-0.0191,-0.0281,0.0285,0.1573,0.1274,0.048,0.0232,0.031,0.0176,-0.0158,0.0653,-0.1873,0.1316,0.0174,-0.0221,-0.0612,-0.035,-0.0732,-0.0203,0.0234,0.0264,0.0193,0.0629,0.0818,-0.0776,-0.0501,-0.0146,0.0947,0.0345,0.0575,-0.0408,0.0771,-0.0226,0.0276,0.0386,-0.0832,-0.0258,-0.0507,-0.0586,-0.0333,-0.0579,-0.0328,-0.0365,0.0157,-0.0094,0.0295,0.0265,0.0102,0.0434,-0.0314,-0.0478,-0.1022,-0.0726,-0.0047,-0.0622,-0.0645,-0.1332,-0.1886,-0.0362,0.0549,0.008,-0.0375,-0.0049,-0.0073,0.09,0.0281,-0.0379,0.0429,-0.0553,-0.1099,-0.0657,-0.0296,-0.0534,0.0177,0.048,0.093,0.1563,0.1884,0.0339,0.1809,-0.1063,0.0775,-0.0692,0.2397,0.0163,-0.0048,0.0581,0.0606,-0.0806,-0.039,-0.1547,-0.1331,-0.0539,0.0523,0.0557,-0.0756,-0.0883,-0.0166,0.0844,-0.0081,-0.0025,0.0078,-0.0507,-0.0596,0.0352,-0.0814,-0.0873,-0.0358,-0.1109,-0.0925,0.1005,-0.0489,0.0256,0.0116,0.0608,0.0282,-0.0062,-0.0334,-0.0869,-0.056,-0.0726,0.0421,-0.0127,0.1256,-0.074,0.0202,0.0575,0.0428,0.0709,0.0131,0.0095,-0.0859,-0.0709,0.0553,-0.0585,-0.0344,-0.0438,0.0691,-0.0094,-0.0124,0.0664,0.0386,-0.0693,-0.0802,-0.0125,-0.0296,-0.0611,-0.1286,-0.1378,0.0121,-0.0383,-0.0866,0.0034,-0.0678,-0.0122,-0.0014,-0.0043,0.0551,0.0083,0.0069,-0.0375,-0.03,-0.0413,-0.0718,0.0537,-0.0271,-0.0511,-0.1089,-0.1664,0.0284,0.0553,0.0633,-0.0207,0.0935,0.0942,0.0157,0.0205,0.0262,-0.0058,-0.0993,0.1292,0.0381,0.1371,0.1009,0.1067,0.139,0.0843,0.0162,0.013,-0.0468,0.0872,0.061,0.1593,0.0381,0.045,-0.0491,0.0125,0.0793,0.0423,0.2026,0.1198,0.1507,0.1377,-0.0008,0.0414,-0.0119,0.0572,0.0052,-0.0356,-0.1013,-0.0644,0.0603,0.0367,-0.0171,-0.0394,0.1271,-0.0057,0.0103,-0.0659,0.1764,0.0022,0.0889,0.0616,-0.0942,-0.053,0.0381,-0.0357,-0.0411,-0.0606,-0.0007,-0.0581,-0.0138,0.0323,0.042,0.0131,0.0338,0.036,-0.0176,-0.0788,0.0135,0.0035,0.1647,0.131,0.0945,0.0706,0.144,-0.0376,-0.0058,-0.1659,-0.0061,-0.0711,0.0391,0.0092,-0.1284,-0.1113,-0.0589,-0.0554,-0.0644,0.2005,0.0071,0.0135,0.0446,0.009,-0.014,0.037,0.0471,0.0225,0.026,0.0027,-0.0032,-0.0896,0.1242,0.1043,0.092,-0.1123,-0.0265,0.0306,-0.0517,-0.0307,-0.011,-0.0911,-0.0482,-0.1199,-0.0384,-0.0648,-0.0212,0.0745,-0.0667,0.0433,-0.0547,-0.01,-0.0386,-0.0209,-0.0458,-0.0385,0.049,-0.0764,-0.2122,-0.001,-0.1487,-0.1277,-0.1929,-0.1001,-0.0422,0.0081,-0.0065,-0.0764,-0.0474,-0.0813,-0.1332,-0.1055,-0.0013,-0.0042,0.0191,0.0008,-0.0321,-0.1053,0.0532,0.0882,0.0016,0.0771,0.061,0.0434,-0.0437,-0.0119,-0.0071,-0.0673,-0.0607,-0.0279,-0.0083,-0.1004,-0.0638,0.0371,-0.0112,-0.0247,0.0231,0.0024,0.0085,0.0912,0.1477,0.0608,0.0404,-0.0016,0.0201,0.0576,-0.0162,-0.0081,-0.0494,-0.0183,-0.0772,0.0584,0.0025,-0.0551,-0.0102,0.193,0.0892,-0.0577,-0.1255,-0.0526,-0.099,-0.0558,-0.0031,-0.0197,-0.053,0.003,-0.0604,0.0752,-0.0519,-0.0077,-0.0035,0.0902,-0.0348,0.1482,-0.0502,-0.0448,-0.0592,-0.0122,-0.0252,-0.0667,-0.0555,0.1738,0.0527,0.1123,-0.1028,0.0472,-0.0048,0.0474,-0.0221,-0.0027,-0.1082,-0.026,-0.01,0.0414,-0.0426,0.1532,0.1631,0.1741,-0.0878,0.013,0.0145,0.0056,-0.0376,0.002,-0.006,-0.0337,-0.0167,-0.0354,0.0597,-0.0142,0.0082,0.0197,-0.0254,0.1768,0.0126,-0.0572,0.15,0.0033,0.0425,0.28,0.0201,0.0006,0.0342,-0.0873,0.1782,0.1692,0.0008,-0.0037,0.0268,-0.0866,-0.0338,0.0324,-0.0651,-0.0207,0.0313,-0.0198,-0.0026,-0.0822,-0.0385,0.0012,-0.0919,-0.0494,0.036,0.0319,-0.0245,-0.0027,0.0046,-0.0591,-0.0177,-0.044,-0.0361,-0.0362,-0.0482,-0.0404,-0.148,-0.1002,-0.0391,-0.0099,0.0259,0.122,-0.0054,0.052,0.0346,0.0848,0.0605,-0.0335,-0.0524,-0.2413,-0.1226,-0.2106,-0.1864,-0.1042,-0.1348,-0.0504,-0.093,-0.0664,-0.0543,-0.1725,-0.1691,-0.2325,-0.2139,-0.0752,0.0181,-0.0067,-0.039,-0.0866,0.1885,0.1045,0.0093,0.079,-0.0298,-0.0689,-0.0141,0.0458,0.1066,-0.1057,-0.0328,-0.0568,-0.1006,-0.0269,0.076,0.0763,0.1617,0.1007,0.091,0.0378,0.0293,-0.077,0.0003,-0.0269,0.0117,0.0019,0.0602,0.0248,-0.0366,0.0883,0.0925,0.0632,0.0302,0.0156,-0.038,0.0591,-0.0998,-0.1367,-0.0469,-0.0243,0.0172,-0.0663,-0.1052,-0.0586,-0.0091,-0.0101,-0.0013,-0.0497,0.0272,0.0998,-0.0023,-0.0255,0.0179,-0.0771,0.0263,-0.0724,-0.0748,-0.1,0.0148,0.0813,0.0519,0.1386,0.1143,0.0933,0.0102,-0.0369,-0.0288,-0.0443,-0.1196,0.0496,-0.0538,-0.0959,0.0559,0.0412,-0.0344,-0.0049,0.0126,-0.0454,-0.0473,0.0613,0.0132,0.0236,0.1282,0.1269,0.0687,0.0344,-0.0981,0.0184,-0.0417,-0.0034,-0.1,-0.0886,-0.0335,0.0,0.1346,0.1146,-0.0497,-0.0504,0.1936,-0.0244,0.0782,0.0571,0.1532,0.0698,-0.0194,-0.0194,-0.0551,-0.0578,0.1137,0.0326,0.0759,-0.0034,-0.0103,0.1567,0.1819,0.1911,0.2058,0.0266,0.0032,-0.0496,-0.0532,-0.0156,-0.049,0.0433,0.0431,-0.0685,-0.0061,0.0239,0.0251,0.006,-0.0613,-0.0184,-0.1095,-0.0534,-0.005,-0.0494,-0.066,0.0426,-0.1035,-0.0738,-0.0215,-0.0635,-0.0329,0.0188,0.0005,-0.0173,0.0518,0.0093,0.0003,-0.126,-0.0531,-0.0592,0.0166,0.0098,-0.0786,-0.1001,0.0367,0.169,-0.1086,-0.0384,-0.0065,-0.0918,0.0113,0.0727,0.0024,0.0044,-0.0227,-0.0705,-0.0831,-0.0786,-0.0624,-0.0625,-0.154,-0.0959,-0.1334,0.009,0.0173,0.1563,-0.0921,-0.0127,-0.0066,-0.0512,0.1453,0.1068,0.116,0.0181,-0.0114,-0.1082,-0.0406,-0.0948,-0.1224,-0.1178,-0.025,-0.2122,-0.2328,-0.0807,-0.0523,0.1023,-0.0793,-0.0202,-0.1426,-0.089,-0.0945,-0.0302,-0.0374,0.0237,-0.1252,-0.106,-0.1298,-0.12,0.0774,0.0426,-0.0307,0.0008,-0.013,-0.0671,-0.0084,0.0327,0.0046,0.0398,-0.0601,0.0441,0.1257,0.087,0.0799,-0.039,0.0284,-0.0181,-0.0137,-0.0014,0.0206,0.0189,-0.0283,-0.029,-0.05,-0.0268,-0.0877,-0.0455,0.169,0.0561,0.0774,0.1373,0.0483,0.1407,0.092,-0.1008,-0.1355,-0.0489,0.0312,-0.0706,-0.0719,0.0276,-0.1064,-0.024,-0.1187,-0.1401,0.1051,-0.0159,0.1385,0.1075,0.0236,0.0455,0.0262,-0.0073,0.0451,-0.0365,-0.0261,-0.1109,-0.0301,-0.0175,-0.0396,0.0017,0.1161,0.0954,0.0578,-0.0679,0.153,0.1911,-0.0821,0.1393,-0.0365,-0.0176,-0.1876,-0.0041,0.0019,-0.026,0.0242,-0.0056,0.0172,-0.0689,-0.0351,0.0671,0.0475,0.0279,0.0102,-0.0124,0.0307,-0.0914,0.028,0.1218,-0.0072,-0.0225,-0.0009,-0.036,-0.0071,0.0306,-0.0423,-0.0228,-0.0198,-0.0582,0.0511,0.0108,-0.0279,0.0269,0.0443,0.0252,-0.0111,-0.0111,0.0612,-0.0244,-0.0517,0.0065,0.0217,-0.1184,-0.0972,0.1141,0.087,0.0317,0.1493,-0.0775,0.0095,0.2067,-0.2311,0.2324,0.159,-0.0165,-0.0685,-0.0431,-0.0775,0.0054,-0.2104,-0.0824,-0.1229,-0.0882,-0.0647,0.0691,-0.0138,-0.118,-0.0719,-0.0283,-0.0363,0.0697,-0.029,0.0201,-0.0203,-0.0472,-0.0517,-0.0105,-0.0194,0.0174,-0.0538,0.0324,0.0123,0.0725,0.0714,-0.0383,-0.0308,-0.0494,0.0046,-0.0636,-0.088,0.0557,-0.2212,-0.2091,-0.0661,-0.1809,-0.1717,0.0063,0.0612,0.0913,0.1512,0.0796,0.0058,-0.0946,-0.0398,-0.0298,0.0705,0.045,-0.0691,0.0881,-0.0033,0.0091,0.0274,-0.2191,-0.0256,-0.2197,-0.1335,-0.1812,-0.0966,-0.1636,-0.0362,-0.0671,0.0407,0.149,-0.0878,0.0332,0.0005,-0.0062,-0.0005,-0.0089,-0.0834,-0.0181,-0.0179,0.0055,-0.1049,-0.0388,0.06,0.0797,0.0046,-0.0034,0.0473,-0.1197,0.0188,-0.03,0.0242,-0.0098,0.0525,0.0533,0.0025,0.0301,-0.0243,-0.062,0.0914,-0.0199,0.0162,-0.0828,0.0947,-0.0659,0.0037,-0.0444,-0.0211,-0.038,-0.0245,-0.0068,0.0283,-0.0328,0.0315,0.0048,-0.0217,0.0339,0.1197,0.2198,-0.0301,-0.0127,-0.0375,-0.0096,-0.0045,-0.0079,0.0182,0.0257,0.0353,-0.0136,-0.0139,-0.0441,0.0179,-0.0315,-0.1259,0.0044,0.0597,0.0243,-0.0106,0.0995,-0.0314,0.0898,-0.107,-0.0564,-0.0322,-0.0059,-0.032,-0.0472,-0.0401,0.052,-0.0318,-0.0293,-0.0895,0.0696,-0.1086,-0.0105,0.0249,-0.0116,-0.0364,-0.1582,-0.1941,-0.0679,-0.0508,-0.0857,-0.0003,0.0397,0.1541,0.1476,0.2123,0.0932,-0.0436,0.0699,-0.0326,0.045,0.039,0.0741,0.0459,-0.0443,-0.0182,-0.0319,-0.0348,0.229,0.0675,0.0198,0.1867,0.0868,0.1196,0.0413,-0.0731,-0.1084,-0.0481,-0.0444,-0.0052,-0.052,-0.0363,0.0711,0.0252,-0.0149,-0.04,0.0166,-0.0085,0.0742,0.0179,-0.0189,-0.0092,0.03,0.0552,0.0237,0.0155,0.0061,0.0541,-0.0874,-0.036,0.0242,-0.0709,0.0418,0.0288,0.0248,0.0373,0.0104,-0.0988,-0.049,-0.0582,0.0103,-0.0397,-0.1055,0.0455,0.0203,-0.052,0.0066,0.0571,-0.0178,0.097,0.0236,-0.042,0.0128,0.0306,0.0264,-0.0385,0.0041,0.0052,-0.009,-0.0386,0.0056,0.0456,-0.0216,0.0691,0.0766,0.0006,-0.084,-0.0291,0.0853,-0.0116,0.1372,0.1181,-0.1261,0.0216,0.0858,0.0019,-0.0367,-0.0345,-0.0199,0.1039,-0.0179,0.0888,0.0312,0.0338,-0.0623,0.0529,-0.03,-0.0555,0.0954,-0.0006,-0.0221,-0.0185,0.0362,-0.0105,-0.1225,-0.0372,0.0799,-0.067,0.0354,0.0411,-0.0386,-0.0293,-0.0437,-0.0406,0.0227,-0.0011,0.0017,0.0422,0.0894,0.0244,0.1038,-0.0554,-0.1074,-0.1444,-0.0087,-0.0506,0.0783,-0.0081,0.1056,-0.0256,-0.0857,-0.0797,-0.0685,-0.0242,-0.0372,-0.064,0.0056,-0.0034,0.1145,0.0914,0.0854,0.0647,0.0408,0.0275,0.0107,-0.0343,-0.077,0.0497,-0.0262,-0.0384,-0.0221,-0.0553,-0.0987,0.1355,-0.0255,-0.0424,-0.0327,0.0352,-0.0441,-0.0255,0.065,0.0154,-0.1732,-0.0534,-0.0329,-0.0199,-0.0294,-0.1053,-0.0682,-0.0092,0.0298,-0.2099,-0.1706,-0.1597,0.0559,0.0025,-0.0508,0.0226,0.0617,-0.0152,-0.0311,-0.0013,-0.0013,-0.0572,0.133,0.0722,0.0603,-0.0166,0.0233,-0.029,0.1423,0.1789,0.0611,-0.0154,-0.0667,-0.007,0.0291,0.2089,-0.0593,0.0016,-0.0323,-0.0043,0.0671,-0.1541,-0.1425,-0.0131,-0.0797,-0.0097,-0.0554,0.0085,-0.0521,-0.0009,0.0075,-0.0773,-0.1637,0.1538,-0.1011,0.1206,0.1911,0.0115,0.0696,0.0044,0.2847,0.0893,0.071,0.1588,0.131,0.1217,-0.1182,-0.0829,0.0517,0.1291,0.0527,-0.1748,-0.1844,-0.1395,-0.0365,0.0409,-0.1054,0.2021,0.0833,0.183,-0.0269,-0.0343,-0.149,-0.0088,-0.0108,-0.1872,-0.0932,-0.1423,-0.0378,-0.0001,-0.0327,-0.0143,-0.0432,-0.0275,-0.0048,-0.0499,0.0058,0.0281,-0.0671,-0.0356,0.0294,0.0142,-0.0089,0.0108,0.0143,-0.0431,-0.0013,-0.033,0.069,-0.0184,-0.0367,0.079,0.0842,-0.0632,-0.1053,-0.0878,-0.0921,0.0223,-0.0546,-0.0288,0.0139,-0.0179,-0.028,-0.1624,-0.0533,-0.044,0.1313,-0.1065,-0.0388,-0.0318,-0.0284,-0.0147,-0.0418,0.0287,-0.0383,0.029,-0.1292,0.036,-0.0843,0.0896,-0.0349,-0.1166,0.041,-0.0694,0.0426,-0.1078,-0.0973,-0.0768,-0.0666,-0.0814,-0.1282,-0.0265,0.002,0.0659,0.0122,-0.0202,0.0503,-0.0433,-0.0023,-0.1025,-0.0378,-0.0685,-0.0531,-0.07,-0.1815,-0.0135,-0.0138,-0.0415,-0.0074,0.221,0.1597,0.1369,0.1494,0.1356,0.1197,-0.0145,-0.0413,-0.1998,-0.1609,-0.1663,-0.0245,-0.0145,0.0181,-0.0497,-0.0244,-0.0368,0.0098,-0.0871,-0.1107,-0.0982,-0.0369,-0.0621,-0.0602,-0.0086,0.0786,0.0757,0.0438,0.1088,-0.0022,0.0629,-0.009,0.0477,0.0568,-0.0364,-0.0413,0.0496,0.0615,0.0121,0.0613,0.0101,-0.0086,0.0096,-0.1102,-0.0869,-0.0986,-0.1456,0.1092,-0.064,0.0155,-0.073,-0.0813,0.0365,-0.0129,-0.0194,-0.0296,-0.0307,0.0078,0.0727,0.0254,0.0352,-0.0049,0.0437,-0.1581,-0.2299,-0.1561,0.095,0.0618,-0.0767,-0.067,-0.1142,-0.0639,-0.0535,-0.0375,0.0299,0.0181,-0.0015,0.001,0.0051,-0.0397,-0.0158,-0.0339,-0.001,-0.0872,-0.0536,0.0592,-0.0916,0.0583,0.078,0.0648,-0.0641,-0.0302,0.0008,-0.0309,-0.0067,0.0209,-0.0097,-0.0127,-0.0062,0.2191,-0.0925,0.0085,-0.0271,-0.0585,-0.0199,-0.0001,-0.0617,0.0132,-0.0549,0.075,0.1411,-0.0137,-0.024,-0.0152,-0.0258,-0.0547,-0.0155,0.0159,-0.0024,-0.0211,0.057,-0.0285,0.025,-0.0299,0.0009,0.0948,0.0128,-0.0567,0.0222,0.0685,0.0741,-0.0647,0.0636,0.0986,0.0553,0.0534,-0.0913,0.1985,0.2026,-0.0458,0.0599,-0.1107,-0.0409,0.0434,-0.1998,0.1775,-0.2379,-0.2202,0.0741,0.0566,0.033,-0.0511,0.0074,-0.0314,-0.0435,-0.0975,0.0503,-0.0055,0.0059,-0.0457,-0.0802,-0.0818,0.0107,0.0512,-0.0274,-0.0,-0.0186,0.1462,0.0205,0.0047,-0.0166,0.0167,0.0447,0.0317,-0.1464,0.0855,-0.0269,-0.1624,-0.1767,-0.0145,0.024,-0.1145,-0.1021,-0.053,0.0411,0.0203,-0.065,-0.0026,0.0718,-0.0969,0.0301,0.0318,-0.0497,-0.0581,0.0372,-0.0642,-0.0316,-0.0096,-0.0829,-0.0514,0.3091,0.3063,0.1136,0.1266,0.1555,0.1835,0.052,0.1705,0.1271,0.0907,0.1055,0.1378,0.2951,0.0019,-0.0687,0.1487,0.116,0.18,0.1762,-0.0099,0.0297,0.0244,0.0184,0.0246,0.0564,-0.0104,-0.0626,0.027,0.0341,0.0168,0.0532,-0.0608,-0.065,0.0995,0.0447,0.1686,0.2104,-0.0224,-0.027,-0.0207,0.1315,-0.0902,-0.0476,0.0657,0.0329,0.0418,0.0915,-0.0467,-0.1429,-0.0444,-0.0539,-0.0589,-0.0366,-0.0965,-0.087,-0.0699,0.0452,-0.1516,0.1654,-0.0251,0.0489,-0.0486,-0.0744,0.0206,-0.0023,0.0401,-0.0483,-0.0099,-0.0962,0.1211,-0.0529,-0.1395,-0.0161,0.0354,0.0062,0.0056,0.0,-0.0343,-0.099,0.0085,0.0177,-0.1933,-0.1925,-0.0151,-0.1502,-0.0024,-0.023,-0.0007,-0.0026,-0.031,-0.0088,-0.0325,-0.0401,-0.0082,-0.1217,-0.0716,-0.0915,-0.0028,-0.0349,0.0005,0.001,-0.0296,-0.0057,0.0807,0.0715,0.0175,-0.0256,0.0145,-0.0755,-0.0511,0.0099,-0.028,-0.0269,0.031,0.0394,-0.0615,-0.0447,0.0284,0.0299,0.0777,-0.0696,0.0035,0.1887,-0.0495,0.072,0.0265,0.0362,0.051,0.0727,0.0599,-0.0078,0.0044,0.057,-0.1188,-0.0489,-0.0696,0.0001,-0.0406,-0.0113,0.0025,-0.0397,0.0121,0.0224,0.0321,-0.0288,-0.0052,-0.1045,-0.0152,-0.0005,-0.0369,-0.0117,-0.0289,0.1467,0.0368,-0.0358,0.0052,-0.0472,0.0148,-0.0816,-0.0197,-0.0296,-0.0,-0.0469,-0.0066,0.0256,-0.0417,0.0055,-0.0273,0.0391,-0.0551,0.0183,-0.0083,0.0875,0.0233,0.0566,-0.0002,0.0077,0.035,-0.0924,-0.0271,0.1783,-0.0462,-0.0424,0.0516,0.0359,0.0903,0.0242,0.0087,-0.007,0.1722,-0.0054,-0.0445,0.0241,0.0616,0.0788,0.1132,0.1719,0.0716,0.1656,0.2305,0.0452,-0.0218,-0.0156,0.0551,-0.0361,0.0219,0.0171,0.0118,0.0058,-0.0746,-0.0659,0.0218,0.0786,0.0148,0.0244,-0.0551,0.0434,0.235,-0.0566,0.1109,-0.052,-0.1816,-0.0542,-0.0447,-0.0004,0.0288,-0.0106,0.0796,0.0191,-0.0152,0.0116,-0.2046,-0.0777,0.0391,0.0317,-0.0439,-0.0136,0.0702,0.0442,0.1459,0.0057,-0.0334,0.0281,-0.0352,-0.0422,-0.0648,-0.0168,-0.0108,0.0166,0.0102,-0.001,-0.0662,-0.0377,-0.0477,-0.0158,-0.024,-0.032,-0.1003,-0.0602,0.0185,0.2123,0.2277,0.0503,0.1746,0.2246,-0.0046,-0.1088,-0.1099,0.0842,0.0317,0.1835,0.0782,0.0575,-0.0314,0.0393,0.0553,0.0225,0.0266,-0.0636,-0.0127,0.007,-0.0239,right hand response execution
trm_557b48d40d3cf,-0.0082,0.0284,0.004,0.0239,-0.0283,-0.0277,0.0108,-0.0027,0.0032,0.0262,-0.0139,0.0102,0.0326,0.0235,0.0079,-0.0143,0.0106,0.0473,0.0057,-0.0013,0.0074,0.0097,0.0135,0.0219,0.0023,-0.0,-0.0019,0.0143,0.0323,-0.0006,-0.0059,0.0253,0.0246,0.0275,0.0226,0.0231,-0.0125,-0.0101,0.0526,0.009,0.0246,0.0132,0.0063,-0.0048,0.0159,0.0291,-0.0397,0.0008,-0.0197,0.0485,0.0215,-0.0156,0.0057,0.0006,0.0042,0.0059,-0.0048,0.0059,0.0114,0.0085,-0.006,-0.0101,0.0518,-0.0339,0.0277,-0.0382,0.0743,0.069,0.0362,0.0049,0.0071,-0.0118,-0.011,0.0421,0.0647,0.0147,0.0362,0.0091,-0.0357,-0.0106,0.0161,-0.0275,0.0489,0.0332,-0.0136,-0.0257,0.0128,0.0062,0.0185,0.005,-0.0012,-0.0029,0.009,-0.0602,-0.058,-0.0457,-0.025,-0.0194,-0.0624,-0.0154,-0.0203,-0.0014,-0.0414,-0.0371,-0.0198,0.0341,0.0342,-0.0283,-0.0018,-0.0017,0.0043,0.0163,-0.0224,-0.0304,-0.0059,-0.0064,0.0364,-0.0597,-0.003,0.0059,0.0511,0.0499,0.0587,0.0052,0.0452,0.0378,0.0469,-0.0144,-0.042,-0.0242,0.0169,0.0032,-0.0276,0.0416,0.0053,0.0472,-0.0375,0.0405,-0.0025,-0.0147,0.025,0.0067,-0.0083,0.0268,0.0199,-0.0187,0.0049,0.0277,0.0157,-0.0101,0.015,0.0431,0.0212,0.0304,-0.0082,-0.0065,0.0015,-0.0103,0.0049,0.0091,0.0084,0.03,0.0416,0.0446,0.0058,0.0008,0.0242,0.026,0.026,0.0079,-0.0242,0.0489,-0.0046,0.0469,0.0368,0.0244,0.0481,0.0355,0.0207,-0.0183,0.0245,-0.0256,0.0292,0.0014,0.0091,0.0215,0.002,0.0391,0.0146,0.0268,0.0272,0.0141,-0.0044,0.0263,0.0247,0.0563,0.0739,0.0042,0.0035,0.0105,-0.0177,-0.0832,0.0475,0.0259,0.0135,-0.0233,0.011,0.0275,0.027,0.0135,0.0477,0.0224,-0.0105,-0.0164,0.001,-0.0192,-0.006,0.0182,-0.0177,0.0147,-0.0219,0.001,0.0335,0.0021,-0.0082,-0.004,0.0331,-0.0273,0.0354,-0.015,-0.0359,0.0518,-0.0488,0.0371,0.0292,-0.0363,0.0099,0.0021,-0.0141,0.0043,-0.0032,0.0141,-0.0171,-0.008,0.0245,0.0367,0.0201,0.0284,0.0045,0.0233,-0.0171,0.0002,0.0033,0.0015,-0.0135,0.0149,-0.0101,0.009,-0.0277,-0.0532,-0.0196,-0.0441,0.0296,-0.0011,-0.0392,-0.0552,-0.0006,0.0065,-0.015,0.0131,0.0038,0.0062,0.029,-0.0033,-0.0244,-0.0465,-0.0213,-0.0054,0.0031,-0.0318,-0.0267,0.0174,0.0184,0.0613,0.0525,0.0068,-0.0199,-0.0211,0.0117,0.0185,0.0223,0.0083,-0.0059,0.0391,0.0135,0.0023,-0.0056,-0.0179,0.005,-0.0293,-0.0225,0.0648,0.0203,0.0165,-0.0189,-0.0228,0.0264,-0.0028,0.0021,0.015,0.0057,-0.0144,0.0228,-0.0108,-0.0068,-0.0114,-0.013,0.0031,-0.0002,0.0363,0.0366,0.0068,0.014,0.0196,0.021,0.0233,-0.0039,0.0041,0.0309,0.0046,0.0175,0.005,0.023,0.0051,-0.0006,-0.0325,-0.0272,-0.0103,0.0173,0.0372,0.0307,-0.0174,-0.0288,-0.0182,-0.0203,-0.0274,0.0295,0.0148,0.0259,0.0069,0.0114,-0.0564,-0.0139,-0.0291,0.0183,0.008,0.0055,0.0397,0.0089,0.0193,-0.0107,0.0222,-0.0154,-0.001,-0.0254,-0.0329,0.0139,-0.0225,-0.0123,0.0076,0.0174,-0.0026,0.0011,-0.0382,0.0298,-0.0132,-0.0022,-0.0302,-0.0583,-0.0352,-0.0518,-0.0294,0.0221,0.0066,-0.0086,-0.0161,0.0046,-0.0118,0.0078,0.022,-0.0293,0.0123,-0.0254,0.0259,-0.0359,-0.042,-0.0379,0.0192,-0.0074,0.0231,0.0204,-0.0307,0.012,0.0223,-0.0111,-0.0243,-0.0083,0.0117,0.0084,0.0104,-0.0182,0.0395,0.0241,-0.0284,0.0472,0.0278,-0.0097,0.0414,0.0386,0.0432,-0.0076,0.0245,0.013,0.0908,0.0915,0.0219,0.0344,-0.0007,0.0409,0.0205,0.0039,-0.0265,-0.003,-0.01,0.0103,-0.0088,0.0083,-0.0116,0.0385,0.0329,-0.0287,-0.0288,0.0011,-0.0204,0.0166,0.0122,-0.0023,-0.0333,0.0463,0.0259,0.0106,-0.0314,0.0092,0.0212,0.0063,0.0318,-0.0229,0.0238,0.0428,-0.0225,0.0095,0.0349,0.0103,-0.001,0.0128,0.0501,-0.0162,-0.0609,0.0085,0.0017,-0.0426,-0.0256,-0.0064,0.0255,0.0122,-0.0147,0.008,-0.0152,0.0024,0.0043,-0.0549,-0.0229,-0.0141,-0.0281,-0.0123,-0.0444,0.0041,0.0038,0.0346,0.0189,-0.0094,-0.0148,0.0452,0.0454,0.01,-0.0005,0.0164,-0.0124,-0.003,0.0382,0.0401,-0.002,0.0328,0.0054,-0.0041,0.0082,-0.0084,0.0256,0.0195,-0.0407,0.0539,0.0028,0.025,0.0169,-0.0188,-0.0192,0.0206,0.0152,-0.0379,0.0041,0.0145,0.0091,-0.0383,-0.0128,-0.0113,0.0049,-0.0194,-0.0532,-0.0392,-0.0024,0.013,0.0165,0.0247,0.0838,0.0338,0.0167,0.0514,0.0342,0.0352,0.0343,0.0117,-0.0117,-0.0024,0.0067,0.0154,0.0155,0.0129,-0.0095,-0.0252,0.0023,-0.0461,0.0368,0.0119,-0.0234,-0.0094,0.0276,-0.0175,-0.0054,-0.0033,-0.0016,0.0229,0.0156,0.0519,-0.0185,-0.0128,-0.0383,-0.0171,0.0254,0.0012,0.0479,0.0571,0.0364,0.0057,-0.0153,-0.0604,-0.0528,-0.0151,-0.0134,-0.0396,-0.01,0.0144,0.0261,0.0323,0.021,-0.023,0.0148,-0.0143,-0.0038,-0.0172,0.0287,0.0323,-0.0021,-0.019,-0.028,-0.0176,0.0111,0.0378,0.0167,-0.0551,0.0301,-0.001,-0.0124,0.0058,-0.0096,-0.0254,-0.0225,0.0156,0.0115,0.0076,0.0081,0.014,0.0112,-0.0188,0.0173,0.0574,0.0137,-0.0029,0.0022,0.0265,0.0529,-0.0065,0.0529,-0.0297,0.0043,-0.0094,-0.026,0.067,0.0188,0.0137,0.0039,0.0008,-0.0335,0.0186,0.016,0.0276,-0.0226,-0.0092,-0.0061,0.0105,0.0184,0.0084,-0.0203,-0.0016,-0.0125,0.0576,-0.0027,0.1051,0.0515,-0.0229,0.0722,-0.0024,0.0761,-0.0506,0.0283,0.0134,0.0086,-0.0507,0.0056,0.0054,0.0073,0.1206,-0.0463,-0.0369,-0.028,-0.0226,-0.0428,-0.0049,0.0221,-0.0425,0.0122,-0.0005,0.0096,0.0048,0.0182,-0.0096,0.0129,-0.0617,0.0367,-0.0034,0.009,0.0037,-0.006,-0.0147,-0.0091,-0.06,0.0519,0.0127,0.0082,0.0059,0.0003,-0.0065,-0.0341,-0.0246,-0.013,-0.0086,0.035,0.0254,-0.0197,0.0041,0.0215,-0.0076,0.004,-0.0087,0.0286,0.0348,0.0273,0.0319,0.0551,0.0232,-0.0199,-0.0147,0.0372,0.0466,-0.0178,0.0333,0.0153,-0.0107,-0.0104,0.0276,-0.0193,-0.0293,0.003,0.1155,0.1134,0.0721,-0.0018,0.0173,0.0295,-0.0177,0.0106,0.0157,0.0021,0.0013,0.0084,-0.0083,0.0012,0.023,-0.016,-0.0042,-0.03,0.0271,0.0335,0.0182,0.0149,0.0358,0.0058,-0.0176,-0.0235,0.0101,-0.0068,0.0174,-0.033,0.0585,0.075,0.0649,0.0426,-0.0107,-0.0376,0.0112,0.0055,0.0284,-0.0313,-0.0036,-0.0282,-0.0041,-0.007,0.025,0.0044,-0.023,-0.0224,-0.0427,-0.046,-0.0236,-0.004,-0.012,0.028,-0.0041,0.0197,0.0324,0.0237,0.027,0.0319,0.0416,-0.0106,-0.0107,0.0009,-0.0144,-0.0097,-0.0027,-0.0317,-0.0141,0.0135,-0.0079,0.0043,-0.0189,-0.0181,-0.0101,0.0412,-0.0176,0.0184,0.0201,-0.0361,-0.0073,-0.0391,0.0219,-0.0118,-0.0021,-0.0049,0.015,-0.0448,-0.019,-0.0466,-0.0082,-0.0374,-0.0267,-0.0113,-0.0717,-0.0466,-0.0088,-0.0252,-0.0113,0.0377,0.0367,-0.0035,0.0071,0.0226,0.0672,0.0285,0.0326,0.0369,0.0802,-0.0227,0.0047,-0.0096,-0.0058,0.0057,0.0309,-0.0081,-0.0233,0.015,-0.0102,-0.0074,0.0074,0.021,0.011,0.03,-0.0206,-0.0401,0.0224,-0.0328,0.0006,-0.0242,0.0179,0.0053,0.0204,-0.0229,0.0308,0.0922,0.0518,-0.0095,-0.0183,-0.0125,0.0116,-0.015,-0.0234,-0.0294,0.0249,0.0401,-0.0174,0.0373,0.0238,0.0376,-0.057,0.0235,-0.0113,0.0036,0.008,0.0029,0.0569,0.0588,0.0179,-0.0442,0.0155,0.0077,0.0254,-0.0182,-0.0163,0.0217,0.0454,0.012,0.0026,-0.0069,-0.0009,-0.0178,0.014,-0.0298,0.0487,0.0317,0.0137,-0.0176,0.017,-0.0249,0.0013,-0.0113,-0.0061,-0.038,-0.0102,0.0032,0.0027,0.0691,0.0208,0.006,0.016,-0.005,-0.023,0.0059,-0.0216,0.0411,-0.0039,-0.0377,-0.023,-0.0093,0.0236,0.0141,-0.0119,0.0081,0.0206,-0.0192,0.0058,0.0282,0.0066,-0.0214,-0.0085,-0.0065,0.0169,-0.0023,0.0314,-0.0017,0.0081,0.0302,0.027,0.0727,0.0537,0.0663,-0.0045,-0.0084,0.0207,0.0555,0.037,0.0416,0.0366,0.0542,-0.0041,-0.0044,-0.0064,-0.0116,-0.0211,0.0097,-0.0017,-0.0089,-0.0165,-0.0361,0.0214,-0.0417,-0.0192,0.0231,0.0053,-0.0166,-0.0049,-0.0072,0.0162,-0.0268,0.0069,0.0035,-0.0049,-0.0192,0.0107,0.0092,0.0113,-0.0124,0.0179,-0.0088,0.0365,0.0005,0.0224,0.0511,0.0374,-0.0079,0.0086,-0.016,-0.0267,-0.0227,-0.0367,0.0013,-0.0008,0.001,0.0018,0.0131,0.0047,-0.0095,0.0242,0.0335,0.022,-0.0131,-0.0092,0.0367,0.0148,0.0337,0.0558,0.0261,-0.0143,-0.0096,-0.0255,-0.0207,-0.0227,0.0409,0.0144,0.0069,0.0254,0.0109,0.0094,-0.0022,0.0045,-0.0187,-0.0067,0.0261,0.0158,-0.0029,0.0365,-0.012,0.0248,0.0011,-0.0671,-0.077,0.0043,-0.0198,0.019,-0.0105,-0.0075,0.0176,0.0412,0.0651,-0.0286,0.0053,-0.0073,0.0341,-0.008,-0.0123,0.0077,0.023,0.0238,0.0327,0.0249,0.0486,0.0122,-0.0393,0.0157,0.0011,0.0299,-0.0577,-0.036,-0.0323,0.0022,0.0136,0.0087,-0.0132,-0.0459,0.0168,0.0337,0.0318,0.0242,0.0097,0.0147,-0.0185,0.0049,0.0188,0.0157,0.0124,0.0406,-0.0041,-0.0198,-0.0241,-0.0179,-0.0169,0.021,-0.0124,0.0399,-0.0094,0.0237,0.0187,-0.0747,-0.065,-0.0728,-0.0469,-0.0517,-0.0304,-0.0573,-0.0342,0.025,-0.0403,-0.0507,-0.0243,-0.0009,-0.0287,0.0148,0.0023,0.0162,0.0387,-0.0308,0.0043,-0.0307,-0.0331,0.0324,-0.0346,-0.0313,-0.0142,-0.0416,-0.006,0.0253,-0.0105,-0.0011,0.0209,-0.0073,0.0024,-0.0177,-0.0036,-0.0565,0.0307,0.0563,0.0458,0.0322,0.0181,-0.0098,-0.0186,0.001,0.023,0.0357,0.0412,0.0207,-0.0483,0.0044,-0.0629,-0.0594,0.0251,-0.0048,-0.0195,-0.067,-0.0734,-0.0451,-0.0484,-0.0234,0.0019,-0.0162,-0.0151,-0.0026,0.028,-0.0162,-0.0064,-0.0371,0.0147,0.0175,0.0027,0.041,0.0233,0.0056,0.0086,0.0078,-0.0332,-0.0061,0.0061,-0.0113,0.0139,0.0122,-0.0518,-0.0321,0.0293,0.0255,0.0203,0.0104,-0.0219,-0.0034,0.0193,0.0063,0.0111,-0.018,-0.0188,-0.0433,-0.0555,0.0172,-0.0107,0.0355,0.0079,-0.0152,-0.0076,0.0224,-0.0146,-0.0389,0.004,0.0271,-0.0192,-0.0301,0.0366,0.0197,-0.0042,0.0588,0.0427,0.0845,0.0005,-0.0259,0.0148,0.031,-0.0449,0.0147,0.0141,0.0116,0.019,0.0127,0.0343,0.006,0.0089,-0.0202,-0.0581,-0.0448,-0.0625,-0.0396,0.0476,0.0223,0.0328,0.0617,0.0391,-0.0149,-0.0221,-0.0435,0.0367,0.0168,-0.0291,-0.03,0.0059,-0.0143,-0.0098,0.0008,-0.0159,-0.0432,0.0172,0.0215,0.0052,-0.0329,-0.0178,0.0163,-0.0129,-0.0129,0.0185,0.0162,0.0376,0.0028,-0.0147,-0.013,0.0172,-0.0785,0.0393,0.041,0.0047,-0.0021,0.0259,0.0331,0.0264,-0.0087,-0.0098,0.042,-0.0074,0.0069,-0.0597,-0.0123,-0.0313,0.0011,-0.0073,-0.0192,-0.0105,-0.0004,0.0172,0.0243,0.0167,0.0078,0.0122,0.0197,-0.0227,-0.0173,0.0051,-0.0668,-0.0256,-0.0632,-0.0052,-0.0696,0.0429,0.0239,-0.0372,0.0479,-0.0393,0.0478,0.0389,0.014,0.018,0.048,-0.0245,-0.0026,0.0503,-0.0167,-0.0067,0.0008,0.03,-0.0037,0.0233,-0.0068,0.0166,0.0054,0.0254,-0.0603,-0.0595,-0.0487,-0.0389,-0.0159,-0.0106,0.0023,0.0081,0.0077,-0.0105,0.0186,0.0106,0.0316,0.0076,0.0006,0.0081,-0.0092,0.011,0.0229,-0.0137,-0.01,-0.0316,0.0167,0.0237,-0.0194,-0.0063,0.0069,0.0272,0.041,0.0372,-0.0069,0.0546,0.0579,0.0097,0.0103,-0.0401,-0.0255,-0.0092,0.0331,0.0281,-0.0196,0.0144,0.0105,0.0026,-0.024,-0.0297,0.0493,-0.0001,-0.0344,0.0288,-0.0004,0.0068,0.0099,-0.0227,-0.007,-0.024,-0.014,0.0517,-0.0312,-0.013,-0.0345,-0.0385,-0.0399,-0.0322,0.0022,-0.0004,-0.0504,0.023,-0.0015,0.0296,0.0079,0.0253,0.0206,0.0191,-0.0242,0.006,0.0199,0.0444,0.0127,0.0062,0.0059,0.0058,0.0258,0.0087,-0.0011,0.0049,-0.0319,0.0144,-0.0104,0.0143,0.0409,0.0293,0.0368,0.0149,0.0143,-0.0184,0.0126,-0.037,0.0204,0.0306,0.0067,0.0043,0.0009,0.0307,0.053,-0.0252,-0.0197,-0.0401,-0.0026,0.0009,-0.0039,-0.0338,-0.0053,0.0028,0.0227,0.0358,-0.0074,0.0698,0.0113,-0.0263,-0.001,0.0205,0.0163,0.0193,0.0188,0.0298,-0.0327,-0.022,0.0039,-0.0378,-0.0256,0.0052,-0.0207,-0.011,-0.0075,0.0206,0.0026,-0.0471,0.0041,0.0061,0.0068,0.0128,0.009,0.0159,-0.0117,-0.0044,-0.0307,-0.0603,-0.0715,0.0238,0.0099,0.0277,-0.0222,-0.0127,-0.0132,0.0276,0.006,-0.019,0.0055,-0.0056,-0.0108,-0.0233,-0.0359,-0.0103,-0.0483,-0.0172,0.028,0.0269,0.0039,0.0234,0.0252,0.033,0.0065,0.029,0.0237,-0.0234,0.0117,0.0062,0.0169,0.0181,-0.0247,-0.0486,0.0103,-0.0012,-0.0086,0.0269,0.0312,0.0324,0.0046,-0.0028,-0.0088,-0.0357,-0.0048,-0.0297,0.0121,0.0255,-0.0022,-0.0835,-0.0831,0.0335,0.0515,-0.0455,0.0082,-0.0169,-0.0036,0.0393,-0.0362,0.0168,0.0186,0.0181,-0.0164,-0.0369,0.0219,-0.0386,-0.0031,0.024,-0.0227,-0.0765,-0.0323,0.0145,-0.0621,0.014,-0.0104,-0.0392,0.0126,0.0352,-0.032,-0.0003,0.0013,-0.0001,0.0163,0.002,0.0255,0.0016,0.0487,0.0135,0.0343,-0.0094,0.0491,0.0124,-0.0016,0.0046,0.0227,0.0094,-0.0049,0.0283,0.036,-0.022,0.0055,-0.0169,0.0073,-0.0111,-0.0124,0.0255,0.0279,-0.0162,-0.0096,-0.0196,0.0005,-0.038,-0.0391,-0.0004,-0.0253,-0.0016,0.0013,-0.0785,0.0511,0.0443,0.0187,0.0235,-0.0135,-0.022,-0.0406,0.0185,-0.0196,-0.0115,0.0197,-0.0214,-0.0009,0.0301,-0.0185,-0.0056,-0.0464,-0.0413,-0.0479,-0.0467,-0.0546,0.0111,0.0124,0.028,0.0083,-0.0235,-0.0154,0.0258,-0.0248,-0.0251,0.0117,-0.0345,-0.0221,0.0533,0.043,0.0294,-0.0049,-0.0243,-0.0264,-0.0253,-0.0289,-0.0096,-0.0138,0.0186,0.0387,0.0016,0.0058,-0.0089,0.0015,0.0197,0.0058,-0.0251,0.0127,0.0266,-0.0348,0.0241,0.0418,-0.0089,-0.041,-0.0132,-0.0341,-0.0026,-0.0229,-0.0374,-0.0152,-0.0346,-0.0576,-0.0298,-0.0061,0.0038,-0.0013,-0.0249,0.0127,-0.0172,0.0468,0.0394,0.0089,0.0284,0.0248,-0.0084,-0.009,-0.0271,0.011,-0.0184,-0.0156,-0.048,0.0055,0.0443,-0.0002,-0.0012,-0.0132,0.0137,-0.0131,-0.0024,-0.0182,0.0607,0.04,0.0442,0.018,0.0107,0.047,0.0023,0.0231,0.0208,0.0006,-0.0093,0.0091,-0.0341,0.0008,0.009,-0.0339,0.0164,0.0103,-0.02,-0.0444,0.0357,-0.006,0.0571,0.0196,0.0267,-0.015,-0.0197,-0.042,0.0013,-0.0087,-0.0142,-0.0102,0.0419,0.0125,0.0364,0.0174,0.0151,-0.0033,-0.0032,0.024,0.038,0.0234,0.0036,0.0071,-0.0014,-0.0301,0.015,-0.0069,-0.008,0.0126,0.0191,0.0156,0.0038,-0.0095,0.0016,0.1041,0.043,0.0267,0.0821,0.1183,-0.0322,0.0217,-0.0205,0.0457,0.0065,-0.004,-0.0133,0.0454,0.001,0.0458,0.0087,-0.002,-0.043,-0.0119,-0.0119,0.0604,0.0032,-0.0009,-0.0285,0.0103,0.0078,0.0494,-0.0129,0.0606,0.0765,0.0472,-0.0019,0.0284,0.0278,0.0078,0.036,0.0047,0.0248,0.0192,0.0208,0.0677,-0.0078,0.0174,0.0067,0.0184,0.002,0.0197,0.0406,0.006,-0.0016,-0.0289,-0.01,0.0243,0.0575,-0.0022,0.033,-0.0137,0.0674,0.0395,0.0243,-0.0509,-0.0253,0.0359,0.0154,-0.0077,-0.0668,-0.046,-0.0421,0.1103,0.1002,-0.0022,-0.0305,0.0095,-0.0014,-0.0208,0.0203,0.0208,-0.0009,0.0095,0.0248,-0.0004,-0.0048,0.0574,-0.0045,0.0595,-0.0098,0.031,-0.0048,-0.0399,-0.0772,0.0087,0.0683,0.0544,0.0238,0.0136,0.0308,0.0187,-0.0608,0.0128,0.0142,-0.0673,-0.0331,-0.0312,-0.0594,-0.0114,-0.0336,-0.0309,-0.0282,-0.0364,-0.0403,-0.048,-0.034,-0.0507,-0.0721,-0.0678,0.0992,-0.0221,-0.0437,-0.0424,-0.0198,0.0419,-0.0298,-0.0131,-0.0183,-0.0533,-0.0842,0.0,-0.0004,-0.0048,0.0016,-0.0088,-0.0494,0.017,-0.0015,-0.0579,-0.032,-0.0285,-0.0274,-0.0014,-0.0174,-0.0521,-0.0208,0.0173,0.0011,-0.0034,0.085,0.0391,0.0387,0.0262,0.0204,0.0508,0.0474,0.0332,0.0072,0.0229,0.009,-0.0298,0.0185,0.0455,0.087,-0.0394,0.0291,0.0042,0.0045,0.0134,-0.0389,0.0522,0.0393,0.0245,0.001,0.008,0.0019,0.0063,-0.0263,-0.0372,-0.0548,-0.0172,0.0307,-0.0001,0.0071,0.0438,0.0161,0.0128,-0.01,-0.025,0.0147,0.0227,0.0072,0.0229,0.0175,-0.0079,-0.0335,-0.0044,0.0182,0.019,-0.0051,0.0106,-0.0141,0.0272,0.0153,-0.0114,0.0152,0.0055,-0.014,-0.027,0.0071,-0.0093,0.0171,0.0322,-0.0043,-0.033,-0.0366,-0.0118,-0.0816,-0.0367,0.0199,0.0079,-0.0843,-0.0635,-0.0197,-0.0191,-0.0519,-0.0454,0.0419,0.0412,0.0286,0.0124,-0.0788,-0.0691,-0.044,0.0038,-0.0166,-0.0286,-0.0699,-0.0737,-0.073,-0.0489,-0.0087,0.0214,-0.0128,-0.005,-0.0253,0.0561,0.0237,0.0006,0.0191,0.0256,0.0291,-0.0177,0.0213,0.0103,0.0052,-0.0266,-0.0226,-0.0344,-0.0118,-0.0072,-0.0246,0.0256,0.0039,0.0125,0.0145,0.0091,0.0468,-0.0155,0.042,0.0684,0.0676,-0.0306,-0.0044,0.0065,-0.0362,-0.0179,-0.0248,-0.0248,-0.0135,-0.0277,0.0083,0.0718,0.0739,-0.0342,-0.0126,-0.0055,-0.0381,-0.0116,-0.0435,-0.0455,0.0288,0.0253,0.0074,0.0085,-0.053,0.0029,-0.0215,-0.0134,-0.0006,-0.0126,-0.0129,-0.0101,-0.0195,0.0046,0.0114,-0.0025,0.018,0.0307,0.0359,-0.0035,0.0017,0.0062,-0.0152,-0.037,-0.0252,-0.0665,-0.0557,-0.0089,-0.0463,0.0183,-0.0361,-0.0256,-0.0386,-0.07,-0.0268,-0.0159,-0.0079,0.0053,-0.0459,-0.0409,0.0004,0.0001,-0.0033,-0.0072,0.0171,-0.0062,0.0116,-0.0146,-0.0079,0.0042,0.0,-0.0041,-0.069,-0.0132,-0.0458,-0.0333,0.0434,0.0477,0.0183,0.0314,0.0482,-0.0218,-0.0005,0.0108,0.006,-0.0305,0.0118,0.081,0.0029,0.0017,0.0437,-0.0205,-0.0136,-0.027,-0.026,-0.0759,-0.0774,-0.0592,-0.0269,0.0254,-0.0056,-0.0232,0.0407,0.0081,0.0215,0.007,0.0327,-0.0285,-0.0033,0.0,0.0418,0.0648,0.0709,0.0422,0.0228,0.0092,0.0034,0.0284,0.0037,-0.0145,-0.0289,-0.007,-0.0159,-0.0115,-0.027,0.0291,-0.0329,-0.014,-0.0158,0.0089,-0.0181,-0.0281,0.012,-0.0092,-0.0439,-0.0197,-0.0173,0.0082,0.0181,-0.0054,-0.0034,0.0065,0.0029,0.0104,-0.0058,-0.0165,0.0369,-0.0245,0.0018,0.0061,-0.0017,0.0527,0.0187,0.0119,0.0108,0.0112,0.0096,0.0271,0.0356,-0.0283,-0.0121,-0.0152,0.0935,0.0447,0.0209,0.0735,0.0462,0.044,0.0275,0.0275,0.0168,0.0031,-0.0096,0.0242,-0.0077,-0.0154,-0.0022,0.0038,0.0184,0.1058,-0.0325,0.0173,0.0143,-0.004,-0.0547,-0.0329,-0.0065,0.0378,0.0065,-0.0175,-0.0164,0.0019,-0.0502,-0.0222,-0.0326,-0.0456,-0.023,0.0136,-0.0103,-0.0454,-0.0256,-0.0289,0.0496,0.036,0.0129,0.0138,0.0188,0.0279,0.0218,-0.0202,0.0192,0.0455,-0.0377,0.0148,0.0837,-0.0357,0.0115,0.0887,0.0265,0.1053,0.003,-0.0041,-0.0353,0.0178,-0.0796,-0.0779,-0.0215,-0.0461,-0.0208,0.0136,-0.0531,-0.0004,-0.0575,0.0088,0.0231,-0.0553,0.0044,-0.045,-0.0057,-0.0036,-0.0111,0.0471,0.0028,-0.0079,-0.0048,-0.0497,0.0005,-0.03,-0.0343,-0.0264,-0.0199,-0.0438,-0.0517,-0.0221,0.0006,-0.0252,0.0177,-0.0186,0.006,0.0397,0.0482,0.0222,-0.0119,-0.0109,0.0263,0.0082,0.0054,-0.0277,-0.0037,-0.0247,0.0095,0.0279,-0.0231,-0.0179,-0.0273,0.015,-0.022,-0.0365,0.0069,-0.0001,0.0064,0.0005,0.0197,-0.0174,-0.0135,0.0257,-0.0397,-0.0149,-0.0366,0.0052,-0.0033,-0.0143,-0.0084,0.029,0.0323,0.0305,0.0323,-0.0262,-0.0026,0.0076,0.0407,0.0243,-0.0248,-0.0012,0.0556,0.0405,0.0374,0.0238,-0.0251,0.0255,0.0138,0.0202,-0.0051,0.0462,0.0073,0.0263,0.0013,0.0098,-0.0055,-0.0443,0.0194,0.025,0.0188,-0.0148,-0.0026,0.0305,-0.0437,-0.0338,0.0276,0.001,0.0119,0.0219,-0.0306,-0.0227,-0.0215,-0.0024,0.0051,0.0339,0.0074,0.0286,0.0586,-0.004,0.0319,-0.0019,-0.0361,-0.0443,-0.0408,-0.0337,0.0428,0.0274,0.0031,-0.0054,-0.0413,-0.0107,0.0077,0.0185,0.0127,0.0504,0.045,0.03,0.0281,0.0164,-0.0142,0.01,0.0182,-0.039,-0.0052,-0.0236,-0.0148,-0.0046,-0.0137,0.0192,-0.0072,0.0203,-0.0404,0.0132,-0.0005,-0.0079,-0.0218,0.0033,0.016,0.0081,0.0168,-0.0233,0.053,0.0879,0.015,0.0058,0.0103,0.0132,-0.0179,0.0021,0.0126,0.0258,-0.0039,0.0323,0.0202,0.0106,0.0612,0.0206,0.0516,0.0331,0.074,0.0277,-0.0236,-0.0491,0.0582,0.0221,0.0292,-0.0112,-0.0056,0.0339,0.0136,0.039,0.0149,0.022,-0.0148,-0.0115,0.0269,-0.0178,0.0179,0.0066,-0.0027,-0.0043,-0.0212,0.0398,0.038,0.0028,-0.0091,-0.0011,-0.0208,0.0196,-0.0017,-0.0349,-0.0134,-0.0155,-0.0156,-0.0397,-0.017,-0.0327,0.005,0.0077,0.0555,-0.0022,-0.0136,-0.0366,-0.0414,-0.0268,0.0021,-0.0143,-0.0049,-0.0441,-0.028,-0.0192,0.0036,0.0621,0.0212,0.0011,-0.0518,-0.0005,0.0008,-0.0175,-0.0029,-0.0254,-0.0166,0.024,0.0053,0.0041,0.0168,0.0211,-0.0264,-0.0102,0.0138,-0.0126,-0.0368,0.0084,0.0086,-0.0089,-0.0323,-0.002,-0.0406,0.0006,-0.0565,-0.0024,-0.0161,-0.0148,-0.0136,0.0543,0.1018,0.099,-0.0423,-0.0218,-0.0005,-0.0138,-0.0191,0.0274,0.0497,0.0495,0.0567,0.0003,-0.0155,-0.0065,0.0437,0.0128,0.0059,0.0599,0.0237,0.0448,0.0829,-0.027,-0.0007,-0.0102,0.0598,0.0345,0.0046,-0.0001,0.0045,0.0082,0.0158,0.0013,0.0267,-0.0286,0.0439,-0.0118,0.012,0.0054,0.0119,-0.015,-0.0412,-0.0505,-0.0381,0.0323,0.0312,0.0152,0.0155,0.0409,0.0142,0.0181,0.0548,0.0296,-0.01,-0.0061,-0.0146,0.0242,0.0072,0.0241,0.0288,0.0033,-0.0167,0.0447,0.0416,-0.04,0.0371,0.0452,-0.0306,-0.0321,-0.0026,0.0076,-0.0163,-0.0195,-0.0441,-0.046,0.0519,0.0391,0.0316,0.0139,-0.0345,-0.0134,-0.005,-0.0002,0.0201,-0.0145,-0.0703,-0.0148,-0.0204,-0.0653,0.0785,0.0852,0.0411,0.0256,0.0062,0.0146,0.051,0.0085,0.0005,-0.0217,-0.0091,0.0107,-0.0183,0.0358,-0.048,-0.0263,-0.0713,-0.058,-0.0319,-0.0303,0.017,0.0161,0.0187,-0.011,-0.0408,-0.05,-0.0357,-0.0129,-0.056,-0.0287,-0.0601,-0.0408,0.0063,0.0234,0.0063,-0.0107,-0.0239,0.0227,0.0092,-0.0008,-0.0042,-0.0284,-0.0244,0.0329,0.0079,0.0518,0.0352,0.0152,0.0261,-0.0501,0.0157,-0.049,-0.037,-0.0171,-0.015,-0.0133,-0.0063,0.0063,-0.0175,-0.0358,-0.0336,-0.0395,-0.0018,-0.0229,-0.0078,-0.0081,-0.0198,-0.0469,-0.0316,-0.0357,-0.0019,0.0088,-0.0298,-0.0067,-0.0049,-0.018,-0.0072,0.0216,0.0003,-0.03,-0.016,0.0396,-0.0067,-0.0166,-0.0335,-0.0009,0.0024,-0.0068,-0.0159,0.0012,-0.0372,-0.0577,-0.0253,-0.0354,-0.0203,-0.0508,-0.0002,0.0425,-0.0086,-0.0203,-0.0432,-0.0338,-0.0225,0.0037,0.0089,0.0136,-0.0264,-0.0616,0.0129,-0.0024,0.0538,0.07,0.0591,0.0385,0.0525,0.0289,0.0502,0.0085,0.0029,0.0257,-0.0468,-0.0431,-0.0342,-0.0037,-0.0362,-0.0073,0.0312,-0.038,-0.0311,-0.0098,0.0067,-0.057,-0.0493,-0.0337,0.0108,-0.0501,-0.0205,-0.006,-0.0212,-0.0148,0.0193,-0.0393,-0.017,0.0156,0.0141,0.0084,-0.0203,0.0005,0.0144,-0.005,0.0236,-0.0163,-0.0169,-0.0224,-0.0004,-0.0352,0.0326,-0.0124,-0.0455,-0.0152,0.0503,-0.0068,-0.0303,-0.0156,0.0058,0.028,0.1038,0.0814,0.0466,0.0727,-0.0458,0.0108,0.0283,0.0061,-0.0174,-0.033,-0.0555,-0.0449,-0.0553,-0.0608,-0.065,-0.0365,-0.0482,-0.0029,-0.0134,-0.0217,0.0144,-0.0041,-0.016,0.0114,-0.07,-0.0416,0.013,0.0637,0.0482,0.018,0.0471,0.0427,-0.0097,-0.0287,-0.0122,-0.0178,-0.0095,-0.0117,0.0185,-0.0079,0.0192,-0.0054,0.0245,0.0191,-0.0244,-0.0214,-0.0005,0.0073,0.0155,-0.0068,0.0062,0.0502,-0.0235,0.0513,-0.0021,0.0133,0.009,0.0027,0.0263,-0.0012,0.0108,0.0066,0.0104,0.0192,0.0081,-0.067,-0.0238,-0.0035,0.0175,-0.0515,-0.003,0.0135,-0.0063,-0.0331,-0.0025,0.0276,0.0058,0.0022,-0.0104,0.0256,-0.0255,-0.0825,-0.0745,-0.0026,-0.018,0.0201,-0.0526,-0.0166,-0.0574,0.0109,-0.0759,-0.0119,-0.0643,-0.061,-0.0136,0.0021,0.0045,0.0168,0.0104,-0.0196,-0.0185,-0.0494,0.0092,-0.0076,0.0463,-0.016,-0.0341,-0.0262,0.0456,0.0388,0.0683,0.0004,0.0213,0.0115,0.0468,-0.0285,0.0182,0.0074,0.0043,0.011,-0.0916,-0.0065,0.0257,-0.0375,-0.0405,-0.0104,0.0187,-0.0299,-0.0446,-0.0323,-0.0397,-0.0072,0.0238,-0.0075,-0.0484,-0.0193,0.0391,-0.0581,-0.0134,-0.0138,-0.0066,-0.0581,0.0057,0.0394,0.03,0.0065,0.004,-0.0171,0.0275,-0.0152,0.0011,0.0004,-0.0007,0.0357,-0.0044,-0.0169,0.0247,0.0457,-0.0117,-0.0173,0.0209,-0.0061,0.0067,0.0166,0.0322,-0.0001,0.0211,0.0238,0.0129,-0.026,-0.0375,0.0198,-0.0214,0.0203,-0.0063,-0.0161,0.0032,0.0204,-0.0055,0.0295,-0.0048,0.0522,0.0504,0.0009,0.0205,0.0256,0.0538,0.0099,0.0243,0.0454,0.0682,0.026,0.0211,-0.021,-0.0086,-0.0269,0.0185,-0.0159,0.0219,-0.0243,-0.0602,-0.0372,0.012,-0.055,0.0458,0.0311,0.001,-0.0219,-0.0065,0.0224,-0.0347,-0.0345,0.0062,0.0288,-0.0786,0.0389,0.0123,-0.0439,0.0071,-0.0056,0.0103,-0.0459,-0.0128,-0.0524,-0.0341,0.062,0.0502,-0.0372,-0.048,-0.0142,-0.0258,0.0035,0.0077,0.032,0.0487,0.001,0.0471,0.0581,0.0152,0.0505,-0.0166,-0.0037,-0.0199,-0.0397,-0.0384,0.0066,-0.0256,0.0224,-0.0152,-0.0102,0.0042,0.0046,-0.0091,0.0153,-0.0062,0.0191,0.0237,0.0308,0.0229,0.017,0.0389,0.0268,0.0012,0.0087,0.0374,0.0479,-0.0018,0.0019,-0.0287,-0.0165,-0.0468,0.0146,-0.0047,-0.0141,-0.0286,-0.0048,0.0159,0.038,0.0013,-0.0403,-0.0152,-0.0327,-0.0047,0.0017,0.0086,0.0236,-0.0126,0.0059,-0.028,-0.0236,0.0534,0.0253,0.0151,0.0359,-0.0088,0.0195,-0.06,-0.0629,0.0669,0.0025,0.0439,0.0198,0.0216,0.065,0.0559,0.0278,-0.0378,0.0238,0.0033,-0.0113,0.0464,0.0331,-0.0308,-0.0046,-0.0144,-0.0029,0.0017,-0.0118,0.0244,-0.0033,0.0129,0.053,0.0045,0.0879,-0.0732,0.0702,-0.0573,-0.0132,-0.0064,0.1238,0.1256,-0.0109,-0.0241,-0.0086,-0.03,-0.0115,-0.0327,-0.0002,0.0066,-0.0138,-0.0331,-0.0351,-0.0303,-0.0105,-0.0238,-0.0461,0.0179,-0.0036,-0.0596,-0.1035,-0.0608,-0.0413,-0.0876,-0.0416,-0.0378,-0.0557,-0.031,-0.034,-0.0629,-0.0334,-0.0423,-0.0227,-0.0604,-0.0139,-0.082,-0.049,-0.049,-0.0605,-0.0268,0.0197,0.0139,0.1294,-0.0185,-0.0112,0.0312,0.0126,0.0082,-0.0387,-0.0267,0.0257,0.0285,0.0099,-0.0267,0.0093,0.0425,-0.0456,0.0399,0.0179,0.0087,0.034,0.0204,0.0014,0.0007,0.0039,-0.0179,0.0241,0.0303,-0.0395,0.0205,-0.0137,0.0095,0.007,-0.0027,-0.0161,0.005,0.0338,-0.0144,-0.0118,0.014,-0.0131,-0.0036,0.0202,-0.0344,-0.0344,0.0214,0.0198,-0.0155,0.0154,-0.0048,0.0148,0.0075,-0.0371,0.021,0.019,0.0127,0.011,0.0368,0.0036,negative emotion
trm_557b4904ee26d,0.1097,0.127,0.1169,0.1243,-0.0007,0.0421,0.0859,0.0931,0.0391,0.0829,-0.0248,-0.0331,0.1271,0.0359,0.1048,0.0889,0.1107,0.0482,0.075,-0.0584,0.0369,-0.0411,0.0335,-0.0721,0.021,-0.0197,-0.0174,0.0974,0.1342,0.0728,0.0814,0.0417,0.1131,0.1109,0.0906,0.1213,0.082,0.0844,0.1414,0.0488,0.1092,0.1345,0.072,-0.0937,0.078,0.0357,-0.2008,0.0924,-0.0314,0.1412,0.0752,0.0073,-0.0487,-0.0195,0.0218,0.079,0.1473,-0.0113,-0.0145,0.0369,-0.0128,-0.025,0.1256,-0.0868,-0.0281,0.0284,0.1447,0.1498,0.0898,-0.0198,-0.0842,-0.0201,-0.1721,0.0329,0.1349,-0.1004,0.1518,-0.0647,-0.0692,0.0755,-0.0504,-0.0766,0.0293,0.0917,-0.0365,0.0052,0.0502,0.0205,-0.0423,0.3655,0.1145,0.1236,0.0217,-0.0794,-0.1172,-0.0908,-0.1149,0.0003,-0.109,0.048,-0.0502,-0.0214,-0.0404,0.0759,-0.0556,0.1431,0.0905,-0.1775,0.0663,0.0767,-0.0318,0.0638,-0.1159,-0.1064,-0.0281,-0.0402,0.0438,0.0455,-0.0424,0.0637,0.0264,0.124,0.0325,-0.0082,0.0695,0.0398,0.0346,-0.0411,-0.0739,0.0236,-0.0347,0.0794,0.0226,0.1702,-0.0025,0.1299,0.0381,0.0735,0.025,0.0485,0.0844,0.1115,-0.0889,-0.0023,0.0302,-0.0048,0.1288,-0.0532,0.0815,-0.0867,0.0493,0.0344,0.1146,0.0841,-0.1733,0.0598,-0.0617,-0.0052,-0.0248,0.0492,0.0729,0.0605,0.1277,0.1845,0.0147,-0.0038,0.0006,0.0834,0.0693,-0.0494,0.0642,0.0557,0.0077,0.0457,0.0895,0.1004,0.0693,0.0182,0.0052,0.037,0.149,-0.07,0.0695,0.0206,0.1096,0.0527,0.1085,-0.0272,-0.0652,0.0091,-0.0039,0.048,0.0078,0.0903,0.0707,0.2304,0.1825,-0.0271,-0.051,0.2303,0.1265,-0.0953,0.0548,0.1487,-0.0371,0.1419,0.0054,0.0621,0.0745,0.0039,0.0728,-0.0028,-0.0123,-0.023,-0.0931,-0.0533,-0.1128,0.1342,0.2687,-0.0426,-0.1098,0.0639,0.125,0.0595,-0.0381,-0.0471,0.0634,-0.1122,0.0154,-0.2094,0.1407,0.0896,-0.1425,0.1459,0.154,0.0347,-0.0312,-0.127,0.0165,0.0681,0.0365,0.1524,0.0952,0.0141,0.0565,0.0477,0.0103,0.1385,0.1253,0.0178,-0.0395,-0.0341,0.0009,-0.0642,0.0569,0.0914,0.0261,0.0954,-0.1791,-0.2596,-0.0482,-0.2208,0.0536,-0.108,-0.1509,-0.2769,-0.0885,-0.0263,-0.0812,-0.0364,0.0708,0.0894,0.0515,-0.0676,0.1982,0.0532,0.3294,0.3295,0.325,0.1572,0.0454,-0.0242,-0.0361,0.0638,0.04,0.1026,-0.0661,-0.1,0.1567,0.0957,0.0819,0.0575,0.0494,0.0283,0.1134,0.0271,-0.0433,-0.0683,0.0223,-0.0947,-0.0734,0.0472,0.1506,0.0742,0.1414,0.1402,0.1216,0.0751,0.1121,-0.0377,0.0364,0.0138,0.1311,-0.1044,-0.0565,0.079,-0.1194,-0.0312,-0.0815,0.1016,-0.0344,-0.0759,0.0694,0.0622,0.0916,0.0623,-0.0072,0.0546,0.0767,0.1367,0.0163,0.0808,-0.058,-0.055,-0.0895,-0.0101,-0.0793,-0.0331,-0.089,0.0503,0.0476,-0.0687,0.0806,0.0792,-0.0828,-0.0158,0.2544,0.1779,0.1838,0.1298,0.1093,-0.0743,0.1711,0.1033,0.0563,0.1494,0.0578,0.0847,0.1729,0.0956,-0.048,0.0256,0.0504,0.0369,0.0653,-0.024,0.1701,-0.1623,-0.0511,0.109,-0.0401,-0.1003,0.0271,-0.0902,0.0857,0.0316,0.0903,-0.1215,-0.2351,-0.0795,-0.2395,0.0706,0.0681,-0.0175,-0.0351,-0.0541,0.0576,0.0302,-0.0457,0.0381,0.0908,0.0462,0.1476,0.0021,-0.0189,0.0899,0.173,0.1583,0.1334,0.0758,0.0307,-0.0451,0.0156,0.0526,-0.0027,-0.0787,-0.1238,-0.0201,0.0938,0.048,0.0564,0.1063,0.0166,-0.2847,0.0283,-0.0198,-0.292,-0.018,0.0471,0.0129,-0.0118,0.2349,0.1842,0.3123,0.2605,0.1562,0.1838,0.1262,0.1124,0.1756,0.0041,-0.035,-0.0027,0.0532,-0.0451,-0.1036,0.057,0.0239,0.2461,0.1238,-0.0406,-0.0701,0.0387,-0.0802,0.0204,0.0922,0.0128,-0.0347,-0.0166,-0.0227,-0.0358,-0.053,0.1066,0.0773,0.0065,0.0402,0.0,0.0463,0.0012,0.002,-0.06,0.0716,0.0126,-0.0831,0.065,0.1447,-0.0189,-0.3746,0.1393,0.1126,0.0248,-0.0022,-0.0282,0.015,0.0214,0.0461,0.0237,0.0319,0.0248,0.0371,0.0407,0.0615,0.0897,-0.0678,-0.1089,-0.1218,0.0577,0.0217,0.0151,0.041,-0.0489,-0.0093,0.1084,0.1527,-0.0684,-0.0673,0.0807,0.0522,-0.0418,0.0396,0.032,-0.0564,0.094,0.1196,0.091,0.0611,-0.0826,-0.1028,0.0282,-0.079,0.1595,0.0748,-0.0257,0.0056,-0.0917,-0.0498,0.0886,0.0828,0.0278,0.0653,0.0778,0.0909,-0.1028,-0.0807,-0.1867,-0.0868,-0.0902,-0.0786,0.0031,-0.0702,0.0786,0.0467,0.131,0.1892,-0.0258,0.0129,0.1081,0.13,0.0379,0.0825,-0.0085,-0.0653,0.016,0.094,0.0584,0.0433,-0.0241,-0.0584,-0.0062,0.0156,-0.0472,-0.027,0.0129,0.1239,0.0334,0.0979,-0.1022,-0.0689,-0.0828,0.0824,-0.0009,-0.0344,-0.0031,-0.0014,0.0461,-0.0135,-0.0903,-0.0634,-0.0131,-0.0001,0.0364,-0.0676,0.1872,-0.0055,0.1888,0.1527,-0.0246,0.025,-0.0555,-0.0829,-0.0174,0.0821,-0.0218,0.0558,-0.0498,-0.057,0.0514,-0.0296,-0.0026,-0.0,0.0981,0.0115,-0.0742,-0.0855,0.1143,0.0874,0.1598,0.0005,-0.1158,0.069,-0.0335,-0.064,-0.0918,-0.042,-0.0395,0.1095,-0.0024,0.1149,0.109,-0.068,0.1584,0.0905,-0.1004,0.0279,0.2061,-0.0028,0.0405,-0.0352,-0.0163,0.1647,0.0962,0.1846,-0.016,-0.0305,0.0701,0.0101,0.0991,0.0692,0.1205,-0.0151,-0.0318,0.0434,0.0307,-0.0297,0.0001,0.0341,-0.0637,0.1202,0.0338,0.0748,0.1108,-0.0303,0.0273,0.1737,0.0938,0.0376,0.0554,0.0381,-0.0761,0.104,-0.0572,0.1036,-0.0988,0.0684,-0.0212,0.0972,0.0747,0.1095,0.0313,0.0963,0.0768,0.1152,-0.1439,0.1389,0.009,-0.0472,0.1965,0.0805,0.1937,0.0553,0.0794,0.0413,0.0742,0.1323,0.0621,0.0766,-0.1021,0.0601,-0.0382,0.0369,-0.0461,-0.0293,-0.0828,0.0065,-0.0454,0.1097,0.0885,-0.0539,-0.0086,0.0342,-0.0484,-0.15,-0.0944,-0.0779,-0.0546,-0.0367,-0.0373,0.0495,0.0633,-0.0159,-0.0192,-0.0206,0.0225,0.0432,0.0313,0.0563,0.1056,0.1288,0.1306,-0.0653,-0.1378,-0.0972,-0.0279,-0.0747,-0.1247,-0.0338,0.0333,0.0082,0.0786,-0.0426,-0.0742,0.0379,0.1809,0.197,0.0921,0.0087,0.0005,0.0525,-0.0689,0.092,-0.073,-0.0067,0.0896,-0.0434,-0.0659,0.0148,0.2126,-0.1309,-0.1247,-0.2308,0.0428,0.0039,0.1088,-0.0067,-0.0889,0.076,-0.1269,-0.0251,0.0135,-0.0336,-0.0083,-0.0773,0.0786,0.111,0.0975,0.0699,-0.0511,-0.2415,-0.0432,0.1722,-0.0134,0.0644,-0.0377,-0.0399,-0.0198,0.0094,-0.01,0.0626,0.0974,-0.0807,-0.0347,-0.1053,0.1108,0.0414,-0.0263,0.0597,-0.0503,0.0504,0.0715,-0.0114,0.0777,0.0808,0.0464,-0.0858,-0.1247,-0.0437,0.0158,0.0414,-0.0038,-0.1569,0.0679,0.0806,-0.1282,0.0155,-0.0106,0.0215,-0.1132,0.0401,-0.1039,0.1015,0.1079,-0.1023,-0.1681,-0.183,-0.0092,-0.0139,-0.0596,0.036,-0.0127,-0.173,0.015,-0.0233,-0.1181,-0.1576,-0.0382,0.0217,-0.1097,-0.1678,0.1841,-0.0343,-0.0874,0.1556,0.0661,0.0967,0.0766,-0.1039,0.1226,0.0279,0.0956,0.0582,0.0809,-0.0411,-0.0092,-0.1331,0.0705,0.0756,-0.0318,0.0248,-0.0635,-0.0823,-0.0592,-0.1299,-0.0226,-0.035,0.005,0.0074,-0.1086,-0.1443,0.0818,-0.1073,-0.0833,0.0518,0.0376,0.0555,0.0246,-0.1342,-0.0067,0.1741,0.0573,0.0307,-0.0853,-0.1225,-0.024,-0.0621,0.0174,0.095,0.0688,0.0698,-0.0059,0.0413,-0.0559,0.0592,0.0999,0.0546,-0.0974,-0.0988,-0.0629,-0.0907,0.0858,0.0506,0.0306,-0.1823,0.0564,0.0437,0.0877,-0.0565,0.0223,0.0929,0.0215,0.0888,-0.0028,0.0958,-0.0379,-0.0477,-0.0359,-0.0557,0.1272,0.0356,0.0317,-0.0705,0.0545,-0.0025,-0.1496,-0.0755,-0.0945,-0.3634,-0.1234,0.0036,0.0456,0.0423,0.027,0.0843,-0.0098,-0.0602,-0.1477,-0.0406,-0.0179,0.1098,-0.1179,-0.1712,0.0269,0.0736,0.0263,0.0132,0.2703,0.1076,0.0786,0.0349,-0.0607,0.0938,0.0925,-0.1434,-0.0166,0.1333,0.0153,-0.0675,0.0293,0.017,0.0129,0.0804,0.0849,0.0907,0.0638,0.0644,-0.0766,-0.0345,0.0298,0.0955,-0.0351,0.085,-0.0463,0.0863,0.0764,0.0639,-0.0101,-0.0989,-0.0816,0.0464,-0.0548,0.0846,-0.0627,-0.0643,-0.1807,-0.2251,-0.1234,0.0607,0.1023,0.0232,-0.0055,-0.1206,-0.1094,-0.0833,0.0343,-0.0815,-0.0123,-0.1558,0.0369,0.0438,0.0802,-0.0525,0.1009,-0.0696,0.1218,0.0052,0.0046,-0.0519,-0.0596,-0.0276,-0.0516,0.0175,-0.0963,-0.1774,-0.1575,0.0204,-0.0183,0.0282,0.0358,-0.033,0.0129,0.0493,0.0634,0.1619,0.0248,-0.0956,-0.0881,0.1628,0.1108,0.001,0.1274,0.0209,-0.1236,-0.0138,-0.1007,-0.1025,-0.1296,0.0302,-0.0325,-0.0767,0.0135,0.021,0.0284,-0.0656,0.0578,0.178,0.0311,-0.0918,0.0809,0.0053,0.0654,-0.0709,0.1477,0.0038,0.0223,-0.01,-0.069,-0.1053,-0.0546,0.014,0.0008,-0.0321,0.0178,0.0275,0.0242,0.0058,0.0187,0.0633,0.0541,-0.0249,0.0085,0.0278,0.1148,0.0939,0.1488,0.0599,0.0829,-0.1213,0.017,-0.0395,0.1114,-0.1757,-0.1229,0.0153,-0.0128,-0.0483,-0.102,-0.0007,-0.0217,0.0977,0.0665,0.0018,0.0535,0.0471,-0.0043,0.0644,-0.0721,-0.1093,0.0364,0.0487,0.0773,-0.0391,0.1113,0.016,-0.0059,-0.0202,0.1363,0.0281,0.0104,-0.0843,0.0502,0.033,-0.4361,-0.2707,-0.2002,-0.0897,-0.1073,-0.0101,-0.1909,-0.173,0.0786,-0.4198,-0.3765,-0.2926,-0.2274,-0.3727,-0.1075,-0.0822,-0.0829,-0.0591,-0.0617,-0.0382,-0.0069,-0.0416,0.0824,-0.0113,-0.0427,-0.0376,-0.057,0.0026,0.0367,-0.2045,-0.1195,0.0174,0.0227,0.0394,-0.0505,-0.0022,-0.1198,0.0215,0.1102,0.0067,-0.0742,-0.0816,-0.1451,-0.1054,0.1717,0.0871,0.1507,0.08,0.0683,-0.3771,0.0898,-0.1726,-0.1077,0.0268,-0.003,0.1537,0.1212,0.0405,0.0944,-0.1747,-0.0685,-0.0055,-0.0443,-0.0315,0.0887,0.0898,-0.0225,0.028,0.0375,-0.0006,0.1175,0.0837,0.1037,0.0427,0.0361,-0.0174,0.2174,0.1263,-0.2023,-0.0344,-0.0048,-0.0129,-0.1575,0.0138,0.0236,0.0868,0.0882,0.0206,0.0866,0.1714,0.1859,0.0072,0.024,-0.0227,-0.0893,-0.0682,0.0156,-0.1156,0.0374,0.0108,-0.0315,-0.1183,0.074,-0.1229,0.0446,-0.1456,-0.2149,-0.0268,0.0644,-0.1671,-0.134,-0.0392,0.0877,0.0215,0.0931,0.0476,0.1856,-0.0028,0.0329,0.1363,0.1141,0.0242,0.1038,0.0374,0.0821,0.0951,0.0782,0.0347,0.0371,-0.0951,0.0508,-0.4879,-0.3722,-0.3161,-0.4132,0.03,0.0366,0.0568,0.0459,0.0524,0.0398,0.143,-0.1871,0.0357,0.0107,-0.0689,0.0656,-0.0413,-0.0963,-0.0565,0.0479,-0.0096,-0.0138,-0.0049,-0.0048,0.0218,-0.1019,-0.0256,-0.0306,0.0825,0.0825,0.1066,-0.0888,-0.0068,-0.029,0.0893,-0.1376,0.0777,-0.1166,0.1989,0.1657,-0.1112,0.0556,0.1638,0.1578,0.1843,0.0613,0.0899,-0.0385,-0.0241,0.0565,-0.0462,0.0225,-0.0605,0.1069,-0.1097,0.0445,-0.0315,-0.04,0.0898,-0.0046,0.0116,0.027,0.0022,-0.0063,0.2036,0.0224,-0.067,0.0955,0.0847,0.0388,0.0195,-0.0105,-0.0059,-0.0199,-0.0412,0.042,0.036,0.1274,0.2556,0.0375,0.0138,0.1306,0.1109,0.0976,0.1291,0.0006,0.1566,-0.0497,0.2691,0.1372,0.1014,0.2758,0.0053,-0.0253,0.0291,-0.2702,-0.0199,0.0689,-0.0149,0.0967,0.04,0.0377,0.3211,0.3172,-0.0746,0.0572,0.0689,-0.0018,0.0242,-0.0446,-0.0672,-0.0401,0.0622,0.0316,0.0473,0.0134,0.1248,0.0537,0.0005,-0.0582,0.0096,0.1178,-0.0397,0.0342,0.0302,0.0424,0.1136,0.1302,-0.0223,-0.0228,0.0246,0.0012,0.0298,0.062,0.0488,0.0003,0.1148,-0.0314,-0.004,0.083,0.2305,0.149,-0.0534,-0.0882,-0.0793,0.0118,-0.0294,0.0047,-0.2657,-0.0342,0.0196,0.0497,0.1142,-0.0727,0.0215,-0.0932,0.0492,-0.2513,-0.0064,0.1115,0.0644,-0.0963,0.0627,0.0048,0.016,-0.0333,0.0415,0.007,-0.0319,-0.0829,0.0663,0.0161,0.0098,-0.0256,-0.0608,0.0277,-0.0147,0.1499,-0.01,-0.0016,0.1086,-0.069,0.0512,0.0616,0.0601,0.0115,0.0547,0.0579,0.0035,0.0574,-0.0046,0.0166,-0.048,0.024,0.0308,0.0312,0.0329,0.0669,0.0273,0.182,-0.0471,0.1676,0.1277,-0.0415,-0.1007,-0.1088,-0.0478,-0.04,0.0988,0.0016,0.0268,0.0591,0.0979,0.0333,0.2356,0.0448,0.0178,0.097,0.0076,0.0586,0.0195,-0.0975,-0.0384,0.0268,-0.3406,0.0058,-0.0919,0.0052,-0.2633,0.0066,0.0595,-0.1125,-0.1989,0.0266,0.0008,0.0861,0.1561,0.0783,0.0486,-0.0649,0.0469,0.1032,0.0183,-0.0589,0.0592,0.0557,0.0434,0.0031,-0.0502,-0.1069,0.3417,0.1747,0.1163,0.3111,0.274,-0.1054,-0.0369,0.0009,-0.0376,0.0657,-0.0508,0.1276,-0.0286,0.0793,0.0864,0.2815,-0.017,-0.0066,0.026,0.1613,-0.1281,-0.0043,-0.0016,0.0162,-0.0122,-0.1019,-0.1541,0.0595,-0.0847,0.0411,0.0083,0.1119,-0.0055,0.004,0.012,0.0136,-0.1252,-0.0516,-0.0038,0.0319,0.0735,0.0375,-0.304,-0.2945,0.1569,0.1314,-0.0099,0.0708,0.11,0.0138,0.1682,-0.0305,-0.0039,0.0233,0.0125,0.025,-0.1034,0.0119,-0.0226,-0.081,0.0372,-0.0376,-0.2811,0.2306,0.0154,-0.2483,0.0257,-0.0235,-0.0637,-0.0669,0.0452,-0.1942,-0.1488,0.0701,0.0822,-0.0887,-0.0705,-0.2001,-0.1245,-0.0654,-0.0137,0.0037,-0.0843,0.0738,-0.0324,-0.2089,-0.0297,-0.0426,-0.0377,0.0301,0.1362,0.019,-0.0672,0.061,-0.024,0.1037,-0.0519,-0.0937,0.0108,-0.022,-0.0142,-0.0656,0.0006,-0.1614,-0.025,-0.094,-0.0966,-0.2285,-0.0448,-0.0286,-0.474,0.0234,0.0705,-0.0761,0.0739,0.0239,-0.0018,-0.0172,0.0683,0.0122,-0.03,0.0457,0.0158,-0.0087,-0.0116,0.0298,0.0226,-0.0409,-0.0974,-0.092,-0.2567,-0.2478,0.1192,0.1677,0.0613,0.0205,-0.0448,-0.0427,-0.0842,-0.066,-0.0967,-0.0106,-0.052,0.1709,0.1903,0.0658,-0.0251,-0.0837,0.0715,0.0316,-0.046,-0.2046,-0.139,0.0234,-0.0306,0.0088,-0.0103,-0.0453,-0.0675,0.2694,0.2414,0.3445,-0.0811,-0.0132,-0.0738,-0.1718,0.0084,-0.0491,-0.0909,-0.0277,-0.051,-0.0898,0.0044,0.0379,0.0796,0.0146,-0.068,-0.0703,-0.1985,0.0447,-0.0921,-0.1434,0.0207,0.0552,-0.0068,0.1772,0.0235,0.015,0.1046,0.015,-0.0357,0.1136,0.1724,0.0377,0.1097,0.1018,0.0978,0.1485,0.0513,0.0188,-0.004,0.1225,-0.0045,-0.1268,-0.017,-0.1107,0.115,0.0621,0.0788,0.0255,-0.0704,0.0005,0.0899,0.0347,0.1329,0.0114,-0.1487,-0.0506,-0.0886,-0.0673,-0.0157,0.0325,0.0685,-0.0228,0.031,0.0672,0.2467,0.0469,0.056,0.038,0.0449,-0.0658,-0.0604,-0.3388,-0.2801,-0.1517,-0.0993,0.1727,0.1868,0.1077,0.1612,0.0933,-0.0554,0.0606,-0.0036,0.0207,0.1018,0.1549,0.0729,-0.0232,-0.0315,0.086,0.0606,0.0005,0.0564,0.1503,0.1508,0.0206,-0.056,0.0117,0.0147,0.0634,0.0149,0.0698,0.0538,0.1465,-0.0074,-0.081,0.148,0.1096,0.0548,0.0437,0.0165,0.1159,0.1528,-0.0184,-0.2045,-0.1606,-0.0899,-0.1271,-0.1059,0.0004,-0.0838,-0.0701,-0.1278,0.0754,0.0045,-0.0113,-0.1028,0.0684,0.0937,0.0347,0.0964,0.0374,0.0795,0.0325,0.0675,0.0936,0.0602,-0.0337,-0.0237,0.1554,-0.0391,0.0161,0.0598,0.1325,0.0823,0.0176,0.1522,0.0051,-0.0322,-0.2027,0.074,-0.008,0.1841,0.0909,0.0525,0.1233,0.0995,0.0677,0.0012,-0.0253,-0.0497,0.0465,0.0559,-0.0428,-0.0235,-0.1154,-0.032,0.1974,0.203,0.134,-0.0011,0.0306,0.1201,-0.0413,0.0482,-0.0334,0.0676,0.0626,0.0766,0.0915,0.0813,0.0558,-0.0302,0.0686,0.0943,0.0604,0.0289,-0.078,-0.0991,0.1015,0.0448,0.0678,0.1363,0.0783,0.1359,0.0502,-0.2965,0.0206,0.0731,0.1578,0.0783,0.217,0.1161,0.1151,0.1104,-0.11,0.1127,0.0147,0.0152,0.2011,0.1254,0.1786,0.0515,-0.1755,0.0543,0.0401,-0.0377,-0.2801,0.0264,-0.0663,-0.027,0.0528,-0.0074,0.0256,0.0543,0.0225,-0.0161,0.2302,0.2676,0.2994,0.1686,0.0272,-0.1153,-0.1646,-0.1846,-0.0046,-0.0263,-0.0913,-0.1522,-0.0542,-0.1044,-0.0241,-0.074,-0.0627,0.1194,0.072,0.1112,0.0397,-0.0601,0.0675,0.0393,0.045,-0.0643,0.0375,0.2768,0.2135,0.0765,0.1347,0.1777,-0.005,0.1554,0.0705,-0.0662,0.0967,0.0462,0.1393,0.0436,-0.0496,0.0907,0.0199,-0.0359,0.1284,-0.061,-0.0615,-0.0625,0.076,0.0636,-0.1282,-0.0043,-0.0268,-0.1113,-0.0312,0.0217,-0.0857,-0.0288,-0.0389,0.248,0.0997,0.0417,0.0236,0.1383,0.0829,0.1171,0.0432,0.0187,0.0755,-0.0658,0.1067,0.0241,-0.0443,-0.0281,-0.0036,-0.0368,0.0054,0.2642,0.0384,0.0965,0.0905,-0.1553,-0.2264,-0.2132,0.0542,-0.433,-0.2881,0.1558,0.108,-0.4625,-0.0953,-0.078,-0.1383,-0.1898,-0.0772,0.0488,0.0447,0.0472,0.1222,-0.5493,-0.4361,-0.3364,-0.0954,-0.1916,-0.2923,-0.4866,-0.4844,-0.4267,-0.0666,0.0295,0.0659,0.052,0.0819,0.1107,0.0395,0.0633,0.0061,0.0241,0.0624,0.0486,-0.1246,0.016,0.0435,0.1452,-0.0758,-0.1172,-0.177,0.1549,0.0647,0.2204,0.0221,0.0248,0.0257,0.0496,0.0716,-0.004,0.0651,0.0609,0.0966,0.0888,0.1002,0.1583,0.0169,-0.2356,-0.1087,-0.1078,-0.0405,-0.1008,-0.2908,0.0451,0.114,0.1071,0.1513,-0.0818,0.0421,-0.156,-0.0802,-0.077,0.077,0.1809,0.1846,0.1324,0.1167,0.0833,0.3435,0.2732,-0.0157,0.0142,-0.1462,0.0825,0.0053,-0.0455,0.0158,-0.0733,-0.0725,-0.0143,0.1183,0.1712,0.0198,-0.0172,0.0996,0.0261,0.0887,-0.0515,-0.1616,-0.1561,-0.0777,-0.1571,0.0288,0.0341,-0.0823,-0.0565,-0.1042,-0.1755,-0.0824,-0.0609,0.0262,-0.0491,-0.0937,0.066,0.0648,0.0938,0.0647,0.0384,-0.0009,-0.0028,0.0448,-0.0006,0.0166,-0.0591,-0.0517,-0.0566,0.1389,-0.1772,-0.1041,0.0247,0.1505,0.0637,0.1004,0.0973,-0.0655,0.0249,0.0303,0.0378,-0.1231,0.0602,0.1643,0.0901,0.0697,-0.032,-0.0238,0.0351,-0.023,-0.0908,-0.0929,-0.3482,-0.1164,-0.0979,0.0358,0.0439,-0.0055,0.1004,0.1232,0.1028,-0.0201,0.1311,0.0743,0.0802,0.0805,-0.0269,0.0468,0.0782,0.0643,0.0351,0.0145,0.0952,-0.0515,0.0851,0.0823,0.0297,0.0854,0.1637,0.1652,-0.1054,-0.1211,0.0443,0.1051,-0.1986,-0.1744,0.2893,-0.1434,0.1195,0.0898,-0.0438,0.2776,0.2789,0.0534,-0.0374,-0.0178,-0.0296,0.0946,0.0587,-0.0179,-0.006,-0.0721,0.1225,-0.0271,-0.0369,-0.0584,-0.0555,0.1086,0.0309,-0.0043,0.0157,0.0439,0.0065,0.0515,0.005,0.0106,0.0287,-0.001,0.1717,0.0858,0.1408,0.1229,0.0954,0.0891,0.0735,0.0735,0.0137,0.0276,0.0001,0.167,0.0388,0.2018,0.1749,0.0362,-0.0008,0.2194,-0.1142,0.2885,-0.0463,-0.0371,-0.1303,0.0445,0.0301,0.088,0.1108,0.0028,-0.0399,0.0377,-0.1025,0.0333,0.0463,-0.1023,-0.1033,-0.0008,-0.0352,0.1276,0.0949,0.0112,0.1124,0.0555,0.0596,0.0837,0.0229,-0.0114,-0.0045,-0.0064,-0.002,0.0484,0.0162,-0.1041,-0.0031,-0.1356,-0.0439,-0.0251,0.0171,0.0219,-0.0261,0.0429,-0.0784,0.0144,0.079,0.0924,0.0882,-0.0387,-0.0411,0.0436,-0.1266,-0.0552,-0.2891,-0.1175,0.0116,-0.035,0.1541,-0.0135,-0.0779,-0.1,0.0774,-0.0096,-0.0721,0.0242,-0.0118,0.2976,0.315,0.229,0.2284,0.1227,0.1568,0.2662,-0.2607,0.0216,-0.0882,-0.1496,0.0548,0.0126,-0.0246,0.052,0.0756,0.0188,-0.0673,-0.1272,0.001,-0.0583,0.0905,0.021,-0.1482,-0.1041,-0.1164,-0.0664,-0.011,0.133,0.0263,0.124,0.058,0.1297,0.0111,0.0735,0.0518,0.0218,0.1007,0.066,-0.0002,0.0986,-0.049,0.0713,-0.0336,-0.0466,-0.0851,-0.0711,-0.0224,0.0408,0.096,0.0962,0.0641,-0.0064,-0.0593,0.0312,0.0412,0.002,-0.0358,0.0565,0.0416,0.0338,0.1271,0.1159,0.0147,0.0244,-0.0463,0.0709,0.0714,0.0703,0.0647,0.0673,0.0648,-0.0149,0.1889,-0.1496,0.0708,0.0482,0.0662,-0.054,0.0988,-0.0394,-0.0544,0.0234,0.198,-0.0613,0.0005,0.0979,-0.0373,-0.0639,0.0297,-0.0768,0.0954,0.0949,0.1287,0.1402,0.1619,0.071,0.0732,0.008,0.0386,-0.0949,-0.0988,-0.0986,0.1055,0.0713,-0.0903,-0.2153,-0.2816,-0.0492,0.0726,-0.0333,0.0097,0.0486,-0.1078,0.0666,0.0575,0.0567,0.0062,0.0785,0.1108,-0.2754,-0.0864,-0.0508,-0.2515,-0.0401,-0.0814,0.0199,0.0999,0.0922,0.0756,0.1185,0.0206,-0.0318,-0.0186,0.0248,0.0531,-0.0022,0.0745,-0.024,0.0273,0.1036,0.0503,0.0322,0.0372,-0.038,0.0049,-0.0242,-0.0229,0.0386,-0.0706,0.1622,0.0968,0.085,0.1272,0.0313,0.0585,0.0546,0.1679,0.0766,0.1773,-0.0297,0.1296,-0.0266,0.0953,-0.0745,-0.1401,-0.1244,0.0755,0.1111,0.0383,0.0153,-0.0454,-0.1229,0.1036,0.0462,0.0518,-0.0674,-0.0377,-0.0446,-0.0822,-0.0256,0.0548,-0.0501,-0.0169,-0.0622,-0.1273,-0.0639,0.0932,0.0974,-0.0193,-0.1223,0.005,-0.1058,-0.119,0.0778,-0.0191,-0.0256,0.1077,0.1301,0.0092,-0.0673,-0.2008,-0.0803,-0.0394,-0.0311,0.0231,-0.1714,-0.1817,-0.1063,-0.1241,0.0796,0.0036,0.0513,-0.0769,0.01,-0.014,0.1,0.063,-0.015,-0.0075,-0.0417,0.0388,-0.1027,-0.034,0.1204,-0.1422,-0.0719,0.0022,-0.0771,-0.0365,-0.1005,-0.0279,0.0109,-0.0012,0.0253,-0.0286,-0.1851,-0.1811,0.0365,0.0217,-0.0976,0.0681,0.1561,0.2819,0.261,-0.0123,-0.0329,0.0108,0.0461,-0.0414,-0.1131,0.0094,-0.0138,0.0274,-0.0725,0.0733,0.0486,-0.0255,-0.0155,0.0276,0.0752,0.0166,0.1007,0.0538,0.0823,0.0328,-0.0121,0.1048,0.0409,0.0038,0.088,-0.0356,-0.1071,0.0038,0.1184,0.0567,-0.2159,0.0902,-0.1004,-0.0995,-0.0875,-0.0096,-0.0707,0.2383,-0.1225,-0.0978,0.0733,0.0296,0.0484,-0.0504,-0.0139,0.0908,0.2744,0.1465,0.0735,0.0069,-0.0354,-0.0611,-0.0059,0.1064,0.1325,0.1692,-0.1792,-0.1857,0.0903,0.0834,0.048,0.077,0.1261,-0.2551,-0.1179,0.1028,-0.0224,-0.1305,-0.0805,0.2968,0.3032,0.1097,0.2024,0.0585,0.0853,0.0067,-0.0369,0.0019,-0.1149,0.0435,-0.0908,-0.3845,-0.1569,-0.1482,-0.3169,0.1781,0.1016,0.0675,-0.1033,-0.0105,-0.0044,0.0214,-0.0194,-0.0698,0.2478,0.2095,0.0391,-0.214,0.0928,0.2079,0.1753,0.1742,-0.0509,-0.0988,0.1349,0.064,0.0526,0.0937,-0.0524,-0.0688,-0.0372,-0.0652,-0.0008,0.0809,0.0196,0.071,-0.0271,0.0374,0.0297,0.0126,0.0918,0.0327,0.0008,-0.0063,-0.106,-0.0313,-0.0233,-0.035,0.0479,-0.0068,0.1627,0.1224,0.0335,0.1277,-0.382,-0.0087,-0.2522,-0.1087,-0.0412,-0.0155,-0.0286,-0.0834,0.1399,-0.1589,-0.1299,-0.0143,-0.0556,-0.0357,0.0124,0.0818,0.081,0.2366,0.048,-0.1791,-0.1115,0.1798,0.0393,0.0106,0.0139,-0.0099,0.0457,0.0995,0.117,0.028,0.288,0.0612,0.0444,-0.1078,-0.0752,0.005,-0.0463,0.0233,0.0146,0.1614,0.0836,-0.0321,-0.0803,0.0873,0.0377,0.1409,-0.0171,0.0211,0.0184,0.0359,-0.1828,-0.024,0.0882,0.2073,0.0641,0.1162,0.1142,-0.002,0.0868,0.0505,0.0201,0.0601,0.0735,0.0137,0.0362,0.0341,0.0541,0.025,-0.0298,0.0986,-0.1009,0.3401,0.2845,0.3006,0.0253,0.2289,0.3392,0.1259,0.0163,-0.1187,-0.0285,0.236,-0.2089,-0.2328,-0.1056,0.0367,0.0294,0.0283,0.1943,0.0404,0.1011,-0.0954,-0.1439,-0.2237,-0.0212,-0.0659,-0.0604,-0.0307,0.2745,0.0154,-0.0096,-0.0035,0.2845,0.2298,0.1905,0.2329,0.0105,0.1707,0.1769,-0.0882,0.1215,0.1805,0.0004,-0.0902,-0.0488,0.0709,0.0649,0.3011,0.2148,0.1223,0.2197,-0.1665,0.0696,0.0068,-0.0869,0.2378,0.1843,0.3018,0.1256,-0.1564,-0.0724,-0.1212,-0.1122,-0.1035,0.0722,0.0361,-0.0984,-0.0296,-0.1003,-0.0713,-0.0245,-0.1499,-0.0508,0.1604,0.1929,0.0653,0.0862,0.0977,-0.0242,0.1626,-0.0454,-0.0601,-0.0616,-0.0937,-0.0702,0.1232,0.0021,0.0748,0.0102,0.1557,0.2035,0.0183,0.0558,0.0383,0.042,0.0814,0.2099,0.0942,0.1211,0.1316,0.0681,0.0757,-0.006,-0.0807,0.005,0.0613,-0.0771,-0.0356,0.0087,0.0305,0.0333,0.1234,0.0427,-0.135,-0.0009,0.0691,-0.1473,-0.0251,-0.0184,-0.1056,0.0164,-0.0499,-0.0285,-0.0316,0.0055,0.0195,-0.0244,-0.1555,-0.1526,-0.2751,0.0504,0.0224,0.0173,0.1135,0.0129,-0.0989,0.1622,-0.1494,0.2255,0.1264,0.1416,-0.1087,-0.0095,0.0438,0.0205,0.0055,0.1755,0.1599,-0.0587,-0.0314,0.0615,0.0703,-0.0343,-0.1202,-0.1227,0.1438,0.1066,0.1103,0.0173,0.1378,0.0933,-0.0069,-0.0096,0.001,0.0201,0.0964,0.1005,0.1356,-0.0631,0.0751,0.142,-0.1463,0.0461,0.0296,-0.0866,-0.2482,-0.072,-0.0756,-0.1503,0.0809,-0.0158,-0.196,-0.1007,0.0598,-0.1871,-0.0612,-0.0623,-0.072,-0.2038,-0.0487,0.0999,0.1336,0.1042,0.0531,-0.1368,0.0614,-0.0068,0.1402,0.151,0.0793,0.0522,0.0182,-0.172,0.0278,0.0874,0.082,0.2789,0.1085,0.0324,0.0828,0.0607,0.0475,0.0545,0.0122,0.1148,0.0702,-0.1665,-0.2623,0.0242,0.0699,-0.0998,-0.0613,0.0685,0.0563,0.1541,0.2164,-0.1152,-0.1045,0.0639,0.0835,0.0742,0.0143,0.0765,0.0429,0.0496,0.0772,-0.0039,0.099,0.0243,-0.0279,0.1147,0.1083,0.0777,0.1387,-0.1007,0.1345,0.0192,-0.1372,0.0594,0.1241,0.1355,0.065,0.0877,0.0517,0.2168,0.2652,-0.0947,-0.0482,-0.1268,0.0479,0.0712,0.1003,0.0121,-0.0065,-0.0434,0.1523,0.0466,0.1069,-0.0432,-0.0498,-0.0789,0.1275,0.1254,0.0748,0.0997,0.1013,-0.0113,-0.015,-0.1155,0.0083,0.0312,0.0247,0.0476,0.0891,0.1716,0.0744,0.0931,-0.0148,0.0043,-0.1007,0.0616,-0.0944,-0.0023,-0.0439,-0.0,-0.0843,-0.1467,-0.1008,0.0093,0.0013,0.0956,0.0045,0.0154,-0.0039,0.0378,0.0295,-0.0009,-0.0348,0.0987,0.0806,0.0497,0.0139,0.0447,0.0397,0.0622,-0.1848,0.1087,-0.0381,-0.0267,-0.0465,0.0019,-0.0366,-0.0123,-0.0073,0.164,0.0501,-0.1046,-0.0911,0.0866,0.0536,0.1285,0.135,0.0348,0.0062,0.1003,-0.0594,-0.0469,0.1582,0.118,0.0366,0.0661,0.0561,0.0582,-0.3996,-0.2659,0.074,-0.0734,0.0235,0.0129,0.1197,0.0485,0.1378,0.206,-0.0151,0.0145,0.1127,-0.0294,0.0708,0.0979,-0.1293,0.0111,-0.0439,0.0238,-0.0188,0.0118,0.0717,0.0039,-0.1655,0.0987,-0.1185,0.1242,-0.0063,0.0959,-0.4128,-0.0709,-0.0867,0.0859,0.0815,-0.0487,-0.118,0.0111,-0.1019,-0.0006,0.0297,-0.0492,-0.1079,-0.017,-0.0404,-0.0721,-0.1391,-0.1781,-0.2668,-0.3033,0.0506,-0.0802,-0.2633,-0.5213,-0.2014,-0.0815,-0.3911,-0.2391,-0.2034,-0.2944,-0.1454,-0.2534,-0.1882,-0.2201,-0.2863,-0.0857,-0.2422,-0.3367,-0.2454,-0.2742,-0.215,-0.0756,-0.2067,0.1601,0.0838,0.0762,0.2919,0.1657,0.1785,0.1581,0.0701,0.1663,0.1582,0.1746,0.1277,0.1667,0.0586,-0.026,0.069,-0.122,0.0011,0.0829,0.0125,0.105,0.0603,0.0636,0.0152,0.1079,-0.0837,0.1159,0.1269,-0.016,0.0206,0.0849,-0.024,-0.0201,0.145,-0.1016,-0.075,0.0525,-0.2211,-0.3356,-0.0519,-0.123,-0.1408,0.1323,-0.1939,-0.1943,0.0128,-0.0056,-0.1424,-0.023,-0.0244,0.113,0.0165,-0.1317,0.0197,0.0436,0.0009,-0.0084,0.0266,0.0817,object maintenance
trm_55c6f58e77fbe,0.0165,0.0458,0.0205,0.0545,0.0089,-0.0132,-0.0082,0.0113,-0.0153,0.0185,-0.0026,-0.0089,0.0258,0.024,0.012,0.0378,0.0326,0.0234,-0.0198,0.0135,0.0112,-0.0122,0.0164,0.0083,-0.0084,-0.0085,-0.0096,-0.0012,-0.0168,0.022,0.0163,0.0026,0.0112,0.0598,0.0184,0.0731,0.0162,0.0215,0.0552,0.0053,0.0525,0.0832,-0.0198,-0.0124,0.0374,0.0311,-0.0424,-0.0334,-0.0276,0.0012,0.0235,-0.046,-0.0111,-0.0282,0.0309,0.0073,-0.0146,0.0215,0.0004,0.0037,0.0161,0.0029,0.0758,0.0152,0.01,-0.0455,0.0621,0.0244,-0.0,-0.0168,-0.0131,0.0113,-0.0142,0.0484,0.1438,-0.0288,0.0217,-0.0225,-0.0502,-0.0215,0.0287,0.0248,0.0388,0.0301,-0.0078,0.0003,0.0,-0.0297,-0.0203,-0.021,0.0437,-0.0376,0.0395,-0.049,-0.0424,-0.0369,-0.0392,-0.0145,-0.0633,0.0143,-0.0359,0.0082,-0.0327,-0.0247,-0.0248,0.067,0.0451,-0.0488,0.0527,0.0561,-0.0052,0.036,-0.025,-0.0591,-0.0066,0.0081,-0.0121,-0.0615,-0.0104,0.0166,0.0458,0.0564,0.0345,-0.0034,0.0548,0.0244,0.0307,-0.007,-0.0072,0.012,0.0482,0.0086,-0.0346,0.0861,-0.0075,0.0567,-0.0346,0.0476,0.0416,-0.018,0.0043,-0.0096,-0.0064,-0.0088,0.0762,0.0034,-0.0259,0.0135,0.0028,0.0172,0.0251,0.0282,0.033,0.0115,0.0046,-0.0094,-0.0161,-0.0098,-0.0123,-0.0168,0.0152,0.0459,0.0524,0.0651,-0.0222,0.0306,0.0349,0.0267,0.0245,-0.0021,0.0303,0.0343,-0.0069,0.0373,0.0517,0.0548,0.0374,0.0082,-0.0132,-0.0215,0.0578,-0.0074,-0.0039,-0.0024,-0.0528,-0.0057,0.0085,0.0207,-0.0091,0.0107,0.0208,-0.0023,-0.0283,-0.0367,-0.0429,0.1604,0.1883,-0.0207,-0.0048,0.045,0.0105,-0.0548,0.0669,0.076,-0.0174,-0.0217,-0.0205,0.0175,0.035,-0.014,0.0561,-0.0156,-0.0483,-0.004,-0.018,-0.0298,-0.0201,0.0365,0.013,0.0537,-0.0175,0.0299,0.0793,0.0393,-0.0007,0.0041,0.0391,-0.0342,0.0031,-0.0501,-0.0046,0.091,-0.0272,0.0445,0.0484,-0.0577,0.0423,-0.0202,-0.0179,0.0171,0.0232,0.0379,0.0389,-0.0258,0.0296,0.0229,0.0511,0.0226,-0.0031,0.0294,0.0029,-0.0247,0.0004,-0.0319,-0.051,-0.0085,0.0165,0.032,-0.0283,-0.0612,-0.0192,-0.017,-0.0088,0.0263,-0.0238,-0.0443,-0.0082,0.0294,0.0633,0.0127,0.0432,0.0058,0.0328,-0.0008,-0.0479,-0.0496,-0.05,-0.0241,-0.0182,-0.0355,-0.0557,0.0388,0.0353,0.0562,0.0489,0.0031,0.01,-0.0417,0.0434,0.0247,-0.0074,0.0036,0.0085,0.0592,0.0169,-0.0014,-0.0344,-0.02,0.0735,-0.054,-0.0511,0.0654,0.065,-0.0006,-0.0315,-0.0271,0.0579,0.0055,0.0359,0.0049,-0.0263,0.0073,0.1084,-0.0041,-0.0079,-0.0018,-0.0297,0.0038,0.0185,0.0379,0.0242,-0.0398,0.0191,0.0577,0.0734,0.0589,-0.0028,0.0446,0.0157,0.0477,0.0225,0.0047,0.0175,0.0272,-0.0027,-0.0704,-0.0303,-0.0559,-0.0037,0.0243,0.0274,-0.0134,0.0002,-0.0255,-0.0353,-0.0352,0.0414,0.0532,0.0244,0.013,0.0316,-0.0422,0.0245,-0.0142,0.0523,0.0373,0.0121,-0.0082,0.0188,0.0232,0.0101,-0.0077,-0.0663,-0.0011,-0.0127,0.0159,0.0317,-0.0465,0.0471,-0.0335,0.0121,0.0243,0.0229,-0.0327,0.0187,-0.0013,0.012,-0.0356,-0.0453,-0.023,-0.0433,0.0193,0.0118,0.001,-0.0436,-0.0551,0.045,0.0028,-0.0316,-0.0092,-0.0412,-0.0079,0.0398,0.0227,-0.0509,-0.0479,0.0005,0.0534,-0.0247,-0.0011,0.0238,-0.0237,-0.015,0.0145,0.0263,-0.0029,-0.0025,-0.0181,0.0123,0.0032,0.0241,0.0988,0.0327,-0.0422,0.0229,-0.0063,-0.0274,0.0392,0.0541,0.0437,0.0004,0.0534,0.0224,0.2174,0.1974,0.0725,0.1111,0.0325,0.0749,0.043,0.0527,-0.0218,-0.0072,-0.0095,-0.0019,-0.0187,0.0095,-0.019,0.0666,0.0374,-0.033,0.0407,0.025,-0.0109,-0.0138,-0.0163,-0.0122,-0.0271,0.058,0.0597,0.0359,-0.0167,0.0613,-0.0114,0.0126,0.0261,-0.0236,0.0373,0.0699,0.0517,0.0181,0.074,0.0118,0.0974,0.0035,0.029,0.0246,-0.0479,-0.011,0.0209,-0.0235,0.0108,-0.0081,0.0121,0.0047,0.0147,-0.0017,0.0219,-0.024,-0.0059,-0.0416,-0.036,0.0134,-0.0065,0.0132,-0.0156,-0.0062,-0.027,0.0601,-0.0052,-0.0271,-0.0638,0.1028,0.1438,0.0252,-0.0245,-0.0568,0.0207,-0.0039,-0.0064,-0.0157,0.015,-0.0033,0.0223,-0.0156,0.0432,-0.026,-0.0303,0.0211,-0.0758,0.0376,0.0074,0.0012,-0.0162,0.0025,0.0098,0.0108,-0.0003,-0.0255,0.022,-0.0125,-0.0144,-0.0423,0.0007,-0.019,-0.0203,-0.0161,-0.0071,-0.0181,-0.0152,0.0327,0.0078,0.0055,0.1018,0.0122,0.0112,0.0588,0.0961,0.0196,0.0233,0.0188,0.0242,-0.0284,0.0025,0.0162,0.0072,0.0146,-0.017,-0.0042,0.0297,-0.0444,0.0009,0.0357,-0.0216,-0.0129,0.0459,-0.0099,-0.0478,0.0118,0.0007,0.0165,0.0262,0.0229,-0.0438,-0.0076,-0.0301,-0.031,-0.0352,-0.0314,0.0041,0.0208,0.0199,0.0013,-0.0258,-0.0276,-0.0185,-0.0061,-0.0142,-0.0411,-0.0338,-0.0025,0.0562,0.0308,0.0299,-0.0429,0.0299,-0.0079,-0.0099,-0.0349,0.0014,0.0301,0.0005,0.0124,-0.0263,0.024,0.0084,0.0595,0.0497,-0.0396,0.0341,0.0116,-0.0576,-0.0077,-0.0213,-0.0337,-0.0115,0.0435,-0.0243,-0.0335,-0.0069,0.0114,-0.0099,-0.0311,-0.0072,0.0883,0.027,0.0046,0.0367,-0.0025,0.0815,0.0126,0.0501,-0.0042,-0.0214,0.0058,-0.0177,0.13,0.032,0.0573,0.0195,-0.0094,-0.0475,0.0232,0.0406,0.0404,0.012,-0.0113,-0.0059,0.0197,0.0032,0.0425,-0.0023,0.0105,-0.0049,0.0715,0.0153,0.13,0.0381,-0.0056,0.0854,-0.0316,0.0694,-0.047,0.0546,-0.0105,0.0191,-0.0208,0.0177,0.033,0.0343,0.1251,-0.0553,-0.0475,-0.0075,-0.0372,-0.0044,0.0088,0.0047,0.0053,-0.0138,0.005,0.0115,0.0381,0.0768,0.0785,0.0087,-0.0334,0.0521,-0.0391,0.0216,-0.0319,-0.0279,-0.0355,-0.0243,-0.0494,0.0385,0.0089,-0.0124,0.001,0.0004,-0.0465,0.0046,-0.0326,-0.0081,0.0096,0.0481,0.0486,-0.004,0.0195,0.0615,-0.0013,-0.0049,-0.0377,0.0376,0.0152,0.0018,0.0537,0.1394,0.1017,-0.0412,0.0074,0.0519,0.0802,-0.0297,0.0398,-0.0278,0.0063,-0.0331,0.0233,-0.0071,-0.0455,-0.0037,0.1724,0.1733,0.0889,-0.0036,-0.0353,-0.0071,0.0029,0.0351,-0.0187,0.0048,0.0023,-0.0026,0.0192,-0.0006,0.008,-0.0117,0.0125,-0.0194,0.0023,0.0313,0.0293,0.0366,-0.0178,-0.0214,-0.005,0.0548,-0.0092,-0.023,0.0075,-0.0385,0.0437,0.0754,0.0566,0.0402,-0.0099,-0.0256,0.0202,0.0311,0.0037,-0.0323,-0.0245,-0.0308,0.0041,0.0008,-0.0087,0.007,0.002,-0.0453,-0.0498,-0.0498,-0.0239,-0.0312,-0.0328,0.0235,0.0126,0.0101,0.0318,0.0125,0.0102,0.01,0.0459,0.0104,0.0292,0.0394,-0.0089,-0.0173,-0.0423,-0.0216,-0.0109,0.0334,0.0144,-0.0011,0.0107,0.0143,-0.0078,0.0638,-0.0126,-0.0381,-0.0379,0.0063,0.0015,-0.0536,-0.005,0.0211,-0.0153,-0.0064,0.0433,-0.054,-0.0265,-0.0095,-0.0127,-0.021,-0.0156,-0.0137,-0.0709,-0.0442,0.0426,0.0063,-0.019,0.0396,0.0569,0.0047,0.0084,0.0423,0.058,-0.0176,0.0282,0.0819,0.0646,0.02,0.0299,-0.0131,0.0368,0.0424,0.0102,-0.0265,-0.0009,-0.0124,-0.0117,-0.0236,-0.0417,0.0286,-0.0138,0.0035,-0.0288,-0.0468,0.0366,0.0042,-0.0044,-0.0364,0.0028,0.0046,-0.0061,-0.0414,0.0475,0.1546,0.0614,0.0025,-0.0518,-0.0422,-0.0034,-0.0086,-0.0409,-0.0178,0.0402,0.0322,0.0397,0.0959,0.0216,0.0762,-0.0274,-0.0007,-0.0216,-0.0067,-0.0082,0.0055,0.0364,0.0331,0.0071,-0.0345,0.0216,0.0185,0.0393,0.0182,-0.0034,0.0378,0.0711,-0.0149,0.0063,0.0244,0.0182,-0.0713,-0.0121,0.0218,0.0744,0.0404,0.0086,-0.0475,0.0719,-0.0501,0.0131,-0.0424,0.0043,-0.0402,-0.0382,-0.0068,-0.034,0.084,0.0387,-0.0006,0.0061,-0.0131,-0.017,0.0129,-0.0288,0.001,-0.0118,-0.0288,-0.0356,-0.0095,0.0282,0.0412,0.0162,0.0128,0.0106,-0.0171,-0.0093,0.0233,0.0059,-0.0177,-0.0127,0.0307,-0.0192,-0.0239,0.0261,-0.0255,0.0029,0.0045,0.005,0.0748,0.0193,0.0761,0.0055,0.0197,0.0349,0.0586,0.0462,0.0355,0.0418,0.0662,0.0261,0.0296,-0.0282,-0.0078,-0.0288,0.0275,0.0086,0.0104,-0.0112,-0.0252,-0.0102,-0.0335,0.0205,0.0176,-0.0031,-0.0233,0.0012,-0.0055,0.0174,-0.0209,0.0395,-0.0456,0.0124,0.0008,-0.0086,0.0152,0.0113,-0.0356,-0.0058,-0.0098,-0.0165,-0.001,0.0279,0.0227,0.0174,-0.032,-0.0443,-0.0573,-0.0423,-0.0163,0.0005,0.0211,0.0255,0.0054,0.006,-0.0039,0.013,-0.0051,0.034,0.0487,0.0367,0.011,0.0174,0.03,0.0175,0.0384,0.0922,0.0558,-0.0198,-0.0119,-0.0262,-0.0048,-0.0017,0.0482,0.0014,0.0008,-0.0227,-0.0241,-0.0258,0.0149,-0.0131,0.0222,-0.0215,-0.0094,0.031,-0.0233,0.0293,-0.005,0.0519,-0.0237,-0.0631,-0.0405,0.0067,-0.0039,0.0093,-0.0214,0.0043,-0.0036,0.018,0.048,0.0086,-0.0188,-0.014,-0.0144,0.051,-0.0092,0.0067,0.0222,-0.0119,0.0589,0.0549,0.0533,0.0295,-0.0198,0.0082,-0.0043,0.0088,-0.0103,-0.0246,-0.0102,0.0227,-0.015,-0.0045,0.0273,-0.0263,0.0028,0.0276,0.0444,-0.0012,0.0005,0.0478,0.0231,0.0366,-0.0273,0.0067,0.0466,0.0133,-0.0052,-0.0046,0.0072,-0.0216,0.0063,0.0323,0.0508,0.0209,-0.0209,0.0259,0.0171,-0.0679,-0.0361,-0.0656,-0.0507,-0.0292,-0.0306,-0.0627,-0.0366,-0.0431,-0.0429,-0.0253,-0.0104,-0.0019,-0.0195,0.0047,0.0123,-0.0224,-0.0056,-0.0009,-0.0172,0.0252,-0.0044,-0.0051,-0.0211,-0.0227,-0.0048,0.0025,0.0533,0.0221,-0.0203,0.0148,0.0273,-0.0079,-0.0451,-0.0381,-0.0036,-0.0087,0.017,0.0585,0.0367,0.0031,0.0118,-0.0307,-0.0165,-0.0067,0.0567,0.0627,0.0423,0.0018,-0.0264,-0.0378,-0.0531,-0.0383,0.01,-0.0089,-0.0347,-0.045,-0.0482,-0.0367,-0.0433,-0.0386,-0.0275,0.0104,-0.0065,0.0289,0.0559,-0.0159,-0.0308,-0.0412,0.016,0.012,0.0172,0.0436,0.0482,0.0058,0.0162,0.0611,-0.006,-0.0249,0.0065,-0.0152,0.0021,-0.0058,-0.0265,-0.0067,-0.0288,-0.0361,0.0529,-0.0018,-0.0019,0.0091,-0.0059,0.007,0.0186,-0.0427,0.0111,-0.0472,-0.0458,0.0059,-0.0453,0.013,-0.0164,-0.0427,-0.0259,-0.0055,-0.0303,-0.0526,0.0233,0.0119,-0.0221,-0.009,0.0142,-0.0066,0.0071,0.037,0.0029,0.1087,0.0393,0.0085,0.0412,0.0953,-0.0212,0.0419,-0.0251,0.0039,0.0267,0.0491,0.0744,-0.0163,-0.0016,-0.0096,-0.048,-0.0254,-0.0276,-0.0376,0.0337,0.0407,0.0102,0.0597,0.0489,0.0316,-0.0243,-0.0263,0.029,-0.0189,0.0143,0.0424,0.032,0.0265,0.0152,0.0078,0.0172,-0.0227,-0.0002,-0.0281,-0.0117,-0.0399,0.0185,0.0055,-0.0215,-0.0215,-0.0152,0.0374,0.0538,-0.0049,0.0014,-0.0248,0.0706,-0.0455,0.0146,0.0121,0.0159,0.008,0.0041,0.0037,0.0217,0.0167,0.0043,0.0333,-0.0176,0.0002,-0.0145,0.0005,-0.0618,0.03,-0.0009,-0.0205,-0.0507,-0.0263,0.0189,0.013,0.0048,-0.0157,0.0283,0.019,-0.0418,-0.0597,-0.016,-0.03,-0.0424,-0.0695,-0.0306,-0.045,0.0093,0.0164,-0.0236,0.0511,-0.0148,0.0499,0.0625,0.039,0.0427,0.0624,-0.0044,-0.0051,0.0528,-0.0268,0.002,-0.0336,-0.0063,-0.0393,0.0159,0.0484,0.0579,-0.0127,0.0155,-0.0414,-0.111,-0.0882,-0.0978,0.0033,0.0091,-0.0011,-0.0383,-0.0364,-0.0343,-0.0111,-0.0459,0.0179,0.0104,0.0431,0.0056,-0.0153,-0.0262,-0.0018,0.004,-0.0282,-0.039,0.0133,0.01,-0.0282,-0.0001,0.056,-0.0029,0.0243,0.0326,-0.0141,0.0282,0.0274,-0.0053,-0.0001,-0.0094,-0.0203,0.0469,0.0417,-0.0082,0.0106,0.0239,0.0122,-0.0039,-0.0064,-0.0158,0.13,0.0011,-0.0586,0.027,0.0488,-0.012,-0.0066,-0.0313,-0.061,0.0009,0.0243,0.0562,-0.0336,-0.0122,-0.0447,-0.0207,-0.0288,-0.015,-0.0118,-0.0104,-0.0469,0.0525,-0.0213,-0.0308,0.0072,0.0175,0.001,0.0061,-0.0286,0.024,0.0125,0.0137,0.0081,0.0041,0.0068,0.0159,-0.0109,0.0129,0.0326,0.0163,-0.033,0.0131,0.0283,0.0013,0.0387,0.0343,0.0434,0.0164,0.0427,0.0061,-0.0148,-0.0245,0.0023,0.0178,0.0018,-0.0044,-0.0204,0.0858,0.1428,-0.0342,-0.014,-0.0403,-0.0068,0.037,0.005,-0.003,-0.0441,0.0173,0.0106,0.0364,0.0033,0.0521,0.0118,0.0415,-0.0181,0.0364,0.0435,0.0174,0.0241,0.0486,-0.102,-0.0642,-0.0226,-0.0359,-0.0446,-0.0065,-0.0101,-0.057,-0.0284,0.0278,-0.008,-0.0644,0.0144,-0.0024,0.0233,0.0631,0.0333,-0.0158,0.0027,-0.024,-0.0055,-0.0547,-0.038,0.0257,0.0217,-0.0064,-0.0475,-0.0099,-0.0375,0.0769,0.0819,0.0102,0.0372,0.0305,-0.0155,-0.0305,-0.0274,0.0129,-0.0315,0.0013,0.0261,-0.0213,0.0308,0.0318,0.0611,0.0146,-0.006,0.0166,0.0575,-0.0308,0.0315,0.0497,0.0506,-0.0218,-0.052,-0.0342,-0.0239,0.0165,0.0116,0.0337,0.0314,0.0408,-0.029,-0.0326,0.0128,-0.0183,-0.0286,-0.0474,-0.0217,0.033,0.01,-0.0791,-0.0834,0.0663,0.1024,-0.04,-0.0083,-0.0219,0.0051,0.0951,0.0011,0.0282,0.0331,0.0098,0.0333,-0.0602,0.0559,-0.0064,-0.0123,0.0543,-0.0265,-0.0733,-0.0225,-0.0071,-0.0539,0.0047,-0.0169,0.0222,0.0141,0.0302,-0.017,-0.0132,0.0183,0.0258,-0.0242,0.0406,0.0122,-0.0278,0.0417,-0.0086,-0.0148,-0.0042,0.0773,0.0232,-0.0065,0.0293,0.0076,-0.0134,-0.0293,0.0268,0.0331,-0.0266,-0.0168,-0.0871,-0.0183,-0.0383,-0.0472,0.0485,0.0496,0.0171,0.0096,-0.0327,0.0155,-0.0618,-0.0111,-0.0301,-0.0214,-0.0175,0.0041,-0.0643,0.0229,0.0894,0.0315,-0.0024,-0.0273,-0.0437,-0.0738,0.0061,-0.0373,-0.0237,0.0382,0.0128,-0.0071,0.0326,-0.0384,-0.0319,-0.0543,-0.0553,-0.0154,-0.0249,-0.0602,0.0156,0.0369,0.0003,0.0203,-0.0501,-0.002,0.0464,-0.0234,-0.0243,0.0044,-0.006,-0.0281,0.103,0.0693,0.0001,-0.0182,0.0213,0.0145,-0.0114,-0.039,-0.0226,-0.0547,0.01,0.0131,-0.0357,0.0068,-0.0275,-0.0309,-0.0303,-0.0221,-0.0008,-0.0077,-0.0137,-0.0164,-0.0296,-0.0238,-0.0232,-0.051,-0.0315,-0.0309,-0.0164,-0.0407,-0.049,-0.0366,-0.0293,-0.0442,-0.0589,-0.0122,-0.0275,-0.0122,0.0017,-0.0221,-0.0211,0.0635,0.0281,0.0021,0.0288,0.0091,0.0014,0.0134,-0.0104,0.0152,0.0145,0.0208,-0.029,0.0007,0.0492,-0.0172,-0.0016,-0.0226,-0.034,-0.0043,0.0072,-0.0428,0.034,0.055,0.0366,0.0313,-0.0045,0.0912,0.019,0.0039,-0.0054,-0.0339,-0.0378,-0.0308,-0.0167,-0.0141,-0.015,0.0064,0.0109,-0.0001,-0.0145,-0.0337,0.0044,-0.017,0.0516,-0.0031,0.0117,-0.0076,0.0094,-0.0257,-0.0092,-0.0187,-0.0202,0.0308,-0.0164,-0.012,0.0072,0.007,-0.0191,0.0122,0.0122,-0.0037,0.0322,0.0075,-0.0014,-0.0274,-0.0251,-0.0087,0.0308,0.0087,-0.0139,0.0111,-0.0036,0.0402,-0.0113,-0.0217,0.0089,0.1356,0.0538,0.0322,0.0411,0.1802,0.0148,-0.0119,0.0374,0.0545,0.0102,0.013,-0.0272,0.0162,-0.0138,0.0348,-0.0086,-0.019,-0.0186,0.0227,-0.0306,0.0188,0.0369,-0.0279,-0.0016,0.0307,0.0239,0.0393,-0.0184,0.018,0.0511,0.0557,0.0336,0.0395,0.0587,0.0088,0.045,0.0291,0.0102,0.0666,0.0636,0.0492,0.0177,0.0123,0.0313,0.0613,-0.0182,0.0017,0.094,0.0123,-0.0223,-0.0243,0.0067,-0.027,0.1412,0.04,0.0234,0.015,0.0676,0.0302,0.0741,-0.0513,-0.0533,0.0395,0.0062,-0.0063,-0.0462,-0.0388,-0.0653,0.171,0.1652,0.002,-0.0115,0.0124,0.0589,0.0139,0.0482,0.0143,-0.0003,0.0164,0.0373,0.0005,0.0011,0.0524,0.0097,0.1423,-0.0118,-0.0073,0.0391,-0.0152,-0.0575,0.0297,0.019,0.0831,0.0075,-0.0048,-0.0096,-0.0007,-0.0493,0.0301,0.0444,-0.0363,-0.0237,-0.0054,-0.0199,-0.0049,-0.0264,-0.026,-0.0235,-0.042,-0.0065,-0.0033,-0.0123,-0.0424,-0.0629,-0.0612,0.1394,-0.0485,-0.0347,-0.0459,-0.0234,-0.0237,-0.0161,0.0028,0.0235,0.0114,-0.0419,0.0734,0.0086,0.0163,-0.0235,-0.0021,-0.0469,0.0155,-0.0454,-0.0556,-0.0697,-0.0188,-0.0219,-0.0052,-0.0195,-0.034,0.0017,0.0192,0.0049,0.0064,0.0945,0.0215,0.0529,0.0271,0.0435,0.0427,0.0602,0.0385,0.0012,-0.0023,0.0245,0.0509,0.0776,0.0836,0.1511,-0.0026,0.128,0.051,-0.0086,-0.0132,-0.0123,0.0442,0.0679,0.0594,-0.0374,-0.0068,0.0137,0.0137,-0.0558,-0.0241,-0.0398,-0.0113,0.0265,-0.0173,0.0433,0.0466,-0.013,0.0261,0.0272,-0.02,0.029,-0.0085,0.0634,0.0619,0.0343,0.0071,-0.062,-0.0025,0.006,0.0101,-0.0222,0.0217,-0.0124,0.0436,0.0002,-0.0162,-0.0322,-0.0262,-0.0093,-0.0168,0.0444,-0.0487,0.0181,0.0317,-0.0181,-0.0511,-0.0363,-0.0269,-0.0814,-0.036,0.0173,0.0107,-0.0724,-0.0465,0.0094,-0.0345,-0.037,-0.0272,-0.0096,-0.0099,-0.0321,-0.0208,-0.0705,-0.0443,-0.0457,0.0157,-0.0318,-0.0336,-0.0655,-0.057,-0.0609,-0.0201,0.0159,-0.0158,-0.0165,-0.0057,-0.0057,0.065,-0.0082,0.026,0.0504,0.0456,0.0256,-0.0123,0.0171,0.0236,-0.0359,-0.007,-0.0081,-0.0633,-0.0142,-0.0456,-0.0357,0.0067,0.0176,0.0145,0.0183,-0.0054,0.0642,-0.031,0.0209,0.0366,0.0322,-0.049,-0.035,0.0412,-0.0298,-0.0057,-0.0393,-0.0101,-0.0601,-0.0683,0.0076,0.0761,0.0688,-0.0339,-0.016,0.0444,-0.0499,-0.0349,-0.0317,-0.0264,0.0265,0.0239,0.0114,0.0134,-0.0332,0.0736,0.0461,-0.0161,0.0195,-0.0022,-0.0215,0.016,-0.0149,0.0229,0.0051,-0.0209,0.0212,0.0651,0.078,-0.0099,-0.0279,-0.0242,-0.0239,-0.0154,-0.0323,-0.0586,-0.0496,0.0028,-0.0433,0.0002,0.0088,-0.038,-0.046,-0.0048,-0.0251,-0.0012,-0.0156,-0.0049,-0.0439,-0.0313,0.0057,0.0056,-0.0583,-0.0456,0.0351,-0.0123,0.0443,0.0168,-0.0306,0.0261,-0.0273,-0.0102,-0.0424,-0.0049,-0.032,-0.0441,0.0293,0.046,-0.0126,0.0124,0.0456,-0.037,-0.0237,-0.0251,-0.0248,-0.007,0.0055,0.1156,0.0046,0.0048,0.058,-0.0091,0.0054,-0.0334,-0.0605,-0.068,-0.0801,-0.0357,0.0123,0.0462,0.009,-0.0351,0.0325,0.0171,0.0077,-0.0016,0.0285,-0.0203,-0.0139,0.027,0.0369,0.0565,0.0781,0.055,0.017,0.0081,-0.0118,0.0297,0.0313,0.0117,-0.0162,0.0234,0.0016,-0.0448,-0.0734,0.0384,-0.0228,0.0514,-0.0361,0.0086,-0.0444,-0.0456,0.0316,0.0335,-0.0668,-0.0485,-0.0477,0.0009,0.0082,-0.0049,-0.0007,-0.0112,-0.0012,0.0108,0.0053,0.0031,0.0645,-0.015,-0.0046,-0.0193,0.0103,0.0358,0.0001,-0.0285,-0.0197,0.0203,0.0103,0.0303,0.0537,-0.0386,0.0156,-0.0508,0.1094,0.0107,0.0455,0.1146,0.0553,0.0387,0.0046,0.0046,-0.0063,0.0324,0.0006,0.0442,-0.0131,-0.0253,-0.0171,0.0342,0.0469,0.1754,-0.0443,0.0474,0.0306,-0.048,-0.0347,-0.0515,-0.0304,0.028,0.0311,-0.0058,0.0307,0.0054,-0.0493,-0.003,-0.0397,-0.0413,-0.0372,0.0244,-0.0112,-0.0477,-0.0363,-0.0356,0.095,0.0382,0.0218,0.0184,-0.0009,0.02,-0.0095,-0.0203,-0.0191,0.0008,-0.0079,0.0322,0.0872,-0.0239,-0.007,0.1009,0.0564,0.1148,-0.0152,0.0197,-0.0409,0.017,-0.0619,-0.0631,-0.0522,0.0019,-0.0088,-0.0174,-0.0428,-0.0331,-0.0792,-0.0074,0.0382,-0.0115,-0.0092,-0.037,-0.0077,-0.0226,0.005,0.0136,-0.0046,0.0046,0.0264,-0.0052,-0.0384,-0.006,0.0016,-0.0001,0.0294,0.0174,-0.0423,-0.016,-0.0009,-0.0289,0.0901,0.0062,-0.0214,0.0283,0.0211,0.0011,-0.0004,-0.03,-0.0045,0.0017,-0.0172,-0.0258,0.0104,-0.0487,0.0442,0.0098,0.0418,-0.0207,-0.039,0.0494,-0.0143,-0.0465,-0.0188,-0.0338,0.0301,-0.0187,-0.0085,0.0234,-0.0267,0.0131,-0.0133,-0.0143,-0.0346,-0.0079,-0.0137,-0.0284,0.0319,0.0271,-0.0052,0.0352,0.0112,-0.0045,-0.0353,0.0257,0.0268,0.0186,-0.0442,-0.0085,0.0238,0.0495,0.0518,0.045,0.0149,0.0438,0.0333,0.046,0.0373,0.0985,0.0144,0.0376,-0.0378,0.0072,-0.0138,-0.0497,0.0241,0.0161,0.0103,-0.0134,0.0172,0.0345,-0.0347,-0.0178,0.0323,0.0156,0.0236,0.0397,0.0014,-0.0434,0.0033,-0.0018,0.0035,0.0449,0.043,0.0613,0.0402,-0.0372,0.03,-0.0321,-0.0205,0.0057,0.0146,-0.0366,0.0447,0.0254,-0.0257,-0.0365,-0.0663,0.0065,0.036,0.0039,0.0073,-0.0004,0.0559,-0.0082,0.0376,0.0025,0.0095,0.008,0.0097,-0.0274,-0.0123,-0.0047,-0.0224,0.0267,-0.0164,0.0168,0.0199,0.0308,-0.0513,0.0291,-0.0084,-0.0073,-0.0062,-0.0438,0.0234,0.0111,0.0202,0.0004,0.0513,0.1542,-0.0181,0.0496,0.0305,-0.0061,-0.0294,-0.0118,0.0007,0.0178,-0.0223,0.0461,0.013,-0.0237,0.037,-0.024,0.0192,0.0107,0.0686,0.0338,-0.0044,-0.057,0.0278,0.0524,0.0109,0.0279,-0.045,-0.0064,0.02,0.0348,0.0057,0.029,-0.013,-0.0248,0.0061,0.0244,0.0077,-0.0211,0.0069,-0.0221,-0.0269,0.0229,0.0178,-0.0018,-0.0511,0.0048,0.0122,0.0168,0.0093,-0.0024,-0.023,-0.037,-0.025,-0.0394,-0.0161,-0.0541,-0.0034,-0.0194,0.0643,-0.0012,0.0182,-0.0366,-0.066,-0.0093,0.0088,0.0446,0.016,-0.0424,-0.0479,0.0257,0.0079,0.038,-0.0059,0.005,0.0114,-0.0054,-0.0201,0.021,0.0127,-0.0364,0.0309,0.0113,0.0135,-0.0152,-0.0206,0.0265,-0.0477,-0.0178,0.0189,0.0104,0.0111,0.0134,0.0245,-0.0474,0.0236,-0.0104,-0.025,0.0001,-0.0177,0.0236,-0.0283,-0.0122,0.022,0.0793,0.131,0.1219,-0.0347,-0.0085,-0.025,0.0086,0.0249,-0.0021,0.0246,0.0363,0.0281,-0.0071,-0.0159,0.0352,0.0446,-0.0125,0.0261,0.083,0.038,0.0604,0.0874,-0.0487,-0.0068,0.0099,0.0553,0.0518,0.026,-0.0119,-0.0138,-0.031,0.0085,0.0587,0.0568,-0.0118,0.0463,0.0239,0.0297,0.0442,0.0277,-0.0065,0.001,-0.0221,-0.0428,0.0397,0.0805,0.0897,0.0298,0.0464,0.0414,0.0026,0.0698,0.0258,-0.0011,-0.0028,0.0028,-0.0052,-0.0259,-0.0048,0.0308,-0.0372,-0.0051,0.0428,0.0263,-0.011,-0.0026,0.0366,-0.0459,-0.0506,-0.0113,-0.0035,-0.0436,-0.0462,0.0251,0.0162,0.0385,0.0807,0.0046,0.0368,0.0274,-0.0322,-0.0307,-0.0107,-0.0317,-0.045,-0.0914,-0.0319,-0.0055,-0.0545,0.1309,0.155,0.0349,-0.0408,-0.016,-0.0194,-0.0056,-0.0013,-0.0534,-0.0133,0.0238,0.0185,-0.0451,0.0078,-0.005,-0.0118,-0.0289,-0.0217,-0.0168,0.0015,-0.0531,-0.0416,-0.0478,-0.0105,-0.0334,-0.025,-0.0237,-0.0147,-0.0596,-0.0891,-0.0424,-0.0528,0.0047,0.0017,0.0098,-0.0119,-0.0027,-0.0076,0.0014,0.0058,-0.0135,-0.0264,0.01,-0.023,-0.0107,0.0716,0.0215,0.0369,0.0364,-0.0387,0.0375,-0.0203,-0.0397,-0.0347,-0.0217,-0.0196,-0.0179,-0.0061,-0.0271,-0.0263,-0.0464,-0.0296,0.027,-0.0245,0.0378,-0.0168,0.0051,-0.0443,-0.039,-0.0661,0.0295,0.0369,-0.0151,0.0202,-0.0083,0.0025,0.0485,0.0762,-0.028,0.0059,-0.0595,0.031,0.0209,-0.0445,-0.0457,0.0005,-0.0143,-0.0214,0.0166,0.0246,-0.0551,-0.0385,-0.0247,0.0321,-0.0286,-0.0544,0.0021,0.0383,-0.0101,-0.0337,-0.0172,-0.0289,0.0216,0.0228,0.0278,0.0049,0.0049,-0.0284,-0.0039,-0.0356,0.0982,0.0763,0.0747,0.0482,0.0368,0.0397,0.0678,0.0085,0.0217,0.0118,0.0288,0.0216,0.0427,0.0653,-0.0296,-0.0331,-0.0001,-0.0089,-0.078,-0.0148,0.0071,-0.0567,-0.049,-0.0446,-0.01,-0.0327,0.0036,-0.0298,-0.0439,-0.0504,-0.0177,-0.0356,-0.0503,-0.0059,0.0239,-0.0374,-0.0212,0.0101,0.0331,0.0224,0.0223,-0.0633,-0.0401,-0.0413,-0.0317,0.0193,0.0471,0.0167,-0.045,-0.0572,0.0736,0.0172,-0.0306,0.0078,0.0014,0.0379,0.1409,0.0728,0.0724,0.1005,-0.0391,-0.0351,0.0329,-0.0332,-0.0359,0.0005,-0.0227,-0.004,-0.0325,-0.0254,-0.0268,-0.0394,0.012,0.0139,0.012,-0.0328,-0.0156,0.0065,-0.0445,-0.0064,-0.0573,-0.0437,0.0673,0.0746,0.0857,0.0171,0.0568,0.0334,-0.0136,-0.0045,0.0003,-0.011,-0.0136,-0.0074,-0.0148,-0.0002,-0.0036,-0.0459,0.0196,0.0609,-0.0323,-0.0553,-0.0087,0.0564,0.0247,-0.0132,-0.0093,0.0387,-0.008,0.0487,-0.0084,0.0132,-0.0059,-0.025,-0.0107,0.0054,0.0104,0.013,0.0313,-0.0169,0.0078,0.0053,-0.0126,-0.0184,0.0289,-0.0717,-0.0026,0.0008,-0.0379,-0.0509,0.0252,-0.0122,0.0121,0.01,-0.001,-0.0415,-0.0386,-0.0834,-0.0769,-0.0051,-0.0555,0.0095,-0.0722,0.0179,-0.0382,0.0136,-0.059,-0.0389,-0.0243,-0.021,-0.0357,0.0124,0.0214,0.0504,0.0448,-0.0427,-0.0304,-0.0647,-0.0041,-0.0313,-0.0169,0.0184,-0.0261,-0.0191,0.0549,0.0528,0.0465,-0.0222,0.0023,-0.0558,0.0286,0.0119,0.0258,-0.0153,-0.0104,-0.0148,-0.0367,-0.0095,0.0587,-0.0332,-0.0401,-0.0097,0.0096,-0.0202,-0.0194,-0.0286,-0.0435,0.0162,0.03,0.0184,-0.0453,0.0036,0.0705,-0.0654,-0.0036,-0.0039,-0.0175,-0.0386,-0.0073,0.0207,0.0086,-0.0191,-0.0535,-0.057,-0.0295,-0.0354,-0.0207,-0.0382,-0.0128,-0.0317,0.0111,-0.0434,-0.0373,0.0203,-0.0394,-0.0477,0.069,-0.0289,-0.0108,0.0194,0.0309,0.0045,0.0068,-0.0396,-0.0205,-0.0339,-0.0567,0.0438,0.0163,0.0006,-0.0307,0.0063,-0.0266,0.0254,0.0232,0.0305,0.0145,0.0626,0.0558,-0.0134,-0.0044,-0.007,0.0486,0.0423,0.0688,0.0592,0.066,0.0151,-0.0235,-0.0189,0.0619,0.011,0.0794,0.0207,0.0341,-0.0207,-0.0307,-0.0612,0.0011,-0.0272,0.0342,0.0077,-0.0234,-0.0287,-0.0402,-0.0026,-0.0357,-0.0501,0.0153,0.0058,-0.0093,-0.0197,-0.0003,-0.0063,-0.0395,-0.0413,-0.0268,-0.023,-0.0462,-0.0509,-0.0362,0.0896,0.0762,-0.029,-0.0281,-0.0496,-0.0482,-0.0147,-0.0206,-0.0124,0.0759,0.0459,0.0604,0.0538,0.0137,0.0443,0.0456,0.0636,0.0102,0.0171,-0.0288,0.0281,-0.0392,-0.0185,-0.0058,-0.0423,0.0216,0.005,-0.0284,-0.0006,0.0089,0.0008,0.0278,0.0011,-0.004,0.0478,0.0054,0.054,0.0038,0.0329,0.0432,0.0286,0.0311,-0.0126,-0.0012,-0.0314,-0.0436,0.0221,-0.0192,0.0373,0.0011,-0.0225,0.0142,0.0515,0.0147,-0.0229,-0.027,-0.0299,0.001,0.0204,0.0431,0.0137,-0.0211,0.0184,-0.0018,-0.0072,0.0849,0.0101,0.0244,0.0216,-0.0494,-0.0145,-0.0624,-0.0574,0.0746,-0.0271,0.0026,-0.013,0.0235,0.0967,0.0698,0.0374,-0.0132,0.0334,0.0462,-0.0354,0.03,0.0213,-0.0263,0.0021,-0.0268,0.0031,-0.0274,-0.0148,0.0014,0.0073,0.0361,0.0578,0.0072,0.1178,-0.0561,0.0944,-0.029,-0.0258,-0.0085,0.1083,0.1161,-0.0407,-0.0788,-0.0028,-0.0609,-0.0452,-0.0381,-0.0032,0.023,-0.0404,-0.0489,-0.0446,-0.0453,-0.0191,-0.0186,-0.023,0.005,-0.0074,-0.0478,-0.0794,-0.0374,-0.0448,-0.0534,-0.0513,-0.0305,-0.0451,-0.0232,-0.0546,-0.0263,-0.0213,-0.0406,-0.0375,-0.0401,-0.0415,-0.0426,-0.059,-0.0757,-0.0284,-0.0388,0.0089,0.0142,0.1307,-0.0347,-0.0311,0.0121,0.0097,-0.0153,0.0074,-0.0072,-0.0024,-0.008,0.0066,-0.0005,0.0309,0.0562,-0.0369,0.0252,0.0017,0.0141,0.0678,0.0013,0.0312,0.0267,-0.0247,0.0198,-0.0362,-0.0319,0.0086,0.0037,-0.0258,0.0086,-0.0016,0.0104,-0.0153,0.0051,0.0483,-0.0626,-0.0471,0.0586,-0.0379,-0.049,0.0081,-0.0459,-0.0444,0.0207,0.0279,-0.0451,0.0041,-0.0046,0.0263,0.0116,-0.0253,0.0177,-0.0246,-0.0021,0.0536,0.0659,-0.0244,story comprehension
trm_557b4aa070c10,-0.0435,-0.0792,-0.0614,-0.1175,-0.0176,-0.069,-0.0128,-0.0657,-0.0394,-0.051,0.0019,0.0398,0.0112,0.0146,-0.0837,-0.0308,-0.0858,-0.0873,-0.0375,-0.0033,-0.0431,-0.0071,0.0074,0.0397,-0.0002,0.0171,0.0187,-0.0473,-0.0573,-0.0278,-0.0268,-0.0351,-0.0329,-0.0501,-0.0185,-0.0719,0.0135,-0.0473,-0.0859,-0.0404,-0.045,-0.0594,0.0089,0.0769,-0.0944,-0.0366,0.1404,0.0065,0.0332,-0.0472,-0.0278,0.0454,0.0356,-0.0384,-0.0614,-0.0275,-0.0153,0.0276,0.0488,-0.0158,0.0064,0.0064,-0.0936,0.024,-0.0773,0.0326,-0.1221,-0.0802,-0.0467,0.0473,0.0173,-0.0282,0.0253,0.0063,-0.1514,0.0702,-0.0376,0.0066,-0.0063,0.0517,0.0914,0.0221,-0.0204,-0.0272,-0.0578,-0.0101,-0.0421,-0.016,0.0169,-0.0467,-0.013,-0.0028,0.0205,-0.0018,0.0949,0.0352,0.0812,0.0153,0.0467,-0.0269,0.0119,-0.0578,0.0193,-0.0186,0.0122,-0.0483,-0.0954,0.1972,-0.0485,-0.0684,0.0136,-0.0425,0.0308,0.0778,0.0399,-0.0018,-0.0696,0.0176,0.0077,-0.0101,-0.0641,-0.1125,-0.0754,0.0082,-0.0615,-0.0469,-0.0977,-0.0087,0.0074,0.0424,0.0864,-0.0382,0.0623,-0.0153,-0.0174,-0.116,-0.0065,-0.0399,-0.0455,0.012,-0.0463,-0.0851,0.062,0.0028,-0.1366,-0.036,-0.0424,-0.0331,-0.0291,0.0589,-0.0288,-0.0438,-0.0408,-0.0653,0.045,-0.0321,0.0207,-0.0394,0.016,0.0019,-0.044,-0.0258,-0.1123,-0.0717,0.0224,-0.0063,0.004,-0.0849,-0.0833,0.0403,0.0139,-0.0697,0.0236,0.0762,-0.007,0.0182,0.0145,-0.0024,0.0457,-0.0426,-0.0386,0.0918,-0.0243,-0.0193,0.0243,-0.03,0.058,0.0994,0.0955,-0.1089,-0.106,0.0478,0.016,-0.0125,0.0027,-0.1909,-0.1962,0.0035,0.0215,-0.096,-0.0425,0.0305,-0.1014,-0.0921,-0.145,0.02,0.0904,-0.0839,-0.0598,-0.0145,-0.0213,0.0312,0.0282,0.0413,0.0408,0.0203,0.0837,-0.0527,-0.0854,0.0061,0.0711,-0.0565,-0.054,-0.0618,-0.0066,0.0443,-0.1054,0.0479,0.0157,0.0095,-0.0231,0.011,0.0733,-0.0761,-0.0821,0.0396,0.0077,0.0316,-0.0272,-0.0303,-0.0708,-0.0354,-0.0234,0.0008,-0.0569,-0.0239,-0.0103,-0.0682,-0.0219,-0.039,0.0554,0.052,-0.0324,0.0224,0.0341,-0.0514,-0.0507,-0.1,0.121,0.1347,0.0008,0.0195,-0.0905,-0.0057,0.007,0.0424,-0.0257,-0.0085,0.0656,-0.0009,-0.0586,-0.0105,0.0027,0.0516,-0.0048,0.141,0.0199,0.0157,-0.0262,0.049,0.0993,0.0068,0.0093,-0.0797,-0.0736,-0.039,0.0335,0.119,-0.0296,-0.0279,0.0097,-0.0029,-0.0214,0.0003,-0.0042,-0.0259,0.0453,0.0029,-0.0725,0.0094,0.0604,-0.0602,-0.0542,-0.0021,-0.0688,-0.0759,-0.0151,-0.0319,0.0445,0.0055,-0.0308,-0.0063,-0.1709,0.0187,0.0351,-0.0502,0.0337,0.0671,0.0032,-0.0707,0.0082,0.0509,-0.0891,-0.1073,-0.0203,-0.0855,-0.0162,0.0022,-0.0365,-0.0727,0.0048,-0.0139,0.0256,0.0076,0.0196,0.0589,0.019,0.0181,0.0974,-0.0515,-0.0564,0.0822,0.0076,0.0221,0.0952,0.0172,-0.067,-0.0639,-0.0455,-0.022,0.0376,0.1497,-0.041,-0.003,0.0151,-0.061,-0.0587,-0.0155,-0.0296,-0.0789,0.0011,-0.0362,-0.0376,-0.0469,-0.0064,-0.0436,-0.0909,-0.0384,0.0065,-0.0117,-0.0256,-0.0263,-0.0173,0.0568,-0.079,0.0005,-0.0307,0.0533,0.1896,0.1223,0.2084,-0.0662,-0.1114,-0.0892,0.0305,0.0553,-0.0618,0.022,0.0008,-0.053,-0.013,-0.0349,-0.0948,-0.0135,0.0332,0.0171,-0.0213,-0.04,-0.0293,-0.0575,-0.0201,0.0173,-0.0283,0.0039,-0.0265,-0.0538,0.0515,-0.0044,-0.0224,-0.006,-0.0654,-0.0794,-0.0158,0.1337,-0.0054,0.0004,0.1279,-0.0773,-0.0995,-0.0932,-0.0426,-0.0827,-0.0642,-0.2707,-0.2261,-0.1265,-0.1056,-0.0499,-0.1123,-0.1161,-0.0404,0.0588,-0.0098,-0.0004,0.0397,0.0402,0.0283,-0.0071,-0.1093,-0.0885,0.0511,-0.0153,-0.031,0.0057,0.0755,-0.0287,0.0263,0.06,-0.0756,-0.2017,-0.163,0.0193,-0.0714,-0.0749,-0.0674,-0.089,0.0331,-0.106,-0.1167,-0.0272,-0.036,-0.0975,-0.0532,0.0115,-0.0194,-0.0999,-0.0516,0.1131,-0.0003,0.0248,-0.0335,0.0172,-0.0956,0.0276,0.0406,-0.0607,-0.0275,0.0354,-0.0284,-0.0475,-0.0114,-0.0114,-0.0788,-0.0444,-0.0236,0.0138,-0.0309,-0.0133,-0.0399,-0.0145,0.1012,-0.0044,-0.1393,-0.1627,-0.0127,0.109,-0.045,-0.0674,-0.014,-0.0968,-0.0957,0.0008,-0.0359,-0.101,-0.0427,-0.0133,0.0089,0.0295,-0.0432,0.0308,-0.0729,-0.0041,-0.0257,-0.0058,0.0826,-0.0315,-0.0112,0.0068,0.0434,-0.0251,-0.0695,-0.029,0.085,-0.0989,0.0522,0.0434,0.05,0.1099,0.0645,0.0091,-0.0772,-0.0031,-0.059,-0.1471,0.0685,0.0167,-0.0772,-0.1467,-0.0404,-0.0171,0.017,0.0055,0.0055,-0.0096,-0.0591,0.0154,-0.0327,0.0456,0.0153,-0.0402,0.0608,-0.0021,-0.0727,-0.0255,-0.013,-0.0317,0.0982,0.0398,0.0531,-0.0252,-0.0355,-0.0426,-0.0736,0.0261,0.0169,0.0808,0.0625,0.0578,-0.0211,-0.0243,-0.0845,-0.0427,-0.0968,-0.0226,0.0115,-0.0057,0.046,-0.0273,0.0607,-0.0089,0.047,-0.0254,-0.0124,-0.0901,-0.0406,-0.0558,-0.1542,-0.0401,-0.0109,0.0111,-0.0071,-0.1312,-0.0667,-0.0221,-0.1473,-0.0258,-0.0922,-0.0256,0.0496,0.0035,0.066,0.0683,0.0217,0.0212,0.0267,-0.0237,0.0088,-0.0158,-0.0117,-0.0803,-0.0821,-0.0282,-0.0279,-0.0248,-0.1112,-0.0154,-0.013,-0.0821,0.0557,-0.0897,-0.065,-0.1343,0.0372,-0.0001,-0.0271,0.0058,-0.1115,0.0367,-0.0761,0.0053,0.0297,-0.0058,-0.0296,-0.066,-0.1773,-0.0544,-0.0661,-0.0707,0.0126,-0.0683,-0.035,0.0183,-0.0398,-0.0491,-0.1213,-0.0417,-0.0887,0.0085,-0.0026,-0.0886,-0.1047,-0.113,-0.0234,-0.0986,-0.033,-0.1058,-0.0483,-0.0574,-0.021,-0.0924,-0.0536,-0.0067,0.1332,-0.0371,-0.0241,-0.0242,-0.0375,-0.0144,-0.0519,-0.0575,-0.0304,0.0182,-0.028,-0.0701,-0.083,-0.054,0.1002,-0.0247,0.0581,-0.0173,-0.0344,0.0595,0.0101,0.007,0.1043,-0.104,-0.0059,0.0417,0.0009,-0.0367,0.0446,-0.0121,-0.0239,0.0142,-0.018,-0.0558,-0.0005,-0.0203,-0.0292,-0.0878,-0.0637,-0.0185,0.0421,-0.0255,-0.0019,-0.0432,-0.0691,-0.1142,-0.0769,-0.0062,0.0524,-0.0643,-0.0999,0.049,-0.047,0.0025,-0.0568,0.0678,-0.0095,-0.0157,0.0928,0.006,-0.1998,-0.195,-0.1316,-0.0292,-0.0117,-0.0809,-0.0088,-0.0261,0.0776,0.013,-0.0137,-0.0438,-0.0509,0.0385,-0.0344,-0.023,-0.033,0.0142,-0.0079,0.0155,-0.0738,0.0299,0.045,-0.0121,0.032,0.0495,-0.0221,-0.0189,0.0189,0.1,-0.0584,-0.0591,-0.0481,-0.0382,0.0472,0.1277,-0.0059,-0.0656,0.0088,0.0443,0.002,0.0418,-0.0031,-0.0064,-0.0226,-0.0457,-0.0443,0.0223,0.0233,0.0507,-0.0089,-0.0171,0.0012,-0.0111,0.018,-0.0374,-0.0478,-0.0114,-0.041,-0.0293,-0.0255,0.0692,0.0776,0.0313,-0.0032,0.0562,-0.0189,0.0389,0.0088,-0.0557,0.0834,-0.0007,0.0114,0.003,0.0358,-0.0324,-0.0326,0.0028,-0.0104,-0.0188,0.1129,0.1027,0.0288,0.0311,0.0046,-0.0276,-0.0813,0.0623,0.0165,-0.0506,0.0684,0.0749,0.0404,-0.0015,0.1335,0.1206,-0.029,0.0065,0.0268,-0.1325,-0.0931,-0.0644,-0.0213,0.1288,-0.1089,-0.0606,-0.0553,-0.0476,-0.0665,0.057,-0.0156,0.1437,-0.0507,-0.0457,-0.0754,0.0494,0.0035,-0.0149,0.0045,0.0633,0.0426,-0.0364,-0.0417,-0.0273,0.0048,0.0427,-0.0618,-0.0455,-0.0244,-0.0062,-0.031,-0.03,-0.0069,0.0024,-0.1868,-0.1794,-0.111,0.0152,0.0574,0.0314,-0.0428,-0.0229,0.0626,-0.018,-0.0851,-0.0431,-0.1118,-0.1318,-0.0503,-0.0891,-0.064,-0.0206,-0.0086,-0.2211,-0.0801,-0.2159,-0.1341,-0.1083,-0.0162,0.0612,-0.0449,-0.018,-0.0438,-0.0104,0.0218,-0.031,-0.0407,-0.012,-0.0161,0.0062,0.1042,0.0692,0.0168,0.0419,-0.138,-0.0083,0.0176,0.1096,-0.0692,-0.0122,0.0789,0.019,0.0102,0.1901,0.0351,0.0177,-0.0203,-0.062,-0.0293,0.0048,0.0099,0.072,0.098,0.0112,0.0499,-0.0156,0.0007,0.0881,-0.0372,-0.0219,-0.0685,-0.0506,-0.0343,-0.0601,-0.0359,0.0333,-0.0444,-0.0059,-0.0073,0.1075,0.0021,-0.0797,-0.0266,0.013,0.0011,0.0117,-0.0101,-0.0206,-0.0299,0.0114,-0.0774,0.0251,0.0513,0.0278,-0.0219,-0.0734,0.0404,0.011,0.0922,0.0283,-0.0361,0.0141,-0.0178,0.0526,0.0137,-0.0109,-0.0101,-0.0207,0.0279,0.0921,0.0457,0.0761,0.0131,-0.0377,-0.0362,-0.0392,-0.0325,0.0197,0.0094,0.0361,-0.015,0.0739,0.0752,0.108,0.0253,-0.0018,-0.0133,0.0038,-0.0307,0.0143,-0.0544,-0.0105,-0.0695,-0.0715,-0.058,0.0382,0.0233,0.0006,-0.0065,0.0696,0.0783,-0.1336,-0.0822,0.0192,-0.0467,0.0143,-0.0119,-0.0019,-0.0572,-0.0689,-0.0519,0.0593,0.0588,-0.0851,-0.0689,-0.0036,-0.0844,-0.016,0.0202,0.0512,0.0138,0.0833,0.0332,-0.063,0.0028,0.0366,0.001,0.0004,-0.0034,0.0421,0.0333,0.0339,0.0217,-0.0206,-0.139,0.0224,-0.0952,-0.028,-0.0995,-0.0012,0.0383,-0.0245,-0.193,-0.0889,-0.0924,-0.1137,-0.0187,-0.0163,-0.0446,-0.034,0.0194,-0.0123,0.0506,-0.078,-0.0592,-0.0481,0.0174,0.0302,-0.0295,0.0487,-0.0391,-0.0472,-0.0671,0.0641,-0.0131,0.0422,-0.052,0.1189,0.0709,-0.0212,0.0513,0.0167,0.0237,-0.0307,0.0386,-0.0437,-0.0496,-0.0195,-0.0442,-0.028,0.0222,0.0014,0.1136,0.1645,-0.0161,0.019,-0.008,0.0443,-0.037,0.0104,0.0512,-0.0344,-0.0777,-0.1237,-0.0099,0.0471,0.0086,0.0151,0.2985,0.1874,0.0837,-0.0022,-0.0106,-0.0052,0.0736,0.1459,-0.0014,0.3872,0.3485,0.2608,0.2185,0.3341,0.2087,0.1661,0.1668,0.0323,0.0735,-0.0385,0.0212,-0.0247,-0.0421,0.0823,0.0954,0.0694,0.0563,-0.0521,-0.0874,0.1372,0.0567,-0.0626,-0.0478,0.0257,0.0684,0.0515,0.0643,-0.0309,-0.0877,0.0805,0.1075,0.0983,0.0813,0.1249,-0.0396,-0.0099,-0.0222,0.029,-0.0104,0.3391,0.0089,0.0878,0.0338,-0.0045,0.0534,-0.0265,-0.0096,-0.0263,-0.0069,0.0771,0.0784,-0.0643,-0.084,-0.0319,-0.0196,-0.0952,-0.0239,0.0149,0.031,-0.016,-0.0829,-0.0227,-0.0229,-0.007,0.0353,0.0273,-0.074,-0.0049,0.1337,0.0622,-0.0251,-0.0505,0.0709,0.0523,0.0216,-0.0155,-0.0131,-0.0363,-0.1167,-0.0411,-0.047,-0.015,-0.0016,-0.016,-0.1237,-0.0727,-0.0437,-0.0023,-0.058,-0.0818,-0.0624,0.0278,-0.0268,-0.1186,-0.0437,-0.1062,-0.0234,-0.0845,-0.0417,-0.0576,-0.0602,-0.0778,-0.0109,0.0187,-0.095,-0.0272,-0.1612,-0.0183,0.0079,-0.0982,-0.0979,0.0304,-0.0828,0.0208,-0.0601,-0.0168,-0.0541,-0.0859,-0.0824,0.0312,-0.0032,0.392,0.3412,0.2347,0.3358,-0.0815,-0.0539,-0.0347,-0.0534,-0.1292,-0.0052,-0.0804,0.1466,-0.0027,0.0091,0.0283,0.0166,-0.0352,0.0797,0.0415,-0.0149,-0.0033,0.0086,-0.0044,-0.0103,-0.0449,0.0924,-0.048,-0.0034,-0.0469,-0.0469,-0.0377,-0.0894,-0.0913,-0.0389,-0.0389,0.0341,-0.0674,0.059,-0.0923,-0.0946,0.0157,0.006,-0.0566,-0.0591,-0.073,-0.0532,0.0098,-0.0452,-0.0152,-0.0526,-0.0156,0.0569,0.0949,-0.0585,0.0594,-0.0152,0.0473,0.0576,-0.0032,-0.0521,-0.0649,-0.0415,-0.0254,-0.0153,0.0435,0.0389,0.0386,0.0058,0.0168,0.0444,0.0205,0.084,0.0911,0.067,-0.0346,-0.0445,0.0254,-0.071,-0.098,-0.0234,0.0141,-0.093,-0.0436,-0.0027,-0.0513,0.02,-0.0313,0.0133,-0.06,0.0591,-0.0323,-0.0738,0.0026,-0.0568,-0.0216,0.1676,0.1063,0.0348,0.0147,-0.0055,-0.0043,0.0087,0.0172,0.0211,0.0094,-0.024,0.0126,-0.0212,0.0411,-0.0032,-0.0078,0.0122,0.0401,-0.0789,-0.0347,0.0138,-0.0063,-0.0127,0.0508,0.0067,0.0517,-0.0549,-0.0063,-0.0078,-0.0455,0.0287,-0.0716,-0.0875,-0.0068,0.0049,0.1087,0.0256,-0.077,-0.061,-0.0818,0.0017,0.0124,-0.0158,0.0378,-0.0565,-0.0572,-0.1636,0.0477,0.0592,0.0826,-0.0337,0.0545,-0.0073,0.2196,0.039,0.0363,0.0302,-0.0407,0.1213,-0.0437,0.1144,-0.043,0.1855,0.0032,-0.0661,-0.0854,0.0689,-0.0163,0.008,-0.0002,-0.0481,-0.0798,-0.0207,0.0189,-0.014,-0.0613,-0.0212,-0.0315,0.0013,0.0438,-0.0422,0.0839,-0.051,0.0379,-0.0035,-0.0461,0.0549,0.0198,-0.0626,-0.0165,-0.0713,-0.0215,-0.0375,-0.0636,-0.0269,0.0442,0.0047,0.051,-0.0172,-0.0443,-0.0325,-0.0403,-0.0273,-0.106,-0.1818,0.0347,-0.0405,0.0058,0.0148,0.0501,0.0171,0.0131,0.0217,-0.0171,0.0043,0.0005,-0.0022,-0.0629,-0.0178,-0.0263,0.0073,0.0486,-0.0287,-0.0504,-0.0673,-0.0522,0.0265,0.0108,-0.0058,0.3347,-0.1114,0.033,-0.0037,0.1793,0.0035,-0.0188,0.1122,0.0586,-0.1031,-0.0595,-0.1522,-0.1286,-0.1152,0.021,0.0171,-0.0446,-0.0626,0.1214,0.1872,-0.0472,-0.0416,-0.0528,-0.0701,-0.0382,0.0207,-0.08,-0.0641,-0.0391,-0.0765,-0.0701,0.1305,0.0302,0.0331,-0.0284,0.1104,0.024,-0.0575,-0.0416,-0.0565,-0.0214,-0.0758,-0.0807,-0.0756,-0.0482,-0.1107,0.0505,0.0279,0.0078,0.0452,-0.0017,0.0858,-0.0102,-0.021,0.0252,-0.0553,-0.0988,-0.0338,0.0054,0.0215,0.0152,0.0545,0.1075,0.0014,0.0177,0.0182,-0.0002,-0.1178,0.082,0.0756,-0.0986,-0.1424,-0.0155,-0.0244,0.0013,-0.0008,-0.0525,0.0444,-0.0364,0.0143,-0.0189,-0.0594,0.0614,-0.0761,-0.0205,0.0789,-0.0793,-0.0343,0.07,0.0053,-0.0255,0.1237,0.0514,0.0099,0.0712,0.0272,-0.073,0.018,-0.0127,-0.0392,-0.0221,0.019,0.0482,0.0271,0.0553,-0.0482,-0.0636,-0.0657,0.0449,-0.0459,0.0251,0.0521,0.0084,0.0002,0.0107,0.047,-0.0568,0.0022,0.0601,0.01,0.0519,-0.0336,0.046,0.0943,-0.0866,-0.0768,-0.045,0.0693,0.0493,0.0175,0.0707,0.0698,0.0111,0.0774,-0.1057,-0.0238,0.3426,-0.0083,-0.1407,-0.1375,0.0119,0.0211,0.0793,0.0558,-0.0136,0.0367,0.0304,-0.0224,-0.0277,0.0206,0.0019,0.0114,0.0016,0.0706,0.1116,0.0844,0.1085,0.1602,0.0114,-0.0323,0.0103,-0.0253,0.0417,0.0548,0.0298,0.0895,0.0674,-0.0243,0.0429,-0.0323,-0.0225,-0.0718,0.0839,0.0123,-0.0374,0.034,-0.023,0.0928,0.0689,0.0187,-0.0177,-0.0797,0.027,-0.0283,0.0074,-0.0237,-0.0188,-0.0293,0.0571,-0.0492,-0.042,-0.0301,-0.0097,0.012,0.0645,-0.057,-0.039,0.0456,0.0626,0.05,0.06,0.0393,0.0846,0.0355,0.0514,-0.0034,0.0122,0.0322,-0.0803,0.008,-0.0109,-0.0537,-0.0605,-0.0551,-0.0698,-0.0015,0.0707,-0.1127,-0.0386,-0.0186,-0.0149,-0.0104,-0.0426,-0.0164,-0.0368,0.0001,0.0226,-0.0368,-0.0483,0.0044,-0.0975,-0.088,-0.0766,-0.0588,-0.0611,0.0484,-0.0743,-0.1124,0.0056,0.0823,-0.0412,-0.0229,0.092,-0.0067,-0.0078,0.0659,-0.0177,0.0205,-0.0175,0.0049,-0.0075,-0.047,-0.0735,0.0106,-0.0186,-0.0608,-0.0005,0.0314,0.0119,0.1996,0.1822,-0.0027,0.0111,-0.0181,-0.0839,-0.037,-0.0735,-0.0348,-0.0141,0.0157,-0.0448,-0.0256,-0.0615,-0.0853,-0.0669,0.0355,0.0755,-0.039,-0.0544,0.0219,-0.0032,-0.0608,-0.0605,-0.0358,0.019,-0.0023,-0.0009,-0.1493,-0.1426,-0.0707,-0.0058,-0.1599,-0.0499,0.0026,0.0102,-0.0435,-0.0547,-0.0449,0.0065,-0.1139,0.0015,-0.0323,-0.0934,0.0694,-0.1005,-0.0068,0.0046,-0.1224,-0.0725,-0.0557,-0.0728,-0.05,-0.0308,-0.1077,0.0013,-0.0924,-0.0579,-0.0648,-0.0503,0.0035,-0.0463,-0.0108,-0.0549,-0.0,-0.038,-0.022,-0.0367,-0.0634,0.0344,-0.068,-0.0106,-0.0445,-0.0077,-0.0316,-0.0764,-0.1537,0.0081,0.0921,-0.0134,0.0574,-0.1442,-0.0903,-0.0884,-0.0416,-0.0882,-0.0478,-0.0043,0.0706,0.0754,-0.0064,-0.0367,-0.0404,0.0672,0.0832,0.0755,-0.1942,-0.1786,-0.0723,0.0281,0.0056,-0.0942,-0.0287,-0.0094,0.0485,-0.0501,-0.0439,0.0096,-0.0334,-0.0217,-0.0394,0.0087,-0.0799,-0.0185,-0.0256,-0.1608,0.0492,0.0939,-0.0384,-0.0217,-0.0801,-0.0626,0.0068,-0.0205,0.0148,0.2096,-0.0483,-0.0445,-0.0367,-0.0102,-0.0227,-0.0432,-0.0358,-0.0308,-0.008,0.015,-0.0211,-0.0261,-0.0795,-0.02,-0.0243,0.0325,0.1198,-0.0988,0.0213,0.0415,0.1654,0.0599,0.0191,0.0351,-0.0146,-0.0207,-0.0094,0.131,-0.0062,0.0679,-0.0144,-0.0304,-0.04,-0.0284,-0.0267,0.0584,0.1231,0.1709,0.0624,0.0467,0.0346,-0.015,0.0298,0.0693,-0.0329,0.0108,0.023,-0.0737,-0.0312,-0.1099,-0.007,0.0482,-0.0329,-0.0429,-0.0236,-0.006,-0.0103,-0.0579,-0.0408,-0.1598,-0.1401,-0.1664,-0.0289,-0.2526,-0.0576,0.0063,-0.0585,0.0262,-0.0806,-0.0434,0.0066,0.0112,-0.0624,-0.0158,-0.0602,0.0738,0.0466,0.0874,-0.0396,-0.0436,0.0208,0.0039,0.1003,0.1374,0.0433,0.0003,-0.0095,-0.0269,-0.0291,-0.0616,-0.0765,-0.0927,-0.0992,0.0713,0.028,-0.0255,-0.1088,0.0127,-0.055,0.0579,-0.089,-0.0375,0.0324,0.0265,0.0013,-0.0035,0.0344,-0.1174,-0.0069,-0.0641,-0.0277,-0.017,0.0439,0.0323,-0.0378,0.2564,0.2175,-0.069,-0.0415,0.2945,0.1305,0.0687,0.1082,0.1338,0.0947,-0.1008,-0.1009,-0.0346,-0.0856,0.3552,0.2907,0.2383,0.0428,0.0787,0.1999,0.3135,0.3148,0.2969,0.0395,0.009,-0.0191,0.0355,-0.0622,-0.0046,0.001,0.0128,-0.0125,-0.067,-0.1414,-0.1239,0.0585,-0.0569,-0.0549,-0.0108,0.0399,0.0107,0.0292,-0.013,-0.0155,-0.0464,0.0078,-0.0189,-0.0234,-0.0478,0.0088,-0.034,0.0485,-0.0153,-0.0355,-0.0271,-0.0444,-0.0516,-0.0718,0.1201,-0.028,-0.0029,0.0272,0.0592,0.2286,-0.0274,-0.0697,-0.117,0.0197,-0.0316,-0.004,0.045,0.0052,-0.0052,-0.045,-0.0443,-0.0468,-0.0253,-0.0303,-0.0031,-0.0916,-0.0745,-0.0012,0.0054,0.0966,-0.0469,-0.0089,-0.0103,-0.0479,0.0103,0.0199,-0.0155,-0.0502,-0.0269,-0.045,0.0003,-0.0109,-0.0608,-0.0799,0.0688,-0.0833,-0.0836,-0.0535,0.0338,-0.0383,-0.0609,0.0107,-0.0722,0.0243,-0.0715,0.0154,-0.0064,-0.0459,-0.0188,0.0221,-0.079,-0.0803,-0.02,-0.0155,-0.0347,0.0251,0.0275,-0.0317,0.006,0.0114,0.0528,0.0208,0.0918,0.0824,0.1584,0.1081,-0.1054,-0.0576,-0.0132,-0.0605,-0.0568,0.1168,0.0526,0.048,0.0033,0.0542,-0.0486,-0.1209,-0.0455,0.0527,0.0176,0.0659,0.0864,0.1008,0.0951,0.2565,0.2377,-0.0318,-0.1344,-0.0953,-0.0515,0.0195,-0.0502,-0.0141,-0.0735,-0.0005,-0.0772,-0.0125,-0.0324,-0.0463,-0.0186,-0.0885,-0.0691,-0.0474,-0.053,-0.0649,0.0132,-0.1433,-0.0656,-0.0446,0.0148,-0.0257,-0.0132,-0.0047,0.1247,0.0899,0.1008,0.013,0.1208,0.1401,-0.0151,0.0594,-0.0405,-0.0531,-0.1215,0.0306,0.0197,0.0441,0.0239,0.0845,-0.0049,-0.066,-0.0227,0.0539,0.0031,0.0254,0.0193,0.0527,0.0057,-0.0233,0.0278,-0.0069,-0.0329,-0.0301,-0.0569,-0.0508,-0.0382,0.0106,0.0131,0.0298,-0.0314,0.0205,-0.0674,-0.0318,-0.0869,-0.059,-0.076,-0.0755,-0.0213,-0.0213,-0.0158,-0.0012,-0.0231,-0.0624,0.0381,-0.0154,-0.0176,-0.0359,0.0559,-0.2022,0.0653,-0.0323,-0.0666,0.0445,-0.0219,0.1091,0.0325,-0.0418,-0.1278,0.0216,0.0266,-0.0083,-0.0261,0.0173,-0.0856,-0.0414,-0.0056,0.004,0.0359,-0.027,-0.0156,-0.0054,-0.1876,-0.1301,-0.008,-0.0341,-0.0264,-0.0127,-0.019,0.0043,-0.0061,-0.0011,-0.017,0.1056,-0.0221,0.0853,0.0647,-0.2573,-0.118,-0.2591,-0.051,-0.1247,-0.1261,0.0036,0.0018,0.0037,-0.0078,-0.0423,-0.0145,0.0244,0.1233,0.0519,0.1899,0.1428,-0.0402,-0.0008,-0.0217,0.0253,-0.0079,0.0417,-0.0008,-0.019,-0.0275,-0.0433,0.0097,0.0031,0.0052,-0.0349,0.0183,-0.0255,0.007,-0.0355,0.1545,0.0341,0.0778,0.1131,-0.0338,0.0401,-0.003,-0.0471,-0.046,-0.0395,0.0429,0.0221,-0.0174,-0.0397,-0.0353,-0.0131,0.0086,0.0883,-0.0673,-0.0567,0.0234,-0.0371,0.1033,-0.0798,0.0346,0.0297,0.0019,-0.0217,-0.0171,-0.0197,0.0113,-0.0336,0.038,-0.0729,0.0368,0.0035,0.1401,-0.0046,-0.0324,0.03,-0.0545,-0.0944,-0.0031,-0.0678,-0.045,-0.0523,0.0191,0.0372,0.014,0.0407,0.1205,0.0512,-0.06,-0.0446,-0.0725,-0.049,0.0863,0.0136,0.0033,-0.0499,-0.0302,-0.0451,-0.0236,-0.0447,0.0556,0.0234,-0.0257,0.0626,-0.0287,0.0046,0.037,-0.0117,-0.066,-0.0185,0.0047,-0.0144,-0.0397,0.0479,0.0107,-0.0628,0.0749,0.0826,0.0179,0.0038,-0.0284,-0.0127,-0.0886,-0.062,-0.0346,-0.0167,-0.0197,-0.0191,-0.0332,-0.0139,-0.0137,-0.0038,-0.0422,0.0037,0.0626,0.1395,0.202,-0.0025,-0.021,-0.0259,-0.0639,-0.122,-0.0941,-0.1212,-0.0282,0.0084,-0.0255,-0.0395,-0.0554,0.1567,-0.0017,-0.0061,0.1804,0.0511,0.0795,-0.0889,0.0401,-0.0759,0.0171,-0.0286,-0.0421,-0.0981,-0.0354,-0.0868,-0.0005,-0.0371,-0.0262,-0.0099,-0.0404,-0.1211,0.043,-0.0245,-0.0531,-0.0022,-0.0054,-0.0102,-0.0137,-0.0871,0.046,-0.0869,0.0378,-0.0264,-0.0861,0.0692,-0.1062,-0.052,-0.1281,-0.0565,-0.0439,-0.0224,-0.0904,0.0034,-0.103,0.0282,-0.0436,0.0256,-0.1056,-0.0759,-0.0276,-0.0,0.0301,0.0089,-0.0433,0.0188,-0.0321,0.0562,-0.0187,-0.0255,0.0453,0.0034,-0.0402,-0.0394,0.0411,-0.0865,-0.0125,-0.0504,-0.0111,0.0021,0.0035,0.1415,-0.037,0.1465,0.1045,-0.0476,0.0397,0.0356,-0.0851,-0.0034,0.0148,0.132,0.1245,0.0618,0.0299,0.0068,-0.0074,-0.0348,0.069,-0.0,-0.042,-0.0885,-0.0376,-0.0768,0.0436,0.0342,-0.04,-0.0062,-0.0372,0.0749,-0.0318,0.047,-0.0187,0.0512,-0.0532,-0.0532,0.0085,0.0661,-0.0073,-0.0466,0.0363,0.0808,0.0225,0.0522,0.0406,-0.1225,-0.0721,0.0527,0.0374,0.1058,0.0185,0.1377,-0.0202,-0.1211,-0.2209,-0.2179,0.0288,0.0755,-0.0147,0.0403,-0.0182,-0.093,-0.0907,-0.0891,-0.0961,0.0582,0.0027,-0.0059,-0.0576,0.0081,-0.0191,-0.0597,0.0059,-0.0346,-0.0786,-0.0228,0.0323,0.0302,-0.143,-0.0546,-0.0188,0.0002,-0.0413,0.0909,-0.0566,-0.1289,-0.0655,0.0869,-0.0777,-0.0228,-0.0621,-0.0678,0.0281,0.0589,-0.0487,-0.0056,0.0052,0.0273,-0.0366,-0.0913,0.0431,0.0082,-0.043,-0.0571,-0.1145,-0.0384,0.0032,0.0553,0.0875,-0.001,-0.0204,-0.0401,-0.0452,0.0676,0.0568,-0.0676,-0.0256,-0.0164,-0.0155,-0.065,0.253,0.0249,-0.0145,-0.0098,0.0523,0.0219,-0.0324,-0.0343,-0.104,-0.1654,-0.0648,-0.0545,0.0473,-0.0195,-0.0132,-0.045,-0.0689,-0.0993,0.3113,0.0559,0.0609,0.232,-0.1547,-0.1218,-0.0412,0.0393,-0.0309,-0.0033,-0.0552,0.0047,0.0185,-0.0532,-0.0527,0.0044,0.2134,0.0219,-0.0131,-0.0174,0.0577,-0.0071,0.0988,-0.0309,-0.0442,-0.0473,-0.0195,-0.0179,0.025,-0.0018,0.0277,0.0775,-0.0642,-0.032,-0.0337,0.0261,-0.0001,-0.0421,-0.0038,-0.0272,-0.0349,0.0215,0.0099,-0.0544,0.0096,-0.0334,-0.0217,0.0069,0.0244,-0.0972,-0.0354,0.0191,-0.1014,0.1857,0.0205,0.1404,-0.0446,-0.0115,0.0322,0.0492,0.0245,-0.0304,-0.041,0.0174,0.0406,0.0132,0.0025,-0.0152,-0.0784,0.0069,-0.0283,-0.0165,0.0953,0.1358,-0.0591,0.0037,-0.0039,-0.0629,0.0132,0.0547,-0.0491,-0.0463,0.0412,-0.0155,0.105,-0.0317,0.086,-0.0175,0.0257,-0.0075,0.0207,0.0021,0.0052,-0.0348,0.0337,0.0759,0.0076,-0.0077,-0.0065,0.0916,-0.1069,-0.1096,-0.0226,0.0683,0.0079,0.0067,-0.062,-0.0251,-0.0302,-0.0568,-0.0152,-0.052,0.0321,-0.0149,-0.0972,-0.0751,0.0023,-0.021,-0.0151,-0.0104,0.0084,0.0523,-0.0154,-0.0485,-0.0249,-0.0194,-0.0338,-0.04,0.0322,0.0127,-0.0591,0.0528,0.086,0.0046,-0.0594,0.0315,0.0973,0.0208,-0.0955,0.0281,0.0026,0.0025,0.0648,0.0329,0.0715,0.1305,0.1552,0.0189,0.0017,0.0527,-0.0055,-0.0538,-0.0219,0.0094,-0.0167,0.0219,0.0009,0.0436,-0.0241,-0.0216,-0.0877,-0.0502,-0.0188,0.0469,-0.1001,-0.0097,-0.0101,0.0341,-0.0038,-0.0461,-0.2128,-0.1731,-0.107,-0.1284,0.1708,0.0472,-0.0366,-0.0084,0.0279,-0.0145,-0.0119,-0.0348,0.2754,0.0578,0.1527,0.0116,-0.0422,-0.0943,-0.0946,-0.0572,0.0189,-0.0589,-0.0409,-0.0918,0.142,0.062,-0.0498,-0.0693,-0.04,-0.0985,-0.055,-0.0311,-0.027,0.0297,0.0443,0.0218,-0.0315,-0.0115,-0.0128,0.0202,-0.0141,0.0539,-0.0575,-0.0552,0.0001,0.1377,-0.064,-0.0068,-0.0771,-0.0248,-0.0191,-0.0268,0.0105,-0.004,-0.043,0.0317,0.0285,-0.0284,-0.0751,-0.018,-0.0868,-0.0458,-0.0705,0.0205,-0.0629,0.0535,0.0654,-0.0063,-0.0221,0.0345,-0.0874,-0.058,0.064,0.0233,0.1122,0.0465,-0.063,-0.0421,-0.0361,0.05,0.056,0.1276,0.0834,0.0437,0.1386,0.0015,0.049,-0.1679,0.0231,-0.0434,-0.0074,0.0876,-0.0678,-0.0685,0.0327,-0.062,-0.0051,-0.0367,0.0259,-0.0728,-0.0801,0.0871,0.0573,-0.0202,-0.0364,0.0207,-0.0311,-0.0686,-0.0768,-0.074,-0.0576,-0.012,0.0072,-0.0282,0.0306,-0.0137,-0.0238,-0.0037,0.0151,0.0035,0.0342,0.0434,-0.1083,-0.0477,0.0143,-0.0129,-0.0198,0.0037,-0.0463,-0.0353,-0.0202,0.0043,-0.1017,-0.0284,0.1402,-0.0561,-0.0768,0.0877,-0.0451,-0.057,0.0711,-0.0085,0.0005,0.0057,-0.0505,-0.0127,0.1146,0.195,-0.0056,0.0764,0.0358,0.0561,-0.0137,0.0023,0.0539,0.1521,-0.015,0.0254,0.1207,0.0197,-0.0992,-0.0129,-0.0532,-0.0935,-0.0862,-0.0897,-0.0478,-0.0074,0.0101,0.0428,0.0776,-0.0484,-0.0217,-0.0223,0.0257,-0.0248,-0.0072,-0.0645,-0.0692,0.0419,-0.0334,-0.0836,-0.0664,-0.0188,0.0198,-0.0084,-0.0836,-0.0102,-0.0821,-0.0749,-0.1674,0.0222,0.0413,0.0128,-0.0638,0.0012,-0.0709,-0.009,-0.0607,0.0147,0.0128,0.0358,-0.009,-0.0359,-0.0476,-0.0351,0.0,-0.0402,-0.0275,-0.0179,0.0345,0.0851,-0.0372,-0.0397,0.0613,-0.0641,-0.0791,0.0053,-0.0247,0.0095,-0.0108,0.0812,0.0409,0.0497,-0.0057,-0.0871,-0.0903,-0.0573,-0.045,0.0387,0.0118,0.08,-0.0457,-0.0089,-0.0314,-0.0353,-0.0255,-0.0801,-0.0456,-0.0754,-0.076,-0.0521,-0.0962,0.0159,0.0834,-0.0571,0.014,0.0076,0.0012,0.0599,0.0549,-0.0298,-0.0147,-0.0988,-0.0464,-0.0859,-0.0465,-0.0636,-0.0567,-0.0123,-0.0109,-0.0794,-0.0586,-0.0571,0.0125,0.0039,-0.0337,-0.0008,0.151,0.0531,0.1487,0.0202,0.0255,0.0019,0.1261,0.0026,-0.0227,0.0036,-0.0167,0.0399,-0.0642,0.0168,-0.0787,-0.0252,-0.107,-0.0096,-0.0122,0.0396,0.0299,0.097,-0.1118,-0.0461,-0.0126,-0.0753,-0.0292,0.0079,0.1928,0.1858,0.0282,-0.0376,0.0054,-0.0134,-0.0784,-0.026,-0.0631,-0.0594,0.0531,-0.0118,-0.0633,0.018,-0.0457,-0.0079,0.0774,0.007,0.0251,-0.0419,-0.0202,0.0435,0.0129,0.0296,0.1541,-0.0697,0.0086,-0.0704,0.0772,-0.0462,0.3008,-0.0716,-0.0661,-0.0559,-0.0584,0.015,-0.0061,-0.0246,0.0093,0.0325,0.0144,-0.1042,0.0284,0.0409,0.0841,0.0786,0.1545,0.1267,0.2145,0.261,-0.0305,-0.043,0.162,0.3322,0.0875,0.1575,0.2569,0.1508,0.1434,0.1839,0.0657,0.1683,0.1669,0.0572,0.1894,0.0437,0.1899,0.2329,0.1253,0.18,0.0929,0.0166,0.0201,-0.0287,-0.1181,-0.0552,0.0254,0.0459,-0.0406,-0.0648,-0.0298,-0.0833,-0.0052,-0.028,-0.0221,-0.0632,0.0099,-0.0071,-0.0349,0.0777,-0.0373,-0.0781,-0.09,-0.0922,0.0031,-0.0154,0.0152,0.0146,0.0762,-0.0167,-0.0326,0.0066,-0.0506,-0.0541,0.0006,-0.0005,-0.0711,-0.0606,-0.0294,0.0024,0.1257,0.2355,-0.0485,0.1042,0.1123,-0.0763,-0.0836,-0.0837,-0.0305,-0.0752,0.1482,0.0291,0.0192,-0.0434,-0.0111,0.1337,-0.0976,-0.0812,-0.0445,-0.0943,-0.0782,-0.0294,selective control
trm_55ef273a77a86,0.0473,0.04,0.0694,0.0606,0.0096,0.0255,0.0426,-0.0036,-0.0004,0.0388,-0.0094,-0.0005,0.0384,0.0674,0.0881,0.0579,0.0563,0.0629,0.0312,-0.0123,0.0293,-0.0006,0.025,-0.0227,0.0074,-0.0043,-0.0038,0.0674,0.0842,0.0547,0.0354,0.0513,0.0591,0.0306,0.0107,0.054,0.0013,0.0323,0.0695,0.0156,0.0313,0.049,0.0039,-0.0427,0.0082,0.0108,-0.0816,0.0647,0.0026,0.0317,0.0095,-0.0236,-0.0238,-0.0018,0.0109,0.0077,0.0323,0.0076,-0.0047,0.0224,0.0019,-0.0171,0.0553,-0.0446,0.007,-0.0176,0.1142,0.0978,0.059,-0.0137,-0.047,-0.0084,-0.066,0.0224,0.057,-0.0395,0.0508,-0.0021,-0.0043,-0.0163,-0.0194,-0.047,0.018,0.0677,-0.0109,-0.0326,0.0105,0.0148,0.0096,0.0561,0.0488,0.0416,-0.0195,-0.043,-0.0853,-0.0504,-0.0492,0.0015,-0.0817,-0.0365,0.001,-0.029,-0.0146,-0.0302,-0.0657,0.0553,0.0848,-0.0879,0.0272,0.0299,0.0251,0.0492,-0.0458,-0.0581,-0.0186,-0.0309,0.0807,-0.0036,0.0184,0.0434,0.039,0.0831,0.0452,0.0178,0.0377,0.0505,0.027,-0.0243,-0.0621,-0.0515,-0.0049,0.034,0.0053,0.0779,-0.0083,0.082,0.0333,0.0421,-0.0196,0.0153,0.0287,0.0588,-0.0667,0.0059,0.0465,0.0092,0.051,0.0038,0.0264,-0.0365,0.0307,0.0199,0.0589,0.0575,-0.0908,-0.0209,-0.0173,0.0129,-0.0082,0.0323,0.0329,0.0293,0.1084,0.0788,-0.0282,-0.0232,0.0171,0.0887,0.0834,0.0019,0.0313,0.0514,-0.0267,0.058,0.0559,0.0559,0.031,0.0579,0.0087,0.043,0.0608,-0.0764,0.0294,-0.0069,0.088,0.0442,0.0304,-0.0183,-0.0118,0.0418,0.0334,0.0378,0.04,0.0964,0.0847,0.09,0.0808,0.0195,-0.0074,0.0315,0.0377,-0.0258,0.0635,0.0507,0.0113,0.0222,0.0168,0.0189,0.0331,-0.0145,0.046,0.0124,-0.0215,-0.0203,-0.0356,0.0242,-0.0281,0.0573,0.0617,-0.0099,-0.0938,0.0489,0.0749,0.039,-0.0231,-0.0091,0.0476,-0.0675,-0.0104,-0.0803,0.0598,0.0282,-0.0679,0.0951,0.095,-0.0378,-0.0047,-0.0248,-0.0125,0.0448,0.015,0.0818,0.0439,0.0325,0.0517,0.0408,-0.0264,0.0391,0.0189,0.0393,0.0074,-0.0156,0.0158,-0.0113,0.0274,0.0834,-0.0091,0.031,-0.0865,-0.0937,-0.0279,-0.1265,0.0834,-0.0746,-0.0674,-0.1345,-0.0296,0.009,-0.0447,-0.0144,0.0125,0.0388,0.0207,0.0105,0.0175,-0.0522,0.0183,0.0426,0.0285,-0.0257,-0.0623,0.0051,-0.007,0.0636,0.0391,0.0371,-0.0593,-0.0607,0.0563,0.0553,0.0376,0.0421,0.0255,0.0178,0.0684,0.0072,0.0141,-0.0441,0.0089,-0.0196,-0.0279,0.0695,0.0222,0.0231,0.0434,0.0422,0.034,0.009,-0.0015,-0.0181,0.0131,0.0129,0.0726,-0.0535,-0.0276,0.054,-0.0791,-0.0273,-0.0342,0.0623,0.0021,0.0057,0.0286,0.056,0.0355,0.0493,-0.0072,-0.0015,0.0685,0.0461,-0.0119,0.0496,0.0071,-0.0129,-0.0234,-0.0421,-0.0542,0.0556,-0.0495,0.0579,0.0632,0.0013,-0.0125,0.0235,-0.0216,-0.0086,0.1033,0.0957,0.0601,0.0257,0.0523,-0.0429,0.0317,0.0259,-0.0252,0.056,0.0196,0.0644,0.0728,0.0189,-0.0041,0.0334,0.0249,0.0307,0.0157,-0.0569,0.0587,-0.0812,-0.0291,0.0756,-0.0293,-0.0336,0.0042,-0.0318,0.0814,0.0395,0.047,-0.0551,-0.1088,-0.097,-0.0971,0.0092,0.0573,0.0096,0.0086,-0.0138,0.0329,-0.0008,-0.0046,0.0027,0.0207,0.0592,0.0579,0.0217,-0.0123,0.0047,0.0366,0.087,0.032,0.0225,0.0155,-0.0205,0.0149,0.0072,-0.0049,-0.0276,-0.0437,-0.0351,0.07,0.0174,0.0383,0.0402,0.0473,-0.1206,0.0363,-0.0043,-0.1587,0.0171,0.0553,0.0367,0.0122,0.0914,0.0635,0.1291,0.1022,0.0732,0.0577,0.0627,0.0821,0.0758,0.0165,-0.013,0.0082,0.0167,0.0186,-0.0442,-0.008,-0.0225,0.1355,0.0821,-0.0483,-0.058,0.014,-0.0402,0.027,0.0589,-0.0353,-0.0551,0.0348,0.0425,0.0154,-0.0276,0.0522,0.028,0.0122,0.0608,-0.0141,0.032,0.0034,-0.0168,0.0102,0.0462,0.0195,-0.0464,0.0666,0.0666,-0.0259,-0.1564,0.0471,-0.0105,0.019,-0.0024,-0.0279,-0.0009,-0.0343,0.0279,0.0071,-0.0432,-0.0016,0.0317,-0.025,0.0183,-0.0005,-0.0255,-0.022,-0.0239,0.0048,0.0174,0.0211,0.0391,-0.061,-0.0533,0.0406,0.0517,-0.0309,-0.0389,0.0458,0.0375,-0.0455,0.0643,0.0606,-0.012,0.0514,0.0624,0.0428,0.0377,-0.0151,-0.0506,0.018,-0.0335,0.097,-0.0057,0.0343,0.0027,-0.0486,-0.0586,0.0737,0.0673,-0.0491,0.0515,0.026,0.0261,-0.0753,0.0014,-0.0611,-0.0116,-0.0475,-0.0879,-0.0518,-0.0555,0.0239,0.0027,0.0613,0.0862,0.0355,-0.0268,0.0679,0.0599,0.025,0.0501,0.0235,-0.0103,-0.0474,0.0369,0.0528,-0.0485,0.0327,0.0072,-0.0264,0.027,-0.0465,0.0069,0.0332,-0.0013,0.0105,0.0659,-0.0492,-0.0324,-0.0735,0.0195,0.0268,-0.0147,0.029,-0.0159,0.0123,-0.031,-0.0395,-0.0197,-0.0094,0.0117,0.034,-0.0121,0.07,0.0209,0.0121,0.0031,-0.0326,-0.0163,-0.0097,-0.0411,-0.0156,0.0574,0.0145,-0.0122,-0.0123,-0.0032,-0.0084,-0.0072,-0.0107,0.0126,0.0234,-0.0045,-0.0266,-0.0511,0.038,0.0363,0.0903,-0.0034,-0.0423,0.0196,-0.0246,-0.0311,-0.0275,-0.0387,0.0132,-0.0058,-0.0105,0.0799,0.0756,-0.0014,0.1019,0.0287,-0.0344,0.0302,0.1022,0.0298,0.0197,-0.0248,-0.0076,0.1006,0.0403,0.1054,-0.04,0.0134,0.0357,-0.0275,0.03,0.0561,0.0272,-0.0113,-0.0088,-0.0161,0.0131,-0.0058,0.0347,-0.0206,-0.0146,0.0344,0.0449,0.0336,0.0405,-0.0298,-0.0202,0.0277,0.0295,-0.0175,0.0524,0.0647,-0.0607,0.0771,0.0244,0.023,-0.0489,0.033,-0.0148,0.0486,-0.0104,0.0356,0.0363,0.0727,0.0555,0.0033,-0.1054,0.0268,-0.0051,-0.0308,0.05,0.0625,0.0276,0.0331,0.0001,0.0196,0.0146,0.0136,0.0306,0.0516,-0.1025,0.0482,-0.0268,0.0139,0.0383,0.0071,-0.0066,0.0087,-0.0617,0.0824,0.0535,-0.0232,-0.0033,0.0409,-0.0087,-0.1031,-0.0425,-0.0549,-0.039,0.0193,-0.0333,0.0491,0.041,0.0069,-0.0288,-0.0247,0.0311,0.049,0.0211,0.0149,0.0628,0.0264,0.0263,-0.0112,-0.0592,-0.015,0.0232,-0.043,-0.0095,-0.0018,0.0241,-0.0148,0.06,-0.0156,-0.0575,0.0398,0.0935,0.0943,0.0569,-0.0109,0.0353,0.0797,-0.0017,0.0249,-0.0078,0.037,0.0297,-0.0112,-0.0121,-0.0161,0.0646,-0.0264,-0.0377,-0.0804,0.0648,0.0108,0.0327,-0.0207,-0.0196,0.0707,-0.0288,-0.03,0.0299,-0.0083,0.0157,-0.0409,0.0668,0.0979,0.0865,0.0747,-0.0317,-0.1141,0.0035,0.0553,0.0069,0.0169,-0.0176,-0.0283,-0.0286,0.0043,0.0294,0.062,0.0346,-0.0416,-0.0573,-0.0664,0.0083,0.0181,-0.0235,0.0401,-0.0261,0.0303,0.0529,-0.0202,0.0739,0.0531,0.0282,-0.0474,-0.0773,-0.0454,-0.0047,-0.0126,-0.0198,-0.0558,0.023,0.0536,-0.0188,-0.0192,-0.0212,-0.0121,-0.0617,-0.0015,-0.0736,0.086,0.0919,-0.0285,-0.06,-0.0872,0.0215,-0.0029,-0.0359,-0.0001,0.0132,-0.1142,-0.0018,-0.0174,-0.0459,-0.0473,-0.0187,0.011,-0.0667,-0.0924,0.048,-0.0132,-0.0464,0.1117,0.0751,0.016,0.0422,-0.0668,0.1096,0.0782,0.0867,0.0552,0.053,-0.0275,-0.0169,-0.0567,0.0257,0.0387,0.0191,-0.0071,-0.0359,-0.0297,-0.0372,-0.0112,0.0002,-0.0064,0.0068,-0.0132,-0.0375,-0.0422,0.0372,-0.0517,-0.0301,0.0048,0.0071,0.0507,0.0238,-0.029,0.0433,0.1098,0.0547,0.0296,-0.0651,-0.0556,-0.0068,-0.0129,-0.0007,0.0128,0.0427,0.0514,-0.019,0.0233,-0.0301,0.0565,0.0028,0.046,-0.0294,0.0069,0.014,0.0075,0.0857,0.0696,0.0509,-0.0848,0.0562,0.0617,0.055,0.0061,0.0163,0.0578,0.0109,0.0792,-0.0187,0.0035,-0.0472,-0.0022,-0.0352,-0.0343,0.0881,0.008,-0.0137,-0.0424,0.0437,0.0033,-0.0404,-0.0121,-0.0392,-0.1449,-0.0442,0.0286,0.0293,0.0197,0.0181,0.0445,0.0111,-0.0259,-0.069,-0.0107,0.0098,0.047,-0.0505,-0.0692,-0.0082,0.001,0.0246,0.0371,0.064,0.0366,0.0237,-0.0092,-0.0018,0.0677,0.0017,-0.0681,-0.001,0.0315,-0.0099,-0.0715,0.0043,0.0219,0.0354,0.0731,0.0724,0.0568,0.0616,0.0544,0.0089,-0.0004,0.0238,0.0495,0.0228,0.0591,0.0164,0.045,0.0347,0.0053,-0.0318,-0.0338,-0.0468,0.0051,-0.043,0.0007,-0.0251,-0.0379,-0.0437,-0.0386,-0.0519,0.0126,0.0195,-0.0135,-0.0121,-0.087,-0.0675,-0.0226,0.0187,-0.0612,-0.027,-0.0724,0.0334,0.0311,-0.0059,-0.0561,0.0197,-0.0037,0.0931,0.0205,0.0371,0.0329,0.0231,-0.0451,-0.0456,-0.0141,-0.0525,-0.0516,-0.0474,0.0206,0.005,-0.0013,0.0118,-0.0278,0.0146,0.031,0.0692,0.0697,0.0269,-0.0435,-0.0373,0.0563,0.0197,0.0307,0.08,0.0402,-0.0606,-0.0407,-0.0444,-0.0457,-0.0139,0.0194,0.017,-0.0199,0.0115,0.0052,-0.0133,-0.0092,-0.0044,0.0002,0.0114,-0.0138,0.0397,0.0186,0.0501,-0.0239,0.0441,-0.0243,-0.0171,-0.0584,0.0022,-0.0244,0.0197,0.0254,0.0128,0.0018,0.0094,0.0173,0.0041,-0.0201,-0.0323,0.0203,0.0441,-0.0228,0.0045,-0.0056,0.0457,0.0484,0.0459,0.0466,0.0379,-0.1009,0.0034,-0.0245,0.0648,-0.123,-0.068,0.0048,-0.0,-0.0217,-0.0388,0.0074,-0.05,0.0692,0.053,-0.0012,0.0328,0.028,0.0089,0.0221,-0.025,-0.0603,0.0274,0.0201,0.0303,-0.0023,0.0369,0.0227,-0.0087,0.0032,0.0762,0.0203,0.0312,-0.0028,0.0325,0.0205,-0.1741,-0.0967,-0.1249,-0.0655,-0.0838,-0.0419,-0.11,-0.0904,0.088,-0.1636,-0.1284,-0.077,-0.0805,-0.1159,-0.065,-0.0655,-0.06,-0.0068,-0.0537,0.0089,-0.0681,-0.0375,0.0483,-0.0273,-0.0342,-0.0156,-0.0464,0.0089,0.0281,-0.0675,-0.0478,0.0286,0.0141,0.0532,-0.0149,-0.0157,-0.0559,0.0086,0.0662,0.0262,0.0087,0.0003,-0.0504,-0.0826,0.0218,0.0179,0.0589,0.0279,0.034,-0.1288,0.0649,-0.0655,-0.0899,0.0293,0.0007,0.0353,0.0161,0.0054,0.0067,-0.0802,-0.0517,0.0461,0.011,-0.0264,0.0472,0.0888,0.0055,0.0322,-0.0056,-0.0058,0.0529,0.0121,0.0589,0.0161,0.0026,0.0108,0.0588,0.0165,-0.0915,0.0325,-0.0147,0.0158,-0.0726,0.0221,-0.0181,0.0958,0.0945,-0.0108,0.0427,0.0274,0.0619,0.0333,-0.0008,-0.0011,-0.0488,-0.0489,-0.0136,-0.0869,-0.0147,-0.036,0.0241,-0.0521,-0.013,-0.0287,0.0239,-0.0214,-0.0919,0.0049,0.0514,-0.1016,-0.0844,0.0131,0.0675,-0.0158,0.0933,0.0269,0.0847,0.0193,-0.0576,0.0269,0.0029,-0.0229,0.0207,0.0221,0.0305,0.0219,0.0109,0.0239,0.0422,-0.0794,0.0285,-0.1716,-0.1111,-0.1258,-0.1481,0.0624,0.0052,0.0683,0.0273,0.0398,0.0256,0.0434,-0.0865,0.0305,0.043,-0.0402,0.005,0.0285,-0.0663,-0.0056,-0.0377,-0.0041,-0.0416,0.0337,0.0347,0.0236,-0.0998,-0.0082,0.0093,0.0435,0.0435,0.0887,-0.0175,0.0017,0.0064,0.0389,-0.0344,0.0248,-0.0495,0.1342,0.1253,-0.0601,0.0331,0.0997,0.104,0.0895,0.026,0.0509,-0.0329,0.0319,0.0101,-0.0503,-0.0264,-0.0843,0.0263,-0.0868,-0.0008,-0.0413,-0.0609,0.0125,0.0074,-0.0091,0.0258,0.0051,0.0046,-0.0139,-0.0539,-0.013,-0.0134,0.0021,-0.0289,-0.0008,-0.0619,0.0167,0.036,0.0205,0.0416,0.0366,0.0921,0.126,0.0156,-0.0067,0.0736,0.0531,0.0239,0.0822,0.0122,0.0535,0.0021,0.0802,0.0254,0.0492,0.0661,-0.021,-0.0318,0.0315,-0.1147,-0.0502,-0.0062,-0.0292,0.0108,-0.0003,-0.0191,0.0434,0.0402,0.0003,0.0459,0.0088,0.0672,0.0118,-0.0279,-0.0034,0.0018,0.0763,0.0427,0.0253,-0.003,0.0413,-0.0101,-0.0096,-0.0026,0.0234,0.0591,0.0408,0.0706,0.0526,0.0152,0.0641,0.0721,0.0146,0.01,-0.0261,-0.0112,0.0014,0.0615,0.0773,-0.0309,0.0695,-0.0062,-0.0312,0.0583,0.0658,0.0502,-0.0232,-0.0548,-0.0187,0.0078,-0.0241,0.015,-0.0989,-0.0442,-0.0184,-0.0134,0.0865,-0.0684,0.0285,0.0116,-0.0169,-0.0616,-0.0368,0.051,0.0324,-0.0414,0.0409,-0.0026,0.059,0.0165,0.0664,0.0288,-0.0363,-0.0143,0.0062,0.0464,0.05,-0.0349,-0.0106,-0.0147,0.0001,0.0516,-0.013,-0.0135,0.0584,-0.0139,0.0143,0.0369,0.0124,0.0442,0.0348,0.03,0.0353,0.0255,-0.0224,-0.0211,-0.0567,0.0369,0.0343,0.0255,0.0179,0.0093,0.0044,0.0629,-0.0445,0.0533,0.0316,-0.009,-0.0512,-0.0165,-0.0031,-0.019,0.0177,0.0027,0.0299,0.0315,0.0703,0.0045,0.0453,-0.0264,0.0026,0.0023,0.0206,0.0124,0.0181,-0.0681,-0.0477,-0.0242,-0.1711,-0.0101,-0.0058,0.0063,-0.0895,0.0257,0.0373,-0.0249,-0.0776,0.038,0.0059,0.0185,0.0341,0.0238,0.0466,-0.0613,0.0225,0.0187,-0.0444,-0.0794,0.0276,0.0242,0.0187,0.0072,-0.0209,-0.0315,0.0817,0.0327,0.0225,0.0923,0.0677,-0.0985,-0.048,-0.0262,-0.0085,-0.0783,-0.0577,0.0855,0.0276,0.0174,0.0251,0.0931,0.0436,0.0093,0.0172,0.0298,-0.05,0.0168,-0.0202,-0.0183,-0.0158,-0.0849,-0.0464,0.0345,-0.0403,0.007,0.0189,0.0307,-0.0165,-0.0441,-0.0045,-0.0178,-0.095,0.0021,-0.0145,0.0146,0.0412,0.0055,-0.1329,-0.1247,0.0859,0.0721,-0.0235,0.031,0.0438,0.0206,0.0653,-0.0192,0.0189,0.007,0.0138,0.0344,-0.0931,0.0121,-0.0219,-0.0547,-0.0041,-0.0282,-0.1025,0.0331,0.0049,-0.1094,-0.0097,-0.0168,-0.0483,-0.0236,0.0709,-0.0591,-0.0043,0.0158,-0.0225,-0.0274,-0.0157,-0.0714,-0.0115,-0.0015,-0.0068,-0.0036,-0.0726,0.0587,-0.0002,-0.0647,-0.0008,0.0077,0.0057,-0.0108,0.0862,0.008,-0.0316,0.038,-0.0195,0.0395,-0.0329,-0.039,0.0124,-0.0153,-0.0029,-0.0127,-0.0027,-0.0522,-0.0391,-0.0391,0.0028,-0.0508,0.012,0.0061,-0.1745,0.0536,0.0412,0.0109,0.0453,-0.0385,-0.0431,-0.055,0.0428,0.0239,0.0091,0.0411,0.0113,0.0249,0.0314,0.001,-0.0276,-0.0211,-0.0312,-0.0813,-0.1344,-0.1015,0.021,0.0401,0.0456,0.0139,-0.0343,-0.0239,-0.0309,-0.027,-0.0366,-0.0076,-0.02,0.0364,0.0812,0.0484,0.0033,-0.0493,0.0375,-0.0087,0.0006,-0.0953,-0.0837,-0.0107,-0.004,0.0618,0.0019,-0.0057,-0.0114,0.0561,0.0586,0.0426,-0.0308,0.0074,-0.009,-0.0535,0.0608,0.0416,-0.0356,-0.041,-0.0168,-0.0507,0.0171,0.0212,0.0014,0.0171,-0.064,-0.0263,-0.0448,0.0406,-0.0191,-0.035,-0.0066,0.0601,0.0071,0.0802,0.0509,0.0476,0.056,0.0052,-0.0728,0.0648,0.0223,0.0375,0.0022,-0.0049,0.0305,0.0576,0.0056,0.0306,0.0254,0.0094,0.0041,-0.05,-0.0147,-0.0289,0.0966,0.0662,0.0868,0.025,-0.0324,0.037,0.0438,0.0169,0.0625,0.0133,-0.0669,-0.0259,-0.0332,-0.0613,-0.0138,-0.0341,0.0231,0.01,-0.0088,0.0212,0.1002,0.0159,0.0435,0.0422,0.0352,-0.0072,-0.0092,-0.155,-0.1219,-0.0233,-0.029,0.0324,0.1483,0.0807,0.1111,0.0857,0.0104,0.0378,0.0012,0.0393,0.0923,0.071,0.0376,-0.006,-0.0405,0.0022,0.0288,-0.001,0.0567,0.107,0.061,0.0337,-0.0313,0.0191,0.0014,0.0816,0.029,0.0652,0.0507,0.0987,-0.0607,0.0197,0.0269,0.0323,0.0546,0.0177,0.028,0.073,0.0489,0.042,-0.0096,-0.0247,-0.0149,-0.0315,-0.0007,0.0304,-0.0082,0.0075,-0.0403,0.0308,0.0161,0.0327,-0.0255,0.0464,0.0585,0.0149,0.0714,0.0249,0.034,0.0548,0.0637,0.0156,0.0223,-0.0344,-0.0135,0.115,-0.0471,0.0029,0.0514,0.0418,0.0491,-0.0131,0.0532,-0.0111,0.0011,-0.0889,-0.0139,-0.0193,0.0796,0.0532,0.047,0.0397,0.059,0.0558,-0.0078,-0.044,-0.028,-0.0282,0.0357,-0.0174,-0.0599,-0.0838,-0.0673,0.0832,0.1063,0.046,-0.0137,0.0179,0.0264,-0.039,0.0222,-0.0122,0.0388,0.0154,0.0417,0.0306,0.0508,0.0345,-0.0043,0.0336,-0.017,0.0336,0.0056,-0.0422,-0.0413,0.0305,0.0453,0.04,0.0787,0.0645,0.1141,0.0419,-0.1637,0.0537,0.0536,0.0027,-0.0058,0.0309,-0.0076,0.0164,0.0241,-0.0786,0.0429,0.0076,0.0053,0.0489,-0.0044,0.0209,-0.0368,-0.119,0.0569,0.0086,-0.0043,-0.1422,-0.0043,0.0368,-0.0271,-0.0156,0.0187,0.0037,-0.038,-0.008,-0.0087,0.059,0.0393,0.0391,0.0042,0.0249,-0.0209,-0.0716,-0.0927,-0.015,-0.0355,-0.0507,-0.0468,-0.0271,-0.0243,0.0016,0.0036,0.0039,0.1,0.0263,0.0844,0.0558,-0.0078,0.0487,0.0618,0.0398,-0.0002,0.0355,0.072,0.0467,-0.0317,0.0403,0.1132,-0.0364,0.0486,0.0064,-0.0294,0.0849,-0.0138,0.0927,0.0316,-0.0221,0.0475,0.025,0.0065,0.048,-0.0255,-0.0272,-0.0335,-0.0012,0.0317,-0.0193,-0.0236,0.011,-0.0265,0.0041,0.0384,-0.0086,-0.0061,0.0194,0.0639,0.0655,0.025,0.0248,0.0189,0.0046,0.0505,0.039,0.0295,0.0496,-0.0393,0.0711,0.0394,-0.0275,-0.0184,0.0172,-0.0052,-0.0303,0.0817,0.0262,0.068,0.0663,-0.0583,-0.1068,-0.1154,0.0437,-0.1613,-0.0923,0.0803,0.0412,-0.1412,-0.0975,-0.0167,-0.0863,-0.065,-0.0452,0.0655,0.0635,0.0628,0.0647,-0.2341,-0.1943,-0.1721,-0.0691,-0.0668,-0.1249,-0.2263,-0.232,-0.1868,-0.0248,0.0332,0.0204,-0.0067,0.022,-0.0079,0.0676,0.0343,0.0045,0.0486,0.0462,0.0509,-0.0601,-0.0002,0.0367,0.0462,-0.0196,-0.058,-0.0401,0.014,0.032,0.0351,0.0234,0.0069,0.0098,0.014,0.0266,0.0264,0.0192,0.0762,0.0931,0.0832,0.017,0.0351,0.001,-0.0778,-0.0064,-0.0879,-0.0331,-0.029,-0.1237,0.0258,0.0655,0.0783,0.0034,-0.0305,0.0013,-0.0479,0.0032,-0.0247,-0.0139,0.0573,0.0608,0.0282,0.0248,-0.0141,0.1002,0.0754,0.01,-0.0227,-0.0709,0.0435,0.0249,-0.0406,-0.0,0.0314,0.0097,0.0306,0.0609,0.0656,0.0023,0.0337,0.0376,0.005,0.0486,-0.0185,-0.0797,-0.0523,-0.0007,-0.0907,0.0194,0.0113,-0.0458,-0.054,-0.0764,-0.0718,-0.0208,-0.0068,0.0127,-0.0424,-0.0359,0.0282,0.0276,0.0333,0.032,0.0434,0.0004,-0.0044,0.0046,-0.0086,-0.009,-0.01,-0.0173,-0.0338,-0.0167,-0.0524,-0.051,0.07,0.0737,0.041,0.057,0.078,-0.0494,0.0044,0.0142,0.0074,-0.086,-0.0268,0.098,0.0225,-0.0184,0.0065,-0.0284,-0.049,-0.0123,-0.0731,-0.1254,-0.2028,-0.0591,-0.0334,0.0367,0.0299,-0.0709,0.0771,0.0526,0.028,0.0019,0.0222,-0.0069,0.0233,0.0255,0.0327,0.06,0.0809,0.0737,0.0315,0.0433,0.0738,0.0315,0.0567,0.0008,0.0264,0.02,0.0461,0.0416,-0.0663,-0.0241,-0.0184,0.0462,-0.0514,-0.0269,0.0001,-0.028,0.0884,0.0566,-0.025,0.0059,0.009,0.0205,-0.0104,-0.0179,-0.0189,0.0734,0.0315,-0.017,-0.0239,-0.026,0.0497,-0.0231,-0.0192,0.0009,-0.0356,0.0792,0.0432,0.0084,0.0565,0.0337,0.0279,0.0201,0.0213,-0.0552,0.0032,-0.0052,0.0963,0.0584,0.0789,0.0699,0.0754,0.0645,0.0683,0.0683,0.0277,0.0188,-0.0128,0.0823,0.0137,0.0627,0.0565,-0.0193,0.0068,0.1089,-0.055,0.0515,-0.0019,-0.0061,-0.0644,-0.0727,-0.0147,0.0559,0.0773,0.0131,-0.0271,-0.0053,-0.0486,-0.0232,-0.0166,-0.0627,-0.0678,-0.0215,-0.0458,-0.0105,-0.0078,0.0025,0.0456,0.0338,0.0362,0.0442,0.0393,0.0083,0.0295,0.0031,-0.0012,0.0295,-0.0135,-0.073,0.0254,-0.0617,-0.025,0.0665,0.0142,0.091,0.0375,0.0416,-0.0194,0.0391,-0.0384,-0.0379,0.0151,-0.0606,-0.0559,0.0245,-0.0667,-0.018,-0.143,-0.0488,0.002,-0.0252,0.0473,-0.0234,-0.0252,-0.0499,0.037,-0.0135,-0.0238,-0.0241,-0.0009,0.0442,0.0562,0.0268,0.0266,0.0135,-0.0186,0.0779,-0.0853,-0.0126,-0.0447,-0.0691,-0.0312,0.0004,0.0128,0.0448,0.0709,0.0293,-0.053,-0.0331,-0.0141,0.0147,0.0657,0.017,-0.0453,-0.0381,-0.0358,-0.0109,0.0044,0.0391,-0.0704,0.0292,-0.0236,-0.0294,0.0255,0.0207,0.0413,0.0401,0.0423,-0.0036,-0.0231,0.0516,-0.0447,0.0074,-0.0207,0.003,-0.0232,-0.0214,-0.0025,0.0507,0.0357,0.0409,0.0348,-0.0249,-0.0067,0.014,0.0189,-0.0205,-0.049,-0.0331,0.0483,0.0243,0.0705,0.0612,-0.0253,0.0054,-0.0199,0.0234,0.0311,0.0623,0.0179,0.0492,-0.0073,-0.0219,0.0546,-0.0701,0.0434,0.0401,0.0103,0.0091,0.0514,-0.0348,-0.0146,-0.0093,0.0658,-0.0583,0.0039,0.0538,-0.0293,-0.0337,0.0009,-0.0411,0.0419,0.0429,0.0419,0.0634,0.0785,0.0389,0.0373,0.0452,0.0218,-0.0434,-0.0572,-0.0237,0.065,0.0495,-0.0397,-0.0873,-0.1526,-0.0462,-0.0012,-0.0263,0.0358,0.0502,-0.0028,0.0657,0.0213,0.024,-0.0282,0.0381,0.0791,-0.06,0.0049,0.0131,-0.0735,-0.0255,-0.0179,0.0473,0.0143,0.0305,0.0229,0.0415,-0.0181,-0.0317,-0.0383,0.0031,0.0211,0.0168,0.039,0.0045,0.0269,0.0702,0.0228,0.0038,0.0208,-0.0044,0.0045,0.0142,-0.029,0.0174,-0.0385,0.1023,0.0443,0.0656,0.0785,-0.0032,0.0658,0.0623,0.1027,0.0399,0.0432,-0.019,0.0734,0.0082,0.0315,-0.0151,-0.04,-0.0319,0.0724,0.0775,0.0288,0.0006,-0.0233,-0.0511,0.0422,0.0193,0.0349,-0.05,-0.0061,-0.0034,-0.0092,0.0024,0.0158,-0.031,-0.0318,0.0274,0.0165,0.0146,0.0326,0.0063,-0.0036,-0.0462,0.057,-0.042,-0.0504,0.025,-0.0322,0.0207,0.0556,0.0449,0.002,-0.0802,-0.0627,-0.0349,-0.0292,-0.0234,-0.0133,-0.059,-0.0913,-0.0716,-0.0473,0.0588,0.009,0.0375,-0.0169,0.0783,-0.0007,-0.0076,0.0013,-0.0276,0.0115,-0.0494,0.0152,-0.0218,-0.0106,0.0833,-0.0612,-0.0406,0.0024,-0.0192,-0.0256,-0.0525,-0.0225,0.0023,-0.0115,0.0119,-0.0061,-0.121,-0.1007,-0.0139,-0.0353,-0.06,0.0279,0.0827,0.1587,0.1496,-0.001,-0.0534,-0.006,0.0321,-0.0038,-0.0065,0.0333,0.0368,0.0517,-0.015,0.0431,-0.0317,0.0192,-0.0007,0.004,0.0611,0.0311,0.0503,0.0435,-0.0013,0.0188,-0.004,0.1129,0.039,0.0114,0.0311,-0.0065,-0.0122,0.0075,0.065,0.0407,-0.098,0.0497,-0.0587,-0.0432,-0.0264,-0.0127,-0.0141,0.0589,-0.0698,-0.07,0.0224,0.0379,0.01,-0.0243,0.0323,0.0359,0.045,0.0826,0.0258,0.0301,0.0046,-0.024,0.0208,0.0062,0.0614,0.0875,-0.011,-0.0374,0.0424,0.0179,0.0317,0.0465,0.0555,-0.0893,-0.0952,0.0233,-0.0104,-0.0256,-0.0391,0.0484,0.0562,0.0824,0.1073,0.0388,0.0581,-0.0113,0.0082,-0.0116,-0.0286,0.0215,-0.0025,-0.1606,-0.0994,-0.0348,-0.1257,0.0852,0.0672,0.06,-0.0165,0.0205,-0.0014,0.0332,-0.0056,0.0019,0.0828,0.0622,-0.0181,-0.0779,0.0302,0.0223,0.0294,-0.0128,-0.031,-0.0899,0.0382,0.0324,0.0234,0.0247,-0.0236,-0.0261,-0.0321,-0.0444,-0.0173,0.0259,-0.0082,-0.0189,-0.0098,-0.0033,0.0567,-0.0155,0.0331,0.0165,-0.0219,-0.0087,-0.0375,-0.0322,0.0155,0.0124,0.0513,0.0067,0.0857,0.0529,0.029,0.0712,-0.1448,0.0181,-0.1367,-0.0355,-0.0209,0.0253,0.0179,-0.0631,0.0029,-0.0712,-0.0889,-0.0351,-0.0321,-0.0085,-0.0129,0.0641,0.0255,0.0435,0.0092,-0.0619,-0.0432,0.0558,-0.0091,-0.035,-0.0228,-0.0062,-0.0225,0.0223,0.0436,0.0123,0.0521,-0.0316,0.0458,-0.0744,-0.024,-0.0258,-0.0086,0.0066,-0.0156,0.0146,0.0503,-0.0635,-0.078,0.021,0.0161,0.0157,-0.0387,0.0498,0.0281,0.0295,-0.0185,-0.0219,0.0121,0.0809,0.0501,0.0572,0.0345,0.0045,-0.0083,0.0404,0.0006,0.0322,0.0464,0.019,0.005,0.0173,0.0335,0.0116,-0.0064,0.0573,-0.0493,0.0656,0.0682,0.0475,0.0155,0.0117,0.0511,0.0765,0.0021,-0.0357,-0.0401,0.0336,-0.0703,-0.1225,-0.011,0.0437,-0.0161,0.0285,0.0205,-0.0173,-0.0019,-0.0309,-0.124,-0.0757,-0.0015,-0.0238,-0.0389,-0.048,0.0698,0.0235,0.0122,0.0031,0.0266,0.0294,0.0027,0.0516,-0.0184,0.1042,0.0595,-0.0428,0.0044,0.0847,0.0078,-0.0348,-0.0582,0.0259,0.0418,0.1557,0.1305,0.0673,0.1054,-0.1177,0.0595,0.0208,-0.0286,0.0028,0.0233,0.0581,0.0194,-0.1439,-0.0713,-0.1103,-0.0384,-0.0361,0.0199,0.0063,-0.0153,-0.0176,-0.0026,-0.012,0.0081,-0.0842,-0.0398,0.0662,0.1066,0.0674,0.0616,0.0688,-0.0103,0.0252,-0.0398,-0.0404,-0.0306,-0.0022,-0.0008,0.1053,0.0306,0.0786,-0.0066,0.0837,0.0966,-0.003,-0.0429,0.0321,0.0298,0.0427,0.0649,0.0461,0.076,0.0397,0.0612,0.0419,0.0253,0.0256,0.043,0.0327,-0.0189,-0.0182,-0.0047,0.0314,0.0332,0.0623,0.0158,-0.0428,-0.0568,0.0284,-0.116,0.034,0.0455,-0.0184,-0.0133,-0.0299,-0.0077,0.0245,-0.018,0.0119,-0.0154,-0.0792,-0.1215,-0.1148,-0.0356,-0.0429,-0.015,-0.048,-0.0097,-0.0831,0.0208,-0.0805,-0.01,-0.0143,-0.0107,-0.0265,0.0149,0.0031,-0.0033,0.0024,0.0173,0.0111,-0.0363,-0.017,0.0135,0.0654,-0.0523,-0.0375,-0.0075,0.1098,0.0774,0.0647,-0.0182,0.0653,0.0381,0.0234,-0.0196,0.0007,0.0188,0.0693,0.0667,0.0096,-0.0068,0.0785,0.0161,-0.1249,-0.0268,0.0488,-0.0573,-0.114,-0.0424,-0.0068,-0.1028,0.0424,-0.0367,-0.102,-0.0494,0.0311,-0.0995,-0.0177,-0.0267,-0.0802,-0.0962,-0.0065,0.0698,0.0581,0.0385,-0.0216,-0.0786,0.0204,-0.008,0.0194,-0.0211,0.0333,0.0796,0.004,-0.0502,0.031,0.0603,-0.0328,0.009,0.0324,0.0031,0.0304,0.0146,0.0085,0.0404,0.0173,0.0957,0.0688,-0.049,-0.0864,-0.0058,0.0293,-0.0129,0.0247,0.0223,0.0341,0.0558,0.0928,-0.0358,-0.022,0.0402,0.0466,0.0196,-0.033,0.0636,0.0326,-0.0061,0.0355,0.0184,0.0729,0.0547,0.032,0.0775,0.0047,0.0034,0.0147,-0.0638,0.043,0.0164,-0.0627,-0.0052,0.0542,0.0227,0.0552,0.0813,0.0498,0.0153,0.0298,-0.0398,-0.0195,-0.0359,0.0232,0.0674,0.0018,0.0034,-0.003,-0.0467,0.0852,0.0457,0.0805,-0.0276,-0.0126,-0.0432,0.028,0.0885,0.0674,0.0254,0.0284,0.0041,-0.0197,-0.0695,0.0216,0.0295,0.0355,0.0238,0.0383,0.1154,0.0556,0.0374,-0.0038,0.0007,-0.0095,0.0016,-0.0622,-0.0039,-0.0123,-0.0036,-0.0498,-0.0722,-0.0759,-0.012,-0.0152,0.0622,-0.0104,0.0516,0.0179,0.0446,0.03,0.0018,-0.0156,0.0469,0.039,0.0556,-0.0015,0.049,0.0132,0.0035,-0.0518,0.0047,-0.0618,0.0051,-0.037,0.0086,-0.0216,-0.0093,0.0248,0.0675,0.0332,-0.0931,-0.0244,0.0046,0.0222,0.0587,0.0465,0.0334,0.0414,0.0273,-0.0447,-0.0593,0.0732,0.0681,-0.0178,0.082,0.0501,0.0236,-0.1555,-0.1368,0.0573,-0.0282,0.0347,0.0353,0.0374,0.0453,0.1086,0.0956,-0.0371,0.0098,0.0531,-0.0263,0.0689,0.0108,-0.0779,0.0132,-0.0173,-0.0079,-0.008,-0.005,0.054,0.0168,-0.0422,0.0659,-0.0264,0.0658,-0.0709,0.0684,-0.1584,-0.015,-0.0041,0.0673,0.059,-0.0032,-0.0106,0.0111,-0.0228,-0.0212,0.008,-0.0032,-0.0081,-0.0073,-0.0557,-0.0536,-0.0785,-0.0518,-0.0808,-0.1392,0.0181,-0.0329,-0.1049,-0.2433,-0.1019,-0.097,-0.155,-0.0766,-0.1042,-0.1415,-0.0742,-0.1424,-0.0818,-0.0884,-0.1145,-0.052,-0.0865,-0.1502,-0.1663,-0.1566,-0.0818,-0.0462,-0.0895,0.0823,0.0645,0.0612,0.0201,-0.0016,0.1111,0.111,0.0505,0.0224,0.0571,0.1312,0.1068,0.0697,0.0043,-0.012,0.0514,-0.0631,0.0181,0.0526,0.0228,0.0289,0.0087,0.0343,0.0401,0.0844,-0.0733,0.0965,0.1107,-0.0,0.0066,0.039,0.0057,0.0019,0.0725,-0.0079,-0.0242,0.0378,-0.0926,-0.151,-0.0316,-0.0562,-0.0524,0.0206,-0.0532,-0.0525,-0.0036,0.0331,-0.0585,0.009,0.0033,0.0557,0.0275,-0.0746,0.0586,0.0468,0.0191,-0.0172,0.0064,0.0396,auditory tone perception
trm_4a3fd79d0b61f,-0.0366,-0.0031,-0.0451,-0.0224,-0.0215,-0.0127,-0.0151,-0.0613,-0.0427,-0.0296,-0.0131,-0.0107,-0.038,-0.0186,0.0128,0.0263,-0.0107,0.0261,-0.0034,0.0381,-0.0038,-0.0059,-0.0138,0.0242,-0.0037,0.0006,0.0011,-0.0158,-0.0227,-0.0343,-0.0181,-0.0001,-0.0119,-0.0111,0.0319,-0.0044,-0.0248,-0.0303,0.0058,0.0579,0.0023,0.0168,0.0137,0.0068,-0.0136,0.0015,-0.0166,-0.0077,0.0033,-0.0212,-0.0177,0.0021,-0.0239,0.0062,0.0073,-0.0093,0.0062,-0.0004,0.0065,-0.0074,-0.0328,-0.0277,0.0159,0.0201,0.0306,-0.0514,0.0074,-0.0078,0.003,-0.0172,0.0131,-0.0083,0.0081,0.0079,0.0046,0.0409,-0.0206,-0.0036,-0.0014,-0.0002,0.0141,0.0181,0.0336,-0.001,-0.0025,-0.0538,0.0157,-0.0238,0.0278,-0.0392,-0.0054,-0.048,0.0394,-0.0561,-0.0095,-0.0227,-0.0182,-0.0167,-0.0557,-0.0243,0.0111,0.0659,-0.0246,-0.0446,0.009,0.0264,0.0158,0.0077,-0.0029,-0.0192,0.0103,0.0048,-0.0144,0.0053,0.0305,0.0349,-0.0127,-0.0412,0.0072,-0.0056,0.0384,0.0108,0.0247,0.0172,-0.0057,0.0097,0.0106,-0.0347,-0.0182,-0.0273,0.007,-0.0193,-0.0123,0.0168,0.0184,-0.0176,-0.0169,-0.0024,0.0116,-0.023,-0.008,-0.0148,0.0808,0.0059,-0.0144,0.0124,-0.0447,0.0106,0.0087,0.0469,-0.0222,0.0231,-0.0364,0.0052,0.0147,0.0194,-0.0358,0.0317,-0.0079,-0.0188,0.0147,0.0211,-0.0108,-0.0159,-0.0148,0.0288,-0.029,0.0065,0.0055,0.0143,-0.003,0.0204,-0.0283,0.01,0.0015,0.0057,0.0116,-0.0036,0.0131,-0.0677,0.009,0.0076,0.0158,-0.0158,-0.042,-0.0438,-0.0003,-0.0054,0.0134,0.0109,0.0078,0.02,-0.0024,0.0027,0.0032,0.0009,0.0108,0.0067,0.0713,-0.0273,-0.0339,-0.0729,0.0084,-0.0076,0.0429,-0.0243,0.028,0.0315,0.0034,0.042,0.0154,0.0113,0.0053,-0.045,0.0452,-0.0109,0.0097,-0.0069,-0.0632,0.0309,0.0047,0.0079,0.0107,-0.027,-0.0035,-0.0149,0.0389,0.0147,0.014,0.0653,-0.0754,0.0114,0.0032,-0.0102,-0.0174,-0.0067,-0.01,0.0309,0.001,-0.025,-0.0285,-0.0083,0.0051,-0.0145,-0.0245,0.0044,0.0334,-0.0005,-0.0235,0.0548,-0.0167,0.0095,0.0174,0.0091,-0.0253,-0.0269,0.0054,-0.0126,0.0514,0.0167,-0.0036,0.0153,-0.003,0.008,0.0048,0.0429,0.028,0.038,0.0259,0.0229,0.0213,-0.0019,0.0145,-0.0199,-0.0139,-0.0203,-0.0332,-0.0146,-0.033,0.0139,-0.014,-0.0304,-0.0248,0.0219,0.0335,-0.0219,0.0109,0.0079,-0.0283,-0.0552,0.0171,-0.0109,0.0024,0.0022,-0.0226,0.0006,0.0121,0.0379,0.0204,0.006,0.0192,0.0265,-0.0202,0.0055,-0.0653,-0.0679,-0.0304,-0.0005,-0.0381,0.0591,0.0079,-0.0125,0.0158,0.019,0.0217,0.0009,0.0291,-0.0021,0.0109,0.0175,0.0024,-0.0078,-0.0001,0.0482,-0.0278,0.0169,0.0091,0.0207,-0.043,-0.0243,0.0241,-0.0012,0.0176,0.0308,0.0366,-0.0249,0.018,0.0593,0.0222,-0.0002,-0.0045,0.0376,-0.0276,-0.0412,0.0407,0.0103,-0.0289,-0.0527,-0.0245,0.0067,-0.0289,-0.0067,-0.0681,-0.0564,-0.0217,-0.0442,-0.0027,-0.0002,-0.0064,-0.0213,-0.0219,-0.0078,-0.0057,-0.0495,-0.0414,-0.0494,-0.0234,0.0444,0.0475,-0.0128,0.048,-0.0061,0.0054,-0.0294,-0.0091,0.0044,0.0422,0.0054,0.0666,0.0026,0.0632,-0.0678,-0.0001,0.0212,-0.0117,-0.0048,-0.011,-0.0247,0.0259,-0.0167,-0.0405,0.0086,-0.0562,0.0151,-0.0751,-0.1072,-0.0726,-0.0463,-0.0269,-0.0001,0.0252,-0.0241,-0.0428,-0.0417,-0.0113,0.0181,-0.0098,0.0061,-0.0374,-0.0057,-0.0049,0.0019,0.0299,0.0178,-0.0067,-0.0169,0.0655,0.0647,0.0285,-0.0158,-0.0247,-0.0265,-0.0054,0.002,0.0185,-0.0079,0.0102,-0.0641,-0.0168,-0.0563,-0.0033,-0.0099,-0.0031,-0.0226,0.0385,0.0201,-0.0107,0.0174,-0.0376,-0.0298,0.0272,-0.0287,0.0153,0.0174,-0.0203,-0.022,-0.0319,-0.0055,0.0247,0.045,0.0326,-0.0019,-0.0094,0.0013,-0.024,0.0105,-0.0108,0.0344,0.0367,-0.0161,-0.0385,-0.0269,-0.0049,0.0308,-0.0138,0.0325,0.047,0.0844,-0.0006,0.0012,-0.014,-0.0377,-0.0317,0.0217,0.002,0.0179,-0.0464,0.0202,0.0172,-0.0165,-0.0312,-0.0293,-0.032,-0.0627,0.0348,0.019,-0.0008,0.0014,0.0573,0.0034,-0.0223,-0.0111,0.031,0.0259,0.0307,0.0273,0.0379,-0.0285,0.0559,0.0002,0.0055,-0.021,-0.0256,-0.0387,-0.0024,0.0041,0.0264,0.0112,0.0167,-0.0158,-0.009,0.0112,0.0194,-0.0085,-0.0066,0.0406,-0.0082,-0.0232,-0.0105,-0.0222,-0.0238,-0.037,0.0202,0.0059,0.0092,0.0233,0.0066,-0.0373,-0.0139,0.0191,-0.009,-0.0006,-0.0538,-0.0189,-0.0115,0.0008,0.0055,0.0018,-0.0104,-0.0161,0.0201,0.0049,-0.0184,-0.0132,-0.0354,-0.004,0.0049,-0.0046,0.0132,0.0138,-0.0317,0.0366,0.0159,-0.0422,0.0056,0.0006,-0.0187,0.0047,0.0245,-0.0385,0.0183,0.0368,0.0152,-0.0027,0.0034,-0.0063,-0.0038,0.0624,0.0108,0.0049,0.0079,0.0425,-0.0378,0.0004,-0.1342,-0.1428,-0.0098,-0.0241,0.0097,0.0397,0.0053,-0.0126,0.0077,-0.0253,-0.0295,-0.0169,-0.0187,0.0226,-0.0184,-0.0207,-0.0028,-0.0193,0.0181,0.0282,-0.004,-0.0324,-0.0208,-0.036,-0.054,0.0131,0.037,-0.0045,-0.0082,0.0062,-0.0144,-0.1108,0.0323,-0.0118,-0.0128,0.0185,-0.0366,-0.0262,0.0019,-0.0051,-0.0389,0.0188,-0.0174,0.0047,0.0479,0.0074,-0.0094,-0.0397,0.0073,-0.021,-0.0125,-0.0243,0.0067,0.0189,-0.043,0.0098,-0.0005,-0.0576,0.0082,0.0144,0.023,-0.0322,0.0152,-0.0048,0.013,-0.0343,-0.0346,0.0189,-0.0491,-0.1102,0.0317,-0.0123,0.0052,-0.0002,-0.0388,0.0044,0.0241,-0.002,-0.0176,0.0188,-0.0099,-0.0361,-0.103,-0.0289,-0.0289,-0.0055,0.02,-0.0935,-0.0072,-0.0682,-0.0459,-0.0217,-0.062,-0.0036,-0.0598,-0.0447,-0.0219,-0.008,-0.0437,0.0194,-0.0152,0.0224,0.0127,0.0039,0.0301,-0.0022,0.0335,0.0228,0.023,-0.0258,-0.0081,-0.0162,0.0035,0.0696,0.0366,-0.0178,-0.0261,0.0502,0.0207,0.0242,0.0131,0.0588,0.0115,0.0008,0.0001,0.0126,0.0154,0.0419,0.0058,0.0107,0.0286,-0.0134,-0.0005,0.0011,0.0098,0.0149,0.0574,0.0509,0.0498,0.0372,0.0661,0.0178,-0.0539,0.0371,0.0017,-0.0279,-0.0064,-0.0347,0.0275,0.0236,0.0113,0.0177,-0.0021,-0.0102,-0.0088,-0.0388,-0.0174,-0.0162,-0.0303,0.0198,0.0052,0.0028,-0.027,-0.0212,0.0225,0.0493,0.0031,-0.0158,-0.024,0.0329,0.0295,-0.0186,0.04,-0.0027,-0.0069,0.0057,-0.0112,0.0112,-0.0012,0.0223,0.029,0.013,0.0306,0.0358,0.017,-0.0143,0.0118,-0.0278,0.0272,0.0182,0.0038,-0.0462,0.0014,-0.0234,-0.0406,0.0006,-0.0055,-0.0317,-0.0356,-0.0188,-0.0415,-0.0253,0.0291,0.0019,-0.0047,0.0286,0.0079,-0.001,0.0638,-0.0124,0.0453,0.0194,-0.0015,-0.0127,0.0049,0.036,-0.0221,-0.0177,0.0185,-0.0162,-0.0449,-0.014,0.0295,0.0472,0.0284,0.0053,-0.0089,0.0005,0.0481,-0.002,-0.0002,0.0187,0.0305,-0.0071,0.0238,-0.0409,-0.0211,-0.0088,-0.0047,-0.0031,-0.0412,0.0148,-0.0181,-0.0204,0.0083,-0.0172,0.0218,-0.0222,0.015,-0.0276,-0.0141,0.0012,0.008,-0.011,0.0092,0.0048,-0.0116,0.0276,-0.019,0.0144,-0.0181,-0.0279,0.0426,0.0022,-0.0008,0.0328,0.0328,0.0214,-0.0128,0.0253,-0.0254,0.0359,0.0047,-0.0436,0.01,-0.0714,-0.042,-0.03,-0.0045,-0.0152,0.0052,0.0228,0.0225,0.0105,0.0268,0.0044,0.0214,0.0522,0.0666,0.0103,-0.0345,-0.0665,0.0057,-0.0038,-0.0279,0.0414,0.0176,-0.0134,-0.1315,0.0013,-0.025,0.0169,0.0302,0.0081,0.0221,0.0336,-0.007,0.0006,0.0284,0.0173,-0.0288,-0.007,0.0238,0.0166,0.0081,-0.0135,0.0032,0.0095,-0.0118,-0.0226,0.0199,-0.0185,-0.0017,0.0147,-0.0035,0.0161,-0.0216,-0.0186,0.0013,0.0073,0.0159,0.0534,-0.0109,0.0069,-0.0297,0.0261,0.0293,0.0015,0.0287,0.0169,0.0133,-0.0206,-0.0019,-0.0082,0.0079,0.0149,-0.052,-0.0131,0.0035,-0.0461,-0.0706,-0.0412,-0.0453,-0.0708,0.0388,0.0276,-0.0172,-0.0037,0.0085,-0.009,-0.0144,0.0243,-0.0097,-0.0153,-0.0184,-0.0491,-0.047,0.0082,0.021,0.0103,0.0177,0.0047,-0.0053,-0.0153,0.0064,-0.001,0.0225,0.0276,-0.0027,0.0188,0.0012,0.0141,0.0312,0.0656,0.0014,0.0383,0.0275,0.0167,0.0542,0.0168,0.0387,0.0275,0.0128,0.0208,0.0006,0.0534,0.0022,0.0036,-0.0118,0.0453,0.004,-0.0114,-0.0257,-0.0025,0.0027,0.0311,0.0005,0.0319,-0.0242,0.0269,0.0152,0.0692,0.0612,-0.0176,0.0182,-0.0511,0.0173,0.0104,-0.0039,-0.0096,-0.0075,0.0091,-0.0375,-0.0093,0.0029,-0.0152,-0.0507,-0.0262,-0.0258,0.0388,0.047,0.0017,-0.0359,0.0154,0.0124,0.0037,0.0174,0.0094,-0.0101,0.0398,-0.013,-0.0022,0.0449,0.0144,0.034,0.0071,0.0045,0.028,-0.0163,-0.0499,-0.0063,0.0331,-0.0113,0.0179,-0.0089,0.0041,-0.0212,-0.0272,-0.0431,-0.0844,0.0131,0.0024,-0.0139,-0.0088,0.0088,-0.01,0.0189,0.0152,-0.0077,0.0184,-0.0136,0.0049,0.0017,0.0131,0.007,0.005,-0.0207,0.0276,0.0203,0.0292,-0.0062,0.0082,-0.0014,-0.0429,0.0059,-0.0042,0.0225,0.0026,0.0002,0.0436,0.0252,0.0132,-0.0082,-0.0236,0.0463,0.0127,0.003,0.0441,0.0694,-0.0087,-0.0075,-0.0034,-0.0141,0.0258,-0.0241,-0.0262,-0.1213,0.0092,-0.0092,0.003,-0.0191,-0.024,-0.0014,0.0089,0.0067,-0.0255,0.0201,-0.0193,-0.0184,-0.0394,-0.0205,-0.0206,-0.0164,0.0321,0.0054,0.0589,0.057,0.0573,0.0339,0.0575,0.0186,0.018,0.0066,0.0421,0.0238,0.0093,-0.0182,0.0045,0.0115,-0.0234,-0.0251,0.0517,0.0203,0.0279,-0.0007,0.0434,0.0381,0.0214,0.0146,0.0015,-0.0159,-0.015,-0.0196,0.0287,0.0116,-0.0027,0.0086,0.0022,0.0451,0.0376,-0.0859,0.0125,0.0317,0.0145,-0.0119,0.0585,-0.0099,-0.0462,-0.0184,-0.0114,-0.0241,-0.0727,-0.1542,-0.121,-0.1271,-0.0018,-0.0469,0.0203,0.0062,0.0151,-0.0345,0.0028,0.0126,-0.0217,-0.0402,0.0006,-0.0209,-0.0105,-0.0053,0.0263,0.0108,-0.0091,-0.0545,-0.1078,0.049,0.0005,0.0052,0.0424,0.03,-0.0505,-0.0015,0.0058,0.0027,0.0444,-0.011,-0.0681,-0.0235,0.0202,-0.0017,0.0204,0.0187,0.0066,-0.0178,-0.0305,-0.0118,0.0228,0.0096,0.0118,-0.0077,0.0264,0.0237,-0.0018,-0.0148,-0.0032,0.0214,0.0468,0.0335,0.0022,-0.0089,-0.0035,-0.0195,-0.0211,-0.0151,-0.0005,-0.0249,0.0121,-0.0117,-0.0308,-0.022,-0.0307,-0.0408,0.0193,0.0004,-0.0064,-0.0485,0.0083,0.0136,0.0636,0.0418,0.0297,0.0649,0.0071,0.0217,0.0043,0.0137,0.0084,0.0098,-0.0692,0.0219,0.0147,0.019,0.0723,-0.001,0.0338,0.011,0.0224,-0.0111,-0.0156,-0.0368,0.0427,0.0054,0.0462,-0.007,0.0169,0.0425,-0.0504,-0.0504,-0.0131,0.052,0.0195,0.0175,-0.0333,0.0136,0.034,-0.0862,-0.0041,0.0006,0.0285,0.0182,-0.0051,-0.0052,-0.0413,-0.0366,-0.0315,0.0017,-0.0489,-0.015,-0.0819,-0.0143,0.0401,-0.0143,0.0431,-0.0283,0.0079,0.0062,-0.0026,0.0161,0.0356,0.0286,0.0178,0.0242,-0.0176,0.0028,-0.0034,-0.1275,-0.0924,-0.0805,0.0368,-0.0339,0.006,-0.0122,0.0122,-0.025,-0.0246,0.0215,-0.0379,-0.0053,0.0104,0.0011,-0.0513,-0.0308,0.0172,0.0083,-0.0276,0.01,-0.019,0.0077,-0.0027,-0.037,0.0211,-0.0151,-0.0186,0.043,-0.0333,-0.0602,-0.0356,-0.021,-0.0343,-0.0048,-0.0147,-0.0097,0.0,0.0089,0.0206,0.0095,-0.0231,-0.0318,0.0015,0.0289,-0.0079,0.0247,-0.022,-0.0494,-0.0284,-0.0104,0.0166,-0.0041,-0.0035,-0.0004,0.0245,0.0302,0.0078,0.0109,0.0071,-0.0024,0.0163,0.0161,-0.003,-0.0205,-0.0166,-0.0164,-0.0094,-0.0289,-0.0086,0.0326,-0.0095,-0.0506,-0.0812,0.0331,-0.0067,-0.0097,0.0448,0.0226,0.0388,0.0153,0.0456,0.0248,-0.0363,-0.0594,0.0091,0.0208,0.0158,-0.0357,-0.0299,0.0005,0.0058,-0.0374,-0.0266,-0.002,-0.0053,-0.0219,0.0007,-0.009,0.0306,0.0085,0.0299,-0.0167,0.0196,0.0065,0.0319,0.0299,0.0498,-0.003,0.0415,-0.0043,0.0368,0.0122,-0.0177,-0.0038,0.0043,-0.0009,0.0272,0.0118,0.0048,0.0008,-0.008,-0.0034,-0.0092,0.0066,-0.0162,0.015,0.0296,-0.0134,-0.0403,-0.0525,0.0617,0.05,-0.0089,-0.1078,-0.1508,-0.0131,0.0302,0.0222,-0.0078,-0.0077,-0.0315,-0.0007,0.0331,-0.0069,0.0215,-0.0078,-0.0368,-0.0002,0.0143,0.0019,-0.0248,0.0179,0.0306,0.0226,0.0299,0.025,0.105,-0.0274,0.0286,-0.0072,0.0185,-0.007,-0.0129,0.0064,0.02,0.0003,0.0077,0.006,-0.0034,0.0104,0.0285,0.0347,-0.0361,-0.0585,-0.0641,-0.0234,0.0156,0.0097,0.0048,-0.0051,0.0056,0.0301,-0.0374,-0.016,-0.0334,-0.0342,-0.0181,0.0004,-0.0201,0.0068,-0.0018,-0.0253,0.0026,-0.0104,0.0073,0.016,-0.0143,-0.031,0.0315,0.0603,0.0267,-0.0261,0.0011,0.0216,0.0118,-0.0108,-0.0093,-0.0073,0.0102,-0.023,0.0595,-0.0509,-0.0036,-0.0281,0.0293,0.0129,-0.009,0.0276,-0.0031,-0.0483,-0.007,0.0268,-0.0155,-0.0308,0.008,0.0135,0.0664,0.0155,0.0317,0.0169,-0.0185,-0.045,-0.0162,0.0003,-0.0067,-0.0111,-0.0271,0.0151,-0.0114,0.0424,0.0017,-0.0106,-0.0148,0.0084,0.0309,-0.1268,0.0281,0.0283,0.0209,0.0239,-0.0228,0.0039,-0.0001,0.0649,0.0675,-0.0142,-0.0193,0.0387,0.036,0.0773,0.0385,0.0516,0.0316,0.0414,-0.0143,0.0351,-0.0127,0.0642,0.0519,0.0425,-0.0012,-0.0053,-0.0081,0.0209,-0.0271,-0.0113,0.0187,0.0229,0.0514,0.0503,-0.0042,0.0159,0.0192,0.0367,-0.0031,-0.0178,-0.0358,-0.0001,0.0287,0.037,-0.0129,0.0116,0.042,0.0109,0.0216,0.0403,0.0065,-0.0102,0.0282,-0.0082,-0.0073,0.0017,-0.0023,-0.0048,0.0362,0.0013,0.0038,-0.0244,0.0354,-0.0041,-0.014,0.0124,0.0552,0.0303,-0.0226,-0.019,-0.0124,0.0007,0.0301,0.003,0.0436,0.0196,0.0151,0.0166,-0.0424,-0.0824,-0.017,-0.0041,-0.0036,0.0172,-0.0112,0.0085,-0.0071,0.0538,0.0483,0.0102,0.0109,-0.0022,-0.0048,0.0092,0.0084,-0.0236,-0.0248,-0.0364,0.0167,-0.0028,0.0041,-0.0078,-0.005,0.0201,0.0291,-0.0428,0.0085,-0.042,0.0301,0.0127,-0.0387,-0.0283,-0.0477,-0.01,-0.0179,0.0148,0.0057,0.0486,-0.0212,-0.0239,-0.0258,-0.0057,0.0073,0.0165,0.0363,0.0201,-0.0029,-0.0205,-0.1343,0.0272,-0.0412,-0.0345,-0.0599,-0.0319,-0.0232,-0.0116,0.0137,-0.0211,-0.0006,0.0126,-0.0037,0.0325,0.0024,0.0137,0.0027,-0.0033,0.0447,0.0458,0.0115,0.0017,-0.0316,0.011,0.046,0.0295,-0.0038,0.0567,0.0391,-0.0037,-0.0367,0.0161,0.0017,0.0002,-0.0002,-0.0313,0.0169,-0.0017,-0.0033,0.0407,0.0334,0.0636,0.0868,0.0369,0.0417,0.0075,0.0,-0.0129,0.0041,0.0208,-0.0144,-0.0332,-0.0477,0.0065,0.0064,-0.0387,-0.0228,0.0323,0.0548,-0.0245,0.0211,-0.0072,-0.0551,-0.0297,-0.0051,0.0061,0.0157,-0.0176,0.0066,0.0326,-0.0184,0.0267,0.0149,0.0209,0.0287,0.0174,-0.067,0.0327,-0.0025,-0.0029,-0.035,-0.0091,-0.0034,0.0156,0.0685,0.0269,-0.0147,0.0365,0.0048,0.0619,0.033,0.0072,0.0227,-0.0102,0.0186,0.0188,0.0114,0.0169,0.0178,0.0428,-0.0236,0.0205,0.0133,0.0005,-0.0156,0.0117,0.0164,-0.0026,0.0203,-0.0009,-0.0169,0.0345,0.0096,0.0045,0.0047,0.0412,0.0012,0.0443,0.0003,0.0368,0.0093,0.0266,-0.0034,-0.0396,0.0138,-0.0181,0.0364,0.0486,-0.0024,-0.059,-0.0291,0.0469,-0.0398,0.0145,-0.0099,0.0214,-0.0221,0.0101,0.0068,-0.0181,-0.0274,-0.0113,-0.0498,0.0166,-0.0181,0.0395,-0.0233,0.006,0.01,-0.0446,-0.0055,0.021,0.0171,0.0321,-0.0149,-0.0286,-0.0101,-0.0436,-0.0245,-0.0378,-0.0108,0.0107,0.0076,-0.007,0.0091,0.0109,0.0257,0.0052,-0.0063,-0.1315,-0.0775,-0.1451,-0.0574,-0.0913,-0.1026,-0.0481,-0.0577,-0.0483,-0.0236,-0.0758,-0.1248,-0.142,-0.1147,-0.0052,0.0124,-0.0518,-0.0394,-0.0055,0.0133,0.0166,-0.0189,0.0313,-0.0238,-0.0811,-0.0306,-0.0024,0.0156,-0.0753,-0.0409,-0.0362,-0.0692,0.0052,0.0485,0.0374,0.0447,0.027,-0.0011,0.038,0.0348,-0.0137,0.0205,0.0182,-0.0245,-0.0167,0.0172,0.0057,0.0194,0.0255,0.0177,0.0097,-0.0163,-0.0008,-0.0089,0.0079,-0.0651,-0.069,-0.0187,0.006,0.0058,-0.0315,-0.0065,-0.0071,-0.0051,-0.0064,-0.0315,-0.0132,0.0209,0.0395,-0.0217,-0.0051,-0.019,-0.0373,-0.0179,-0.0479,-0.0027,-0.0305,-0.0166,0.0081,0.0282,0.0101,0.0026,0.0055,0.0066,0.0269,0.0133,0.0237,-0.0246,-0.0219,-0.0257,-0.0246,-0.0394,0.0008,-0.0214,-0.0143,-0.0407,-0.0514,0.0175,0.0374,-0.0341,-0.0155,0.0424,0.0015,0.0557,0.006,-0.037,-0.0325,-0.0021,-0.0011,0.0303,0.0345,0.0264,-0.0221,0.0178,0.0204,0.0074,-0.0142,0.04,-0.0201,0.008,0.0054,0.0246,0.0077,0.0012,0.0015,-0.015,-0.0242,0.0764,0.0514,0.0828,0.0319,0.0249,0.0154,0.0427,0.0513,0.0418,0.0067,-0.0147,-0.0293,0.0102,-0.0133,0.0024,0.0113,0.0197,-0.0027,0.0192,-0.021,-0.02,0.0108,0.0094,-0.0521,-0.0335,0.0179,0.0088,0.0336,-0.054,-0.045,-0.0527,-0.0049,0.0184,-0.0074,0.0023,-0.0071,0.0175,-0.0067,-0.0118,0.001,0.0004,-0.0268,-0.0538,0.0061,0.0178,0.0053,0.0314,-0.0191,0.0275,0.0274,-0.009,0.003,0.0422,-0.0621,0.0575,0.0048,0.0203,0.0048,-0.0235,-0.0096,-0.0237,-0.0239,0.0066,0.005,-0.1176,-0.0504,-0.0337,0.0066,0.0229,0.0494,-0.0504,0.0016,0.0516,0.0241,0.0298,0.0227,0.0272,-0.0122,-0.0133,-0.0036,-0.0244,-0.0232,-0.0303,-0.0327,-0.0,-0.0136,-0.0166,0.0092,-0.0164,0.0362,-0.0343,0.0125,-0.0242,-0.0343,0.0082,-0.0145,-0.0163,0.0205,-0.016,0.0322,-0.0261,-0.0199,-0.0414,-0.045,-0.0298,-0.0074,0.023,-0.027,-0.008,0.019,-0.0114,-0.0137,-0.0317,-0.022,0.0165,0.0135,0.0033,0.0025,-0.0153,0.0084,0.0082,-0.0308,-0.0241,0.0093,0.0046,0.0138,-0.0561,0.0114,-0.0281,-0.0136,0.0312,-0.019,-0.0107,-0.0195,-0.0011,-0.0286,0.0243,-0.078,-0.0059,-0.0319,-0.0155,-0.0627,-0.0326,-0.0088,-0.0073,0.019,-0.0153,-0.0468,-0.0099,-0.0346,0.0234,0.0172,0.0147,-0.0157,0.0042,-0.0037,-0.0089,0.0466,0.0099,-0.0097,-0.0237,-0.0052,-0.0442,-0.0168,0.0187,0.0227,0.0034,-0.0252,0.0571,0.0531,-0.0015,0.0216,0.0133,0.0305,-0.0209,-0.0355,-0.0399,-0.0315,0.006,0.0071,0.0137,0.0076,-0.0135,0.0601,0.0138,0.0355,-0.0046,-0.0287,0.0328,-0.0123,0.0185,0.0075,0.0078,0.0433,0.0171,-0.0003,-0.0144,0.023,0.0211,-0.0258,0.0315,0.0131,0.0036,-0.0016,-0.0142,0.0064,0.0021,0.0109,-0.0469,-0.0469,0.0117,-0.01,-0.0064,-0.0018,0.0111,-0.0606,-0.029,0.0246,0.0168,0.0376,0.02,-0.0341,0.0062,0.0244,-0.0131,0.0033,0.0397,0.0327,0.0023,-0.0487,-0.0102,0.0184,-0.0192,-0.0354,-0.0614,-0.0711,-0.0084,-0.0085,0.0149,-0.0988,-0.0633,-0.0327,0.0443,0.0471,-0.0013,0.0514,0.0085,-0.0011,-0.0105,-0.0213,0.0143,0.0059,-0.0233,0.04,0.0287,0.0021,-0.002,0.0427,0.0392,0.0472,-0.0017,-0.0064,0.0027,0.0315,-0.1195,-0.133,-0.0566,-0.0215,0.0369,-0.0322,0.0359,0.0187,0.0386,0.0358,-0.014,-0.0386,0.0056,-0.0151,0.0523,0.0054,-0.032,0.0355,0.0039,-0.0307,-0.0105,-0.1262,-0.0303,-0.1382,-0.0747,-0.133,-0.0376,-0.0587,-0.0097,-0.0472,0.0149,0.0168,0.0002,-0.0246,0.0276,-0.0006,0.018,0.0148,-0.011,0.0474,0.0373,0.0406,0.0029,-0.0043,0.0464,-0.0017,0.0707,0.0385,-0.0245,-0.0247,-0.0061,-0.0496,0.0176,-0.0174,-0.0402,-0.0024,-0.026,-0.0109,-0.0243,-0.037,-0.0291,-0.0041,-0.0274,-0.0413,-0.0262,-0.0003,0.0223,0.0058,-0.0119,-0.0024,-0.0189,0.0187,0.0277,-0.0173,0.0233,0.006,0.0378,-0.0106,0.0278,-0.0012,0.0181,0.0204,0.035,0.0123,-0.0145,-0.0145,-0.0056,0.0275,0.0112,0.008,-0.0035,-0.0078,0.0286,0.0066,-0.0724,0.0292,0.006,-0.0142,0.0209,0.0173,0.0192,0.0152,-0.0319,-0.0467,0.0212,0.0203,-0.0223,-0.0262,-0.0122,-0.0061,-0.0261,0.0276,-0.0235,0.003,-0.0741,-0.0178,-0.0086,-0.062,0.0258,-0.0595,-0.0787,0.0008,0.0053,-0.0168,0.0148,0.0129,0.0649,0.0469,0.0524,0.0088,-0.0457,0.0006,0.0244,0.0049,0.0573,-0.009,-0.0167,0.028,-0.015,0.0126,0.0075,0.0576,0.0533,0.0353,0.0301,0.0398,0.0168,0.08,0.0039,-0.0169,-0.0423,-0.0277,0.0141,-0.0004,-0.033,-0.0149,0.0214,-0.0145,-0.0104,-0.0136,0.0132,0.0002,0.0002,-0.0156,0.0378,0.0287,-0.0115,-0.0432,0.0177,0.0244,-0.0179,-0.0389,-0.0412,0.0077,0.0018,-0.0191,-0.0033,-0.0243,0.0207,0.0012,-0.0316,-0.0267,-0.0024,-0.0108,0.0249,-0.0103,0.0359,0.0243,-0.013,0.0119,0.019,-0.003,0.0379,0.034,-0.0271,-0.0311,-0.0216,-0.0176,-0.0067,0.0018,0.006,-0.0259,0.0055,0.0517,-0.0017,0.0543,0.009,0.0148,-0.0,-0.0727,0.0312,-0.0182,0.0198,-0.0272,-0.0204,-0.0678,0.0482,0.024,0.0152,-0.0217,0.0094,-0.0251,-0.0119,-0.0222,-0.0033,0.023,-0.0199,0.0052,-0.0114,0.0213,0.0159,0.0243,0.0285,-0.0098,0.0067,-0.0125,0.0433,-0.035,-0.0414,0.0443,0.0032,0.0005,0.0079,0.0165,-0.0182,-0.0313,0.0025,-0.0013,-0.0043,0.037,-0.0038,-0.0027,0.0268,-0.0307,-0.011,0.0132,-0.0481,0.0268,0.0382,0.013,0.0221,0.0024,-0.0287,0.007,-0.0101,0.0014,-0.0497,0.0051,-0.032,-0.0062,0.0298,0.0823,0.047,0.0215,0.0284,0.0546,-0.0262,-0.003,0.0288,0.0027,-0.0172,0.0096,-0.0089,-0.0189,0.0167,-0.0838,0.0111,0.0136,0.0238,0.0103,-0.0215,-0.0361,-0.0079,0.0578,0.0301,-0.0765,-0.0081,0.0135,0.0104,0.0165,0.0147,0.0128,-0.0084,-0.0248,-0.0957,-0.0123,-0.0221,0.0109,0.0479,0.0445,0.0212,0.0337,-0.0044,-0.0318,-0.0117,0.0284,0.0094,0.0441,0.0151,0.0149,-0.0116,-0.0088,-0.0086,0.0001,0.008,0.0665,0.0143,-0.072,-0.0068,0.0065,0.0744,-0.0093,-0.0198,0.0033,0.0125,-0.001,-0.1118,-0.0955,-0.0162,-0.0227,-0.0169,-0.0122,0.0163,-0.0175,0.0268,0.0477,-0.0141,-0.0072,0.0608,0.0055,0.0401,0.0229,-0.0085,-0.0006,0.0079,0.0575,-0.0096,0.0381,0.0201,0.0219,0.0204,-0.0215,-0.0345,0.0443,0.0596,0.0184,-0.1338,-0.1412,-0.0842,-0.0251,0.0074,-0.096,0.0358,0.0427,0.0216,-0.0244,-0.0098,-0.0292,0.0124,0.0046,-0.0779,-0.0409,-0.0771,0.009,-0.0075,0.0077,0.0074,-0.0479,-0.0214,0.0079,-0.0023,0.0647,0.0617,-0.0046,-0.0139,-0.0288,0.0252,-0.0027,-0.0099,0.0059,-0.0075,0.0402,-0.0043,0.0132,-0.0121,-0.0049,-0.0251,-0.0221,0.0047,-0.0282,0.0469,-0.0016,-0.0111,-0.025,-0.0452,0.0117,-0.0258,-0.0266,-0.0869,-0.0514,-0.0003,0.0039,-0.0419,-0.0729,-0.009,0.0362,-0.021,-0.0292,-0.008,-0.0193,-0.0173,-0.0843,-0.0019,0.0159,0.0062,0.0105,-0.0645,0.0219,0.0436,0.0529,-0.0407,-0.0301,-0.0448,-0.0123,-0.0873,-0.0326,0.0107,-0.0385,0.0447,0.018,0.0039,-0.022,-0.0217,-0.0263,-0.0523,-0.0224,0.0177,0.0021,-0.0245,-0.1066,-0.0247,-0.0067,0.008,0.0024,0.0271,0.0228,0.0364,0.0021,0.0054,-0.0085,-0.0081,0.0574,-0.1028,-0.0842,-0.0867,0.041,-0.0191,-0.0294,0.0195,0.0438,0.0256,0.013,-0.0351,-0.0025,-0.0025,-0.0097,-0.046,0.0194,-0.0197,-0.0164,0.0268,0.006,0.028,0.0135,0.021,0.002,0.0365,0.005,0.0201,-0.0351,-0.0169,-0.0154,-0.0196,-0.0106,-0.0192,-0.0033,-0.0064,-0.0073,-0.0174,-0.0695,-0.0196,-0.0298,0.0027,0.0616,0.011,-0.0042,0.0062,-0.0241,0.0035,0.0034,-0.008,-0.0169,-0.0391,-0.0089,0.0445,-0.0167,-0.0083,-0.0732,-0.0685,-0.0546,0.0393,0.0043,-0.0005,0.0391,0.0066,0.0311,0.0307,0.0283,0.0624,0.0436,0.019,0.0059,-0.0257,-0.0074,-0.0331,-0.0085,-0.0002,-0.0202,-0.0068,0.0338,-0.0646,0.0015,0.0127,0.0177,0.032,0.0212,-0.015,-0.0009,-0.0116,-0.0032,0.0194,-0.0205,0.0131,-0.0196,-0.0354,0.0166,0.006,-0.0624,-0.0215,-0.0052,-0.0559,0.0274,-0.0052,0.0526,0.0301,0.0281,-0.0278,0.0261,0.0124,-0.003,0.011,-0.0039,0.0005,-0.0558,-0.0006,0.0184,-0.0316,0.0321,0.051,0.049,0.0239,-0.0271,0.0103,0.0376,0.0302,-0.0211,0.0042,0.007,0.0013,0.0051,0.0313,-0.0089,-0.0185,-0.0209,-0.0075,0.0142,-0.0356,-0.0416,-0.0215,-0.0109,-0.104,-0.1011,0.0111,-0.011,-0.0083,0.0167,-0.0041,-0.0625,-0.0653,-0.0231,-0.0138,-0.0047,-0.0093,-0.0247,0.0483,0.0383,0.0045,0.005,0.0093,-0.0227,-0.0113,0.0374,0.0003,0.0295,-0.0398,-0.0167,0.0039,0.0109,-0.0717,-0.0224,0.0162,-0.1412,-0.0147,-0.0367,-0.0249,-0.0205,0.0114,-0.0583,-0.009,0.0308,-0.0401,0.0262,0.0367,-0.0251,-0.0077,0.0226,0.0038,0.0346,0.0156,-0.0093,-0.0331,-0.0028,-0.0113,-0.0094,0.0134,0.0428,0.0098,0.0162,-0.0294,0.0022,-0.0073,0.0172,0.0267,0.0294,0.0187,0.0043,0.0165,-0.0399,-0.0108,0.0242,0.0155,0.0395,0.0272,-0.0014,0.0234,-0.0056,-0.008,0.0302,0.0402,-0.0084,-0.0205,0.042,0.0028,-0.0158,0.0147,-0.0054,-0.0422,0.0335,0.0045,0.049,0.0307,-0.017,0.0069,-0.0026,0.0346,-0.0155,-0.0141,0.0211,0.018,-0.0007,0.0141,-0.0261,-0.0195,-0.0519,0.0193,0.0187,-0.0494,-0.0121,-0.0007,-0.0912,-0.0193,-0.0683,0.048,-0.0426,-0.0243,-0.0156,-0.0095,0.0127,0.0053,0.0179,-0.0265,-0.0028,-0.0445,0.0457,0.0334,-0.0025,-0.0223,0.0063,-0.0116,0.0223,-0.0087,0.0144,-0.0288,0.009,-0.0144,-0.0562,-0.0624,-0.0067,-0.0677,-0.0095,0.0195,0.0089,0.0186,-0.019,0.0038,-0.0269,-0.0073,-0.0204,0.0182,-0.0056,0.042,0.0004,-0.0073,0.0043,-0.0305,0.0145,0.0273,0.0384,0.0025,0.0271,-0.0051,-0.0505,0.0084,0.004,0.0187,-0.0153,0.0006,0.0111,0.0373,0.0034,-0.0063,0.0303,0.0078,0.0172,-0.0266,-0.0092,0.0181,-0.0476,0.0139,0.0057,0.03,0.0248,0.0042,0.0065,-0.0032,-0.0142,0.0377,0.0034,0.0287,-0.0599,0.0029,-0.0311,0.0223,0.0162,-0.0513,-0.0203,-0.0047,-0.0277,-0.0088,0.0111,-0.0456,-0.0154,0.0031,-0.0061,0.0663,-0.0071,-0.0004,0.0244,-0.0345,-0.0108,-0.0535,0.0169,-0.0069,-0.034,0.0153,0.0088,-0.0109,0.0063,-0.0075,0.0397,-0.0031,-0.0447,0.0067,0.0206,-0.0205,0.0171,0.0084,0.02,-0.007,0.0173,0.0194,-0.0043,-0.1003,0.0161,0.037,0.0077,0.0167,0.0211,0.0263,0.0248,0.0239,0.0283,-0.008,0.0291,-0.0662,0.0263,0.0378,-0.0267,0.0172,0.0266,0.0606,0.0281,0.0312,0.0156,-0.0156,0.0238,0.041,0.0367,0.0042,0.0247,0.0132,0.006,0.062,-0.0111,-0.0387,0.0219,-0.0197,-0.0047,0.0334,-0.0014,-0.01,0.0496,-0.0452,0.053,-0.0158,-0.0536,0.0175,0.0204,-0.0012,0.0224,-0.0314,0.0072,-0.0027,-0.0132,-0.0121,-0.0867,-0.0579,0.0157,0.0113,0.0119,-0.0321,0.0543,0.0096,0.0152,0.0198,0.0037,-0.0172,-0.032,-0.0147,0.0141,-0.0083,-0.0172,-0.016,0.0057,-0.0104,-0.0111,0.0097,-0.0455,0.0179,0.019,-0.001,0.0186,0.0244,0.0161,0.0762,0.0697,0.0564,0.0021,0.0625,0.0076,0.0165,0.0173,0.0144,0.0027,0.0293,-0.0106,-0.0147,-0.016,-0.026,-0.005,-0.0054,0.0082,-0.006,-0.003,0.0161,-0.0444,decision
trm_557b474e2b578,-0.0393,-0.007,-0.0467,-0.0131,0.004,0.0062,-0.0051,0.0168,-0.0037,-0.0218,-0.0208,-0.0162,-0.028,-0.0084,0.0037,0.0037,-0.0271,-0.0126,0.0038,-0.0043,-0.0392,-0.0027,-0.0139,0.0021,-0.0145,-0.0084,-0.0091,-0.031,-0.0264,-0.0428,0.0028,0.0116,-0.03,-0.0181,-0.0013,0.0022,-0.013,-0.0086,-0.014,0.0003,0.0263,-0.0155,-0.0192,0.0125,-0.0059,0.0002,-0.0156,-0.0069,-0.0008,-0.0104,-0.0201,0.0107,0.0084,-0.0122,0.0157,-0.0005,-0.002,0.0055,-0.0009,0.0063,-0.0168,-0.0015,-0.005,-0.0184,0.0,-0.0151,-0.0218,-0.0476,-0.0249,0.0012,0.039,0.0287,0.0147,0.0067,-0.0254,0.0242,-0.0027,0.0139,0.006,0.0042,-0.0099,-0.0067,-0.0042,-0.0006,-0.0219,-0.0118,0.0164,-0.0041,-0.0219,-0.0177,-0.0107,-0.0061,0.0091,0.0014,0.0102,0.0044,-0.0247,-0.0301,-0.0105,0.0075,0.008,-0.0057,-0.0169,-0.0272,0.0194,0.017,-0.0333,0.0047,-0.0314,0.0158,-0.0348,-0.0183,0.0195,-0.0008,0.0225,0.0193,-0.0125,0.01,0.0004,-0.0052,-0.0091,-0.0105,-0.0148,-0.001,-0.0277,-0.0271,-0.0141,-0.0088,-0.0009,-0.0093,0.0252,-0.0127,-0.015,0.0315,-0.0029,-0.0436,-0.0322,-0.0018,-0.0101,0.0014,-0.0191,-0.0292,0.0312,-0.0134,-0.0295,-0.0111,-0.0426,0.0071,-0.0174,0.0015,-0.0029,-0.015,-0.0384,0.0141,0.018,-0.0266,-0.008,-0.0019,-0.0015,-0.0107,-0.0054,0.008,0.0021,-0.0008,0.0017,0.0403,0.0071,-0.0295,-0.0304,-0.0119,-0.0025,-0.0292,0.0137,0.07,0.0403,0.0464,0.0224,0.0307,0.0711,-0.0263,-0.0065,0.0418,0.0112,0.0004,-0.0408,-0.0299,-0.0021,0.0312,0.0368,-0.0192,-0.0295,-0.004,0.0063,-0.0866,-0.0875,-0.0058,-0.011,0.0037,0.0273,0.0217,-0.0054,-0.0012,-0.0097,-0.0161,-0.0033,0.0036,0.0295,-0.0135,-0.0194,0.0114,0.0212,0.0409,0.0066,-0.0014,0.0343,0.008,0.0248,-0.0171,-0.0193,-0.0152,0.0166,0.0015,-0.0111,-0.0154,-0.0089,0.01,0.0053,0.0075,0.0207,0.0031,-0.023,0.0186,0.0349,-0.0047,-0.0067,-0.0339,0.0055,0.0147,-0.0235,-0.0005,-0.0122,-0.0434,-0.0288,-0.0053,-0.0064,-0.0275,0.0497,-0.0033,-0.0013,-0.009,-0.011,0.0148,0.0083,0.0222,-0.0263,-0.0086,-0.0007,-0.008,0.0268,0.0175,-0.0063,0.0121,-0.0087,0.0087,-0.0083,0.0342,0.0338,0.0127,0.0142,0.0065,-0.0054,-0.0191,0.006,0.004,0.0041,0.0384,0.0039,0.0117,-0.0098,0.0154,0.022,0.0073,-0.007,-0.0153,-0.0077,-0.0171,0.0109,0.006,-0.008,-0.0318,-0.0027,0.0271,-0.0053,0.0144,0.0085,0.0085,0.0016,0.0026,-0.0026,-0.0121,0.0085,-0.0175,-0.0177,-0.0212,-0.0314,-0.03,-0.0123,-0.023,0.0097,0.0138,-0.0189,0.0099,-0.0056,-0.0042,0.0167,-0.0454,0.01,0.0171,0.0304,-0.0257,0.0056,-0.0156,0.0007,0.0187,0.0211,-0.0129,-0.0035,0.0067,-0.0207,-0.0015,-0.0041,-0.032,0.0208,-0.0125,0.0011,-0.0066,-0.006,-0.0085,0.0317,-0.0112,-0.0119,-0.0018,-0.0063,-0.0091,0.0158,0.0051,-0.0214,-0.0206,-0.0268,0.0089,0.0041,0.029,-0.0196,-0.025,0.0163,-0.0089,-0.0202,-0.0091,-0.0322,0.0051,0.0106,0.0021,-0.0093,-0.0082,-0.0014,-0.0078,-0.0474,-0.0266,0.0155,-0.0744,0.0002,-0.0133,0.0114,-0.0041,0.0196,-0.01,-0.0088,0.02,0.0446,0.0251,0.064,-0.0202,-0.0453,-0.0214,-0.0096,0.0117,0.0021,-0.0127,-0.005,-0.0138,-0.0032,0.0062,0.0064,-0.0037,-0.0677,-0.0679,-0.0316,-0.0179,-0.0514,0.0038,0.0022,-0.001,0.0004,-0.0243,0.0107,0.0193,-0.0026,0.0071,-0.0191,-0.0139,0.0003,-0.0003,-0.0022,0.0053,-0.0053,-0.0051,0.0531,0.0057,-0.0251,-0.0256,0.0046,-0.025,-0.0348,-0.0319,-0.0255,-0.014,-0.0102,-0.0157,0.0046,-0.0076,-0.038,-0.027,-0.0024,0.0044,0.0293,0.0145,-0.0244,0.0074,-0.0453,-0.0182,0.0546,0.0117,0.0047,0.0364,-0.0223,-0.0285,0.0169,-0.0008,-0.0039,-0.0295,-0.0272,-0.0098,-0.0144,-0.0419,-0.0301,-0.0147,-0.0004,-0.0165,-0.0122,-0.0128,-0.0337,-0.0195,-0.0238,0.0325,-0.0114,0.0119,0.0206,0.0397,0.0099,-0.0138,-0.0135,-0.002,-0.0297,0.0063,0.022,-0.0282,-0.0272,0.0084,0.0105,-0.0248,-0.0186,-0.0321,0.001,-0.0131,0.0275,0.0016,-0.0112,0.0154,0.0115,-0.0313,0.037,0.0306,0.0161,0.0071,0.0227,0.0244,0.0103,0.0148,0.0126,-0.03,-0.0259,-0.0206,-0.0039,-0.0219,-0.0237,-0.0049,0.0033,0.0023,0.0182,-0.0055,-0.0196,0.0023,-0.0015,-0.0497,0.0127,0.0046,0.0229,0.0123,0.005,0.025,-0.0008,-0.009,0.0064,-0.0206,0.0261,-0.0086,0.0299,0.0196,0.0282,0.0012,0.0204,-0.0021,-0.0167,-0.0178,0.0112,0.0162,-0.0041,0.0076,-0.0037,0.0058,0.0157,-0.0193,-0.0243,-0.0104,-0.0153,-0.0035,-0.0183,-0.0182,0.0148,0.012,0.0001,0.0051,0.0089,0.005,0.0117,-0.0202,0.0063,0.005,0.0162,-0.0326,0.0117,0.002,-0.0177,0.0115,-0.0054,0.0208,-0.0145,0.0277,0.014,0.0314,0.0244,0.0217,-0.011,0.0009,-0.0232,-0.0324,0.0258,-0.0078,0.0119,-0.0106,0.0164,-0.0041,0.0149,-0.0109,0.0045,-0.0038,-0.0105,-0.0014,0.0066,-0.0003,0.0135,-0.0039,0.0058,0.0025,-0.0058,-0.0346,-0.0292,-0.0193,-0.019,-0.0119,0.0387,0.011,-0.0199,0.0304,-0.0237,-0.0219,0.0086,-0.0757,-0.0744,-0.0183,-0.053,-0.0325,-0.0198,-0.0031,-0.0347,-0.0161,-0.0187,-0.0153,0.0155,-0.0392,-0.0109,-0.0398,0.0321,-0.0148,-0.0259,-0.0093,-0.0158,0.0205,-0.0259,0.0195,-0.0009,-0.0307,-0.0138,-0.003,-0.0098,-0.0199,0.0038,-0.0177,-0.002,0.0208,0.0059,0.0132,-0.0136,-0.0257,0.0079,-0.0205,-0.0092,0.0135,0.0073,-0.0134,0.0018,-0.0104,-0.012,0.0058,-0.0024,-0.0144,-0.0294,0.0016,0.0197,-0.0089,0.0011,-0.0297,0.0117,-0.0174,0.002,-0.0108,-0.0099,-0.0103,0.0094,-0.0441,-0.0017,-0.0072,0.0087,0.0182,-0.0078,-0.0209,-0.0033,0.0053,0.0053,0.0104,0.0175,0.0141,0.0281,-0.024,0.0112,-0.0451,0.0042,0.0203,-0.0016,-0.0562,-0.0708,0.0307,0.0003,0.0552,0.0206,-0.0034,0.0109,-0.026,-0.0294,-0.0088,-0.0189,-0.0039,-0.0046,0.0201,-0.003,-0.0169,-0.0112,-0.0219,-0.0101,-0.008,0.0064,-0.0037,0.0007,0.0094,0.002,-0.0031,-0.0063,0.0237,0.0165,-0.0173,0.0279,-0.0284,-0.0181,-0.0166,-0.0261,0.0022,-0.0052,-0.0094,0.0126,-0.0182,-0.0098,0.0059,0.0118,-0.0191,-0.0035,0.0059,-0.0082,-0.0235,-0.0093,0.0072,-0.0068,0.0102,-0.0188,-0.0027,-0.0058,-0.0297,0.0078,0.0025,-0.0126,0.0414,-0.0014,0.0432,-0.011,-0.0012,0.0027,0.0057,0.0112,0.0173,-0.0231,-0.0089,0.0161,0.0081,0.012,0.0175,-0.0023,-0.0317,-0.0045,-0.0344,0.0095,0.0297,0.029,0.0302,-0.0072,-0.0127,-0.039,-0.0286,0.0198,-0.018,-0.0159,-0.0152,-0.0407,-0.0373,0.0047,0.0099,0.0503,0.0305,-0.0123,-0.0073,0.0142,0.011,0.0076,-0.0291,0.0257,0.0322,0.0027,-0.0419,-0.015,-0.0185,-0.0004,-0.0723,-0.0796,-0.0258,0.0527,0.0002,0.0034,0.0435,0.0455,0.0026,-0.0075,0.0232,-0.0078,-0.0114,0.0554,0.0125,-0.0038,0.0009,0.0053,0.0059,0.0205,-0.0178,0.0119,-0.038,-0.0298,0.0062,0.0148,0.0608,-0.0144,-0.0094,0.0034,-0.0136,0.0153,0.0187,0.0173,0.0006,-0.0206,-0.0146,-0.0131,0.0093,-0.0084,0.0341,0.0388,0.0021,-0.0445,-0.0029,-0.0044,-0.0118,-0.0116,-0.0099,-0.0034,0.0135,-0.0154,-0.0074,0.0129,-0.0222,-0.0017,-0.009,-0.0073,-0.0272,0.0095,0.0141,-0.0114,0.0379,0.0158,0.0008,-0.0133,-0.0166,-0.008,-0.0098,-0.0098,0.0005,0.0159,-0.0046,-0.0117,-0.021,-0.0145,-0.002,0.0155,-0.0066,0.019,0.0293,-0.0104,0.0013,-0.0055,-0.0092,-0.0423,0.0046,0.002,-0.0032,-0.0093,-0.0758,-0.0334,0.0044,-0.0021,-0.0119,0.0108,0.0203,-0.0376,-0.0026,-0.009,-0.0048,0.0039,-0.0007,0.0304,0.0168,0.0202,0.0701,0.0003,-0.0114,-0.0245,0.0075,-0.0183,0.0104,-0.0076,-0.0021,0.0109,0.019,-0.0056,0.0103,0.0117,-0.0035,-0.0279,0.0103,0.0051,-0.0208,-0.0196,-0.0409,-0.048,0.0058,-0.0053,0.0111,0.0364,0.0122,-0.0107,-0.0023,-0.0055,0.0168,-0.0017,-0.0015,-0.0112,-0.0179,-0.0168,0.043,0.0209,0.0416,0.0181,0.0087,0.0124,0.0051,0.0431,0.018,0.0652,0.0414,0.0116,0.017,0.0029,0.0083,0.0226,0.0355,0.0079,0.0283,-0.002,0.0063,0.0124,0.0014,0.0244,0.0396,-0.0112,0.0051,-0.0022,0.0308,0.0006,0.0231,-0.0017,0.0458,0.0302,0.0193,0.0042,-0.0034,-0.024,0.0261,0.0103,0.0102,-0.0336,-0.006,-0.0226,0.0069,0.0138,0.0079,0.0027,0.0026,-0.0018,0.0524,0.015,-0.0119,0.014,0.0234,-0.0331,-0.0129,0.0098,0.0046,-0.0533,-0.0062,-0.0148,-0.0004,0.0013,-0.0133,-0.0176,0.0017,0.003,0.0128,0.0019,0.0133,-0.0193,0.0537,0.0038,0.0013,-0.0044,-0.0094,0.0308,-0.0042,-0.0254,0.0123,0.0023,0.007,0.0114,-0.0191,-0.0432,0.0043,-0.0142,-0.0178,-0.0089,-0.0058,-0.0006,0.0062,-0.0052,0.0079,-0.0121,-0.0039,0.0012,0.0045,0.0161,-0.0017,-0.0081,-0.0051,0.0231,0.0134,-0.0159,0.0167,0.0164,-0.0046,-0.0115,0.0359,-0.0059,0.0078,-0.0178,0.0161,0.017,0.0233,0.0025,0.0185,0.03,-0.0095,-0.0041,0.0014,0.0204,-0.0163,0.0062,-0.0176,-0.0169,0.0308,0.0135,-0.0045,0.0382,0.0234,0.0152,0.0555,0.0024,0.0092,-0.0141,-0.0122,-0.0215,0.0057,0.0178,-0.0109,-0.0178,-0.0142,0.0259,0.0311,0.0044,0.006,0.0486,0.0384,0.0175,-0.0064,-0.0047,0.0044,0.0041,0.0278,-0.0906,0.0967,0.0577,0.056,0.0519,0.0819,0.0636,0.0429,0.0579,-0.0107,0.0251,-0.0196,-0.0163,-0.0003,0.0023,0.0199,0.0102,0.0123,0.0218,0.0095,0.0023,0.0336,0.0261,-0.0158,-0.0164,-0.0524,0.018,-0.0003,0.0044,-0.007,-0.0028,0.0573,0.0476,0.0294,0.0125,0.0424,-0.0048,-0.0058,0.0134,0.0263,-0.0074,0.0664,-0.0711,-0.0183,-0.0009,0.0023,0.0075,-0.002,-0.0311,-0.0389,-0.0201,0.0109,0.0118,-0.0244,-0.0244,0.0025,-0.0134,-0.0049,-0.0278,-0.0323,0.0112,0.0135,0.009,0.0003,-0.0159,0.0175,-0.0013,-0.0094,-0.0088,-0.0163,0.0144,-0.0013,-0.017,-0.0244,0.0121,-0.0206,-0.0332,-0.0854,-0.0864,0.037,-0.01,-0.023,-0.0225,-0.0124,-0.0116,-0.0073,-0.0136,0.0002,-0.0065,-0.0055,-0.0257,0.0049,-0.0428,0.0107,-0.0067,-0.0026,-0.0152,-0.0037,0.0228,-0.0102,-0.0,0.0289,0.023,0.0131,-0.0034,-0.009,-0.0375,-0.0367,-0.0216,-0.0074,0.0159,-0.0059,-0.0052,-0.0276,-0.0033,-0.0019,-0.0178,0.032,0.0322,-0.0097,-0.0263,0.0104,0.0166,0.0699,0.0524,0.0415,0.0705,-0.0401,-0.0001,-0.0125,-0.0517,-0.0078,-0.0185,-0.0294,0.0317,-0.0091,0.0238,0.0473,0.0167,0.0026,0.0236,-0.0056,-0.0054,-0.0132,0.008,0.0088,0.0323,-0.004,0.0222,-0.0047,0.0153,-0.0062,-0.0062,-0.0245,0.0097,-0.0055,0.0026,-0.0192,-0.0001,0.008,0.0022,-0.0225,-0.021,0.0046,0.0078,-0.0434,-0.0439,-0.0137,-0.0268,0.007,0.0004,-0.0141,-0.002,-0.0183,0.0056,0.0302,0.0246,0.0038,-0.0343,0.0178,0.0062,0.0032,0.0178,0.0105,0.012,-0.0268,0.0054,0.0031,0.0247,0.0089,-0.0071,-0.0232,-0.0071,0.0063,0.0118,0.0413,0.0067,-0.0151,-0.0282,-0.0142,-0.0174,-0.0147,0.0118,0.0157,-0.0259,0.0022,0.0069,-0.0294,0.0082,-0.0174,0.0203,0.0004,0.0039,-0.0209,-0.0215,0.0186,-0.0159,-0.004,0.0183,-0.0116,-0.0369,-0.0113,0.0461,0.0104,0.0307,-0.0038,0.0013,-0.0292,-0.0025,0.0243,-0.0101,-0.0131,0.0009,-0.0284,-0.0245,-0.0323,-0.019,-0.0196,-0.0258,-0.0096,0.0081,0.0298,-0.0078,0.0077,-0.0006,-0.0075,0.0078,-0.0211,0.0048,-0.009,-0.0122,0.0017,0.0027,0.0169,0.0106,-0.0022,-0.0014,-0.0088,0.019,-0.0039,0.0059,0.0224,-0.0132,-0.0162,0.0061,-0.0114,0.0121,-0.0137,0.016,0.0022,-0.0152,0.0324,0.0154,-0.0295,-0.0167,-0.0242,0.0052,0.0052,-0.0251,-0.018,0.0088,-0.013,-0.0188,-0.0134,0.0108,0.0012,-0.0006,0.0191,-0.0049,-0.016,-0.0133,0.0215,-0.0012,0.0215,0.0174,0.0089,0.0043,0.0168,0.0142,0.0706,-0.0021,0.0162,0.0245,-0.0413,-0.0159,-0.0105,-0.0134,-0.0111,-0.0192,-0.0069,-0.013,-0.0141,-0.0216,-0.0018,0.0082,0.0157,0.0027,-0.0159,-0.0076,-0.0324,0.0007,0.023,0.0111,0.0103,-0.0212,-0.02,-0.0214,0.0521,0.0203,-0.0089,0.021,-0.026,0.0135,0.0015,-0.0044,-0.0095,-0.0109,0.0141,-0.0087,0.0214,0.0131,-0.0052,0.0042,0.0186,0.0084,0.0128,0.0013,0.1087,-0.0114,0.0051,-0.0221,0.0253,0.005,0.0083,0.0179,0.0179,-0.0181,-0.0096,-0.0013,-0.0331,-0.0146,0.0049,-0.0091,-0.044,-0.044,0.0039,-0.0003,-0.011,-0.0309,0.0168,0.0009,0.0122,0.0233,0.0056,0.0237,0.0068,0.0016,0.0055,0.0399,0.0133,0.0102,-0.0063,0.0332,0.0333,-0.0661,-0.0291,-0.0092,0.0105,-0.0161,-0.0089,0.0005,0.0203,-0.0003,0.039,0.0037,0.0092,0.0292,0.0085,0.0341,-0.0034,-0.0467,0.0247,-0.0316,0.0128,0.0075,0.0316,0.0267,0.0161,0.0151,0.0289,-0.0052,-0.0167,0.0102,-0.0105,-0.0138,0.0175,0.0194,0.0384,0.0222,0.0146,-0.0257,-0.0245,-0.0133,-0.0212,0.0511,-0.0134,-0.0103,-0.025,-0.0081,0.0018,0.004,-0.0102,0.0114,0.0062,-0.0043,0.0063,-0.0201,-0.031,0.029,0.0248,0.0048,0.0055,-0.0168,-0.0431,0.0025,-0.0177,-0.0251,0.0118,0.0124,0.0271,0.042,-0.0061,0.0022,0.0131,0.0337,0.0305,0.0149,-0.0003,0.0104,-0.0102,0.0306,0.0103,-0.0224,-0.0021,0.012,-0.0117,-0.0311,0.0058,0.011,0.0186,0.0289,0.0074,0.0261,0.0214,0.019,0.0266,0.0122,-0.0036,0.0177,0.0239,0.0082,-0.0158,0.003,0.0471,-0.0293,-0.0177,0.0009,-0.009,-0.0103,0.0087,0.0242,-0.0137,0.003,-0.0049,-0.0156,-0.0066,-0.015,-0.0112,0.0241,0.0084,-0.0127,-0.0088,0.0321,-0.0004,-0.0087,-0.0021,-0.013,-0.0057,0.0005,0.0062,0.0081,0.0217,0.0005,0.0389,0.0158,-0.017,-0.0186,0.0011,-0.0084,-0.0044,0.0083,-0.0018,0.0322,-0.0157,0.0528,0.0644,0.0081,-0.0008,-0.0262,0.0011,-0.0016,0.009,0.0139,0.0042,-0.0086,-0.0247,-0.002,0.019,-0.019,-0.0416,-0.0074,0.0068,-0.0365,-0.0134,-0.0539,0.0379,0.0118,-0.0028,-0.0164,-0.0072,0.0003,-0.0042,-0.0162,0.013,0.0262,-0.0246,-0.0464,-0.0101,-0.0069,-0.0387,-0.0026,-0.0113,-0.0147,0.0389,-0.0338,-0.0236,0.0215,-0.0093,-0.0075,-0.028,-0.0261,-0.0267,-0.003,0.0017,-0.0059,-0.0146,0.0032,-0.0173,-0.0062,-0.0199,-0.0065,-0.0055,-0.0063,-0.0029,0.0057,-0.0069,0.0041,-0.0286,-0.0099,0.0411,-0.0063,-0.0146,0.028,0.01,-0.0052,-0.0022,0.0027,-0.0248,-0.0274,-0.04,-0.0165,-0.0138,-0.0243,0.0201,0.0012,-0.0104,0.0835,0.0707,0.0295,-0.0031,0.0161,-0.0541,-0.026,-0.0217,-0.0095,0.0029,0.0035,-0.0147,-0.0224,-0.0013,-0.0475,-0.0255,0.0295,0.0333,0.0108,-0.0075,-0.0005,0.0025,-0.0535,0.0039,0.0148,0.0007,-0.033,0.0127,-0.019,-0.0318,0.0019,-0.0063,-0.0093,0.0029,0.005,-0.0234,0.0133,0.001,-0.0046,-0.0062,-0.0152,0.0029,0.0054,-0.0041,0.0275,-0.0222,0.0295,0.005,-0.0087,-0.0084,-0.0179,-0.0024,0.0193,0.0031,-0.0218,-0.0142,-0.0038,-0.0029,0.0259,-0.0167,0.0063,0.0007,-0.0094,-0.0225,-0.0253,-0.0195,-0.0021,0.0112,-0.0328,-0.0055,0.0122,-0.0273,-0.0108,-0.0014,-0.0028,0.0036,0.0146,-0.0186,0.0092,-0.0215,0.003,-0.0182,-0.0244,-0.0115,0.0003,0.0001,0.0153,0.0156,-0.0109,-0.0136,0.0222,-0.0164,0.0026,0.0101,0.0345,0.016,-0.0157,-0.0308,-0.0284,0.0116,0.0114,-0.0149,0.0259,-0.0012,0.006,-0.0169,0.0045,0.001,-0.0168,-0.0092,-0.0085,0.0048,-0.004,0.0099,-0.0072,-0.0092,-0.0145,-0.012,-0.0044,0.0031,0.0071,-0.0294,-0.0043,-0.0017,0.0139,0.0334,-0.0143,-0.0207,-0.0307,-0.0135,-0.0382,-0.0077,-0.02,-0.0337,-0.0281,-0.0023,-0.0124,-0.0012,-0.0291,-0.0409,-0.0273,-0.0245,0.0315,-0.0041,-0.0527,0.0003,0.0073,0.0082,-0.0049,-0.0092,0.0099,-0.0165,-0.036,0.0037,0.0138,0.0206,-0.0315,-0.014,-0.0091,-0.0239,0.0144,0.0181,-0.0051,0.0562,0.0171,0.0439,0.0173,0.0244,0.0037,0.0023,0.0044,-0.0062,-0.0116,0.0062,0.0356,-0.041,0.004,0.0201,0.0167,-0.0155,-0.0048,0.0219,-0.0174,-0.0324,-0.0183,0.0206,-0.0174,-0.0279,0.0014,-0.0086,-0.0114,0.009,-0.0161,-0.0191,-0.0077,0.0021,-0.0148,0.0013,0.0068,-0.0143,-0.0278,-0.014,-0.0251,0.0012,0.0273,0.0062,0.004,0.02,0.0696,0.0532,0.0508,0.0411,-0.0348,0.0003,-0.0012,0.0018,-0.0154,0.0141,0.0073,-0.0269,0.0101,-0.0461,-0.0279,-0.0192,-0.0407,0.0013,-0.0175,-0.021,0.0073,-0.0067,-0.0337,0.0227,0.0275,-0.0052,-0.0361,-0.0237,-0.0005,-0.005,-0.003,0.0057,-0.0202,0.032,0.0343,-0.0099,-0.016,0.0396,0.0338,0.0055,-0.0006,0.0086,0.0282,-0.0342,-0.0309,-0.0306,-0.0253,0.0701,0.066,0.0584,0.0327,-0.0096,0.0355,0.0595,0.0716,0.0341,0.0275,-0.0133,-0.0126,0.0069,-0.0036,0.0134,0.0179,-0.0031,0.0128,-0.0113,-0.0338,-0.032,0.0104,0.0155,-0.0049,0.0101,0.041,-0.0034,-0.001,-0.0115,-0.0183,-0.0275,-0.0031,0.0305,-0.0065,0.0055,-0.0174,0.0261,0.0064,-0.003,-0.0003,0.0034,-0.0233,-0.0198,0.0023,0.0142,-0.0004,0.0194,0.0058,0.0267,0.0168,-0.026,-0.0327,-0.0229,-0.035,0.02,0.0146,-0.0081,-0.0138,-0.0168,-0.0142,-0.0265,-0.0254,0.0085,0.0098,-0.0269,-0.0169,-0.0071,-0.0172,0.012,0.0031,-0.0062,-0.0057,0.0217,0.0049,0.0024,0.0044,-0.0054,0.0085,0.002,0.0047,-0.0261,-0.011,-0.0304,-0.0238,0.0056,-0.0084,-0.0224,0.0033,0.0079,0.0106,-0.0372,0.0033,-0.0146,-0.0007,0.0004,0.0255,-0.009,0.007,-0.0181,-0.0017,-0.0046,-0.0037,-0.0162,-0.0183,-0.0143,0.0004,0.011,-0.0189,-0.0185,0.0238,0.0024,0.0187,-0.0046,0.0121,0.0295,0.0286,-0.0034,-0.0267,-0.0344,-0.0238,-0.0273,0.0055,-0.0154,0.0046,-0.0224,0.0122,0.0013,-0.0205,0.001,0.0211,0.0114,0.0037,0.0099,0.0341,0.0013,0.0453,0.0498,-0.021,-0.0255,-0.0008,-0.0313,-0.0112,-0.0175,-0.0048,-0.0036,0.0025,0.0099,0.0142,-0.0248,0.0261,0.0123,-0.0144,-0.0136,-0.0117,-0.0224,-0.0075,-0.0231,0.0087,-0.0227,-0.0261,0.0074,-0.0046,0.0006,-0.0089,-0.0096,0.0174,-0.005,-0.0247,0.0358,0.0546,0.0179,-0.0082,-0.0124,-0.0005,-0.0013,0.0129,0.0094,-0.0029,-0.0111,-0.0078,-0.0237,-0.0082,-0.0214,0.0155,0.0209,0.0111,0.0148,0.0036,0.0073,0.0032,0.0119,0.0049,0.0161,-0.0188,-0.0234,-0.0121,-0.0286,0.0044,-0.0423,0.0128,0.0284,-0.0072,-0.0049,-0.0215,-0.0214,0.0027,-0.0217,-0.0104,-0.0162,-0.0162,-0.0204,-0.0424,-0.0021,-0.023,0.005,-0.0224,-0.0268,-0.0153,0.0145,-0.0327,0.0117,-0.0018,-0.0079,0.0233,-0.0087,0.0369,0.0279,0.0135,-0.0132,0.0073,0.0235,0.0089,-0.0128,-0.0206,-0.0399,-0.0356,-0.0216,0.0146,0.0146,-0.0211,-0.017,-0.0242,-0.0047,0.0009,-0.0203,0.0077,-0.0002,0.019,0.0022,-0.0071,-0.0002,0.0043,0.0168,0.0054,-0.0011,0.0269,0.0286,-0.0049,0.0046,-0.0089,-0.0204,-0.0075,-0.0254,0.0134,-0.0174,-0.0153,-0.0172,-0.0025,0.0253,0.0019,0.0284,0.0124,0.0581,0.0284,-0.0027,-0.0182,-0.0297,-0.0242,0.0001,0.0166,-0.0153,0.0316,0.0158,-0.0039,0.0093,-0.0155,0.0039,-0.0356,-0.0042,-0.0249,-0.0086,-0.0093,0.0008,-0.0067,0.008,-0.0066,0.0147,-0.0102,0.0088,0.0225,-0.0343,0.0034,-0.0041,-0.0093,-0.0077,0.0046,0.0013,0.0007,-0.0019,0.0111,0.0101,0.0178,-0.0079,0.0124,0.0192,0.0003,0.0145,-0.0229,-0.0089,0.0092,-0.0231,-0.018,-0.0139,0.0036,-0.0012,0.0011,0.0408,-0.0059,0.023,-0.0177,0.0136,-0.0037,-0.0214,-0.0176,0.0036,0.0125,0.0158,-0.0119,-0.0226,-0.0163,0.0056,0.0106,-0.0039,0.0092,0.0143,0.0181,-0.0183,0.0118,0.0283,0.0085,0.007,-0.0049,-0.0051,-0.012,0.0002,0.0036,0.0054,-0.0044,-0.0268,0.0095,-0.0301,-0.014,0.0064,-0.0075,0.0093,0.0111,-0.0216,-0.0155,-0.0204,0.0096,0.0251,0.0067,-0.0125,0.0224,-0.0183,0.0257,-0.0333,-0.0143,-0.0147,-0.027,0.0223,-0.0447,-0.0016,-0.0281,-0.0185,0.0102,0.004,0.0142,-0.0229,0.0358,0.0275,0.0312,0.035,0.0159,-0.0174,-0.005,-0.0149,-0.0015,-0.0144,0.0024,0.0131,0.0059,-0.0008,-0.0181,-0.0073,0.0194,-0.0078,0.0026,0.0307,0.0064,0.0278,0.0056,0.0134,-0.0023,-0.0028,-0.0156,-0.0084,-0.0103,0.0129,-0.0098,-0.0021,-0.0098,-0.0284,-0.0171,0.0066,-0.0155,0.0011,0.0071,0.0187,-0.0048,0.0135,0.0073,0.0338,0.0073,0.0048,-0.0174,-0.0023,-0.0198,-0.0144,0.0009,0.0018,-0.0126,0.0056,-0.0053,-0.0147,-0.0449,-0.0144,0.0109,-0.0278,0.0083,0.0057,0.0025,-0.0195,-0.0324,-0.0077,-0.0073,0.015,0.0173,-0.0144,-0.0001,-0.0435,0.0193,0.0155,-0.0112,0.0177,-0.0012,0.0072,0.036,0.0048,-0.0157,-0.0198,-0.0075,-0.0111,-0.0174,0.0158,-0.0119,0.0123,-0.0167,0.0146,-0.0382,0.0069,0.0142,-0.0241,0.0168,-0.0032,0.0055,0.0002,-0.0131,0.0122,0.0055,-0.0025,0.0259,0.0247,0.0102,0.0024,0.0226,0.0226,-0.0251,0.0027,-0.0179,0.0032,-0.0072,-0.0229,-0.0007,0.0259,0.0071,0.0148,0.0131,0.0129,-0.0009,-0.0083,0.016,0.0018,0.0125,0.0351,0.0217,0.0508,0.0204,0.0307,0.0063,-0.0062,0.0329,0.0137,0.0508,0.0285,0.0287,-0.0249,-0.0166,-0.0418,-0.0397,-0.0171,0.0144,-0.0041,0.0082,-0.0018,0.0065,0.0117,0.0065,0.0069,0.002,-0.0002,0.0065,0.003,0.0015,0.0004,-0.01,-0.0135,-0.0171,-0.0152,-0.0427,0.019,0.0004,-0.0327,-0.0272,0.0212,-0.0248,-0.0041,-0.0033,-0.0021,-0.0374,-0.0337,0.0204,-0.0249,0.0091,-0.0202,-0.0053,-0.0095,0.0017,-0.0162,0.0056,0.0028,0.0151,0.027,0.0292,0.0533,0.0054,-0.028,-0.0051,-0.0206,0.0076,-0.02,0.0144,0.043,0.0038,-0.0103,0.0099,-0.0222,0.0005,0.0406,0.0006,-0.0067,-0.0477,-0.024,-0.0255,0.0518,-0.0033,-0.0066,0.0076,0.0155,0.0039,-0.03,-0.025,-0.0451,-0.0167,-0.0123,-0.0223,0.0012,-0.0158,0.0259,0.0089,-0.0305,-0.0214,0.0677,-0.0095,0.0388,0.0441,-0.0208,-0.0127,-0.0097,0.0107,0.0068,0.0214,-0.0158,0.0018,0.0008,-0.0178,-0.0043,0.02,0.052,0.0218,-0.0364,-0.0284,0.0076,-0.0027,0.0489,-0.0362,0.0049,0.0145,0.0056,0.0128,-0.0077,0.0233,0.0392,0.0085,-0.0444,-0.0206,-0.0327,-0.0214,-0.0009,0.0272,0.0021,-0.0012,-0.0134,0.0248,0.0271,0.0129,-0.0124,0.0105,-0.0059,0.0081,-0.0137,-0.0095,-0.0144,0.0118,-0.0138,0.0562,0.0122,0.0283,-0.0279,0.0007,-0.0244,-0.0152,0.0214,0.0015,0.0348,0.0329,0.0217,-0.0103,0.0146,-0.0072,-0.008,-0.0102,-0.0334,0.0057,0.004,0.0334,-0.0024,-0.0122,-0.0086,0.0349,-0.0089,0.0202,0.0146,-0.0122,-0.0088,-0.0251,0.0092,-0.0086,0.0031,0.0106,0.0129,0.0107,-0.0,0.0136,-0.0348,-0.0189,-0.0014,0.0188,-0.0069,0.0269,0.0022,0.0022,0.0059,0.0103,-0.0103,-0.0029,0.026,-0.0083,0.0121,0.0259,-0.016,-0.0124,-0.0151,-0.0355,0.0082,-0.0143,0.0083,0.0032,0.0255,0.0157,0.0021,0.0089,-0.0061,-0.0229,-0.0273,0.0191,-0.0186,-0.019,-0.011,0.0261,0.0124,0.0082,-0.0099,0.025,0.033,-0.015,0.0022,0.0051,0.0229,0.0158,-0.0413,0.0284,-0.0084,0.0126,0.0356,0.0242,-0.0051,0.0411,0.0238,0.001,0.015,0.0182,0.0084,-0.0051,0.0023,-0.0084,-0.0018,-0.0019,-0.0097,-0.0015,-0.0016,-0.0038,-0.009,-0.0409,-0.0215,-0.0042,-0.0041,0.0318,0.0403,0.0112,-0.0059,-0.012,-0.0249,-0.0416,-0.0134,-0.0112,-0.0065,-0.051,-0.003,-0.0264,-0.0007,-0.0051,-0.021,-0.0343,0.096,0.0226,0.0325,0.0103,-0.0032,0.0087,0.0197,-0.0296,0.0066,0.0037,-0.0169,0.0093,-0.0048,0.012,-0.0181,-0.0129,-0.0148,-0.0314,-0.0161,0.0185,-0.051,0.0384,0.0067,0.044,0.0012,-0.0083,-0.0209,0.0133,-0.0417,-0.0164,-0.013,-0.0274,0.0006,0.0175,-0.0188,0.0005,-0.0146,-0.0196,-0.0415,-0.0125,0.0001,0.0158,-0.0013,0.0168,0.0144,-0.0303,-0.0169,0.0253,-0.004,-0.0007,-0.0041,-0.0113,0.0095,0.0043,0.0096,0.0205,-0.0128,-0.0151,0.0089,0.0108,-0.0101,-0.0028,0.0349,0.0305,0.004,0.014,-0.0114,0.0062,0.0063,0.0405,0.0137,0.0009,0.0145,-0.0021,-0.0087,-0.023,0.0106,-0.0105,-0.0082,0.0168,-0.0327,-0.0282,0.0112,0.0233,0.0092,-0.0091,-0.0069,-0.0181,-0.0131,-0.0067,-0.0142,0.0005,-0.0136,0.0068,0.0186,-0.0178,-0.0095,0.0006,-0.0014,-0.0202,-0.0224,0.0007,-0.0066,0.0479,-0.0133,-0.0316,-0.0166,-0.0173,-0.0072,-0.0084,-0.0201,-0.024,0.027,0.0223,-0.0022,0.0006,0.0024,-0.0254,-0.0007,-0.0033,-0.0245,0.0142,0.0488,0.0062,0.0126,0.0273,0.0164,-0.0056,0.0178,-0.0105,-0.0054,-0.0089,-0.0279,-0.0328,0.0184,0.0327,0.0063,0.0337,-0.003,0.0061,0.0062,-0.0112,0.0247,0.0177,-0.0013,0.0097,0.0376,0.0094,-0.0203,0.0057,-0.0045,0.0183,0.0255,-0.0175,-0.0035,-0.0822,-0.0669,0.0049,0.0257,0.0217,-0.0224,-0.0238,0.0026,-0.0011,-0.0059,-0.0286,-0.0175,-0.0073,-0.005,-0.0001,0.0051,-0.0091,0.015,-0.0246,0.0015,-0.0055,-0.0065,-0.0044,-0.0219,0.0285,0.0534,-0.0332,-0.026,0.0188,0.0206,0.0124,-0.0169,-0.003,0.0011,-0.0219,-0.0241,-0.0347,0.0139,-0.0233,-0.0224,-0.009,0.0047,-0.0058,0.0038,0.0224,-0.012,-0.0265,0.0159,0.034,0.0299,0.0177,-0.0657,-0.0308,-0.0499,-0.016,-0.0338,-0.0091,-0.0348,0.0008,-0.0117,-0.0329,-0.026,-0.0252,-0.0025,0.0463,0.0122,0.0271,-0.015,-0.0226,-0.011,-0.0236,-0.0082,-0.0275,-0.008,-0.0171,-0.0048,0.0161,0.0375,0.0057,-0.0072,0.0299,-0.0059,0.0249,0.026,0.01,-0.0076,-0.0319,0.0166,-0.0055,-0.007,-0.0014,0.0015,0.007,0.0275,-0.0186,-0.0175,-0.0096,-0.0317,-0.0163,0.0004,0.024,0.025,-0.01,0.0149,0.019,0.0137,0.0284,0.008,0.0152,-0.0082,0.006,-0.0035,0.0098,0.0154,-0.0121,-0.003,-0.0086,-0.0046,0.0083,-0.0072,0.0093,-0.0005,0.0436,-0.0187,0.0042,-0.0024,-0.0385,0.0083,-0.023,0.0395,0.0051,0.0157,0.0011,-0.0093,-0.0399,-0.0241,-0.0015,-0.0493,0.0019,0.0046,0.0096,-0.0133,-0.0062,-0.0144,-0.0075,0.0291,-0.0165,-0.0226,0.0206,-0.0206,0.0449,0.006,0.0134,0.0162,-0.0088,-0.0088,0.0012,-0.0023,0.0022,0.0387,0.0084,0.0001,-0.0027,0.0002,-0.0208,-0.0297,-0.0398,-0.035,0.0007,-0.0457,-0.0026,-0.0124,-0.0497,0.0366,0.0537,0.0383,0.0377,0.0511,0.0517,-0.0119,0.0183,0.0387,0.0632,0.02,0.0252,0.0361,0.0199,0.0517,0.0214,-0.0106,0.0233,0.0281,0.0116,0.0584,0.0353,-0.0149,0.0305,0.0131,0.0303,0.0193,0.0127,0.0004,-0.0095,-0.0086,0.0131,-0.016,0.0038,-0.0298,-0.0229,-0.0341,-0.015,-0.0043,-0.0272,0.0008,-0.0501,-0.0155,0.0333,0.0017,0.0401,-0.019,-0.0205,-0.002,-0.0087,-0.0223,-0.0141,-0.0152,-0.0254,-0.0117,-0.0577,-0.0663,-0.0005,-0.0078,-0.0172,0.0043,0.0025,-0.0551,-0.0275,0.002,-0.0108,0.0213,0.0323,0.0066,-0.0022,0.0234,-0.0101,-0.0187,-0.0172,-0.0052,-0.0365,0.0167,0.0117,0.0084,-0.0061,-0.0176,0.0142,-0.0277,-0.0183,-0.0096,-0.0152,-0.0323,-0.0336,auditory tone detection
trm_4a3fd79d0ab65,0.1259,0.1093,0.1309,0.12,0.0048,0.0468,0.0938,0.1286,0.0586,0.1058,-0.0203,-0.0256,0.1294,0.0459,0.1193,0.0858,0.0758,0.0277,0.0918,-0.0746,0.0354,-0.0398,0.0449,-0.0812,0.0232,-0.0016,0.0017,0.0654,0.1111,0.0639,0.0776,0.009,0.0864,0.1302,0.0521,0.08,0.1216,0.095,0.133,0.0225,0.0901,0.1215,0.0684,-0.0904,0.0716,0.0272,-0.167,0.1016,-0.0067,0.0937,0.062,0.0377,-0.0227,0.0098,-0.0146,0.0569,0.1302,0.0275,-0.0096,0.032,0.0021,0.0009,0.086,-0.05,-0.0341,0.0668,0.1314,0.1354,0.0813,-0.0037,-0.0351,0.0072,-0.1588,0.0243,0.187,-0.1244,0.1319,-0.0261,-0.0464,0.0518,-0.0444,-0.0875,0.0306,0.0756,-0.0468,-0.0369,0.0296,0.0216,-0.0554,0.2074,0.0707,0.1118,-0.0186,0.0108,-0.0384,-0.0436,-0.0384,0.0472,-0.0309,0.0875,-0.0682,-0.0215,-0.0234,0.1331,-0.0057,0.1189,0.0503,-0.1625,0.0631,0.0275,-0.0158,0.0593,-0.1012,-0.0639,-0.054,-0.0768,0.0533,0.0461,0.0136,0.0702,0.0161,0.1029,0.0167,-0.0246,0.058,0.0215,-0.0004,-0.0175,-0.054,-0.0032,-0.0527,0.0664,0.0303,0.1581,-0.053,0.0921,0.0463,0.0499,-0.002,0.0563,0.0753,0.1031,-0.0894,-0.0402,0.0009,-0.0206,0.1419,-0.0425,0.0851,-0.102,0.05,0.0171,0.0845,0.049,-0.1578,0.0586,-0.0555,0.0149,-0.0572,0.0083,0.0337,0.0186,0.0985,0.1715,0.0197,-0.0198,-0.0036,0.0373,0.0301,-0.0675,0.0333,0.0345,-0.0236,0.0202,0.0801,0.0605,0.0469,0.0126,-0.007,0.0607,0.0817,-0.0697,0.041,0.0213,0.0917,0.0321,0.0816,-0.0608,-0.0687,-0.0178,-0.0229,0.0465,0.0091,0.0529,0.037,0.2533,0.2219,-0.0475,-0.0721,0.2869,0.1589,-0.0474,0.021,0.1026,-0.0274,0.0551,-0.0864,0.0587,0.1059,0.0079,0.0696,0.0072,-0.0249,-0.0122,-0.0867,-0.0618,-0.099,0.1563,0.304,-0.0036,-0.0832,0.0702,0.0773,0.0522,-0.0346,-0.0376,0.0467,-0.0996,-0.0317,-0.1865,0.1695,0.1076,-0.1154,0.1587,0.1612,0.0274,-0.0295,-0.1159,-0.0025,0.041,0.0715,0.1459,0.1097,0.0331,0.0624,0.0532,-0.0275,0.0877,0.102,-0.0375,-0.0665,-0.002,-0.0505,-0.0702,0.0117,0.047,0.0391,0.1154,-0.1278,-0.2295,-0.0534,-0.1486,0.0797,-0.0684,-0.1093,-0.2124,-0.075,0.0016,-0.0835,-0.0519,0.0723,0.1019,0.0198,-0.0493,0.1117,-0.055,0.1668,0.1465,0.1878,0.0319,-0.0275,-0.0386,-0.0415,-0.0182,-0.0406,0.0992,-0.0668,-0.1085,0.2039,0.082,0.0553,0.0858,0.049,-0.0033,0.1009,0.0297,-0.0746,-0.0673,0.0272,-0.0745,-0.065,0.0204,0.1302,0.0013,0.2029,0.2008,0.1146,0.0468,0.0986,-0.0448,0.0235,0.0065,0.1398,-0.0962,-0.0464,0.07,-0.1131,-0.0018,-0.0723,0.0816,-0.0173,-0.0458,0.0383,0.0253,0.0949,0.0496,-0.0302,0.0194,0.1047,0.1076,-0.0219,0.0904,-0.0515,-0.0345,-0.0863,-0.0129,-0.085,-0.0731,-0.0948,0.0134,0.013,-0.0537,0.1091,0.1052,-0.0667,-0.004,0.2349,0.1877,0.1678,0.0938,0.14,0.0051,0.1754,0.0872,0.0663,0.1444,0.0639,0.0509,0.1767,0.0921,0.0025,0.0115,0.0479,0.0735,0.0689,-0.0052,0.1613,-0.1144,-0.0758,0.1016,-0.0599,-0.0648,0.0162,-0.053,0.0482,0.0506,0.0206,-0.0813,-0.2483,-0.1058,-0.253,0.114,0.0773,-0.0022,-0.0355,-0.0473,0.0276,0.0254,-0.0242,0.0537,0.1144,0.0223,0.2023,0.0007,0.0439,0.1772,0.2332,0.1619,0.1324,0.0277,0.0209,-0.0452,-0.0013,0.0042,-0.0245,-0.057,-0.0963,-0.0088,0.076,0.0484,0.0856,0.0722,-0.001,-0.244,0.0178,-0.062,-0.248,-0.0221,0.0335,0.0434,0.0182,0.2674,0.2083,0.3163,0.2802,0.1835,0.1536,0.1512,0.1275,0.2267,-0.0073,-0.0528,-0.0071,0.0475,-0.0833,-0.0986,0.0623,-0.0043,0.2336,0.1441,-0.0647,-0.0066,0.0691,-0.0666,0.0071,0.0852,-0.0267,-0.0221,-0.0313,-0.0094,0.0038,-0.037,0.0891,0.0607,0.0443,0.0172,-0.0632,0.0565,-0.0011,-0.0005,-0.0314,0.0947,0.0052,-0.1049,0.0261,0.0824,-0.0153,-0.3159,0.0898,0.0744,0.0408,0.0063,0.0473,-0.0263,-0.0318,0.0478,0.0485,0.0363,0.0093,0.0655,0.0575,0.08,0.0759,-0.0083,-0.0707,-0.1031,0.0253,0.0743,0.0048,0.0777,-0.0844,-0.0308,0.0505,0.0699,-0.0896,-0.1025,-0.0359,0.0863,-0.0705,0.0584,0.0423,-0.0713,0.053,0.1103,0.1054,0.065,-0.1123,-0.1337,0.0313,-0.048,0.1424,0.0535,-0.0469,0.0006,-0.0731,-0.0404,0.1092,0.1234,0.0316,0.1062,0.0544,0.0749,-0.1167,-0.0055,-0.1369,-0.0853,-0.0953,-0.0552,-0.0125,-0.0183,0.0948,0.0526,0.1229,0.1542,-0.0252,-0.0074,0.0867,0.1176,0.0214,0.0504,-0.0128,-0.0363,0.0114,0.0534,0.0542,0.0388,-0.012,-0.0584,-0.0294,0.0102,-0.0204,-0.0296,0.0218,0.1577,0.0386,0.0404,-0.0767,-0.0323,-0.1116,0.0661,-0.0274,-0.0674,-0.0189,0.002,-0.0022,-0.043,-0.1193,-0.1493,-0.0246,-0.0214,0.0173,-0.0985,0.1252,0.0004,0.2158,0.2455,-0.008,0.0145,-0.0725,-0.0769,-0.0147,0.0857,-0.0026,0.0454,-0.0264,-0.0422,0.1356,-0.0558,0.0094,-0.0083,0.0523,0.0566,-0.0278,-0.0798,0.1404,0.1143,0.1415,0.004,-0.0826,0.0098,-0.0792,-0.0699,-0.0368,-0.0426,0.0015,0.184,-0.0353,0.104,0.1016,-0.0654,0.1349,0.0734,-0.0807,0.0204,0.1993,0.0111,0.0497,-0.0587,-0.0512,0.1256,0.0984,0.1662,-0.0157,-0.0439,0.0428,0.023,0.1532,0.06,0.1748,0.0058,0.0038,0.0964,0.0098,0.0313,0.043,0.1067,-0.0242,0.1171,0.0241,0.0974,0.1547,0.0019,0.0738,0.1833,0.0681,0.0166,0.0467,0.0401,-0.0132,0.0499,-0.0031,0.0492,-0.0604,-0.001,-0.0101,0.1094,0.1464,0.1485,0.047,0.0894,0.0362,0.1575,-0.1268,0.1523,0.0748,-0.0439,0.2474,0.0369,0.2126,0.0929,0.1096,0.0207,0.0743,0.0814,0.056,0.0716,-0.0651,0.0323,-0.0773,0.0217,-0.0418,-0.0095,-0.1044,-0.009,-0.0683,0.0868,0.0974,-0.0814,-0.0006,0.0669,0.0003,-0.1117,-0.0565,-0.1082,-0.0643,-0.1102,-0.0499,0.0229,0.0806,0.046,0.001,-0.0231,-0.012,0.0133,0.0059,0.0653,0.0959,0.0844,0.1063,-0.0629,-0.1259,-0.0884,-0.0028,-0.1044,-0.1126,-0.0593,0.0186,-0.0754,0.0403,-0.0311,-0.0811,0.0399,0.1168,0.1339,0.0361,-0.0035,0.0161,0.0766,-0.0668,0.1482,-0.0782,0.0075,0.1119,-0.0138,-0.0348,0.0139,0.2238,-0.0953,-0.0716,-0.1765,0.0,-0.0217,0.1162,0.0143,-0.087,0.0343,-0.1337,-0.0417,-0.0086,-0.0316,0.0125,-0.0427,0.0648,0.0645,0.0593,0.0461,-0.0651,-0.2494,-0.0546,0.184,-0.0571,0.095,-0.0399,-0.0626,0.0049,0.0205,-0.0184,0.0705,0.1078,-0.0728,-0.0396,-0.097,0.0897,0.0621,0.0121,0.0603,-0.0575,0.0156,0.0564,-0.0373,0.0382,0.0501,0.0226,-0.0478,-0.1066,-0.0352,0.0017,0.0388,0.0426,-0.131,0.0809,0.061,-0.0885,0.0009,-0.0148,0.046,-0.0766,-0.0071,-0.0848,0.0507,0.0649,-0.0811,-0.1897,-0.1824,-0.0267,-0.0286,-0.0642,0.0345,0.007,-0.0892,0.042,0.0411,-0.0991,-0.1201,-0.0492,-0.0046,-0.1002,-0.1424,0.1603,-0.0226,-0.1107,0.1079,0.038,0.0673,0.0818,-0.0838,0.1052,0.0435,0.0647,0.0386,0.0758,-0.0722,0.0116,-0.1229,0.0472,0.0665,-0.014,0.0407,-0.0433,-0.0891,-0.0671,-0.1402,-0.0401,-0.0692,0.0235,-0.014,-0.0647,-0.0818,0.0483,-0.0507,-0.0466,0.0289,0.0037,0.0532,0.0112,-0.0703,0.0422,0.1104,0.0426,0.0859,-0.0929,-0.148,-0.0521,-0.0576,0.0146,0.1271,0.0682,0.0467,0.0669,0.0855,-0.0365,0.0646,0.133,0.059,-0.0474,-0.0111,-0.054,0.001,0.0678,0.0268,0.0495,-0.1414,0.0654,0.0793,0.0642,-0.0607,0.0097,0.1104,0.0076,0.0508,-0.0329,0.0819,-0.0656,-0.036,-0.0518,-0.0598,0.1229,0.027,0.0011,-0.0743,0.0655,0.014,-0.1594,-0.0522,-0.0636,-0.3469,-0.0821,0.0173,0.0466,0.0371,0.0257,0.0426,-0.0261,-0.0599,-0.1119,0.002,-0.0224,0.1098,-0.0888,-0.1374,0.0426,0.0536,0.0505,0.0107,0.3463,0.1078,0.0779,0.0369,-0.0521,0.0792,0.0807,-0.1063,-0.0127,0.1172,0.0275,-0.0974,0.0093,-0.0259,0.042,0.0906,0.0951,0.0508,0.0514,0.0404,-0.0609,-0.0219,0.0003,0.0692,-0.0351,0.0442,-0.0616,0.0474,0.0847,0.0642,-0.0139,-0.0864,-0.0626,0.0257,-0.0387,0.0768,-0.0912,-0.0289,-0.1935,-0.2195,-0.1418,0.0188,0.0493,0.0422,0.0203,-0.1439,-0.0879,-0.0926,0.0582,-0.1293,-0.0434,-0.1289,-0.0009,0.0266,0.1024,-0.0784,0.0413,-0.084,0.0859,-0.0228,0.0158,-0.126,-0.1203,0.0198,-0.0373,0.0187,-0.0893,-0.1704,-0.1351,0.057,0.0135,0.0191,0.0604,0.0163,0.0018,0.0426,0.058,0.1101,0.0103,-0.1102,-0.1028,0.1235,0.1007,-0.0029,0.1016,-0.001,-0.1013,-0.0056,-0.0359,-0.1145,-0.1098,0.0121,-0.0618,-0.0707,0.0046,0.0072,-0.0023,-0.061,0.0546,0.1837,0.0144,-0.0574,0.0823,0.0066,0.0589,-0.0684,0.1396,0.0431,0.0725,0.09,-0.0169,-0.0621,-0.0221,0.0445,-0.0065,-0.0305,-0.0104,0.0138,0.0057,0.025,0.0208,0.0672,0.0654,0.0213,0.0337,0.0326,0.1255,0.0443,0.1436,0.0345,0.0698,-0.1131,0.0002,-0.028,0.0942,-0.1502,-0.1142,0.0102,-0.0313,-0.0705,-0.1351,0.0039,-0.0336,0.0586,0.0414,-0.0159,0.0603,0.0238,-0.0352,0.0381,-0.0629,-0.1192,0.0379,0.0089,0.0334,-0.053,0.1973,-0.0004,0.0119,0.0111,0.0988,0.0607,0.0065,-0.0804,0.0348,-0.0037,-0.3802,-0.2374,-0.1366,-0.0288,-0.0505,-0.0135,-0.1113,-0.1504,0.0397,-0.4013,-0.3577,-0.282,-0.209,-0.363,-0.1254,-0.0962,-0.1042,-0.0836,-0.1089,-0.0473,0.0082,-0.0342,0.0651,0.0074,-0.0184,-0.0808,-0.0261,-0.0106,0.0196,-0.1952,-0.1567,0.0014,-0.0051,0.0227,-0.0638,0.0124,-0.093,0.0076,0.0937,0.0115,-0.073,-0.0769,-0.1673,-0.1475,0.1892,0.103,0.1292,0.0688,0.0793,-0.3566,0.0935,-0.1014,-0.0771,-0.0093,-0.018,0.1428,0.1557,0.0893,0.1202,-0.1525,-0.0756,0.0208,-0.0276,-0.016,0.0901,0.0826,-0.0121,0.0014,0.0587,-0.0251,0.0909,0.0949,0.0553,0.0461,0.0465,0.0081,0.373,0.1664,-0.1971,-0.0322,-0.0084,-0.0161,-0.1433,-0.0005,0.0274,0.0475,0.0518,-0.0215,0.0794,0.1757,0.1334,-0.0003,0.0365,-0.0219,-0.0374,0.0016,0.0286,-0.0627,0.0483,-0.0131,-0.0291,-0.1069,0.1251,-0.0575,0.0274,-0.0966,-0.1457,-0.0019,0.0019,-0.1161,-0.1047,-0.0133,0.0539,0.0034,0.0986,0.0336,0.16,-0.0012,0.0875,0.0868,0.0932,0.0208,0.0902,0.0219,0.0917,0.0617,0.0603,0.013,0.0969,-0.0304,0.0588,-0.4624,-0.3469,-0.2912,-0.4005,0.0474,0.0441,0.0549,0.0281,0.0613,0.0161,0.2017,-0.1566,0.0121,-0.0241,-0.0801,0.0382,-0.0312,-0.0698,-0.0749,0.0506,0.0083,0.0359,-0.0154,-0.0189,-0.0063,-0.1025,0.0137,-0.0309,0.0909,0.0909,0.0531,-0.0686,0.0181,-0.0323,0.0836,-0.1179,0.0439,-0.0702,0.1731,0.1318,-0.12,0.0427,0.145,0.1315,0.1682,0.0956,0.1397,-0.0186,-0.0081,0.0521,0.0091,-0.023,-0.1439,0.0846,-0.1209,0.0577,-0.033,-0.0136,0.088,-0.0122,0.0185,-0.0122,-0.0246,-0.0359,0.0901,-0.0326,-0.0796,0.1348,0.0953,0.062,-0.0034,-0.0109,-0.0244,-0.0184,-0.0212,0.0288,0.0363,0.0963,0.3011,0.0469,0.0115,0.1089,0.1192,0.0866,0.1094,0.0388,0.2129,-0.0133,0.1618,0.0295,0.1044,0.3201,0.0076,0.009,0.0269,-0.2438,-0.01,0.0825,0.0064,0.0885,0.0222,0.048,0.152,0.1467,-0.0413,0.0344,-0.023,-0.0263,0.0296,-0.055,-0.0501,-0.0487,0.0094,-0.0034,0.0381,-0.0313,0.0976,0.0853,-0.0514,-0.0363,0.0101,0.0599,-0.084,-0.0235,0.0521,0.0371,0.0728,0.0822,-0.0355,-0.0334,0.0112,0.0566,0.0532,0.0842,0.0719,0.0069,0.1215,-0.0093,-0.0197,0.1232,0.2346,0.0571,-0.0699,-0.0524,-0.0986,0.021,-0.0457,-0.0176,-0.2668,-0.0462,0.0497,0.0775,0.0785,-0.0781,0.0406,-0.0864,0.1378,-0.2073,-0.0109,0.1944,0.0999,-0.0367,0.0674,-0.0216,0.0144,-0.0286,0.0321,-0.0334,-0.0747,-0.0394,0.0292,0.0222,0.0055,-0.0423,-0.0972,0.002,-0.0524,0.1522,-0.0012,0.0017,0.14,-0.0566,0.0304,0.0776,-0.0042,0.0178,0.0446,0.0506,-0.0062,0.0385,0.0153,-0.0033,-0.046,0.0418,0.0106,0.0184,0.0304,0.055,-0.0218,0.0818,-0.0198,0.1981,0.1432,-0.0254,-0.087,-0.0991,-0.0132,-0.0473,0.0928,-0.0089,0.0337,0.0756,0.0733,0.0214,0.2438,0.052,0.0452,0.0865,0.0096,0.0321,-0.021,-0.0729,-0.0561,0.0149,-0.353,0.0883,-0.0917,0.0362,-0.2589,0.0106,0.0275,-0.1146,-0.2045,0.038,0.0209,0.1118,0.1835,0.079,0.0155,-0.0765,0.0631,0.1762,0.0318,-0.0584,0.0773,0.0347,0.0064,0.052,-0.0589,-0.1065,0.3806,0.222,0.1279,0.3664,0.321,-0.1332,-0.0426,-0.012,-0.0335,-0.0027,-0.0471,0.1047,-0.0115,0.0385,0.1241,0.3033,-0.0282,-0.0323,-0.0165,0.1292,-0.1323,-0.0076,-0.0156,-0.0468,-0.0213,-0.0913,-0.087,0.0046,-0.1202,0.0431,0.0204,0.1343,-0.017,-0.0167,0.005,-0.0328,-0.1094,0.0061,0.0183,0.0287,0.0978,0.0138,-0.2326,-0.2316,0.0777,0.1002,0.0395,0.059,0.0708,-0.0115,0.1475,-0.0359,-0.0033,0.0059,0.0616,0.0121,-0.0338,-0.0026,-0.0163,-0.0949,0.046,0.0308,-0.2254,0.2782,0.0104,-0.2024,-0.0049,-0.0251,-0.0867,-0.0794,0.0334,-0.206,-0.1597,0.1273,0.1113,-0.102,-0.0817,-0.2174,-0.1401,-0.102,-0.0349,-0.0171,-0.0751,0.0659,-0.0198,-0.2052,-0.0753,-0.1062,-0.0074,0.0329,0.1335,-0.0082,-0.0528,0.0681,-0.0861,0.0111,-0.1183,-0.1247,0.0239,-0.0137,-0.0191,-0.0807,-0.0332,-0.1411,-0.0304,-0.0922,-0.136,-0.1753,-0.0012,-0.0391,-0.437,0.037,0.0237,-0.029,0.0005,0.0123,-0.0274,-0.0123,0.0515,-0.0058,-0.0167,0.0162,-0.0195,-0.002,-0.0296,0.0372,-0.0065,-0.0456,-0.0851,-0.0629,-0.2304,-0.2189,0.1037,0.1564,0.0459,-0.0229,-0.0858,-0.0636,-0.1288,-0.0508,-0.0925,0.0288,-0.007,0.2666,0.1564,0.0498,-0.0165,-0.1033,0.0396,0.0073,-0.0242,-0.2161,-0.1486,-0.0507,-0.0242,0.0093,-0.0192,-0.0453,-0.085,0.1256,0.118,0.1727,-0.0506,-0.0149,-0.0462,-0.1083,-0.0348,-0.0647,-0.1428,0.0689,0.0053,0.0045,-0.0328,0.0297,0.0378,0.035,-0.0304,-0.0706,-0.1688,0.053,-0.0859,-0.1463,0.0343,0.0508,0.0075,0.1235,0.0322,0.0127,0.0817,0.0287,-0.0832,0.1582,0.1895,0.0125,0.1513,0.1469,0.0886,0.1014,0.0562,0.0496,0.0525,0.1201,0.0005,-0.1086,0.0035,-0.067,0.089,0.0567,0.0523,0.0494,-0.0816,0.0156,0.0779,-0.0063,0.1312,-0.0285,-0.1535,-0.086,-0.0399,-0.0889,-0.0259,0.0543,0.0848,-0.0334,0.0518,0.0675,0.2152,0.07,0.0275,0.0317,0.0063,-0.0503,-0.0375,-0.3049,-0.2836,-0.1503,-0.076,0.1841,0.1455,0.0517,0.1467,0.0708,-0.0476,0.0583,0.0485,-0.0192,0.0772,0.1409,0.0641,-0.1067,-0.0764,0.0851,0.0642,0.0057,0.0466,0.1367,0.1108,0.0238,-0.0359,-0.0019,0.0273,0.0426,0.0671,0.0641,0.0451,0.0962,-0.0023,-0.1194,0.1337,0.0804,0.0819,0.0538,0.021,0.081,0.0813,-0.0853,-0.2171,-0.1688,-0.0451,-0.1294,-0.0934,-0.0488,-0.0636,-0.0347,-0.066,0.1119,0.0201,-0.0166,-0.0391,0.0263,0.0171,-0.0089,0.1189,0.0252,0.0469,-0.0102,0.0727,0.0302,0.0498,-0.036,-0.0362,0.1065,-0.0487,0.0146,0.0798,0.1447,0.0952,-0.0383,0.1893,0.0005,-0.0276,-0.183,0.0287,-0.0972,0.1207,0.0687,0.0107,0.1286,0.032,-0.0051,-0.0092,0.0032,-0.0233,0.0444,0.064,-0.022,-0.0408,-0.1127,-0.0605,0.1417,0.1354,0.1092,0.0055,0.005,0.1501,-0.0181,0.0793,-0.0825,0.0776,0.053,0.0575,0.0521,0.0933,0.0504,-0.0326,0.0739,0.0687,0.059,0.0604,-0.0218,-0.0432,0.1111,0.0233,0.0495,0.1114,0.0202,0.0941,0.0053,-0.255,0.0321,0.0639,0.2433,0.1347,0.258,0.2253,0.1952,0.1731,-0.0396,0.1155,0.0556,0.0528,0.3145,0.145,0.2475,0.1417,-0.0964,0.0494,0.0848,0.0031,-0.236,-0.0361,-0.0835,-0.0281,-0.023,-0.0052,0.0835,0.012,-0.015,-0.0513,0.3127,0.177,0.1927,0.132,0.0341,-0.1284,-0.134,-0.2024,-0.0864,-0.0748,-0.1166,-0.146,-0.0486,-0.0894,-0.0352,-0.0593,-0.0549,0.0843,0.0395,0.0879,0.0076,-0.0564,0.0226,0.0402,0.0356,-0.0445,-0.0032,0.3019,0.2523,0.0912,0.1127,0.1113,0.0319,0.1565,0.0886,-0.0303,0.0708,0.0434,0.1346,0.0225,-0.053,0.0478,0.0065,-0.0433,0.1536,-0.0348,-0.0198,-0.0561,0.0528,0.0584,-0.1308,-0.0673,-0.0443,-0.1121,-0.0131,-0.0159,-0.088,-0.024,-0.0346,0.328,0.0865,0.0412,0.0428,0.0346,0.0477,0.0866,0.0321,0.0149,0.0621,-0.0915,0.0785,0.0533,-0.0492,-0.0675,-0.031,-0.0604,-0.0215,0.3602,0.0665,0.1062,0.0753,-0.123,-0.1488,-0.1568,0.0643,-0.3877,-0.2814,0.1863,0.0574,-0.4127,-0.0158,-0.0736,-0.1094,-0.1894,-0.0519,0.0561,0.0545,0.012,0.0955,-0.513,-0.3917,-0.3218,-0.1084,-0.1847,-0.2516,-0.4157,-0.4198,-0.3614,-0.0768,0.0336,0.0639,0.0364,0.0665,0.0686,0.0395,0.0314,-0.0014,-0.0432,0.0415,0.0463,-0.1368,0.0375,0.0431,0.0906,-0.0532,-0.0828,-0.1387,0.1918,0.1258,0.2799,0.001,0.0183,0.0382,0.0237,0.0605,-0.0193,0.0692,0.0652,0.0972,0.0912,0.0859,0.1569,0.046,-0.2087,-0.0683,-0.0904,-0.0407,-0.1421,-0.2561,0.0329,0.1013,0.0896,0.1749,-0.0847,-0.0156,-0.1349,-0.0282,-0.037,0.1113,0.1598,0.17,0.0984,0.0907,0.111,0.4283,0.363,-0.0211,-0.0102,-0.1786,0.0909,-0.036,-0.0725,0.0082,-0.1036,-0.0892,-0.0596,0.0859,0.1416,0.0242,-0.0073,0.0565,0.0554,0.1065,-0.0575,-0.0684,-0.066,-0.0499,-0.1147,-0.003,0.059,-0.083,0.0224,-0.0081,-0.1322,-0.0973,-0.0274,0.0047,-0.0327,-0.1198,0.0614,0.0635,0.1383,0.1258,0.0272,0.0055,-0.0256,0.0809,0.039,-0.0277,-0.039,-0.037,-0.0302,0.105,-0.1474,-0.1342,-0.0192,0.1109,0.0614,0.1079,0.0798,-0.0678,0.066,0.0333,0.0309,-0.054,0.0873,0.1036,0.0583,0.0639,-0.0593,-0.0151,0.0325,-0.0805,-0.1114,-0.1023,-0.3192,-0.0254,-0.0558,0.0579,0.0665,0.0093,0.121,0.1427,0.1051,-0.0298,0.1073,0.1143,0.0573,0.0822,-0.035,0.0123,0.0664,0.0421,0.0369,0.0475,0.0798,-0.014,0.1097,0.1058,0.0505,0.0853,0.1372,0.0996,-0.1064,-0.0926,0.0566,0.125,-0.196,-0.1651,0.1628,-0.1288,0.1576,0.1109,0.0466,0.1569,0.1587,0.0422,-0.0247,0.0052,-0.0043,0.1096,0.0521,-0.0197,-0.0062,-0.0655,0.1038,-0.0365,-0.0316,-0.0408,-0.0677,0.0509,0.0117,-0.0027,0.0014,0.0367,0.0209,0.027,-0.0141,0.0097,0.0233,-0.0177,0.1271,0.0601,0.1269,0.0809,0.0815,0.0793,0.0851,0.0851,-0.0077,0.0565,0.0311,0.1412,0.0312,0.1484,0.1108,-0.0352,-0.0524,0.1255,-0.1074,0.2843,-0.0586,-0.0868,-0.0676,-0.0354,-0.045,0.0465,0.0774,0.0014,-0.0433,-0.0029,-0.0605,0.055,0.1135,0.0016,-0.0328,0.0154,-0.0241,0.1733,0.1363,0.0031,0.0338,0.0085,0.0352,0.0637,0.0154,0.0067,0.0208,-0.0046,0.0144,0.0125,0.0345,-0.1249,-0.0087,-0.1028,-0.0504,0.0099,0.0011,0.04,0.0065,0.0749,-0.0023,0.0145,0.1601,0.1538,0.1154,0.0447,-0.0168,0.056,-0.1582,-0.0473,-0.3165,-0.1331,0.0167,-0.0154,0.1865,0.0019,-0.0822,-0.0747,0.1124,-0.0292,-0.0408,-0.0174,-0.0191,0.306,0.1469,0.2799,0.2639,0.1785,0.1557,0.2822,-0.2219,0.0466,-0.1156,-0.1698,0.0551,-0.0168,-0.0668,0.0366,0.0465,0.0383,-0.038,-0.1183,-0.0193,-0.044,0.0676,0.0303,-0.1415,-0.134,-0.1051,-0.0532,0.003,0.0913,0.0347,0.1355,0.0041,0.0986,0.0153,0.0278,0.0377,0.0225,0.0967,0.0679,-0.0248,0.0849,0.0058,0.0826,-0.0975,-0.0377,-0.0816,-0.0584,-0.0081,0.0247,0.0962,0.1038,0.056,0.0079,-0.0337,0.025,0.0268,-0.0279,-0.05,0.007,0.0157,0.02,0.1308,0.0833,0.0088,0.034,-0.0107,0.0331,0.0457,0.0505,0.0725,0.0599,0.0216,-0.0214,0.2432,-0.1333,0.0388,0.0454,0.051,-0.0706,0.0943,-0.0589,-0.0346,0.0399,0.182,-0.0706,0.0151,0.078,-0.0038,-0.0765,0.0644,-0.058,0.1077,0.0765,0.1362,0.1297,0.1838,0.0691,0.0532,0.0344,0.0402,-0.0632,-0.0633,-0.0728,0.1312,0.0718,-0.1329,-0.1994,-0.2868,-0.0642,0.1052,-0.0784,0.0235,0.0556,-0.1019,0.0184,0.0257,0.04,0.0685,0.0635,0.0875,-0.3118,-0.1179,-0.074,-0.2335,-0.0678,-0.1116,-0.0545,0.0689,0.1261,0.0707,0.1115,0.0139,-0.0096,0.0155,0.0209,0.0708,0.0277,0.0469,-0.0221,-0.019,0.0681,0.0123,0.0097,0.0242,-0.0515,-0.0132,-0.0187,-0.0444,0.017,-0.0672,0.1374,0.0804,0.0694,0.0847,0.0393,0.0913,0.0619,0.1548,0.0874,0.2077,0.0347,0.083,-0.0135,0.0924,-0.0312,-0.1217,-0.1351,0.0664,0.0823,-0.0072,0.015,-0.0841,-0.1172,0.1036,0.0094,0.053,-0.0318,-0.034,-0.0358,-0.1082,-0.0117,0.038,-0.0569,-0.0022,-0.0742,-0.1251,-0.0907,0.0577,0.1037,-0.0425,-0.0762,0.0233,-0.1312,-0.133,0.1102,-0.0341,-0.0248,0.0839,0.1131,-0.004,-0.0497,-0.1935,-0.0658,-0.0706,-0.0594,0.0219,-0.1587,-0.1503,-0.107,-0.1134,0.0291,-0.0151,0.0661,-0.0311,-0.0055,-0.0095,0.145,0.1161,-0.048,0.0184,-0.0625,0.028,-0.0585,-0.007,0.1249,-0.0739,-0.088,0.0198,-0.0715,-0.0396,-0.103,-0.0334,0.0243,0.0201,0.0885,0.047,-0.1444,-0.1484,0.0399,0.0149,-0.0993,0.0504,0.1522,0.2319,0.2055,-0.0108,-0.0294,0.0614,0.0353,-0.0352,-0.1687,-0.0544,-0.0535,-0.014,-0.069,0.0429,0.0505,-0.0278,-0.0294,-0.004,0.0641,0.0216,0.0853,0.0437,0.1426,-0.0371,-0.0022,0.0815,0.05,0.0088,0.0657,-0.0403,-0.0938,-0.0087,0.1779,0.0709,-0.1713,0.0361,-0.0433,-0.0809,-0.0444,0.0148,-0.0628,0.2801,-0.0595,-0.0592,0.0248,0.0397,0.058,-0.0365,-0.0368,0.1066,0.2137,0.1324,0.0641,-0.009,-0.0994,-0.0429,-0.0215,0.0762,0.1119,0.1536,-0.1758,-0.1751,0.0234,0.0213,0.0831,0.0751,0.1257,-0.2552,-0.1211,0.0678,0.0033,-0.1264,-0.0826,0.3735,0.3864,0.0868,0.1877,0.0644,0.0897,0.0298,0.002,-0.0223,-0.1093,0.0426,-0.0659,-0.3896,-0.1408,-0.1352,-0.3139,0.1424,0.0645,0.0547,-0.1694,-0.0318,-0.0422,-0.0286,-0.0822,-0.076,0.3142,0.2719,0.0083,-0.2509,0.0529,0.2604,0.2011,0.1772,-0.0452,-0.1318,0.171,-0.0311,-0.0121,-0.0117,0.0102,-0.0456,-0.0226,-0.0555,-0.0337,0.1073,0.0227,0.1101,0.002,-0.0062,0.0394,0.0239,0.0938,0.0429,0.0237,0.0106,-0.0904,-0.0929,0.0207,-0.0036,0.0242,-0.0198,0.1267,0.1101,0.0433,0.1202,-0.3525,-0.0284,-0.2397,-0.0608,-0.0004,0.0162,0.0038,-0.1091,0.1067,-0.1336,-0.0787,-0.0499,-0.0357,-0.0277,-0.0178,0.0951,0.0412,0.2782,0.0888,-0.1654,-0.1217,0.1738,0.0378,0.0302,0.0344,0.0215,0.0137,0.0672,0.0791,0.0319,0.3664,-0.0148,0.0113,-0.103,-0.0725,0.0048,-0.0226,-0.018,-0.0181,0.1479,0.0734,-0.0142,-0.0708,0.0771,0.0517,0.1098,-0.0106,0.0097,0.0061,0.0732,-0.1482,-0.0206,0.0876,0.2533,0.1054,0.0779,0.1075,0.0166,0.2167,0.032,-0.0054,0.0623,0.0619,-0.0355,-0.0175,-0.0134,0.0227,-0.0063,-0.048,0.0697,-0.0933,0.3797,0.3267,0.3426,0.017,0.1097,0.1547,0.0749,-0.0444,-0.1586,-0.0351,0.1763,-0.1791,-0.1818,-0.0874,0.0596,-0.0172,0.0074,0.0643,-0.0019,0.021,-0.1093,-0.1255,-0.2095,-0.0248,-0.0631,-0.0704,-0.0302,0.1436,-0.0077,-0.0183,-0.0031,0.1283,0.1098,0.1184,0.0934,0.041,0.1682,0.2386,-0.0247,-0.0033,0.1213,-0.0564,-0.0853,-0.0464,0.0353,0.105,0.2367,0.1814,0.0834,0.1877,-0.0995,0.0219,-0.0131,-0.0809,0.0946,0.2284,0.3419,0.0873,-0.174,-0.0676,-0.09,-0.0946,-0.0723,0.0746,0.0627,-0.0427,-0.0935,-0.1067,-0.0276,-0.0301,-0.1574,-0.0662,0.1587,0.1541,0.0408,0.0953,0.0967,-0.0478,0.1843,-0.0481,-0.0717,-0.0556,-0.0486,-0.037,0.0864,0.0103,0.0649,-0.0351,0.0968,0.2099,0.0192,-0.0491,0.0554,-0.0188,0.0772,0.2215,0.1148,0.1241,0.1313,0.0696,0.1019,-0.0235,-0.0852,0.0222,0.0609,-0.061,-0.035,0.0278,0.0268,0.0088,0.1042,0.0768,-0.1296,-0.0189,0.08,-0.1152,-0.0363,-0.0611,-0.1067,-0.0034,-0.0112,-0.09,-0.0449,0.0155,0.0225,-0.0389,-0.1598,-0.1873,-0.2222,0.0168,-0.0542,0.0194,0.0192,0.073,-0.0525,0.1249,-0.0866,0.0683,0.2471,0.2553,-0.1058,-0.006,0.0203,0.0182,-0.0157,0.1808,0.1773,-0.0165,-0.0521,0.0024,0.0571,-0.0165,-0.0862,-0.0684,0.1128,0.0898,0.0775,0.0081,0.1248,0.0197,-0.0527,-0.0333,0.0132,0.0189,0.0558,0.0593,0.1769,-0.0623,0.072,0.17,-0.1304,0.0262,0.0406,-0.0832,-0.1826,-0.0074,-0.0427,-0.1162,0.0855,-0.014,-0.1596,-0.059,0.067,-0.1655,-0.054,-0.0317,-0.0709,-0.1195,-0.0289,0.1081,0.1001,0.0994,-0.0825,-0.2011,0.0224,-0.0876,0.0546,0.0138,0.0553,-0.0385,-0.0782,-0.1849,-0.0115,0.0334,-0.0481,0.1587,0.0894,0.0045,0.0414,0.0273,0.0149,0.0625,-0.0076,0.0676,0.0294,-0.1452,-0.2407,0.0314,0.0733,-0.1138,-0.0671,0.0573,0.0364,0.1411,0.2455,-0.1185,-0.0956,0.0014,0.0086,0.061,-0.0003,0.036,-0.0195,0.0656,0.0719,0.0037,0.0455,0.033,-0.0243,0.1649,0.1108,0.0961,0.08,-0.0542,0.1242,0.0327,-0.1065,0.1064,0.0691,0.1059,-0.0051,0.0941,0.043,0.1589,0.1476,-0.0944,-0.066,-0.1351,0.0715,0.0943,0.1117,-0.0204,-0.0143,-0.0058,0.1584,0.0293,0.0774,-0.0409,-0.0332,-0.0524,0.1573,0.1051,0.0629,0.0912,0.093,-0.0192,0.0221,-0.128,-0.0109,0.0238,0.0175,0.0784,0.0648,0.1726,0.093,0.0704,0.027,0.035,-0.0615,0.0552,-0.0536,-0.0131,-0.0185,-0.0091,-0.0799,-0.1356,-0.1019,-0.0144,-0.0196,0.1017,-0.005,0.0135,-0.0302,0.0557,0.0308,-0.0329,-0.0303,0.0684,0.0666,0.034,0.0013,0.0336,0.0467,0.0481,-0.1752,0.1079,-0.0992,-0.0206,-0.0493,-0.0304,-0.0583,-0.043,0.0055,0.1592,0.0028,-0.0854,-0.0736,0.1255,0.0392,0.1261,0.0868,-0.0085,0.0221,0.0416,-0.0187,-0.0318,0.125,0.0818,0.0817,0.0608,0.0604,0.04,-0.3549,-0.1946,0.0356,-0.073,0.0132,-0.0003,0.096,0.0108,0.0981,0.1843,-0.0362,0.0034,0.1361,-0.0302,0.0343,0.0505,-0.1493,0.0068,-0.038,0.0095,-0.0168,-0.0322,0.0284,-0.0093,-0.1323,0.0863,-0.1148,0.0672,0.0731,0.076,-0.3708,-0.0438,-0.066,0.0336,0.0304,-0.0549,-0.0989,0.02,-0.0348,-0.0461,0.0869,-0.0216,-0.0944,0.0456,-0.0398,-0.0906,-0.1606,-0.1666,-0.2464,-0.2561,0.0624,-0.0874,-0.2822,-0.459,-0.1922,-0.1401,-0.3491,-0.2174,-0.2128,-0.2444,-0.0958,-0.2038,-0.1596,-0.1752,-0.2927,-0.0826,-0.198,-0.3107,-0.1886,-0.272,-0.1935,-0.0184,-0.1699,0.1097,0.0821,0.0351,0.1992,0.0217,0.1423,0.1317,0.0726,0.246,0.2116,0.1058,0.0864,0.1282,0.0597,-0.0642,0.0281,-0.1086,-0.0062,0.0787,0.0016,0.1116,0.0644,0.06,0.0161,0.0741,-0.0615,0.0659,0.0853,0.0061,0.0116,0.0704,-0.0349,-0.0298,0.0915,-0.0554,-0.064,0.0908,-0.2509,-0.322,-0.1151,-0.1194,-0.1918,0.0808,-0.1216,-0.1212,-0.071,-0.0269,-0.1591,-0.0618,-0.0616,0.0808,0.0201,-0.1011,0.0248,0.0453,0.0239,-0.0412,-0.0039,0.127,pattern recognition
trm_4a3fd79d09ab2,0.0275,0.058,0.072,0.0939,0.0106,0.0566,0.0718,-0.055,-0.0825,0.0364,0.0187,0.0382,0.0729,0.0806,0.1006,0.0156,0.0929,0.1686,-0.0254,0.1743,0.1049,0.032,0.0861,0.0214,0.0562,0.0269,0.0277,0.1378,0.1137,0.0367,0.1318,0.1462,0.1026,0.0505,0.1696,0.1735,0.0353,0.0346,0.093,0.0472,0.1217,0.0681,0.0398,0.0133,0.0738,0.1438,-0.0364,0.0082,-0.0661,0.0562,0.0309,-0.1424,-0.0814,-0.1169,0.0655,0.0718,0.0883,0.0697,0.0094,0.0702,0.0629,0.0053,0.1988,-0.0988,-0.0651,-0.1794,0.2333,0.3123,0.1462,0.0545,-0.0866,-0.0259,-0.1203,0.1582,0.0405,0.0276,0.0529,0.026,-0.0504,0.0455,0.0246,-0.0526,0.0913,0.1378,-0.0891,-0.1115,-0.0608,-0.0445,0.0283,0.0704,0.0953,-0.0978,0.0341,-0.4018,-0.2571,-0.2998,-0.1722,-0.1232,-0.3759,-0.2831,-0.0635,0.0311,-0.1832,-0.2618,-0.1782,0.171,0.2483,-0.1149,-0.0125,-0.0252,0.0158,0.1284,-0.0774,-0.2156,-0.0321,-0.0012,0.1234,-0.1738,0.0575,0.0513,0.2012,0.1807,0.2451,0.0344,0.1017,0.2314,0.1478,-0.0553,-0.107,-0.0521,0.1854,0.0763,0.0318,0.2929,0.0952,0.2624,-0.0609,0.1757,0.0782,0.0051,0.086,0.0773,0.0089,0.1069,0.0691,-0.1215,-0.037,-0.0025,0.1044,0.0062,0.0735,0.1804,0.1511,0.2058,-0.11,-0.0215,-0.0933,-0.0411,0.0272,0.0899,0.0389,0.159,0.275,0.2311,0.0298,0.0003,0.0678,0.2755,0.265,0.023,0.098,0.2099,-0.0517,0.3472,0.1859,0.2601,0.1956,0.2057,0.1336,0.0002,0.1798,-0.007,0.136,-0.0676,0.0375,0.0679,0.0619,0.2164,0.1727,0.1113,0.0948,0.1315,0.0785,0.2161,0.2055,0.1232,0.1385,0.1537,0.0754,-0.0806,-0.0939,-0.3862,0.2183,0.1729,-0.0653,0.0499,0.2755,0.0169,0.0176,0.0014,0.2744,0.1486,-0.0413,0.0033,-0.0012,0.0267,0.0268,0.0681,-0.0674,0.0349,-0.0858,0.1593,0.2189,0.0708,-0.1406,0.0209,0.0625,-0.1217,0.1045,-0.207,-0.1203,0.1992,-0.127,0.1071,0.0961,-0.2237,0.1035,-0.0514,-0.0304,0.0561,-0.0517,0.171,0.0083,-0.0458,0.046,0.1152,0.1503,0.1554,0.0162,0.238,-0.0215,-0.033,0.0266,-0.0784,-0.033,0.2148,-0.088,-0.0211,-0.114,-0.081,-0.0821,-0.2169,0.1232,-0.0776,-0.1912,-0.2751,-0.1168,0.0544,0.0574,0.0564,0.0285,-0.0225,0.1581,0.0863,-0.0339,0.0317,-0.0224,0.1299,0.0068,-0.0333,-0.0312,0.1699,0.1469,0.3446,0.2903,0.0888,-0.0457,-0.0362,0.0227,0.0781,0.12,0.1213,0.0093,0.1382,0.0911,-0.0066,0.0839,-0.1557,0.0449,-0.2149,-0.1189,0.267,0.0749,0.1901,-0.2078,-0.236,0.1024,0.031,-0.0723,0.0125,-0.0325,0.0183,0.0736,-0.0573,-0.0365,-0.0333,-0.1884,-0.0415,-0.0251,0.1137,0.0126,0.0088,0.1486,0.2017,0.0727,0.0608,0.042,0.085,0.0401,0.1078,-0.0489,0.0785,0.0916,0.0264,0.0416,-0.2093,-0.0889,0.0439,0.152,0.1779,0.157,0.1219,-0.1358,-0.1093,-0.0472,-0.0621,0.1738,0.1126,0.0931,0.0947,0.063,-0.0854,-0.0394,-0.0697,0.0669,-0.0035,0.0375,0.1459,0.0606,0.0898,-0.009,-0.0092,-0.1381,-0.0843,-0.1091,-0.1355,0.1111,-0.3246,0.0182,0.1328,0.0486,-0.1078,0.0387,-0.1843,0.1633,-0.0284,0.1088,-0.0624,0.0331,-0.047,0.0181,-0.2343,0.0021,-0.1196,-0.0737,-0.1198,0.103,0.0165,-0.0496,0.003,-0.0895,0.0376,-0.0566,0.1137,-0.2729,-0.3039,-0.1245,0.1337,0.0303,0.058,0.0646,-0.0292,-0.0422,0.0351,-0.0191,-0.0799,-0.0304,0.0168,0.1448,0.0171,-0.0137,0.2105,0.0905,-0.1466,0.2458,0.1394,-0.1746,0.0059,0.1021,-0.0066,-0.0384,0.1282,0.052,0.2686,0.2506,0.0183,0.1695,-0.0985,0.1034,-0.0602,0.0682,-0.0886,0.0133,-0.0396,0.1166,-0.0316,-0.1129,-0.0432,0.2344,0.0838,-0.0402,-0.0936,0.0401,-0.0397,0.0868,0.0809,-0.0556,-0.1814,0.1883,-0.0078,-0.1153,-0.0991,0.1142,0.0268,-0.124,0.2364,0.0163,0.0176,-0.0086,-0.0344,-0.0683,0.0224,0.1112,0.0566,0.1638,0.1281,-0.0633,-0.269,0.0835,0.0157,-0.0552,-0.0309,-0.2368,0.0469,0.1152,0.0379,-0.1035,-0.0826,0.0081,0.0013,-0.2181,-0.0956,-0.1289,-0.1446,-0.0802,-0.1014,-0.0133,-0.0237,0.1719,0.0114,-0.0387,-0.2733,0.1728,0.2192,-0.0725,0.0666,0.1451,0.0129,-0.013,0.106,0.0903,0.0231,0.0586,0.1,0.0449,0.127,-0.0011,0.0776,0.0548,-0.1918,0.1384,-0.1147,0.0406,-0.0049,-0.0544,-0.1305,0.1385,0.1137,-0.2523,0.0903,0.0134,0.0428,-0.0168,-0.15,-0.1895,-0.0082,-0.1554,-0.1724,-0.0737,-0.0849,0.0611,-0.0231,0.0107,0.2653,0.1798,-0.0059,0.2311,0.0722,0.0457,0.1797,0.1048,0.0397,-0.0503,0.0304,0.1038,-0.0074,0.0015,-0.015,0.017,0.142,-0.1314,0.0752,-0.0117,-0.1644,-0.0138,0.1798,-0.1004,-0.0724,0.0315,-0.0037,0.1253,0.0231,0.1576,-0.0659,0.1271,-0.0011,-0.0229,0.1914,0.0268,0.0804,0.0989,0.1048,0.0426,0.0083,-0.2616,-0.2418,-0.0522,-0.102,-0.1087,-0.0787,-0.0414,0.1109,0.0526,-0.0038,-0.2084,-0.0587,-0.2743,-0.0576,-0.1802,0.0797,0.1408,-0.0718,-0.1639,-0.1649,-0.076,-0.078,0.2487,0.1055,-0.2236,0.087,-0.0042,-0.0375,-0.0405,-0.0164,-0.092,-0.3017,0.0901,0.1438,0.1328,-0.0946,0.1395,-0.0031,-0.0338,0.0659,0.2434,0.1064,0.0595,0.0187,0.0438,0.2699,0.0096,0.2069,-0.0748,0.0147,0.083,-0.0871,0.025,0.1657,-0.0476,-0.0638,-0.0997,-0.2645,0.0941,-0.0017,-0.1427,-0.1645,-0.114,-0.0288,0.1056,-0.1045,0.0435,-0.1404,-0.0763,-0.1817,0.1012,0.0394,0.3055,0.2192,-0.2247,0.2916,-0.0698,0.1681,-0.248,0.2157,0.0564,-0.0287,-0.3039,-0.0333,0.0521,0.0843,0.2731,-0.2186,-0.1692,-0.1999,-0.1785,-0.1277,-0.1269,0.2547,-0.1383,-0.122,-0.0045,0.0961,0.0716,0.0298,0.0447,0.0768,-0.2386,0.1557,0.0345,0.0643,-0.0399,-0.0827,-0.0438,-0.0112,-0.1171,0.1637,0.0951,0.0153,-0.0491,-0.1082,-0.132,-0.1948,-0.2367,-0.0358,0.0661,0.1426,-0.0235,0.0811,0.0441,-0.0153,-0.101,-0.0443,0.0548,0.1583,0.0966,-0.0315,0.1456,0.1263,0.1192,-0.043,-0.0266,0.0363,0.091,-0.0142,0.1015,0.0752,-0.0104,0.026,0.2156,-0.0279,-0.0925,0.0653,0.3896,0.3813,0.2797,0.0279,0.0367,0.1297,0.005,-0.0366,0.0571,0.0536,-0.0087,-0.1405,-0.1479,0.0085,0.0489,-0.1174,-0.1411,-0.3225,0.2465,0.0584,0.0147,-0.0125,0.0817,0.1962,-0.087,-0.0599,0.0855,-0.0269,0.0275,-0.0318,0.2227,0.3639,0.3125,0.2367,-0.0135,-0.056,0.0431,0.0631,0.079,-0.1249,-0.1343,0.0172,-0.1074,-0.0394,0.1467,0.0685,-0.0261,-0.0971,-0.068,-0.0971,0.0144,-0.0302,-0.0805,0.0926,-0.0578,0.1433,0.1875,0.0706,0.2063,0.2023,0.1299,-0.0733,-0.0176,-0.0073,0.0281,0.0422,-0.0526,-0.0977,-0.0437,0.0913,0.0222,0.0278,-0.0504,-0.0747,-0.1263,0.1249,-0.206,0.2161,0.2101,-0.1009,-0.0053,-0.0585,0.0701,0.0755,-0.069,-0.0326,-0.0623,-0.1922,-0.0341,-0.1774,-0.0809,-0.0913,-0.0514,0.0,-0.1717,-0.1255,0.0598,-0.0763,-0.0448,0.1812,0.2372,-0.0774,0.1076,0.1315,0.3481,0.1145,0.2307,0.1889,0.2876,0.0626,0.0536,0.0651,0.0886,-0.009,-0.0081,-0.1841,-0.1347,0.0195,-0.067,-0.0672,-0.0435,-0.0882,-0.1099,-0.0212,-0.1031,-0.1075,0.1418,-0.1671,-0.0898,0.0134,0.098,0.0949,0.0713,-0.0804,-0.1479,0.3797,0.2299,0.0312,-0.0679,-0.1079,-0.0582,-0.044,-0.1385,-0.2283,-0.0174,0.0536,-0.2654,0.0582,0.0248,0.1991,-0.4003,0.0898,-0.1758,-0.2482,-0.0214,-0.2481,0.2507,0.2517,0.1117,-0.1479,0.0719,0.1015,0.0996,-0.0757,0.0237,0.1432,0.1007,0.1767,-0.1447,0.0014,0.0018,-0.1509,0.0653,-0.0329,0.166,0.1349,0.0392,-0.0846,0.1096,-0.0599,0.0932,-0.0702,-0.1007,-0.0334,-0.098,0.1545,0.077,0.1638,0.1058,0.1872,0.0826,-0.081,-0.1777,-0.0491,0.0465,0.085,-0.1414,-0.2087,-0.1799,-0.0578,0.0011,0.1067,-0.0328,0.0561,0.048,-0.0516,-0.0038,0.1605,-0.0009,-0.0189,-0.009,0.0426,0.0384,-0.0405,0.1329,0.0714,0.0414,0.1341,0.1266,0.3925,0.2002,0.4137,0.1455,0.1201,0.1698,0.1692,0.2327,0.2234,0.2839,0.3477,0.0931,0.0785,-0.034,-0.0088,-0.1077,0.031,-0.0493,-0.0537,0.0423,-0.0737,0.0335,-0.0044,0.0127,0.0372,-0.0849,-0.0934,-0.0014,-0.0428,-0.0567,-0.0879,-0.0389,-0.0823,0.1352,0.0115,0.0851,0.0225,-0.0095,-0.0034,0.0148,0.0158,0.1794,0.1526,0.1092,0.2642,0.2272,-0.1097,-0.1579,-0.1433,-0.0585,0.0027,0.0323,-0.1121,-0.0951,-0.0038,-0.0665,-0.0972,-0.017,0.0139,0.0403,0.0489,0.0578,-0.0376,0.0035,0.0686,0.0723,0.1472,0.2363,0.1831,-0.1606,-0.0953,-0.2057,0.0207,0.0534,0.1441,0.0748,-0.0273,0.0203,0.0477,0.0022,0.0116,0.0235,-0.0311,-0.0487,-0.043,0.1128,0.0377,0.1161,-0.0087,0.1003,-0.1192,-0.2546,-0.5071,-0.2083,-0.0986,-0.0386,-0.1361,0.0159,0.0477,0.0655,0.0877,-0.0223,-0.0553,-0.1025,-0.0642,-0.011,-0.0872,-0.0042,0.118,-0.1102,0.1957,0.1272,0.2132,0.0847,-0.2262,-0.0066,-0.0487,0.2062,-0.2,-0.07,-0.0082,0.0772,0.0665,0.0265,0.0313,-0.0667,0.107,0.1333,0.0787,-0.0023,0.1925,0.1532,0.1098,0.1464,0.197,0.0668,0.1155,0.0546,-0.0195,-0.135,0.0226,-0.0311,-0.0949,0.074,-0.175,0.1774,0.0325,0.0466,0.1514,-0.1166,-0.0874,-0.3074,-0.3064,-0.3077,-0.0547,-0.2773,-0.0157,0.2188,0.1171,0.0614,0.0958,0.0676,0.2002,0.232,0.118,0.1765,0.0908,0.0156,0.0068,-0.0953,-0.0439,0.1686,-0.1066,-0.0844,0.0212,-0.0849,0.0114,0.1081,-0.012,0.0572,0.153,-0.0347,0.1128,-0.1013,-0.0357,-0.1754,0.0543,0.2512,0.2658,0.2318,0.1424,-0.0143,-0.024,-0.1481,0.0696,0.2277,0.2411,0.0877,0.0545,0.0334,-0.1919,-0.2244,0.1061,-0.0032,-0.1068,-0.4284,-0.4363,-0.367,-0.0977,-0.0652,-0.0518,-0.1653,-0.1273,0.0889,0.2547,-0.0977,0.1096,-0.2043,0.0086,0.0571,-0.0249,0.1132,0.0632,-0.0137,0.1343,-0.0431,-0.2494,-0.0464,0.1275,0.0317,0.0486,-0.1118,-0.0866,-0.105,0.2355,0.2111,0.1453,0.0876,0.0105,0.1324,0.166,-0.0007,0.0306,-0.2733,-0.139,-0.1528,-0.3624,-0.0338,-0.0956,0.0713,-0.1095,-0.1358,-0.2783,0.0854,-0.2719,-0.4023,-0.0755,0.1272,-0.2829,-0.2479,0.0531,0.1486,-0.0009,0.1718,0.1014,0.2784,0.0708,-0.2554,0.0661,0.0456,-0.1516,0.0229,-0.0178,0.0348,0.0683,0.0301,0.1138,-0.1265,-0.0325,0.03,0.0269,0.0555,-0.0403,0.026,0.1643,0.0064,0.0886,0.1396,0.0878,0.1435,-0.2339,-0.0292,0.2605,0.1635,-0.0851,-0.035,0.0311,-0.0738,-0.013,-0.0655,-0.0068,-0.2651,0.141,0.1624,-0.0208,-0.1426,-0.1099,0.1096,-0.1082,-0.1082,0.2221,-0.0944,-0.0627,-0.0881,-0.0327,0.0112,0.0545,-0.3549,0.3148,0.3131,-0.0596,0.0731,0.2206,0.238,0.1835,0.0003,0.0267,0.1193,0.0433,-0.0359,-0.3024,0.0645,0.0164,0.0225,-0.0296,-0.0323,-0.0943,-0.1006,-0.01,0.1196,-0.0227,0.1062,0.1128,0.1475,-0.0252,-0.0513,0.0566,-0.3884,-0.2459,-0.3849,-0.0338,-0.3224,0.2623,0.1936,-0.0134,0.187,0.0545,0.1882,0.1478,-0.0303,0.121,0.2452,-0.1463,-0.0146,0.1971,-0.0212,-0.055,0.0055,0.096,0.0278,0.0764,-0.0108,0.1293,-0.1307,0.0818,-0.0492,-0.195,-0.2768,-0.2504,0.0187,-0.0371,0.0797,0.1187,0.1262,0.022,0.1423,0.0268,0.2048,0.0567,-0.0051,-0.0647,0.0671,0.2352,0.1819,-0.0506,-0.0658,-0.0903,-0.0301,0.1315,0.0049,0.1202,0.1455,0.241,0.3304,0.1759,0.0745,0.2041,0.1908,0.0327,0.0354,0.0547,-0.065,-0.0856,0.1264,0.1225,-0.1241,0.1931,0.0243,-0.0849,-0.0858,-0.0481,0.2259,0.003,-0.1612,0.1434,0.0416,0.0394,0.0935,-0.0028,-0.0944,-0.0675,-0.0682,0.2549,-0.0529,-0.012,0.0399,-0.3368,0.1076,-0.0499,-0.0733,-0.1494,-0.22,0.1089,0.0115,0.1693,0.0452,0.1657,0.191,0.0729,-0.1195,-0.0558,0.1626,0.1672,0.0055,0.1255,-0.028,0.1592,0.103,0.0214,-0.013,0.0326,-0.0849,0.1092,0.0182,0.0646,0.1325,0.054,0.0362,0.103,0.0195,-0.0373,0.014,-0.1386,0.042,0.0313,0.0624,-0.1029,-0.0679,0.1219,0.2631,-0.0798,-0.1226,-0.2575,0.0065,0.0308,0.0173,-0.0935,-0.0791,0.0589,0.0661,0.161,0.0031,0.3078,-0.0082,0.0558,-0.0065,0.1238,0.0675,0.0171,0.1487,0.1638,-0.2786,-0.1463,-0.0485,-0.008,-0.3512,0.0053,-0.1481,-0.0089,0.0423,0.0526,0.0814,-0.153,-0.0595,-0.0747,-0.0779,-0.0189,0.0195,0.1315,-0.0256,-0.1393,-0.154,-0.1552,-0.0959,0.0954,0.091,0.0455,-0.167,-0.1402,-0.0324,0.0639,-0.0308,-0.0858,0.0347,-0.0173,0.0202,-0.0947,-0.0037,-0.0369,-0.0499,0.0096,0.1623,0.0835,-0.069,0.0201,0.1108,0.157,0.0507,0.1301,-0.0089,-0.0683,0.0568,0.0733,0.0638,0.0038,-0.1098,-0.3075,0.0296,0.0176,-0.1103,-0.024,0.0866,0.1042,-0.0813,-0.0258,0.0353,-0.1873,-0.1671,-0.1244,0.0845,0.088,-0.1039,-0.4722,-0.4662,0.2286,0.1764,-0.1218,0.046,0.0364,0.0332,0.1517,-0.0423,0.0685,0.1186,-0.0458,-0.0595,-0.3973,0.042,-0.2968,-0.0406,-0.0924,-0.2035,-0.375,-0.2033,0.105,-0.1443,-0.0625,-0.1202,-0.0111,-0.0147,0.0829,-0.037,-0.0009,-0.0867,-0.0217,0.0219,0.0508,0.0242,-0.0119,0.1291,0.0772,0.1065,-0.1047,0.156,0.0267,-0.0207,0.1207,0.1149,0.0266,-0.0645,0.1194,0.0681,-0.0642,0.0489,-0.0836,0.0957,-0.0281,-0.1153,0.0402,0.0896,-0.0265,0.0873,0.0494,-0.0032,-0.1472,-0.0241,0.1028,-0.1323,-0.1243,-0.047,-0.1501,0.1956,0.1778,-0.1345,0.2369,-0.1352,-0.0988,-0.2047,0.1071,-0.0337,-0.0219,0.0205,-0.0565,-0.0954,0.0441,-0.0875,-0.0818,-0.0981,-0.0008,-0.1435,-0.2274,-0.2089,0.0637,0.0715,0.0803,0.0042,-0.0883,-0.0259,0.1728,0.0412,0.0179,-0.0818,-0.1439,-0.1622,0.3038,0.1411,0.0444,-0.1079,0.002,-0.0206,-0.0017,0.0399,0.0385,-0.0524,0.0426,0.0732,-0.0122,-0.0118,-0.0834,0.0907,0.1142,0.0782,0.0126,0.031,0.017,-0.3501,0.1757,0.1771,0.0772,-0.3519,-0.1712,-0.2666,0.1471,0.0503,-0.0288,-0.0136,-0.207,-0.1711,-0.114,0.0241,-0.0116,0.0298,-0.1361,0.0941,-0.2188,0.2458,0.0873,0.1646,0.181,0.0518,0.0199,-0.037,-0.215,0.0964,-0.1469,-0.1349,-0.163,0.143,-0.0023,-0.02,-0.0376,-0.0779,-0.1723,-0.2134,-0.1974,-0.3481,0.2865,0.1647,0.2452,0.0548,-0.0666,0.1261,0.1666,0.1584,0.1412,0.111,-0.1101,-0.0138,-0.2373,-0.086,0.011,-0.1462,-0.0203,0.0354,-0.0207,-0.0938,0.1446,-0.0187,0.192,0.0633,0.1345,0.0811,-0.0793,-0.118,-0.0002,-0.0229,-0.0454,-0.0282,0.3497,0.2077,0.2487,0.213,0.0613,-0.0085,-0.0659,0.2047,0.2457,0.0927,0.0433,0.0292,0.0317,-0.024,0.081,0.0478,0.0548,0.1801,0.1208,0.1273,-0.1034,-0.0369,0.0331,0.3966,0.0179,0.1338,0.206,0.4328,-0.0325,0.1919,0.0183,0.0679,-0.0029,-0.018,0.0104,0.1394,0.1575,0.3056,-0.0472,0.0824,-0.2371,0.0769,-0.0668,0.1391,-0.04,-0.1387,-0.3581,0.0796,0.027,0.019,-0.1544,0.2304,0.2879,0.2273,0.0002,0.0818,0.1854,0.198,0.1426,0.1341,0.0044,0.0267,-0.0064,0.2997,0.0392,-0.0117,0.081,-0.0045,0.032,0.0902,0.1243,-0.1316,-0.0092,0.0358,0.0292,0.1919,0.2703,0.1199,0.2262,0.0341,0.2948,0.2403,-0.0579,-0.2069,-0.1262,0.0419,0.0671,0.0319,-0.1388,-0.1353,-0.2099,0.3471,0.3861,-0.0766,-0.1324,0.0093,-0.0452,-0.0589,0.0976,0.0463,-0.0083,0.0532,0.1334,-0.0315,0.0688,0.0916,0.003,0.1269,-0.1271,-0.0118,-0.1565,-0.2428,-0.1256,-0.0089,0.2456,0.2567,0.1358,0.1395,0.3432,0.2007,-0.0951,0.0313,0.0886,-0.457,-0.2977,-0.2767,-0.3894,-0.2278,-0.2486,-0.3248,-0.2004,-0.1818,-0.1486,-0.2793,-0.2877,-0.3522,-0.4332,-0.2165,0.3073,-0.0738,-0.0346,-0.1506,0.0999,0.1853,-0.0822,0.0977,-0.0281,-0.2438,-0.0905,0.0944,0.069,-0.0982,-0.0241,-0.0072,-0.2186,0.0416,0.0485,-0.1571,-0.1738,0.1138,0.0824,-0.0149,-0.0171,-0.0114,0.0049,-0.009,0.0189,-0.022,0.4456,0.1757,0.184,0.2182,0.1867,0.1918,0.2897,0.192,0.125,0.1318,0.0355,-0.0276,-0.1565,0.122,0.3888,-0.2168,0.0034,-0.0824,-0.0264,0.0894,-0.1327,0.1311,0.107,0.0555,0.0476,0.1307,-0.0453,0.045,-0.1151,-0.1675,-0.1728,-0.0528,0.1418,0.0155,0.1081,0.3094,0.1825,0.1907,0.1464,-0.1162,0.0155,0.0542,-0.045,0.1173,0.0136,-0.0519,0.0768,0.0498,0.0904,0.0699,-0.0312,0.011,-0.0343,0.1122,0.1029,-0.145,-0.0486,-0.0239,0.0258,0.0123,0.0131,-0.0858,-0.0002,0.1337,-0.2128,-0.3084,-0.2454,0.0343,-0.2211,-0.0143,0.1128,0.1088,-0.146,-0.2799,-0.0971,-0.0959,-0.0145,-0.1318,0.1044,0.0973,0.0617,0.0524,-0.0612,-0.0801,0.002,0.0613,-0.0016,-0.0263,-0.1831,-0.1705,-0.1824,0.0695,0.011,0.0171,0.0076,-0.0488,-0.0261,0.2559,0.0976,0.0727,0.1447,0.1041,0.1088,-0.0562,-0.0134,-0.0349,0.0347,0.0644,-0.2165,-0.2648,-0.153,-0.1017,-0.1523,0.0368,0.0842,0.0445,-0.0188,0.0811,0.0974,-0.0506,0.2195,0.3052,0.272,-0.2033,-0.0865,-0.0038,-0.0435,-0.0659,-0.2062,-0.0531,-0.0483,-0.23,0.1105,0.181,0.2268,-0.1979,-0.06,0.1376,-0.1162,-0.0966,-0.1957,-0.2599,0.1051,0.0925,0.0979,0.0797,-0.3593,0.0283,-0.0454,-0.0289,0.1231,-0.0617,-0.1082,0.0638,-0.137,-0.055,0.2539,0.101,0.2426,0.1943,0.1743,-0.072,0.0327,-0.0009,-0.1493,-0.0585,-0.0467,-0.4584,-0.4136,-0.1866,-0.249,0.1641,-0.146,-0.0983,-0.3181,-0.3229,-0.3382,0.0177,-0.0485,-0.0123,-0.1806,-0.0519,-0.1008,-0.0864,-0.0897,-0.1017,0.1135,-0.0225,0.0798,-0.0778,-0.0604,-0.0167,-0.0563,0.0217,-0.1968,-0.0259,-0.0218,0.0059,0.2261,0.1621,0.113,0.0843,0.2134,-0.0944,0.0698,0.1231,0.0093,-0.197,-0.1238,0.3108,-0.0323,0.0307,0.2232,-0.0139,-0.0046,-0.0237,-0.1061,-0.07,-0.1825,-0.3865,-0.3183,-0.0493,-0.0556,-0.2541,0.122,0.0709,-0.078,0.0233,0.0317,-0.022,0.0018,0.0659,0.2346,0.2555,0.3153,0.2693,0.1154,0.0926,0.1488,0.0188,0.0392,-0.1113,-0.0358,0.0415,-0.0224,-0.0082,-0.2973,0.1767,-0.046,0.1109,0.0763,0.21,-0.0418,0.0166,0.1547,0.0499,-0.3515,0.0237,0.0252,0.0117,0.0094,0.0021,-0.0617,-0.0072,0.0189,0.0807,-0.0145,0.0366,0.1906,-0.0435,0.0364,-0.1095,0.0288,0.2841,0.1596,-0.0159,0.0965,0.055,0.0348,0.1892,0.0881,-0.1325,-0.0299,-0.1126,0.4385,0.1431,0.1322,0.3486,0.2254,0.1494,0.1243,0.1243,0.1039,0.0222,-0.1541,0.2144,0.0771,-0.007,0.0359,0.0731,0.1068,0.4285,-0.1999,0.0573,-0.0479,0.01,-0.3242,-0.0172,0.0362,0.2281,0.0451,0.0399,0.0574,0.0568,-0.2568,-0.1527,-0.3237,-0.4766,-0.3517,0.027,-0.0465,-0.2762,-0.1706,-0.0338,0.2096,0.1945,0.0627,0.1348,0.039,-0.0117,-0.0058,-0.1081,0.0265,0.0934,-0.143,0.0456,0.1203,-0.0743,0.062,0.1116,0.0303,0.1629,0.0358,-0.042,-0.248,0.1299,-0.5355,-0.4989,-0.2306,-0.3755,-0.246,0.0758,-0.0559,0.0813,-0.0826,-0.0391,0.0124,-0.1773,0.0364,-0.0764,-0.0774,-0.0733,-0.0073,0.1002,-0.0404,0.0303,0.0219,-0.1867,0.0982,-0.2537,-0.1127,-0.2124,-0.0216,-0.1277,-0.0075,-0.1023,0.0364,0.0849,-0.0132,-0.0123,-0.0161,0.1555,0.119,0.0171,-0.094,-0.1194,-0.0218,-0.0291,0.0822,-0.0225,-0.0705,0.0436,-0.1345,-0.0599,-0.0629,0.0051,-0.1415,0.0175,-0.0168,-0.1892,-0.0078,0.1066,0.0929,0.0478,0.0418,-0.0585,-0.0929,0.0737,-0.0873,-0.1326,-0.032,-0.037,-0.0752,-0.1822,-0.0965,0.021,0.0695,0.07,0.0522,-0.1245,-0.0251,0.0424,0.0854,0.0502,-0.1484,0.068,0.2357,0.1715,0.161,0.1899,0.0539,0.0068,-0.0415,0.2162,0.1652,0.2136,-0.0344,0.0866,-0.0555,-0.0122,-0.1656,-0.0864,0.1609,0.128,0.0207,-0.0339,0.0312,0.122,-0.1092,-0.142,0.1031,0.018,0.0292,0.0538,-0.0335,-0.0343,-0.0588,-0.0035,-0.0017,0.2229,-0.0105,0.1942,0.211,-0.0539,0.1279,-0.1044,-0.1901,-0.1775,-0.1747,-0.1611,0.1166,0.2475,0.0397,-0.1193,-0.1697,0.0023,0.0073,0.0965,0.0314,0.0896,0.0285,0.1332,0.1564,0.0641,-0.001,0.1097,0.1595,0.1044,0.1026,0.0412,0.0403,0.0552,0.0085,0.1987,0.0845,0.0092,0.0071,-0.0103,-0.0771,-0.229,-0.168,-0.0297,0.0579,0.0515,0.1116,0.0547,0.0873,0.3161,0.0448,0.0263,0.0378,0.0764,-0.0178,-0.0249,-0.0077,0.1126,-0.0593,0.2069,0.0946,0.2071,0.2024,-0.0844,0.1806,0.1329,0.3075,0.0914,-0.0955,-0.3822,0.1898,0.0911,0.013,-0.0446,-0.051,0.0192,0.1404,0.2249,0.1232,0.146,0.0719,-0.0578,-0.0191,0.0557,0.0195,-0.0902,-0.0675,-0.0664,-0.1081,0.0467,0.0106,-0.0592,0.007,-0.0032,0.0908,0.1411,0.1105,-0.1764,-0.0077,-0.0774,-0.0371,-0.0981,-0.1147,-0.2053,0.0045,0.1102,0.2038,0.0915,0.0404,-0.2448,-0.2564,-0.0926,0.0477,0.0531,-0.0582,-0.3328,-0.1606,-0.1759,-0.1464,0.2991,0.0284,0.009,0.044,0.1678,-0.0952,-0.1401,-0.1239,-0.0342,-0.0813,-0.0406,0.0826,-0.0577,-0.123,0.1433,-0.244,-0.0541,0.0145,0.0351,-0.0875,-0.0059,0.0217,0.001,-0.0142,-0.1147,-0.2881,-0.1562,-0.214,0.1308,-0.0797,0.1167,0.0268,0.127,0.4191,0.4202,-0.0838,-0.1049,-0.1927,0.0865,-0.0468,0.0807,0.1712,0.2236,0.2284,-0.0431,0.0674,-0.0217,0.0465,-0.0901,0.0135,0.1787,0.0544,0.1379,0.1187,-0.1876,0.207,0.0164,0.3006,0.1218,0.1015,-0.0049,0.0079,-0.0655,-0.0148,-0.1018,0.1438,-0.1945,0.16,-0.198,-0.1667,-0.1679,-0.0181,0.0249,-0.1635,-0.2624,-0.2367,0.2491,0.1921,0.0663,0.1018,0.2429,0.0994,0.0642,0.2809,0.1584,0.0671,0.2109,-0.0784,0.0931,0.0124,0.0385,0.1736,0.1278,0.1559,0.2737,0.1472,-0.173,0.1224,0.288,0.0942,-0.1742,0.0657,-0.0716,-0.0246,-0.1429,-0.1347,-0.0984,0.1637,0.2109,0.1173,0.0594,-0.0409,-0.1626,-0.0501,-0.0606,-0.0197,-0.2837,-0.0742,-0.1637,-0.1049,-0.0401,0.2917,0.3116,0.1633,0.0957,0.0761,0.0791,0.1584,0.0766,-0.0981,-0.0254,0.018,0.0307,0.0296,0.197,-0.2585,-0.1956,-0.1458,-0.0929,-0.0189,-0.147,0.0902,0.0263,0.0702,-0.0974,-0.1631,-0.1775,-0.0161,-0.0147,-0.344,-0.3258,-0.3758,-0.2235,0.0131,0.1323,-0.0155,-0.0407,-0.0224,-0.0303,-0.0529,-0.1446,-0.048,-0.0572,-0.0713,0.071,0.0529,0.2148,0.1486,0.1437,0.0651,-0.1958,0.0705,-0.1002,-0.218,-0.1589,0.0273,0.0503,-0.162,-0.0672,-0.2043,-0.2134,-0.1345,-0.2331,-0.1247,-0.026,0.0719,0.0358,-0.1439,-0.13,-0.0014,-0.1081,-0.011,-0.0585,-0.0685,-0.0544,0.0252,0.0538,0.0583,0.0932,-0.0797,-0.0875,-0.0707,0.1206,-0.0601,-0.0295,-0.2501,-0.1357,0.0727,-0.0216,-0.0747,0.0302,-0.1563,-0.1875,-0.0674,-0.0285,-0.0779,-0.1204,0.0588,0.0637,-0.0885,-0.005,-0.1817,-0.1081,0.0168,0.0862,0.138,0.0711,-0.0718,-0.4724,0.0591,0.0525,0.1379,0.1883,0.3993,0.2312,0.215,0.1975,0.1673,0.1419,0.122,-0.0931,-0.1232,-0.1013,-0.0826,0.1243,-0.0369,0.0896,0.1084,0.0851,-0.0248,-0.0429,-0.0269,-0.2474,-0.253,-0.0966,-0.0345,-0.0171,0.0682,0.1011,-0.0509,-0.008,0.0596,-0.1657,-0.0895,0.0678,0.0289,-0.0225,-0.1662,0.1461,0.1802,0.1427,0.1025,0.0256,0.0292,-0.0641,0.0713,-0.1052,0.1236,-0.0478,-0.284,0.0016,0.2706,0.0911,-0.1034,-0.1639,0.0951,0.0872,0.4633,0.3566,0.1801,0.293,-0.1029,0.1714,0.1546,-0.023,0.0349,-0.1337,-0.0701,-0.055,-0.004,-0.1104,-0.2206,-0.1419,-0.249,-0.0678,-0.0919,-0.2447,0.0072,-0.0194,-0.0857,-0.032,-0.1634,-0.1269,0.152,0.2556,0.2092,-0.0382,0.0825,0.0841,-0.1077,-0.0075,0.0111,-0.0344,-0.142,-0.0742,0.2447,0.1203,0.2072,0.0546,0.1669,0.1785,-0.0398,0.0894,-0.0212,0.1351,-0.0335,-0.0801,0.0192,0.1997,-0.0624,0.1993,0.0009,0.1185,0.1502,0.0753,0.0893,-0.001,-0.094,-0.0938,0.1043,0.0784,0.0977,-0.0376,-0.0791,-0.1316,0.0245,-0.3241,0.0606,0.1339,-0.0004,-0.154,0.0515,0.0822,0.1002,-0.107,-0.0043,0.0978,-0.1071,-0.2921,-0.373,0.035,0.066,0.0076,-0.1282,-0.0327,-0.2918,-0.0333,-0.4176,0.1215,-0.4708,-0.4589,-0.0917,-0.0387,-0.0346,0.0069,-0.0377,-0.1871,-0.1865,-0.094,0.0089,0.0518,0.1198,-0.0961,-0.21,-0.1866,0.2363,0.2099,0.2404,-0.0175,0.1503,0.0129,0.0799,-0.0569,-0.0692,0.0302,0.1265,0.1806,-0.2084,0.0323,0.1249,-0.3952,-0.2979,-0.0737,0.0776,-0.1841,-0.4836,-0.2552,-0.1635,-0.2131,-0.0083,-0.0602,-0.1443,-0.2417,0.1075,-0.2173,-0.0914,-0.1202,-0.0383,-0.5142,-0.1032,0.1419,0.1161,0.0275,0.2385,0.0658,0.1759,0.0748,0.0517,0.1398,-0.0155,0.2927,0.194,0.0272,0.1648,0.2653,0.1422,0.0252,0.0271,0.1149,0.1563,0.1557,0.158,0.0519,0.1036,0.2349,0.1901,-0.1148,-0.1773,0.03,-0.0064,-0.0111,-0.0153,0.085,0.0966,0.0706,-0.0023,0.0661,-0.0524,0.2452,0.312,0.1004,0.0365,0.241,0.242,-0.035,0.1078,0.0773,0.1846,0.1629,0.1443,0.0296,-0.0148,-0.0215,0.0225,-0.2107,0.1068,-0.1255,-0.2173,-0.2159,0.1607,-0.1274,0.2459,0.1673,0.0746,-0.0096,-0.0102,0.0146,-0.129,-0.1305,0.0171,0.0971,-0.1384,0.1519,-0.0048,-0.1788,0.0921,0.0871,0.1635,-0.0117,-0.0503,-0.1808,-0.1756,0.3154,0.2811,-0.1308,-0.1644,0.0022,-0.1852,-0.0108,0.0424,0.1507,0.2126,0.0559,0.1583,0.2747,0.1258,0.1058,-0.1509,-0.0406,-0.2082,0.0009,-0.237,0.0489,-0.0693,-0.0068,-0.0621,-0.0827,-0.021,0.0278,0.0396,0.0048,-0.0885,0.0442,-0.0365,0.088,0.0711,0.0643,0.0181,0.0456,-0.0222,0.0922,0.0782,0.172,0.0581,-0.0207,-0.0057,0.0001,-0.0101,0.0244,0.0224,0.0959,0.1024,-0.0177,0.0772,0.1314,0.1232,-0.2235,-0.1901,-0.1514,0.0547,-0.0505,0.1546,0.1363,-0.0195,0.0883,-0.1763,-0.1551,0.209,0.2033,-0.0742,0.1625,-0.0024,0.0561,0.0118,-0.1526,0.3342,-0.0337,0.1557,0.0542,0.0009,0.2633,0.2396,0.1291,-0.0587,0.0174,0.0742,0.0031,0.1482,0.0591,-0.1091,-0.0545,-0.0631,0.0062,-0.0239,-0.0016,0.1991,0.1015,-0.008,0.1503,-0.0628,0.273,-0.4303,0.1938,0.0109,-0.1432,-0.0919,0.3584,0.3173,-0.1316,-0.2487,-0.086,-0.2926,-0.1037,-0.1663,-0.1547,0.0658,-0.1711,-0.0583,-0.0658,0.0283,0.0595,0.1413,0.0675,0.0559,-0.02,-0.0716,-0.2268,-0.1013,-0.1055,-0.0408,0.0334,-0.0147,-0.059,-0.2079,-0.1548,-0.0345,-0.1717,-0.086,-0.0548,-0.04,-0.1382,-0.3685,-0.1543,-0.2542,-0.3129,-0.1776,0.1855,0.0394,0.3032,0.0114,0.0932,0.2912,0.2295,0.152,-0.2414,-0.1163,0.3727,0.3282,0.1638,0.0248,0.0339,0.2436,-0.0747,0.0498,0.0417,-0.072,0.0801,0.0228,-0.0058,0.1336,0.1623,-0.1029,0.2701,0.2647,-0.0554,-0.0312,-0.0242,0.0354,0.0233,0.1981,-0.2494,-0.2034,0.1616,-0.1249,-0.1124,0.0489,-0.0107,-0.0391,0.0944,-0.4321,-0.4387,0.1635,0.1297,-0.044,0.1591,0.0674,0.149,0.0208,-0.1201,0.1037,0.1246,-0.0849,0.0337,0.0846,-0.0706,auditory perception
